ibge,anomes,cadunico_tot_fam,cadunico_tot_pes,cadunico_tot_fam_rpc_ate_meio_sm,cadunico_tot_pes_rpc_ate_meio_sm,cadunico_tot_fam_pob,cadunico_tot_pes_pob,cadunico_tot_fam_ext_pob,cadunico_tot_pes_ext_pob,cadunico_tot_fam_pob_e_ext_pob,cadunico_tot_pes_pob_e_ext_pob
110001,202112,4318,11668,2861,8954,632,2126,988,3125,1620,5251
110002,202112,14454,36161,10417,29374,2719,8176,2623,7495,5342,15671
110003,202112,678,1960,512,1614,131,426,160,464,291,890
110004,202112,13487,33704,8976,25911,1789,5559,2727,7737,4516,13296
110005,202112,2697,6809,1875,5485,401,1258,484,1522,885,2780
110006,202112,1785,4885,1096,3435,165,564,217,652,382,1216
110007,202112,1403,3512,896,2654,288,889,210,767,498,1656
110008,202112,3751,9484,2733,8045,348,943,1709,5507,2057,6450
110009,202112,4819,12905,3032,9642,640,2168,1098,3493,1738,5661
110010,202112,8509,25333,6303,21233,1327,4472,2953,11007,4280,15479
110011,202112,7898,20220,5340,15692,1655,5199,732,2233,2387,7432
110012,202112,17134,41548,10369,29954,2274,7057,1117,3362,3391,10419
110013,202112,5897,16309,4073,12738,1539,5182,432,1482,1971,6664
110014,202112,4201,10736,2840,8143,558,1701,1221,3398,1779,5099
110015,202112,6184,15428,3783,10895,743,2382,1033,2619,1776,5001
110018,202112,4127,10125,2433,7200,418,1434,606,1809,1024,3243
110020,202112,84463,193392,61495,162321,14949,40039,23003,68308,37952,108347
110025,202112,5687,13340,3802,10156,702,2008,1774,4652,2476,6660
110026,202112,579,1421,411,1171,94,294,151,475,245,769
110028,202112,7759,18959,4737,13625,1066,3408,582,1662,1648,5070
110029,202112,1701,4068,1005,2870,207,601,374,1091,581,1692
110030,202112,14288,32145,8711,23832,1813,5789,1158,3463,2971,9252
110032,202112,3700,10006,2217,6915,695,2199,350,1197,1045,3396
110033,202112,3964,11845,2973,9998,986,3380,723,2735,1709,6115
110034,202112,3496,7987,2300,6349,753,2384,644,1958,1397,4342
110037,202112,1782,5095,1289,4191,300,975,523,1756,823,2731
110040,202112,3228,8614,2316,6973,582,1885,697,2019,1279,3904
110045,202112,5201,14407,3727,11723,991,3376,1134,3729,2125,7105
110050,202112,1895,4985,1284,3907,398,1341,153,422,551,1763
110060,202112,965,2762,646,2013,165,539,149,450,314,989
110070,202112,1695,5047,1198,3941,319,1124,245,747,564,1871
110080,202112,7032,15829,5275,13721,1121,2824,2845,8056,3966,10880
110090,202112,631,1678,430,1317,81,260,123,383,204,643
110092,202112,1378,3828,963,3050,199,629,429,1465,628,2094
110094,202112,3095,8803,2238,7136,841,2892,213,721,1054,3613
110100,202112,1827,5185,1412,4395,424,1399,490,1567,914,2966
110110,202112,1922,5012,1361,4131,453,1465,255,872,708,2337
110120,202112,1400,3860,1046,3176,241,794,353,1055,594,1849
110130,202112,3060,7378,1767,4981,133,397,175,423,308,820
110140,202112,2385,6697,1674,5273,362,1211,517,1640,879,2851
110143,202112,1447,3843,1021,3021,316,955,171,516,487,1471
110145,202112,1021,2589,601,1788,149,449,198,631,347,1080
110146,202112,527,1331,369,1080,72,178,177,556,249,734
110147,202112,820,2050,522,1487,64,202,214,532,278,734
110148,202112,1027,2733,496,1579,122,448,59,180,181,628
110149,202112,3548,9128,2347,7190,798,2582,460,1534,1258,4116
110150,202112,2966,7185,1889,5570,581,1937,375,1288,956,3225
110155,202112,843,2385,596,1803,120,403,212,573,332,976
110160,202112,1559,4608,1133,3677,330,1095,239,800,569,1895
110170,202112,2272,5634,1442,4109,241,742,773,2090,1014,2832
110175,202112,1954,5336,1347,4156,257,781,479,1565,736,2346
110180,202112,1575,4112,1101,3179,134,418,583,1643,717,2061
120001,202112,3603,10040,2910,9009,502,1654,1764,5575,2266,7229
120005,202112,2048,7542,1865,7285,162,635,1457,5876,1619,6511
120010,202112,5661,16010,4810,14783,440,1258,3571,11313,4011,12571
120013,202112,2465,7934,2166,7567,523,1741,1212,4628,1735,6369
120017,202112,2790,8226,2407,7646,411,1264,1444,4924,1855,6188
120020,202112,16270,58904,14960,56463,955,3847,12059,45806,13014,49653
120025,202112,3438,9064,2782,8290,339,1010,2000,6090,2339,7100
120030,202112,6747,25834,6253,24940,388,1747,4854,19664,5242,21411
120032,202112,1878,7944,1790,7785,88,547,1544,6590,1632,7137
120033,202112,4464,15604,4160,15052,83,477,3657,13087,3740,13564
120034,202112,2944,10060,2532,9377,99,533,2113,7723,2212,8256
120035,202112,4095,15023,3857,14612,231,998,3227,12168,3458,13166
120038,202112,2938,8865,2488,8142,452,1511,1476,4894,1928,6405
120039,202112,2137,8886,1994,8612,108,650,1625,7006,1733,7656
120040,202112,51088,148850,43692,137279,5732,18425,27724,88094,33456,106519
120042,202112,3695,12780,3417,12294,145,637,2888,10310,3033,10947
120043,202112,1619,6160,1432,5898,34,214,1313,5410,1347,5624
120045,202112,6454,16157,5535,15103,385,1138,4597,12501,4982,13639
120050,202112,10018,34451,9171,33208,372,1652,7694,28041,8066,29693
120060,202112,10144,38096,9281,36852,334,1967,8118,32011,8452,33978
120070,202112,3546,10636,3065,9977,292,851,2184,7461,2476,8312
120080,202112,4804,14198,4269,13428,487,1468,3120,10128,3607,11596
130002,202112,3511,12615,3144,12093,259,749,2637,10565,2896,11314
130006,202112,2716,9400,2252,8631,333,1146,1450,6005,1783,7151
130008,202112,2855,9636,2508,9145,79,310,2142,7848,2221,8158
130010,202112,4137,11827,3472,11066,115,282,3109,10096,3224,10378
130014,202112,3805,10495,2936,9138,466,1475,1805,5757,2271,7232
130020,202112,3186,11992,2838,11479,96,553,2407,9717,2503,10270
130030,202112,11972,35049,10913,33800,357,799,9874,31167,10231,31966
130040,202112,4498,12641,3717,11621,460,1192,2761,9027,3221,10219
130050,202112,8102,28298,6787,26590,238,884,6077,24274,6315,25158
130060,202112,8250,31392,7056,29846,359,1864,5937,25026,6296,26890
130063,202112,6960,22082,6188,21220,192,794,5642,19423,5834,20217
130068,202112,4163,13476,3502,12569,156,782,2775,9865,2931,10647
130070,202112,8070,21644,6602,20054,415,984,5289,16849,5704,17833
130080,202112,7975,26939,6994,25829,241,1114,6039,22774,6280,23888
130083,202112,2985,9324,2651,8915,176,593,2147,7481,2323,8074
130090,202112,3909,11612,3471,11084,39,163,3166,10282,3205,10445
130100,202112,8377,24725,7064,23351,125,259,6546,22299,6671,22558
130110,202112,8864,24310,7180,22228,1126,2856,4945,16711,6071,19567
130115,202112,5383,16614,4622,15744,119,307,4063,14194,4182,14501
130120,202112,14436,49940,12675,47583,1147,4466,10086,38492,11233,42958
130130,202112,6113,17933,4685,16075,520,1713,3356,11863,3876,13576
130140,202112,7620,25805,6622,24669,299,1255,5617,21148,5916,22403
130150,202112,3948,14066,3713,13801,60,365,3444,12823,3504,13188
130160,202112,5826,19172,4992,18117,386,1016,4160,15845,4546,16861
130165,202112,3390,12474,3179,12226,106,467,2881,11194,2987,11661
130170,202112,12614,34928,10153,32117,714,2143,8312,27016,9026,29159
130180,202112,4617,14781,4384,14521,43,202,4226,13985,4269,14187
130185,202112,20435,47876,16756,43921,1491,2288,13445,38428,14936,40716
130190,202112,20538,64678,16530,58860,1747,5511,11918,44568,13665,50079
130195,202112,2682,9253,2190,8601,90,353,1835,7293,1925,7646
130200,202112,3047,7823,2500,7124,97,270,2165,6183,2262,6453
130210,202112,1404,5182,1256,5000,101,542,1018,3971,1119,4513
130220,202112,2597,8199,2178,7692,90,300,1901,6872,1991,7172
130230,202112,5276,20241,4594,19290,185,1095,4015,16874,4200,17969
130240,202112,13602,38435,11071,35205,140,729,10112,32194,10252,32923
130250,202112,27937,80490,23907,75911,1667,4036,19502,64761,21169,68797
130255,202112,5159,16040,4428,14779,169,574,3606,12121,3775,12695
130260,202112,282881,745653,229841,672226,62665,189457,103656,322186,166321,511643
130270,202112,10608,35409,8746,32546,1762,5996,5056,20353,6818,26349
130280,202112,3798,14632,3486,14280,91,418,3237,13421,3328,13839
130290,202112,15088,46650,13216,44324,834,2398,11266,38878,12100,41276
130300,202112,5263,17101,4724,16392,151,769,4106,14260,4257,15029
130310,202112,7197,22019,6245,20833,336,1203,5261,17704,5597,18907
130320,202112,3716,11808,3101,10993,459,1556,2188,8123,2647,9679
130330,202112,4983,15155,4008,14003,215,833,3378,11881,3593,12714
130340,202112,26395,75518,22697,71351,1882,3945,18859,62335,20741,66280
130350,202112,4249,14810,3828,14285,132,620,3377,12594,3509,13214
130353,202112,8473,21663,6829,19598,983,2547,4688,14282,5671,16829
130356,202112,5731,17296,4763,15810,915,2832,2751,9866,3666,12698
130360,202112,3271,10274,2724,9572,69,247,2466,8701,2535,8948
130370,202112,5931,23400,5076,22212,337,1800,3936,17350,4273,19150
130380,202112,7656,31741,7103,30927,420,2276,5992,25988,6412,28264
130390,202112,6696,26427,5973,25286,556,2465,4781,20519,5337,22984
130395,202112,2636,8056,2256,7458,209,687,1743,5832,1952,6519
130400,202112,3060,9001,2621,8426,124,296,2324,7673,2448,7969
130406,202112,11393,38246,9545,36004,1904,6733,6166,24828,8070,31561
130410,202112,4718,15805,4035,14694,1150,4319,1885,7160,3035,11479
130420,202112,15262,50477,12736,47342,1006,3995,9846,37214,10852,41209
130423,202112,4743,14326,4152,13649,198,674,3647,12006,3845,12680
130426,202112,2944,11276,2713,10996,45,227,2528,10337,2573,10564
130430,202112,4640,12463,3979,11604,171,495,3474,10123,3645,10618
130440,202112,5466,16246,4594,15206,81,298,4290,14306,4371,14604
140002,202112,2458,7035,2142,6656,105,359,1791,5678,1896,6037
140005,202112,3415,9325,2966,8804,233,580,2411,7465,2644,8045
140010,202112,57461,149955,45912,132869,11209,34311,18550,55242,29759,89553
140015,202112,4144,11690,3519,10939,294,797,2954,9515,3248,10312
140017,202112,5504,14012,4857,13208,371,792,3988,11234,4359,12026
140020,202112,5474,15315,4713,14337,268,950,3857,11716,4125,12666
140023,202112,2674,7638,2177,6936,205,647,1654,5398,1859,6045
140028,202112,2014,5118,1691,4718,81,252,1359,3808,1440,4060
140030,202112,5632,13923,5006,13205,310,551,4438,12079,4748,12630
140040,202112,2726,10328,2517,10053,84,504,2316,9116,2400,9620
140045,202112,2684,9699,2216,9056,388,1335,1376,6335,1764,7670
140047,202112,6695,18366,5571,16739,626,1904,3938,12071,4564,13975
140050,202112,1578,4517,1339,4181,148,415,965,3164,1113,3579
140060,202112,1812,4613,1562,4267,121,304,1275,3563,1396,3867
140070,202112,2029,10190,1959,10057,107,763,1685,8525,1792,9288
150010,202112,48992,118998,44189,112844,1160,2438,39575,101196,40735,103634
150013,202112,2111,5091,1783,4734,148,263,1415,4017,1563,4280
150020,202112,14867,43519,13671,41938,1949,4777,10421,33820,12370,38597
150030,202112,8919,33322,8079,32317,470,1699,7011,28616,7481,30315
150034,202112,4646,10736,3785,9685,286,651,3111,8161,3397,8812
150040,202112,17546,43304,15369,40911,1266,1761,12941,37378,14207,39139
150050,202112,7636,24963,6966,24078,127,500,6448,22515,6575,23015
150060,202112,23713,62141,19089,55282,2684,7826,12539,37046,15223,44872
150070,202112,8042,27419,7059,26266,185,793,6480,24254,6665,25047
150080,202112,98799,216781,80766,192197,21339,56091,18804,55777,40143,111868
150085,202112,8741,23785,7903,22814,149,379,7367,21513,7516,21892
150090,202112,11025,36929,10361,35693,789,2449,8479,29557,9268,32006
150095,202112,6638,17443,5855,16494,385,594,5050,14877,5435,15471
150100,202112,3043,10249,2691,9675,265,746,2040,7665,2305,8411
150110,202112,4484,17932,4171,17581,169,737,3850,16383,4019,17120
150120,202112,8540,25762,8056,25194,277,609,7157,23124,7434,23733
150125,202112,831,2038,604,1736,99,343,372,1045,471,1388
150130,202112,24338,66968,20801,61587,4189,11022,12264,39617,16453,50639
150140,202112,289718,635920,244237,574834,38690,84129,139207,343034,177897,427163
150145,202112,4569,13807,3819,12625,1159,3656,1553,6010,2712,9666
150150,202112,18412,44013,15926,40923,1025,2519,12877,33315,13902,35834
150157,202112,3924,10226,3111,9161,370,987,2098,6538,2468,7525
150160,202112,3559,9349,3294,8969,473,1113,2286,6410,2759,7523
150170,202112,27317,82263,23965,76716,4605,13331,14282,49378,18887,62709
150172,202112,5584,14355,4490,12856,336,749,3333,9998,3669,10747
150175,202112,1798,5348,1478,4782,248,815,873,2873,1121,3688
150178,202112,11474,28898,9345,26479,489,790,8013,23637,8502,24427
150180,202112,24622,80124,22305,77517,1578,3404,19204,69751,20782,73155
150190,202112,7346,22763,6816,22120,190,683,6200,20142,6390,20825
150195,202112,5684,16976,5320,16438,203,638,4774,14761,4977,15399
150200,202112,6223,17694,5675,17088,46,106,5380,16306,5426,16412
150210,202112,29518,95100,27622,92723,1473,4091,23331,81070,24804,85161
150215,202112,9573,25993,8263,23988,1438,4107,4784,14290,6222,18397
150220,202112,13773,36823,12032,34383,1164,2883,8337,24592,9501,27475
150230,202112,13941,37507,12321,35330,1500,3591,8245,25116,9745,28707
150240,202112,36431,95792,30214,85397,7197,20940,11593,32502,18790,53442
150250,202112,4498,16429,4187,16083,579,2179,3311,13020,3890,15199
150260,202112,2818,8693,2518,8248,130,352,2050,6834,2180,7186
150270,202112,9847,26772,6901,21490,2084,6906,1504,5026,3588,11932
150275,202112,7318,22090,6649,21169,229,717,5781,18427,6010,19144
150276,202112,2558,6503,2191,6053,290,658,1410,4451,1700,5109
150277,202112,5566,13785,4407,12450,487,1258,3139,9491,3626,10749
150280,202112,7480,28493,7211,28069,397,1440,6290,24848,6687,26288
150285,202112,3468,11833,3026,11137,217,786,2245,8465,2462,9251
150290,202112,11564,29679,10465,28507,459,726,9331,26332,9790,27058
150293,202112,10147,23881,7868,20944,1264,3163,4669,13176,5933,16339
150295,202112,8131,20830,5775,17584,1852,6042,1701,6183,3553,12225
150300,202112,2571,7267,2329,6973,30,85,2161,6512,2191,6597
150304,202112,4706,13080,3885,11813,630,1689,2489,8105,3119,9794
150307,202112,6359,19446,5795,18525,306,828,4588,14888,4894,15716
150309,202112,7081,19650,5679,17325,893,2606,3301,10579,4194,13185
150310,202112,7887,29919,7477,29425,191,904,6663,26518,6854,27422
150320,202112,9698,25654,8816,24386,424,1139,6849,18925,7273,20064
150330,202112,14816,44892,13664,43176,1779,4907,9662,32337,11441,37244
150340,202112,2661,7536,2337,7063,339,910,1594,5024,1933,5934
150345,202112,9327,25043,8328,23746,442,1227,7165,20552,7607,21779
150350,202112,9819,23712,8955,22612,821,1396,7313,19180,8134,20576
150360,202112,25549,67379,20317,60843,2320,4955,14095,46136,16415,51091
150370,202112,12154,34391,9881,31324,1313,3361,6822,23720,8135,27081
150375,202112,4005,15638,3640,15133,225,982,3158,13280,3383,14262
150380,202112,11809,28748,9667,25944,130,395,8542,22897,8672,23292
150390,202112,7958,30974,7088,29628,1128,3858,4982,22442,6110,26300
150400,202112,6994,24088,6700,23564,216,673,5958,21100,6174,21773
150405,202112,9764,24649,8487,23136,559,1014,6825,19366,7384,20380
150410,202112,2118,6230,1804,5710,276,697,1137,3834,1413,4531
150420,202112,43620,115109,33433,100258,8613,26583,11995,41874,20608,68457
150430,202112,8833,24657,8011,23615,983,1918,6176,19346,7159,21264
150440,202112,6219,18277,5619,17470,925,2431,3757,12509,4682,14940
150442,202112,30553,67703,25349,61410,2526,5635,18165,44740,20691,50375
150445,202112,7130,20412,6237,19110,230,643,5443,16767,5673,17410
150450,202112,5583,22348,5163,21797,394,1891,4364,18415,4758,20306
150460,202112,9016,28287,8206,27272,226,739,7059,24366,7285,25105
150470,202112,22491,56957,20130,54277,324,873,19013,51215,19337,52088
150475,202112,5602,16552,4750,15266,810,2263,3126,10679,3936,12942
150480,202112,14717,44493,13169,42251,2543,6694,8654,30334,11197,37028
150490,202112,8987,30011,8175,28971,460,1361,6878,24939,7338,26300
150495,202112,5898,18551,5595,18150,127,468,5093,16539,5220,17007
150497,202112,2973,9022,2370,7977,509,1725,1225,4444,1734,6169
150500,202112,3525,8656,3105,8042,316,727,2323,6031,2639,6758
150503,202112,5341,13228,3694,11081,1035,3276,1172,4041,2207,7317
150506,202112,11884,33127,9924,30458,2071,5672,6026,20566,8097,26238
150510,202112,11240,36915,9729,34245,1388,4204,6489,24209,7877,28413
150520,202112,8220,29560,7888,29156,142,741,7268,26785,7410,27526
150530,202112,13269,43156,11427,40487,1461,3912,8210,31198,9671,35110
150540,202112,5455,13880,4667,12721,322,741,3840,10558,4162,11299
150543,202112,7536,19762,6171,18068,472,1310,4765,14645,5237,15955
150548,202112,10868,32755,9747,31210,234,766,8691,28000,8925,28766
150549,202112,2110,5883,1789,5431,59,176,1476,4529,1535,4705
150550,202112,22443,63133,18461,56703,4947,15216,6976,23217,11923,38433
150553,202112,37816,100255,29133,85268,7973,23453,11175,34086,19148,57539
150555,202112,2131,5380,1660,4645,191,412,1082,3243,1273,3655
150560,202112,2051,5806,1810,5350,302,804,1046,3268,1348,4072
150563,202112,2806,8043,2293,7155,467,1486,1236,3935,1703,5421
150565,202112,4807,14788,4275,13960,91,366,3596,11828,3687,12194
150570,202112,7015,20612,6529,19970,477,1160,5460,17130,5937,18290
150580,202112,11243,42201,9552,40330,575,2705,7487,33636,8062,36341
150590,202112,8631,28833,7374,27338,133,768,6772,25053,6905,25821
150600,202112,10650,32901,9865,31949,230,769,9129,29718,9359,30487
150610,202112,3219,8593,2861,8041,135,378,2400,6727,2535,7105
150611,202112,3563,9364,3160,8818,103,298,2807,7823,2910,8121
150613,202112,15200,39711,11520,33683,2050,6311,5790,16774,7840,23085
150616,202112,4014,10723,2903,8815,637,1970,1200,3696,1837,5666
150618,202112,7559,20729,6136,18550,651,1919,3797,12050,4448,13969
150619,202112,7297,19206,5993,17434,344,731,4944,14749,5288,15480
150620,202112,7154,23047,6147,21365,722,2246,4074,14754,4796,17000
150630,202112,7020,17724,6395,16977,326,673,5576,14993,5902,15666
150635,202112,5529,14415,4600,12900,641,1666,2904,8345,3545,10011
150640,202112,2334,6772,2123,6504,38,109,1977,6109,2015,6218
150650,202112,12452,32626,10726,29908,3010,8072,4531,13946,7541,22018
150655,202112,5866,16458,5298,15628,234,610,4571,13577,4805,14187
150658,202112,4947,13613,3684,11514,776,2480,1732,5695,2508,8175
150660,202112,6210,16842,5474,15806,779,2071,3566,10601,4345,12672
150670,202112,9973,21454,7869,19056,779,1397,6267,16059,7046,17456
150680,202112,75681,210512,58563,183886,14117,42613,25074,90206,39191,132819
150690,202112,2969,6993,2544,6513,151,282,2165,5739,2316,6021
150700,202112,6703,18928,5988,18019,468,963,4684,14771,5152,15734
150710,202112,3921,12709,3540,12112,317,954,2631,9291,2948,10245
150715,202112,5541,14750,4539,13269,321,805,3629,10794,3950,11599
150720,202112,7396,24440,6860,23654,487,1493,5607,19911,6094,21404
150730,202112,13969,39947,11856,36846,1416,4456,8538,27262,9954,31718
150740,202112,4343,11512,3789,10655,357,808,2803,8160,3160,8968
150745,202112,5531,14969,4462,13436,613,1885,3135,9606,3748,11491
150746,202112,1871,5220,1689,4964,84,189,1405,4187,1489,4376
150747,202112,5426,15686,4779,14712,738,1849,3254,10684,3992,12533
150750,202112,4022,11806,3283,10677,247,809,2434,8238,2681,9047
150760,202112,12408,35186,11169,33466,1779,4680,7529,23712,9308,28392
150770,202112,7105,23865,6597,23297,272,546,5921,21857,6193,22403
150775,202112,1172,2972,905,2627,122,373,594,1749,716,2122
150780,202112,4679,14028,4137,13386,148,376,3725,12405,3873,12781
150790,202112,6477,17043,5528,16025,366,862,3855,13248,4221,14110
150795,202112,15627,45238,13455,41970,3108,9146,7563,25120,10671,34266
150796,202112,4178,9598,3621,8961,273,509,2992,7655,3265,8164
150797,202112,4469,12948,3836,12067,229,511,3121,10212,3350,10723
150800,202112,14159,42664,12661,40713,1643,4742,9193,30949,10836,35691
150803,202112,8066,23389,7474,22522,492,1150,6329,19501,6821,20651
150805,202112,3765,11026,3181,10195,283,812,2397,7939,2680,8751
150808,202112,6818,18876,4994,15855,1739,6150,687,2517,2426,8667
150810,202112,22609,55966,16988,49217,3480,10260,8269,27196,11749,37456
150812,202112,6080,16062,5362,14930,459,1353,4082,11151,4541,12504
150815,202112,10432,29054,8695,27009,782,2286,6979,22247,7761,24533
150820,202112,13432,33598,11472,31205,1719,3426,8084,24188,9803,27614
150830,202112,12884,43722,11903,42545,490,1650,10056,37754,10546,39404
150835,202112,3117,9182,2695,8529,366,1140,1793,5697,2159,6837
150840,202112,8647,22795,6952,20159,1165,3627,3853,11051,5018,14678
160005,202112,1317,3394,1158,3203,63,204,990,2747,1053,2951
160010,202112,2500,6567,2330,6383,17,71,2255,6124,2272,6195
160015,202112,3309,8701,2967,8293,69,196,2762,7739,2831,7935
160020,202112,2363,6951,2046,6555,202,509,1547,5270,1749,5779
160021,202112,1324,4692,1213,4555,49,242,962,3675,1011,3917
160023,202112,1433,4741,1270,4463,225,754,779,2932,1004,3686
160025,202112,1903,5635,1788,5507,34,84,1701,5286,1735,5370
160027,202112,9307,25060,8301,23788,702,1833,6641,19425,7343,21258
160030,202112,83256,223005,67561,202064,14687,40381,34578,115807,49265,156188
160040,202112,6222,20139,5660,19435,121,375,5262,18266,5383,18641
160050,202112,5389,15313,4225,13801,1474,4467,1562,6562,3036,11029
160053,202112,4310,12396,3838,11807,325,828,3027,9834,3352,10662
160055,202112,1059,2774,1025,2737,26,46,952,2575,978,2621
160060,202112,28588,69812,23573,64166,1761,4232,18125,52212,19886,56444
160070,202112,2990,10560,2618,9997,246,818,1984,8044,2230,8862
160080,202112,3542,10637,3107,10149,22,116,2935,9633,2957,9749
170025,202112,703,1762,496,1437,99,267,231,724,330,991
170030,202112,1318,3821,1032,3335,180,547,432,1466,612,2013
170035,202112,1577,3940,1160,3299,87,260,741,2078,828,2338
170040,202112,2025,5395,1618,4820,110,338,1034,3174,1144,3512
170070,202112,2030,4591,1445,3856,95,259,851,2402,946,2661
170100,202112,2564,7100,2116,6368,295,735,1237,3955,1532,4690
170105,202112,760,2117,524,1627,148,426,145,452,293,878
170110,202112,1071,3053,832,2630,96,322,462,1401,558,1723
170130,202112,1460,4051,1081,3363,180,567,560,1761,740,2328
170190,202112,1632,4205,1232,3592,285,959,492,1404,777,2363
170200,202112,2236,5108,1484,3910,236,612,591,1572,827,2184
170210,202112,28252,73685,21375,62347,6044,19289,3375,10376,9419,29665
170215,202112,1424,3682,1137,3282,45,161,898,2586,943,2747
170220,202112,6307,18683,5226,16749,1543,4808,1647,6183,3190,10991
170230,202112,1327,3723,979,3050,282,888,172,586,454,1474
170240,202112,2779,7421,2223,6536,167,506,1588,4583,1755,5089
170255,202112,4180,11573,3023,9577,676,2076,1210,4030,1886,6106
170270,202112,980,2332,665,1874,69,185,366,1038,435,1223
170290,202112,3138,8791,2725,8254,178,430,2124,6708,2302,7138
170300,202112,2198,5588,1781,4972,221,524,1189,3421,1410,3945
170305,202112,713,1876,603,1696,84,242,309,898,393,1140
170307,202112,1079,3365,884,3010,103,339,526,1815,629,2154
170310,202112,1696,4099,1209,3343,174,489,590,1668,764,2157
170320,202112,1120,2836,841,2384,80,230,520,1513,600,1743
170330,202112,949,2810,857,2677,42,173,711,2169,753,2342
170360,202112,594,1505,425,1229,22,83,294,797,316,880
170370,202112,1374,3469,992,2836,216,602,358,1052,574,1654
170380,202112,1979,5432,1511,4720,111,321,868,2855,979,3176
170382,202112,574,1629,474,1462,23,100,360,1070,383,1170
170384,202112,1776,5868,1452,5268,324,1096,690,2671,1014,3767
170386,202112,1055,2802,664,2057,76,270,247,726,323,996
170388,202112,770,2016,528,1598,78,253,234,686,312,939
170389,202112,1075,3212,879,2877,65,227,614,2054,679,2281
170390,202112,1911,4151,1443,3597,32,80,1225,3113,1257,3193
170410,202112,650,1723,465,1404,23,80,311,906,334,986
170460,202112,418,1086,346,975,42,120,227,644,269,764
170510,202112,984,2648,714,2188,42,144,441,1259,483,1403
170550,202112,7095,18164,5231,15229,1468,4499,1061,3336,2529,7835
170555,202112,1487,3856,1175,3377,116,286,550,1706,666,1992
170560,202112,1099,2953,842,2592,87,238,499,1650,586,1888
170600,202112,1427,3658,1129,3242,316,779,488,1575,804,2354
170610,202112,1731,4357,1282,3688,90,271,793,2245,883,2516
170625,202112,469,1205,316,912,40,106,124,343,164,449
170650,202112,1359,3831,1089,3393,140,414,647,2076,787,2490
170700,202112,3703,10546,2802,8823,565,1780,1157,3685,1722,5465
170710,202112,1625,4022,1260,3456,190,494,759,2137,949,2631
170720,202112,1865,4494,1428,3808,302,779,727,1998,1029,2777
170730,202112,1160,2992,866,2530,136,316,466,1452,602,1768
170740,202112,2209,6984,1897,6422,171,627,1355,4567,1526,5194
170755,202112,933,2448,657,1994,96,309,263,794,359,1103
170765,202112,1207,3018,855,2470,158,445,372,1120,530,1565
170770,202112,1992,5429,1609,4849,156,482,1106,3349,1262,3831
170820,202112,3804,10805,2941,9293,608,1895,1300,4316,1908,6211
170825,202112,1079,2413,885,2166,100,216,641,1582,741,1798
170830,202112,1450,3717,1166,3279,341,928,526,1532,867,2460
170900,202112,2943,8816,2485,8166,239,640,1920,6536,2159,7176
170930,202112,4033,10704,3059,8902,697,2135,872,2559,1569,4694
170950,202112,12075,32359,8411,25791,2124,7481,872,2942,2996,10423
170980,202112,515,1309,390,1115,71,208,199,549,270,757
171050,202112,1747,5298,1519,4917,53,213,1256,4057,1309,4270
171070,202112,1437,3910,1228,3606,326,881,535,1894,861,2775
171090,202112,1123,2765,879,2417,132,372,492,1337,624,1709
171110,202112,612,1582,419,1237,88,247,170,464,258,711
171150,202112,1168,2750,732,2026,75,222,443,1204,518,1426
171180,202112,834,2170,555,1655,100,274,237,724,337,998
171190,202112,2083,6481,1790,5978,283,973,1085,3732,1368,4705
171195,202112,850,2593,669,2252,74,293,425,1393,499,1686
171200,202112,635,1723,471,1455,115,388,163,491,278,879
171215,202112,414,1086,334,959,29,89,212,590,241,679
171240,202112,839,2633,668,2329,27,143,458,1558,485,1701
171245,202112,826,2249,648,1912,58,176,408,1160,466,1336
171250,202112,1066,2782,768,2324,141,450,348,1071,489,1521
171270,202112,521,1751,407,1504,88,324,169,679,257,1003
171280,202112,936,2702,749,2375,71,212,452,1491,523,1703
171320,202112,4296,11603,3354,9991,674,1855,1275,4075,1949,5930
171330,202112,2972,7928,2287,6714,569,1638,935,2884,1504,4522
171360,202112,1575,4258,1239,3771,111,313,836,2721,947,3034
171370,202112,765,1825,591,1584,53,140,418,1119,471,1259
171380,202112,1596,4197,1341,3854,162,406,896,2776,1058,3182
171395,202112,1106,2806,761,2207,67,198,505,1411,572,1609
171420,202112,2121,5846,1576,4813,289,840,693,2172,982,3012
171430,202112,1143,3198,962,2877,52,155,660,1907,712,2062
171488,202112,2569,7084,2051,6262,358,1108,1102,3408,1460,4516
171500,202112,1007,2471,745,2070,72,187,481,1339,553,1526
171510,202112,862,2665,746,2451,46,170,543,1772,589,1942
171515,202112,521,1267,395,1084,42,123,238,608,280,731
171525,202112,763,2023,575,1725,40,138,366,1059,406,1197
171550,202112,365,1023,283,894,40,148,152,453,192,601
171570,202112,1198,3450,1008,3117,150,443,570,1846,720,2289
171575,202112,1828,4789,1185,3660,134,419,526,1627,660,2046
171610,202112,6216,16773,4579,13989,916,3187,1048,3521,1964,6708
171620,202112,2826,7570,2395,6957,104,381,1981,5724,2085,6105
171630,202112,1115,2746,862,2410,92,248,592,1714,684,1962
171650,202112,2268,6182,1750,5332,399,1304,487,1673,886,2977
171660,202112,2510,6114,1747,4875,215,535,1023,2900,1238,3435
171665,202112,1306,3569,1030,3127,202,652,465,1441,667,2093
171670,202112,2044,5278,1530,4429,244,741,711,2073,955,2814
171700,202112,1267,3456,925,2839,108,312,512,1588,620,1900
171720,202112,828,2065,646,1789,54,145,463,1279,517,1424
171750,202112,1396,3806,938,2926,213,702,130,500,343,1202
171780,202112,1340,3257,1001,2768,69,199,728,1998,797,2197
171790,202112,1493,4625,1204,4028,182,582,583,1974,765,2556
171800,202112,785,2011,598,1738,74,232,333,946,407,1178
171820,202112,12399,33605,9164,28084,2178,6944,2214,7462,4392,14406
171830,202112,1662,5035,1417,4620,169,592,848,2820,1017,3412
171840,202112,794,2031,612,1752,20,62,395,1128,415,1190
171845,202112,688,1601,525,1367,44,153,352,867,396,1020
171850,202112,999,3135,838,2787,70,266,582,1897,652,2163
171855,202112,1116,3252,949,2950,73,193,605,1862,678,2055
171865,202112,481,1367,411,1259,71,209,217,651,288,860
171870,202112,886,2322,617,1852,81,229,316,962,397,1191
171875,202112,1397,3844,1129,3430,35,145,878,2645,913,2790
171880,202112,1343,3773,1169,3540,43,95,915,2874,958,2969
171884,202112,1008,2769,754,2322,142,436,280,917,422,1353
171886,202112,1578,4092,1127,3395,289,995,233,720,522,1715
171888,202112,717,1960,500,1561,25,94,307,914,332,1008
171889,202112,434,1250,311,1020,72,247,107,338,179,585
171890,202112,1262,3475,917,2919,152,440,520,1683,672,2123
171900,202112,586,1940,448,1629,72,221,186,729,258,950
172000,202112,618,1764,510,1585,78,231,256,799,334,1030
172010,202112,1147,3630,989,3348,90,286,633,2170,723,2456
172015,202112,399,1317,294,1105,52,183,122,475,174,658
172020,202112,2998,8020,2624,7547,180,506,1913,5777,2093,6283
172025,202112,755,2016,551,1688,43,135,381,1174,424,1309
172030,202112,1310,3783,1089,3419,76,237,795,2507,871,2744
172049,202112,1394,3238,921,2599,176,433,439,1383,615,1816
172065,202112,1518,3742,1203,3341,108,219,933,2780,1041,2999
172080,202112,2493,7127,2035,6328,125,360,1352,4233,1477,4593
172085,202112,494,1308,318,947,58,166,104,287,162,453
172090,202112,4356,10338,3412,9102,156,350,2626,7131,2782,7481
172093,202112,488,1420,346,1170,20,92,206,667,226,759
172097,202112,762,1923,524,1512,76,225,214,604,290,829
172100,202112,53498,127811,38670,104934,6704,19489,14482,40019,21186,59508
172110,202112,1721,5941,1475,5571,113,420,1115,4337,1228,4757
172120,202112,5417,15313,4258,13432,514,1649,2385,7704,2899,9353
172125,202112,424,1099,318,935,25,83,195,546,220,629
172130,202112,670,1601,511,1336,20,76,360,868,380,944
172208,202112,2777,6473,2232,5778,278,518,1541,4217,1819,4735
172210,202112,2832,6908,2176,6084,306,869,1252,3755,1558,4624
210005,202112,20193,55471,15142,47278,4223,13678,5546,18181,9769,31859
210010,202112,2011,5980,1816,5741,59,188,1602,5091,1661,5279
210015,202112,3507,10117,3040,9491,164,462,2493,7913,2657,8375
210020,202112,7557,17613,6428,16307,112,286,5888,15018,6000,15304
210030,202112,4862,15555,4453,14941,567,1722,3348,11627,3915,13349
210040,202112,2105,4629,1833,4306,104,233,1498,3491,1602,3724
210043,202112,6252,17301,5264,15912,385,1099,4099,12579,4484,13678
210047,202112,6961,20820,5658,19085,149,642,4863,16478,5012,17120
210050,202112,2305,7429,1821,6543,210,740,1220,4472,1430,5212
210055,202112,2065,6235,1874,5952,44,141,1653,5282,1697,5423
210060,202112,7855,27778,6975,26222,794,2817,4661,18236,5455,21053
210070,202112,7397,20086,6860,19381,36,121,6500,18319,6536,18440
210080,202112,4452,14554,4211,14285,25,153,3919,13359,3944,13512
210083,202112,5870,16199,4861,15108,172,451,4447,14053,4619,14504
210087,202112,3064,8304,2604,7685,184,518,2027,6044,2211,6562
210090,202112,9640,28971,8988,27865,1055,2229,7001,22748,8056,24977
210095,202112,6898,21635,6280,20849,430,1330,5099,17603,5529,18933
210100,202112,7065,21231,6173,19725,691,2061,4316,14083,5007,16144
210110,202112,2975,9198,2732,8901,52,223,2435,7932,2487,8155
210120,202112,25183,65157,20890,59709,2184,4567,14170,43752,16354,48319
210125,202112,4592,12134,3984,11420,857,1946,2599,8205,3456,10151
210130,202112,4486,11258,3682,10256,174,335,3119,8834,3293,9169
210135,202112,1720,4548,1418,4103,105,211,1147,3435,1252,3646
210140,202112,21115,53381,16329,47219,3542,9303,8547,26736,12089,36039
210150,202112,4834,10957,4266,10191,271,448,3528,8501,3799,8949
210160,202112,18645,50253,15768,46687,1405,3799,11213,34949,12618,38748
210170,202112,16591,48463,15384,46919,1004,2195,13261,41415,14265,43610
210173,202112,2333,8841,2172,8573,90,487,1885,7367,1975,7854
210177,202112,3564,9575,3082,8961,444,1121,2273,6984,2717,8105
210180,202112,1471,3854,1279,3620,25,63,1157,3288,1182,3351
210190,202112,5691,14523,4791,13317,92,267,4141,11413,4233,11680
210193,202112,1413,3951,1238,3677,58,140,898,2748,956,2888
210197,202112,2189,6557,2002,6305,163,454,1633,5289,1796,5743
210200,202112,8211,25410,7259,23899,435,1474,5749,18997,6184,20471
210203,202112,7547,21459,6359,19885,422,1201,5011,16175,5433,17376
210207,202112,4030,9601,3114,8586,167,357,2538,7167,2705,7524
210210,202112,8096,25536,7354,24500,122,657,6289,20814,6411,21471
210215,202112,2569,7988,2204,7451,110,526,1657,5530,1767,6056
210220,202112,6579,21672,6190,21106,133,855,5527,18466,5660,19321
210230,202112,5629,16116,5093,15323,417,952,4266,13165,4683,14117
210232,202112,12011,35720,9816,32407,1899,5909,5685,20385,7584,26294
210235,202112,3500,10441,3079,9824,165,572,2557,8197,2722,8769
210237,202112,3269,9711,2754,9100,20,94,2578,8499,2598,8593
210240,202112,2717,8179,2485,7797,63,187,2033,6279,2096,6466
210250,202112,6100,17808,5519,17070,62,297,5035,15533,5097,15830
210255,202112,2759,8153,2353,7450,288,929,1496,4690,1784,5619
210260,202112,5700,16645,4996,15634,387,1089,4035,12856,4422,13945
210270,202112,5333,14031,4744,13289,82,303,4273,11878,4355,12181
210275,202112,3579,8945,3085,8336,123,300,2528,6859,2651,7159
210280,202112,6040,16318,4851,14543,267,849,3668,10945,3935,11794
210290,202112,8069,20069,7229,19041,136,343,6747,17833,6883,18176
210300,202112,33965,90705,27510,81400,3576,10806,16424,51782,20000,62588
210310,202112,3228,7975,2835,7425,101,202,2508,6627,2609,6829
210312,202112,2920,6982,2610,6651,12,47,2499,6342,2511,6389
210315,202112,3193,8566,2749,8070,116,272,2393,7272,2509,7544
210317,202112,4411,13515,3986,13017,76,348,3612,11773,3688,12121
210320,202112,21384,60708,19619,58431,279,1091,17762,52704,18041,53795
210325,202112,3746,10398,3173,9650,160,428,2666,8379,2826,8807
210330,202112,25948,68847,20796,62388,4716,12215,11584,39421,16300,51636
210340,202112,10825,29967,9636,28409,595,1623,7708,23162,8303,24785
210350,202112,9309,26210,8160,24806,121,389,7302,22291,7423,22680
210355,202112,4315,14023,3807,13225,90,404,3231,11296,3321,11700
210360,202112,14336,43135,12616,40477,532,1943,9433,29757,9965,31700
210370,202112,11593,24941,8834,22039,305,468,8005,20511,8310,20979
210375,202112,3464,9060,2607,7826,850,2749,691,2327,1541,5076
210380,202112,5675,14121,4861,13145,351,807,3991,10960,4342,11767
210390,202112,2951,9266,2729,8897,119,380,2341,7664,2460,8044
210400,202112,4638,13686,4063,13004,121,340,3626,11825,3747,12165
210405,202112,7465,19008,6050,17043,1425,3643,3061,9472,4486,13115
210407,202112,2135,6683,1797,6099,85,295,1426,4817,1511,5112
210408,202112,2761,9818,2562,9539,140,600,2025,7595,2165,8195
210409,202112,4056,13290,3673,12770,99,467,3062,10825,3161,11292
210410,202112,3690,10626,3119,9666,114,385,2495,7670,2609,8055
210420,202112,3992,12374,3559,11595,263,647,2890,9691,3153,10338
210430,202112,2331,6676,2059,6321,139,354,1694,5339,1833,5693
210440,202112,4583,11898,3975,11140,84,220,3617,10105,3701,10325
210450,202112,2418,6944,2077,6455,138,356,1652,5214,1790,5570
210455,202112,4715,11879,3578,10434,956,2793,1639,5110,2595,7903
210460,202112,3878,10855,3273,10064,63,195,2855,8773,2918,8968
210462,202112,1791,5184,1503,4727,52,159,1194,3786,1246,3945
210465,202112,2822,7969,2448,7449,85,334,1984,5907,2069,6241
210467,202112,6304,18988,5478,17926,320,1014,4528,15127,4848,16141
210470,202112,2042,5372,1522,4636,127,293,1127,3610,1254,3903
210480,202112,17739,49975,14719,46292,1508,3658,10353,36173,11861,39831
210490,202112,3729,9096,2995,8102,78,183,2541,6866,2619,7049
210500,202112,6566,24401,6032,23499,382,1607,4961,19348,5343,20955
210510,202112,6050,19514,5267,18667,83,369,4758,17076,4841,17445
210515,202112,3907,11166,3318,10459,210,645,2661,8648,2871,9293
210520,202112,2642,7484,2352,7084,71,229,2008,5995,2079,6224
210530,202112,55124,132957,42542,114557,7150,22271,12805,41625,19955,63896
210535,202112,3678,11375,3327,10868,120,390,2846,9378,2966,9768
210540,202112,15790,43732,13064,39875,1828,4697,8648,28234,10476,32931
210542,202112,7011,15895,5505,14198,628,1299,4093,11282,4721,12581
210545,202112,2340,7016,2169,6744,31,107,1920,5921,1951,6028
210547,202112,3800,13095,3370,12307,251,823,2578,9676,2829,10499
210550,202112,6192,18339,4808,16097,373,1369,3267,11281,3640,12650
210560,202112,3953,11553,3480,10799,167,422,2886,8983,3053,9405
210565,202112,1550,4739,1289,4369,56,295,1008,3406,1064,3701
210570,202112,11058,29414,9804,27887,265,639,8612,24982,8877,25621
210580,202112,3219,8212,2538,7359,159,371,1764,5425,1923,5796
210590,202112,4423,12797,3842,12069,55,276,3447,10785,3502,11061
210592,202112,2746,7868,2512,7501,21,87,2174,6426,2195,6513
210594,202112,2642,6964,2043,6040,119,317,1505,4619,1624,4936
210596,202112,2920,9683,2598,9111,288,830,1919,7062,2207,7892
210598,202112,1937,5370,1781,5143,68,182,1549,4480,1617,4662
210600,202112,3154,8340,2572,7511,237,615,1757,5228,1994,5843
210610,202112,2951,7788,2510,7259,53,201,2177,6301,2230,6502
210620,202112,2983,7456,2445,6802,80,181,2162,6042,2242,6223
210630,202112,3265,10346,2935,9786,122,443,2401,7968,2523,8411
210632,202112,4947,14596,4359,13800,218,774,3548,11197,3766,11971
210635,202112,1808,6243,1696,6031,183,580,1277,4697,1460,5277
210637,202112,2673,8486,2275,7919,130,549,1699,6042,1829,6591
210640,202112,4816,16460,4500,16089,57,246,4170,14944,4227,15190
210650,202112,7568,21137,6834,20189,148,398,6094,18114,6242,18512
210660,202112,8460,24027,7517,22500,228,858,6403,18782,6631,19640
210663,202112,2893,7746,2625,7438,216,400,2115,6348,2331,6748
210667,202112,2059,6506,1845,6199,62,184,1603,5505,1665,5689
210670,202112,5190,16145,4681,15356,100,408,4133,13516,4233,13924
210675,202112,5392,14021,4604,13034,480,1054,3520,10514,4000,11568
210680,202112,4948,11388,4166,10474,120,152,3755,9595,3875,9747
210690,202112,7883,23578,6502,22013,243,873,5632,19480,5875,20353
210700,202112,2880,7844,2269,6962,173,435,1620,5201,1793,5636
210710,202112,5316,15709,4691,14851,90,407,4183,13132,4273,13539
210720,202112,3224,10001,2818,9500,57,313,2513,8387,2570,8700
210725,202112,1384,4370,1187,4063,48,145,813,2942,861,3087
210730,202112,1318,3202,1106,2913,48,109,953,2507,1001,2616
210735,202112,4936,13743,4193,12805,246,577,3500,11132,3746,11709
210740,202112,5432,13850,4663,12958,118,246,3969,11136,4087,11382
210745,202112,4623,12215,4249,11741,112,267,3835,10591,3947,10858
210750,202112,24959,63191,21578,58863,3434,8035,13386,39590,16820,47625
210760,202112,6135,15518,5105,14417,105,201,4769,13697,4874,13898
210770,202112,6516,16021,5620,14997,56,187,5286,14056,5342,14243
210780,202112,7886,23748,6846,22029,675,1785,5154,17038,5829,18823
210790,202112,4590,13751,4102,13116,251,480,3318,11202,3569,11682
210800,202112,5019,13238,4275,12239,64,231,3828,10856,3892,11087
210805,202112,4190,14552,3969,14214,149,581,3426,12331,3575,12912
210810,202112,5054,14304,4613,13736,482,1115,3582,11173,4064,12288
210820,202112,7401,20451,6159,18490,788,2275,3626,11331,4414,13606
210825,202112,7374,21835,6611,20832,374,892,5556,18058,5930,18950
210830,202112,8379,22470,7574,21511,577,1313,6278,18467,6855,19780
210840,202112,3320,8504,2980,8054,32,98,2696,7188,2728,7286
210845,202112,6689,17542,5917,16690,60,171,5623,15990,5683,16161
210850,202112,6348,20159,5182,18432,293,1095,4010,14456,4303,15551
210860,202112,22305,54191,18465,49504,1293,2940,14397,40797,15690,43737
210870,202112,7662,19100,6107,17336,201,441,5393,15470,5594,15911
210880,202112,4267,12798,3808,12224,210,685,2987,9651,3197,10336
210890,202112,4162,11563,3751,11088,460,1067,2840,8820,3300,9887
210900,202112,5004,13878,3864,11831,1482,4855,525,1915,2007,6770
210905,202112,2149,5548,1800,5111,66,113,1623,4741,1689,4854
210910,202112,7465,22087,6147,19988,764,2418,4007,13215,4771,15633
210920,202112,3230,10352,2798,9780,57,311,2500,8659,2557,8970
210923,202112,1684,4708,1424,4307,102,265,1047,3205,1149,3470
210927,202112,5216,16433,4539,15610,584,1851,3158,11474,3742,13325
210930,202112,2631,8421,2291,7767,151,450,1763,5993,1914,6443
210940,202112,4094,11400,3802,11062,121,421,3434,9864,3555,10285
210945,202112,7324,19877,6524,18944,268,644,5460,16335,5728,16979
210950,202112,5532,14774,4241,12991,664,1525,2698,9182,3362,10707
210955,202112,1636,4854,1397,4469,374,1145,683,2326,1057,3471
210960,202112,9645,27351,8344,25400,1938,5508,4646,15215,6584,20723
210970,202112,1481,4253,1199,3780,104,276,907,2856,1011,3132
210975,202112,1905,5562,1715,5271,149,454,1290,3990,1439,4444
210980,202112,10344,23416,9049,22074,118,234,8511,20894,8629,21128
210990,202112,17970,47702,13818,42388,936,2641,9874,32057,10810,34698
211000,202112,15371,42630,12691,39308,1488,3812,9023,29945,10511,33757
211003,202112,6027,16983,5024,15779,109,401,4336,13960,4445,14361
211010,202112,6645,22692,5914,21760,99,425,5296,19774,5395,20199
211020,202112,8517,23866,7373,22574,232,691,6256,19840,6488,20531
211023,202112,2108,6609,1946,6395,95,273,1636,5391,1731,5664
211027,202112,3298,9879,3121,9607,227,567,2648,8303,2875,8870
211030,202112,3938,10646,3511,10107,320,795,2664,7953,2984,8748
211040,202112,4953,16848,4563,16193,127,606,4067,14383,4194,14989
211050,202112,9258,23516,8375,22375,131,401,7575,20226,7706,20627
211060,202112,7196,21154,6503,20210,172,627,5747,17819,5919,18446
211065,202112,2427,6331,2023,5829,100,234,1681,4973,1781,5207
211070,202112,8552,25145,7297,23294,473,1398,5900,19022,6373,20420
211080,202112,1376,3674,1105,3254,28,139,892,2506,920,2645
211085,202112,2255,6000,1885,5510,119,245,1539,4755,1658,5000
211090,202112,3265,8857,2935,8485,28,121,2717,7826,2745,7947
211100,202112,6975,17267,6436,16621,36,119,6023,15636,6059,15755
211102,202112,3373,10754,3064,10294,263,959,2455,8222,2718,9181
211105,202112,2489,7508,2074,6775,142,466,1517,4907,1659,5373
211107,202112,5047,15390,4270,14237,161,599,3358,11710,3519,12309
211110,202112,6436,16660,5050,14577,416,1071,3712,10941,4128,12012
211120,202112,47608,112948,39079,102902,7066,16935,23008,65272,30074,82207
211125,202112,2141,6279,1799,5748,48,141,1512,4865,1560,5006
211130,202112,187433,434780,160104,399337,26646,59197,82437,229094,109083,288291
211140,202112,5201,14836,4531,13985,253,600,3760,11814,4013,12414
211150,202112,9934,25784,8340,23762,432,976,6879,19954,7311,20930
211153,202112,2591,7303,2066,6658,373,1138,1243,4317,1616,5455
211157,202112,1245,3744,1044,3376,43,150,750,2429,793,2579
211160,202112,4701,12338,3712,10956,135,431,2880,8344,3015,8775
211163,202112,1615,5108,1461,4883,37,144,1286,4327,1323,4471
211167,202112,1678,4995,1559,4822,25,74,1439,4461,1464,4535
211170,202112,6912,16280,6401,15686,78,138,6064,14845,6142,14983
211172,202112,2729,7244,2339,6653,107,298,1874,5232,1981,5530
211174,202112,2946,8310,2668,7997,26,128,2510,7493,2536,7621
211176,202112,4461,12186,3479,10754,174,611,2801,8666,2975,9277
211178,202112,5281,11400,4519,10593,15,57,4378,10188,4393,10245
211180,202112,4332,13750,3968,13234,179,570,3259,10930,3438,11500
211190,202112,3204,9130,2707,8405,29,156,2436,7502,2465,7658
211195,202112,1498,4030,1274,3698,150,303,973,2979,1123,3282
211200,202112,2282,6360,1820,5697,224,647,1215,3870,1439,4517
211210,202112,6401,19226,5750,18355,385,1232,4652,14939,5037,16171
211220,202112,40366,97743,33152,88961,4025,9528,23437,65159,27462,74687
211223,202112,5491,14170,4508,12856,526,1434,3072,8866,3598,10300
211227,202112,1817,5729,1602,5428,56,227,1259,4316,1315,4543
211230,202112,8561,23020,7318,21220,400,790,5956,17775,6356,18565
211240,202112,8114,25121,7601,24444,285,887,6834,22030,7119,22917
211245,202112,7447,18496,6526,17520,114,238,6177,16595,6291,16833
211250,202112,14111,42719,12691,40659,1046,3239,9816,31816,10862,35055
211260,202112,8393,26244,7407,24968,232,832,6562,22339,6794,23171
211270,202112,10398,32402,8820,30302,324,1349,7112,24799,7436,26148
211280,202112,13910,35652,12482,33841,869,1902,10526,29334,11395,31236
211285,202112,2033,6227,1819,5941,139,463,1379,4617,1518,5080
211290,202112,7686,22496,6914,21461,285,884,5797,18107,6082,18991
211300,202112,7907,22414,6908,20777,377,1136,5404,16118,5781,17254
211400,202112,12353,33210,10057,30072,1250,3438,6429,20554,7679,23992
220005,202112,1997,4912,1802,4633,37,93,1539,3885,1576,3978
220010,202112,1535,4276,1251,3773,23,85,968,2902,991,2987
220020,202112,4124,10519,3527,9701,143,396,2946,8072,3089,8468
220025,202112,2329,5127,1995,4648,28,60,1684,3824,1712,3884
220027,202112,1389,3312,1184,3037,20,63,1035,2610,1055,2673
220030,202112,3648,8767,3403,8440,119,252,2950,7284,3069,7536
220040,202112,7847,22863,6822,20939,1684,4779,3266,10730,4950,15509
220045,202112,1652,4659,1362,4182,20,95,1165,3506,1185,3601
220050,202112,4848,12834,4097,11871,61,264,3773,10824,3834,11088
220060,202112,2648,5255,2267,4818,37,72,2142,4548,2179,4620
220070,202112,2549,6232,2141,5644,97,185,1769,4686,1866,4871
220080,202112,781,2164,675,2014,19,59,577,1711,596,1770
220090,202112,1824,4260,1528,3840,11,25,1248,3278,1259,3303
220095,202112,758,1715,716,1672,53,85,611,1476,664,1561
220100,202112,1513,3927,1219,3471,34,100,1001,2763,1035,2863
220105,202112,2197,6465,1928,5972,143,404,1426,4448,1569,4852
220110,202112,3576,9632,3202,9005,28,143,2876,7987,2904,8130
220115,202112,2886,8036,2658,7741,94,249,2394,6988,2488,7237
220117,202112,1504,3446,1184,3010,4,13,997,2478,1001,2491
220120,202112,14057,35655,12812,34103,77,220,12069,32039,12146,32259
220130,202112,1219,3086,1028,2824,7,33,933,2516,940,2549
220140,202112,2256,4550,1908,4147,111,236,1659,3598,1770,3834
220150,202112,6837,19210,6219,18159,136,474,5278,15181,5414,15655
220155,202112,1269,3495,1018,3046,40,101,722,2133,762,2234
220157,202112,1107,2616,930,2346,28,76,748,1846,776,1922
220160,202112,3002,8033,2566,7244,48,159,2076,5759,2124,5918
220170,202112,1691,4305,1432,3922,15,54,1266,3434,1281,3488
220173,202112,2329,6176,1794,5212,50,137,1456,4114,1506,4251
220177,202112,2170,5853,2063,5735,8,29,2041,5666,2049,5695
220180,202112,1190,2750,967,2385,3,15,780,1805,783,1820
220190,202112,7697,18089,6528,16525,369,869,5081,13158,5450,14027
220191,202112,1692,4818,1532,4550,112,315,1061,3131,1173,3446
220192,202112,2163,5530,1583,4523,30,81,1280,3605,1310,3686
220194,202112,1814,4980,1606,4651,49,172,1332,3817,1381,3989
220196,202112,2167,5417,1971,5129,32,123,1724,4405,1756,4528
220198,202112,1358,3528,1157,3273,6,15,1068,3053,1074,3068
220200,202112,5417,15307,4711,14379,77,286,4071,12440,4148,12726
220202,202112,2262,6166,1926,5627,24,119,1661,4765,1685,4884
220205,202112,2615,7328,2326,6803,50,172,1959,5656,2009,5828
220207,202112,807,2368,676,2146,58,189,444,1422,502,1611
220208,202112,1841,5387,1522,4805,201,621,903,2857,1104,3478
220209,202112,1684,4668,1452,4260,25,91,1202,3486,1227,3577
220210,202112,1891,4359,1647,3991,14,48,1450,3413,1464,3461
220211,202112,1762,4189,1616,3995,17,69,1420,3490,1437,3559
220213,202112,1919,4872,1646,4409,17,49,1366,3547,1383,3596
220217,202112,2407,6637,2253,6464,61,110,2064,6067,2125,6177
220220,202112,11597,28503,9726,25743,894,1801,6450,18289,7344,20090
220225,202112,1029,2660,844,2422,2,13,794,2256,796,2269
220230,202112,5893,14395,5032,13214,156,334,4327,11465,4483,11799
220240,202112,3311,9171,2896,8463,96,324,2392,6923,2488,7247
220245,202112,1905,4161,1435,3601,13,45,1306,3300,1319,3345
220250,202112,3149,8437,2757,7947,14,61,2589,7430,2603,7491
220253,202112,1757,4471,1510,4086,54,135,1280,3408,1334,3543
220255,202112,2084,4650,1794,4256,32,109,1572,3606,1604,3715
220260,202112,4871,13889,4220,12710,215,615,3316,9998,3531,10613
220265,202112,1493,4403,1353,4226,51,207,1140,3502,1191,3709
220270,202112,6221,19731,5842,19052,177,788,4873,15446,5050,16234
220271,202112,1548,3896,1353,3621,21,66,1180,3131,1201,3197
220272,202112,1848,5174,1634,4778,60,178,1222,3466,1282,3644
220273,202112,1351,3684,1130,3288,59,189,845,2440,904,2629
220275,202112,2513,5540,1997,4840,37,55,1781,4331,1818,4386
220277,202112,2383,5613,2023,5105,73,138,1680,4205,1753,4343
220280,202112,1819,3982,1510,3586,18,51,1321,3094,1339,3145
220285,202112,1511,3658,1283,3391,5,11,1199,3145,1204,3156
220290,202112,7286,19236,5787,17162,401,1127,4158,12815,4559,13942
220300,202112,2125,5855,1709,5312,26,124,1425,4390,1451,4514
220310,202112,3265,8407,2564,7592,50,161,2189,6456,2239,6617
220320,202112,3246,9062,2510,7735,50,224,1974,5921,2024,6145
220323,202112,1744,4820,1360,4218,55,153,1116,3419,1171,3572
220325,202112,1299,3757,1109,3439,22,92,921,2809,943,2901
220327,202112,1677,4479,1462,4146,35,128,1209,3330,1244,3458
220330,202112,4965,11189,4230,10316,49,153,3864,9362,3913,9515
220335,202112,1761,5140,1590,4911,30,84,1424,4414,1454,4498
220340,202112,2009,5121,1533,4318,81,207,987,2738,1068,2945
220342,202112,1266,3534,1136,3338,67,151,878,2620,945,2771
220345,202112,3251,7112,2485,6050,19,54,2240,5431,2259,5485
220350,202112,3549,8666,2842,7635,176,412,1989,5431,2165,5843
220360,202112,1310,3286,1036,2837,16,43,822,2244,838,2287
220370,202112,9127,25465,8285,24137,258,704,7045,20526,7303,21230
220375,202112,1709,4665,1514,4429,2,7,1448,4256,1450,4263
220380,202112,1577,3573,1302,3198,16,29,1151,2820,1167,2849
220385,202112,910,2082,747,1807,3,8,655,1563,658,1571
220390,202112,11624,28310,9003,24374,2253,5849,3262,9888,5515,15737
220400,202112,1609,3698,1233,3123,22,69,960,2343,982,2412
220410,202112,1229,3284,1001,2895,42,110,821,2351,863,2461
220415,202112,862,2159,725,1937,25,58,575,1526,600,1584
220420,202112,2102,5702,1689,4920,51,147,1287,3687,1338,3834
220430,202112,2778,6834,2520,6473,52,142,2231,5646,2283,5788
220435,202112,1923,4716,1650,4310,33,96,1392,3553,1425,3649
220440,202112,2740,7784,2325,7172,73,323,2014,6023,2087,6346
220450,202112,2682,6732,2184,6117,47,142,1891,5306,1938,5448
220455,202112,1361,4098,1300,4012,6,35,1182,3642,1188,3677
220460,202112,1080,2538,1003,2440,27,51,868,2097,895,2148
220465,202112,2546,7447,2237,6974,205,547,1665,5359,1870,5906
220470,202112,3919,10248,3488,9549,194,431,2734,7482,2928,7913
220480,202112,3007,7369,2430,6470,284,516,1542,4285,1826,4801
220490,202112,2580,6258,2225,5812,22,94,1939,5001,1961,5095
220500,202112,3372,7886,2833,7065,136,248,2151,5365,2287,5613
220510,202112,2791,7347,2241,6377,118,251,1759,5086,1877,5337
220515,202112,1784,4122,1650,3935,48,75,1433,3416,1481,3491
220520,202112,5354,13322,4810,12563,96,242,4142,10869,4238,11111
220525,202112,1535,3604,1308,3326,4,19,1207,3056,1211,3075
220527,202112,1445,3734,1259,3465,22,64,1102,3063,1124,3127
220530,202112,1597,3732,1372,3451,52,122,1230,3107,1282,3229
220535,202112,859,2261,805,2189,50,102,622,1706,672,1808
220540,202112,3421,10439,3175,9966,179,528,2586,8155,2765,8683
220545,202112,1543,4381,1409,4175,54,206,1198,3493,1252,3699
220550,202112,9124,27298,8118,25511,476,1496,6110,19022,6586,20518
220551,202112,1504,4032,1333,3762,26,86,1093,3023,1119,3109
220552,202112,1780,4903,1432,4289,23,119,1159,3346,1182,3465
220553,202112,1930,4632,1590,4190,52,71,1343,3633,1395,3704
220554,202112,990,2405,742,2016,54,119,520,1406,574,1525
220555,202112,2669,7138,2325,6714,31,94,1957,5803,1988,5897
220556,202112,1300,3596,1142,3302,29,106,873,2436,902,2542
220557,202112,1826,5285,1507,4598,119,367,1048,3120,1167,3487
220558,202112,1501,3786,1183,3341,18,70,1016,2824,1034,2894
220559,202112,1895,4530,1610,4097,21,41,1308,3360,1329,3401
220560,202112,1876,4053,1547,3649,50,79,1387,3324,1437,3403
220570,202112,7981,22477,7282,21503,566,1353,5723,17243,6289,18596
220580,202112,7247,18991,6561,17929,114,281,5871,16057,5985,16338
220585,202112,2210,6618,1822,5924,39,93,1514,4960,1553,5053
220590,202112,1494,3840,1220,3444,88,208,883,2550,971,2758
220595,202112,2847,7315,2580,6960,22,74,2318,6211,2340,6285
220600,202112,1589,3282,1353,3008,68,87,1174,2656,1242,2743
220605,202112,1661,4707,1429,4297,20,99,1166,3401,1186,3500
220610,202112,2870,8158,2686,7886,23,110,2521,7360,2544,7470
220620,202112,8486,24731,7761,23750,116,577,7107,21533,7223,22110
220630,202112,400,1146,309,985,29,90,198,623,227,713
220635,202112,1918,5499,1710,5076,32,134,1371,3945,1403,4079
220640,202112,2513,6799,2140,6271,60,225,1761,5111,1821,5336
220650,202112,2328,5997,2011,5523,44,110,1629,4477,1673,4587
220660,202112,2688,8161,2269,7481,59,232,1875,6108,1934,6340
220665,202112,1323,3851,1116,3515,23,108,943,2898,966,3006
220667,202112,1724,5071,1553,4760,61,214,1258,3824,1319,4038
220669,202112,1743,4979,1668,4866,51,170,1487,4269,1538,4439
220670,202112,2329,5759,1853,5102,14,47,1609,4419,1623,4466
220672,202112,3439,8147,2787,7361,83,261,2493,6508,2576,6769
220675,202112,1390,3631,1238,3365,43,98,991,2699,1034,2797
220680,202112,2930,7507,2791,7322,146,214,2478,6706,2624,6920
220690,202112,1674,4239,1470,3930,69,195,1134,3038,1203,3233
220695,202112,981,2593,910,2463,22,58,791,2129,813,2187
220700,202112,11284,25783,9186,22982,430,901,7016,17482,7446,18383
220710,202112,966,2511,712,2050,32,84,542,1514,574,1598
220720,202112,2271,5147,2046,4853,13,52,1816,4237,1829,4289
220730,202112,1383,3720,1173,3379,12,56,1005,2830,1017,2886
220735,202112,1066,2341,825,1977,37,78,660,1560,697,1638
220740,202112,1452,3594,1158,3204,32,76,962,2718,994,2794
220750,202112,4157,9955,3652,9246,142,319,3277,8270,3419,8589
220755,202112,1521,3455,1271,3089,20,52,1059,2514,1079,2566
220760,202112,3357,8598,2939,8049,52,148,2719,7470,2771,7618
220770,202112,25841,73096,21925,66565,6498,20579,7487,24007,13985,44586
220775,202112,1268,3030,1126,2854,10,30,1087,2735,1097,2765
220777,202112,1697,4157,1317,3586,49,98,992,2754,1041,2852
220779,202112,1316,3329,1138,3065,22,61,983,2613,1005,2674
220780,202112,6310,14840,5420,13539,322,738,4227,10504,4549,11242
220785,202112,1562,3355,1378,3120,8,16,1317,2962,1325,2978
220790,202112,10919,29493,9841,27956,158,590,8353,23506,8511,24096
220793,202112,1008,2511,807,2174,8,12,674,1833,682,1845
220795,202112,1493,3668,1311,3419,28,73,1156,3018,1184,3091
220800,202112,20264,42702,17262,38778,931,1877,13120,29609,14051,31486
220810,202112,3227,8592,2701,7695,46,117,2250,6368,2296,6485
220820,202112,5556,13588,4849,12559,346,633,3683,9756,4029,10389
220830,202112,7702,19440,6875,18271,300,752,5623,14806,5923,15558
220840,202112,13166,37737,11009,33500,2596,7238,5060,16299,7656,23537
220850,202112,3304,9828,2956,9394,36,191,2657,8463,2693,8654
220855,202112,778,1821,682,1698,22,61,608,1509,630,1570
220860,202112,1131,2669,985,2440,13,49,910,2227,923,2276
220865,202112,2528,6513,1949,5488,54,204,1463,3988,1517,4192
220870,202112,3333,8561,2758,7819,27,118,2534,7171,2561,7289
220880,202112,5689,12925,4901,11958,63,212,4532,10932,4595,11144
220885,202112,1522,4259,1252,3826,87,210,943,2982,1030,3192
220887,202112,1661,3447,1390,3103,23,34,1283,2864,1306,2898
220890,202112,1467,4265,1270,3983,46,143,1052,3347,1098,3490
220900,202112,2132,4866,1775,4405,32,70,1561,3855,1593,3925
220910,202112,1694,4310,1438,3935,98,196,1147,3222,1245,3418
220915,202112,1031,2656,815,2272,14,47,617,1644,631,1691
220920,202112,1566,4609,1352,4332,78,228,1099,3586,1177,3814
220930,202112,1936,4884,1612,4440,17,54,1510,4141,1527,4195
220935,202112,1151,3228,925,2745,21,85,605,1696,626,1781
220937,202112,1606,4034,1367,3654,25,83,1105,2899,1130,2982
220940,202112,1702,4455,1370,3883,31,98,1090,3034,1121,3132
220945,202112,531,1684,420,1473,17,87,306,1057,323,1144
220950,202112,1479,3318,981,2563,16,41,788,1986,804,2027
220955,202112,1698,4189,1413,3710,26,64,1213,3155,1239,3219
220960,202112,838,2064,619,1699,36,95,419,1089,455,1184
220965,202112,1897,4945,1651,4591,14,80,1428,3898,1442,3978
220970,202112,2118,4791,1569,3991,16,33,1343,3373,1359,3406
220975,202112,725,1943,614,1803,9,50,556,1587,565,1637
220980,202112,1221,3308,1085,3125,30,96,913,2609,943,2705
220985,202112,1414,3411,1227,3139,71,136,990,2521,1061,2657
220987,202112,1558,4431,1373,4108,66,201,1103,3287,1169,3488
220990,202112,1760,4746,1539,4413,11,62,1307,3695,1318,3757
220995,202112,1250,3462,1029,3061,32,90,774,2321,806,2411
220997,202112,2488,7286,2283,6954,44,166,2029,6112,2073,6278
221000,202112,4739,12483,4149,11639,97,344,3559,9895,3656,10239
221005,202112,1575,3951,1425,3697,15,75,1239,3113,1254,3188
221010,202112,1344,2858,1052,2496,19,31,910,2139,929,2170
221020,202112,1658,4851,1500,4583,14,45,1174,3564,1188,3609
221030,202112,1738,4071,1475,3751,19,49,1287,3331,1306,3380
221035,202112,1645,4037,1427,3742,25,30,1269,3405,1294,3435
221037,202112,762,1976,636,1763,6,18,477,1250,483,1268
221038,202112,556,1497,424,1265,16,53,291,860,307,913
221039,202112,913,2420,763,2173,24,99,610,1684,634,1783
221040,202112,4593,12735,3988,11687,255,604,3169,9412,3424,10016
221050,202112,4232,10407,3760,9815,76,198,3405,8870,3481,9068
221060,202112,9376,25316,7716,22589,401,895,6056,18060,6457,18955
221062,202112,1193,3695,1026,3422,30,119,828,2729,858,2848
221063,202112,1184,3082,1020,2844,60,170,804,2199,864,2369
221065,202112,2798,6930,2448,6333,15,49,2163,5526,2178,5575
221070,202112,3627,10708,2915,9228,373,1093,1717,5596,2090,6689
221080,202112,3739,8833,3068,7834,67,182,2537,6371,2604,6553
221090,202112,1478,3630,1214,3222,9,27,1042,2719,1051,2746
221093,202112,1565,4087,1430,3829,159,368,999,2653,1158,3021
221095,202112,937,2370,791,2151,11,28,672,1798,683,1826
221097,202112,904,2246,681,1848,22,55,512,1324,534,1379
221100,202112,128693,328239,107260,292503,10354,29644,70607,186736,80961,216380
221110,202112,10422,29825,9541,28674,113,522,8631,25741,8744,26263
221120,202112,5057,13677,4497,12822,154,431,3900,11186,4054,11617
221130,202112,6001,14534,4590,11936,835,2011,2402,6252,3237,8263
221135,202112,1929,4655,1715,4375,52,100,1523,3927,1575,4027
221140,202112,1445,3233,1217,2951,13,42,1100,2618,1113,2660
221150,202112,1149,2792,897,2364,22,94,703,1733,725,1827
221160,202112,764,1847,674,1732,26,36,536,1404,562,1440
221170,202112,1053,2900,965,2747,6,23,845,2359,851,2382
230010,202112,3244,8166,2666,7198,32,95,2205,5806,2237,5901
230015,202112,3326,10233,2924,9430,162,543,2050,6622,2212,7165
230020,202112,13670,41899,12796,40609,397,1407,10976,34755,11373,36162
230030,202112,13539,32701,11330,29839,287,678,9766,25815,10053,26493
230040,202112,4769,11789,3952,10483,35,159,3352,8750,3387,8909
230050,202112,2834,8543,2160,7017,336,1012,945,3005,1281,4017
230060,202112,2528,6639,2020,5743,28,94,1617,4510,1645,4604
230070,202112,4518,11104,3579,9420,268,726,2467,6431,2735,7157
230075,202112,9554,29334,8708,27870,781,2263,6496,21043,7277,23306
230080,202112,3250,6617,2476,5681,4,9,2289,5258,2293,5267
230090,202112,4765,11120,3996,9907,180,410,3250,7998,3430,8408
230100,202112,20403,49389,17811,46010,1679,3891,12432,32546,14111,36437
230110,202112,13354,38354,11118,34020,1911,5654,5552,17226,7463,22880
230120,202112,8344,21278,7266,19574,583,1354,5317,14503,5900,15857
230125,202112,3398,8616,2751,7619,144,341,2087,5744,2231,6085
230130,202112,6123,17795,4982,15380,485,1370,3197,9891,3682,11261
230140,202112,3638,10550,3071,9410,78,312,2362,7045,2440,7357
230150,202112,1731,4955,1419,4287,233,616,800,2524,1033,3140
230160,202112,6933,16946,5981,15544,108,291,5106,13083,5214,13374
230170,202112,6894,18681,5612,16103,480,1236,3822,10925,4302,12161
230180,202112,1751,4668,1470,4127,14,61,1212,3292,1226,3353
230185,202112,4739,12802,4011,11606,363,958,2843,8370,3206,9328
230190,202112,15062,42343,12609,37831,1473,4265,7350,21999,8823,26264
230195,202112,5841,16271,5286,15272,429,1147,3939,11409,4368,12556
230200,202112,5281,14074,4402,12466,168,440,3366,9374,3534,9814
230205,202112,4773,12693,4173,11827,285,725,3189,8986,3474,9711
230210,202112,11228,25327,9471,23019,442,1040,7414,17790,7856,18830
230220,202112,15109,36675,13200,33973,741,1797,10688,27317,11429,29114
230230,202112,7470,20805,6678,19248,520,1330,4894,14126,5414,15456
230240,202112,13851,35515,11875,32174,278,1014,9809,25882,10087,26896
230250,202112,9429,25251,8714,24167,220,658,7065,19012,7285,19670
230260,202112,15894,44285,13709,40545,2574,6905,6974,21556,9548,28461
230270,202112,8154,20814,6278,17421,731,1879,3764,10759,4495,12638
230280,202112,21276,54686,17361,48172,426,1549,13796,36777,14222,38326
230290,202112,5257,13952,4341,12262,236,534,3326,9368,3562,9902
230300,202112,5243,13242,4737,12551,81,193,4197,11104,4278,11297
230310,202112,5023,13808,4214,12361,115,403,3018,8687,3133,9090
230320,202112,8307,23161,6949,20756,187,715,5379,15714,5566,16429
230330,202112,5028,13119,3975,11170,110,318,3028,8299,3138,8617
230340,202112,4060,12051,3481,10884,200,670,2473,7579,2673,8249
230350,202112,19350,50396,16874,46822,857,2482,11635,32300,12492,34782
230360,202112,3192,8061,2526,6918,129,317,1775,4832,1904,5149
230365,202112,3235,7712,2660,6873,60,221,2278,5809,2338,6030
230370,202112,66112,171707,56547,157911,6841,19130,36601,101961,43442,121091
230380,202112,6756,17900,5339,15340,122,386,3972,11114,4094,11500
230390,202112,3673,10265,3163,9460,78,281,2469,7285,2547,7566
230393,202112,3648,10110,2879,8567,63,309,2257,6429,2320,6738
230395,202112,6101,16171,5241,14745,542,1380,3430,9801,3972,11181
230400,202112,5955,15475,5252,14363,85,297,4268,11337,4353,11634
230410,202112,14202,40813,11694,36315,965,3104,7880,24582,8845,27686
230420,202112,31394,82314,25590,72462,2958,8307,14651,41116,17609,49423
230423,202112,5100,14520,4448,13251,268,795,3275,9646,3543,10441
230425,202112,6143,18046,5614,17000,573,1671,3872,11710,4445,13381
230426,202112,2994,7537,2210,6067,27,84,1675,4497,1702,4581
230427,202112,1998,5357,1413,4165,115,346,862,2409,977,2755
230428,202112,10703,27324,9182,25054,1739,4358,4783,13242,6522,17600
230430,202112,5199,14044,4086,12115,150,450,3067,8953,3217,9403
230435,202112,6676,16286,5534,14321,859,2002,3157,8295,4016,10297
230440,202112,464015,1091040,388693,983014,33683,88185,264224,654757,297907,742942
230445,202112,4476,11598,3583,10037,244,616,2400,6587,2644,7203
230450,202112,3852,10565,3340,9824,222,743,2459,7037,2681,7780
230460,202112,2262,6052,1960,5578,46,173,1648,4623,1694,4796
230465,202112,4517,11958,3808,10621,120,356,2900,7803,3020,8159
230470,202112,11727,37411,10507,35200,874,3058,7293,24260,8167,27318
230480,202112,1568,4379,1306,3918,58,225,962,2767,1020,2992
230490,202112,2856,7594,2412,6767,198,560,1514,4023,1712,4583
230495,202112,6243,17276,5477,15933,783,2139,3153,9423,3936,11562
230500,202112,9768,30209,8620,28131,282,1032,6955,22754,7237,23786
230510,202112,1791,4925,1406,4138,154,459,780,2241,934,2700
230520,202112,5125,13379,4417,12171,492,1057,2942,8316,3434,9373
230523,202112,16605,47164,13114,39949,2973,8882,3044,9968,6017,18850
230526,202112,4107,10925,3479,9904,223,512,2502,7296,2725,7808
230530,202112,5928,17767,4968,15956,886,2801,2895,9396,3781,12197
230533,202112,4985,10972,4036,9534,149,291,3345,7824,3494,8115
230535,202112,5502,14918,4640,13473,359,1006,3013,8839,3372,9845
230540,202112,16631,44090,14191,40452,289,902,11743,33278,12032,34180
230550,202112,23049,57835,18541,50373,1573,4138,12079,32495,13652,36633
230560,202112,8331,19844,6713,17343,65,209,5799,14864,5864,15073
230565,202112,3267,8764,2714,7755,124,414,2083,5842,2207,6256
230570,202112,3604,8935,3041,8145,81,182,2487,6650,2568,6832
230580,202112,12204,29707,10445,27226,503,1118,8443,22155,8946,23273
230590,202112,9928,26893,8239,23877,673,1852,5843,16679,6516,18531
230600,202112,4080,9803,3199,8311,133,291,2119,5617,2252,5908
230610,202112,7123,18795,6310,17455,536,1318,4879,13543,5415,14861
230620,202112,2243,5817,1743,4875,102,303,1105,2976,1207,3279
230625,202112,9318,24635,7859,22051,1951,5742,2748,7765,4699,13507
230630,202112,12213,33136,10705,30355,1451,3694,6657,19288,8108,22982
230640,202112,29247,85134,26433,80651,1146,4016,21218,63768,22364,67784
230650,202112,5725,14612,4835,13126,107,368,3983,10499,4090,10867
230655,202112,9761,31704,9164,30701,655,2073,7357,24930,8012,27003
230660,202112,6331,18248,5130,16163,120,604,4131,12737,4251,13341
230670,202112,6552,14966,4715,12086,206,458,3681,9284,3887,9742
230680,202112,2895,7539,2420,6715,121,263,1728,4839,1849,5102
230690,202112,7591,21563,6475,19413,470,1502,4096,12135,4566,13637
230700,202112,11171,26959,8995,23066,498,1031,6586,16719,7084,17750
230710,202112,7220,22011,6302,20095,737,2112,4083,13154,4820,15266
230720,202112,2056,5799,1682,5092,105,275,1175,3498,1280,3773
230725,202112,4639,12903,4149,12070,425,1286,2601,7478,3026,8764
230730,202112,63304,160932,49697,140973,11279,33328,14683,45409,25962,78737
230740,202112,6513,17504,5501,15890,143,388,4377,12666,4520,13054
230750,202112,8994,23070,7430,20494,177,483,5926,15970,6103,16453
230760,202112,12090,30338,10449,27848,487,1431,7907,20517,8394,21948
230763,202112,5348,13817,4439,12231,93,382,3604,9588,3697,9970
230765,202112,43930,113762,36410,101826,5140,14723,19532,53557,24672,68280
230770,202112,28217,64641,23733,58898,2235,5241,16485,40845,18720,46086
230780,202112,6876,23093,6184,21459,947,3024,3419,12388,4366,15412
230790,202112,3243,8849,2899,8299,108,404,2241,6208,2349,6612
230800,202112,9007,26945,7875,24694,1241,3705,4290,13469,5531,17174
230810,202112,11699,34111,10473,32132,423,1272,8161,24777,8584,26049
230820,202112,3835,11744,3167,10331,253,932,1997,6167,2250,7099
230830,202112,8049,21090,6830,19125,126,457,5661,15423,5787,15880
230835,202112,4474,10290,3467,8748,127,296,2763,6907,2890,7203
230837,202112,3421,9722,3038,9076,132,399,2443,7195,2575,7594
230840,202112,10192,28265,8743,25796,992,2616,6104,18164,7096,20780
230850,202112,10491,28695,8823,25542,441,1171,6431,18499,6872,19670
230860,202112,5929,14036,4888,12548,61,169,4328,10993,4389,11162
230870,202112,17338,40579,14913,36629,567,1307,12087,29262,12654,30569
230880,202112,2226,6449,2035,6141,39,186,1625,4773,1664,4959
230890,202112,4777,14677,4347,13867,337,1017,3150,10049,3487,11066
230900,202112,3344,9083,2893,8260,146,475,2037,5622,2183,6097
230910,202112,3439,8779,2729,7704,54,205,2206,6219,2260,6424
230920,202112,5173,13667,4265,12221,89,295,3386,9469,3475,9764
230930,202112,7286,19420,6009,17171,320,824,4084,11667,4404,12491
230940,202112,8745,21077,7592,19361,213,423,6401,16316,6614,16739
230945,202112,7018,19165,5970,17232,328,969,4238,11968,4566,12937
230950,202112,6616,15997,5849,14965,139,273,5008,12918,5147,13191
230960,202112,14486,39653,12654,36288,2305,6368,5898,16942,8203,23310
230970,202112,15666,39502,13184,35699,1718,4325,8082,21956,9800,26281
230980,202112,3001,8115,2621,7467,367,939,1678,4972,2045,5911
230990,202112,1778,4803,1466,4206,59,199,1041,2867,1100,3066
231000,202112,2752,7064,2200,6005,98,219,1619,4312,1717,4531
231010,202112,3951,8705,3111,7323,24,83,2752,6308,2776,6391
231020,202112,9056,26037,8041,24171,1370,3660,4672,14642,6042,18302
231025,202112,8276,21258,7216,19547,755,1861,5146,14111,5901,15972
231030,202112,7848,22429,6136,18914,1104,3094,3068,9694,4172,12788
231040,202112,3199,8574,2756,7780,116,294,2181,6056,2297,6350
231050,202112,12741,30837,10371,26738,690,1558,7831,19829,8521,21387
231060,202112,3092,8366,2735,7806,55,147,2289,6527,2344,6674
231070,202112,8632,23738,7423,21649,646,1844,5000,14392,5646,16236
231080,202112,4192,11379,3520,10282,136,472,2653,7603,2789,8075
231085,202112,7355,16993,5871,15268,249,523,4599,12080,4848,12603
231090,202112,4762,12006,3511,9655,121,413,2411,6374,2532,6787
231095,202112,2386,6839,1889,5796,195,552,1215,3762,1410,4314
231100,202112,3382,9424,2745,8224,127,381,2064,6136,2191,6517
231110,202112,3985,11081,3658,10488,202,578,2704,7636,2906,8214
231120,202112,2534,6981,2110,6257,103,292,1528,4513,1631,4805
231123,202112,2038,5112,1686,4512,121,249,1166,3158,1287,3407
231126,202112,5951,15600,4822,13503,318,742,3457,9637,3775,10379
231130,202112,23392,56418,19387,51456,1300,3410,14290,37678,15590,41088
231135,202112,4401,11957,3620,10475,196,556,2523,7249,2719,7805
231140,202112,17809,48179,14401,42449,639,2090,10376,29936,11015,32026
231150,202112,6398,16557,4677,13272,698,2024,1853,5434,2551,7458
231160,202112,6668,19887,5903,18500,850,2365,3298,10754,4148,13119
231170,202112,4935,13441,4092,11871,280,802,2851,7990,3131,8792
231180,202112,15848,42660,12846,36588,2667,7356,5418,15541,8085,22897
231190,202112,4271,11464,3479,10069,72,225,2700,7683,2772,7908
231195,202112,5494,15584,4537,13679,274,831,3286,9869,3560,10700
231200,202112,8350,24362,7227,22172,154,672,5866,17438,6020,18110
231210,202112,5221,14529,4412,13166,146,462,3431,10019,3577,10481
231220,202112,13752,33141,10769,27724,549,1280,7974,19892,8523,21172
231230,202112,9658,29792,8508,27694,668,2212,6051,19857,6719,22069
231240,202112,12474,34915,10963,32139,1880,5175,6330,18915,8210,24090
231250,202112,2249,5493,1469,3828,132,336,856,2173,988,2509
231260,202112,3491,9299,3033,8574,341,819,1975,5820,2316,6639
231270,202112,6754,16982,5406,14763,130,468,4148,10975,4278,11443
231280,202112,1853,5513,1679,5208,93,246,1244,3854,1337,4100
231290,202112,39920,114675,33232,101620,5530,16412,15391,46708,20921,63120
231300,202112,4447,11718,3479,9833,144,459,2412,6608,2556,7067
231310,202112,8130,19879,6430,16815,606,1556,4337,11050,4943,12606
231320,202112,8023,21453,6139,18091,103,352,4939,14365,5042,14717
231325,202112,2688,6602,2201,5886,198,338,1526,4237,1724,4575
231330,202112,10642,29817,8847,26338,1826,4912,4596,14521,6422,19433
231335,202112,5906,15216,4979,13756,80,289,4346,11904,4426,12193
231340,202112,19737,57182,17747,53733,1316,3693,13264,40711,14580,44404
231350,202112,16678,44181,15214,42096,260,782,13680,37589,13940,38371
231355,202112,4741,13390,4261,12514,258,721,3329,9692,3587,10413
231360,202112,8336,23877,7193,21936,377,1132,5592,17016,5969,18148
231370,202112,2293,6112,1830,5292,34,97,1404,4025,1438,4122
231375,202112,4442,13406,4054,12765,97,394,3429,10682,3526,11076
231380,202112,6346,16577,5721,15723,255,510,4616,12916,4871,13426
231390,202112,3683,10185,3292,9525,114,364,2461,6926,2575,7290
231395,202112,4475,12351,3714,11141,275,807,2477,7397,2752,8204
231400,202112,10250,28577,8574,25531,227,949,6536,19000,6763,19949
231410,202112,15988,46970,14548,44655,873,2275,11549,35837,12422,38112
240010,202112,2771,6940,2156,5851,293,752,1119,3042,1412,3794
240020,202112,13698,36472,11446,32535,752,2296,7463,20955,8215,23251
240030,202112,3347,7528,2990,7003,135,337,2581,5967,2716,6304
240040,202112,879,2449,728,2172,26,106,500,1409,526,1515
240050,202112,3616,9319,2889,8011,42,117,2216,6010,2258,6127
240060,202112,1528,3874,1239,3349,24,66,997,2638,1021,2704
240070,202112,2613,6988,2302,6341,278,711,1553,4217,1831,4928
240080,202112,3118,8084,2485,6987,87,274,1820,5059,1907,5333
240090,202112,2386,5720,1942,4989,18,38,1624,4117,1642,4155
240100,202112,11243,26227,8943,22242,186,518,7157,17149,7343,17667
240110,202112,4817,13205,4004,11703,215,711,2935,8387,3150,9098
240120,202112,3622,9727,2976,8914,226,633,2097,6418,2323,7051
240130,202112,4062,7989,3303,7001,28,55,2998,6290,3026,6345
240140,202112,1932,5623,1634,5060,198,624,1046,3234,1244,3858
240145,202112,7089,18948,5762,16694,930,2671,3239,9498,4169,12169
240150,202112,1038,2857,907,2601,55,149,689,1936,744,2085
240160,202112,1563,4485,1303,3996,34,121,991,3043,1025,3164
240165,202112,1027,2704,855,2380,25,88,708,1926,733,2014
240170,202112,2920,7355,2456,6551,308,758,1519,4089,1827,4847
240180,202112,3236,9261,2570,7921,614,1825,1051,3433,1665,5258
240185,202112,1335,4006,1230,3826,53,176,1029,3185,1082,3361
240190,202112,1172,3188,995,2909,19,69,820,2411,839,2480
240200,202112,12150,29223,9717,25145,1099,2805,5480,13951,6579,16756
240210,202112,3500,8263,2838,7208,22,104,2415,5913,2437,6017
240220,202112,7750,22731,6952,21489,400,1474,5429,16678,5829,18152
240230,202112,6197,15163,4922,13074,268,601,3750,10106,4018,10707
240240,202112,1892,5290,1235,3812,125,382,420,1169,545,1551
240250,202112,3193,7975,2753,7360,64,185,2386,6307,2450,6492
240260,202112,14337,41658,12319,38293,2544,7355,6414,21536,8958,28891
240270,202112,2584,7248,2220,6638,115,328,1635,4997,1750,5325
240280,202112,1808,4463,1495,3953,80,178,1150,3037,1230,3215
240290,202112,1246,3516,1008,3008,27,112,725,2046,752,2158
240300,202112,2424,6011,1745,4790,83,210,1070,2885,1153,3095
240310,202112,8965,23137,7041,19696,926,2701,3534,9734,4460,12435
240320,202112,2165,5667,1554,4495,45,174,1149,3162,1194,3336
240325,202112,34912,88830,27956,77101,4625,12887,13212,35989,17837,48876
240330,202112,1924,5040,1476,4216,53,181,1025,2788,1078,2969
240340,202112,2150,4695,1744,4101,45,100,1440,3295,1485,3395
240350,202112,2447,5857,2174,5551,35,92,1987,5080,2022,5172
240360,202112,10710,28197,9483,26306,1304,3357,6004,17134,7308,20491
240370,202112,2209,5355,1685,4352,89,207,1169,2920,1258,3127
240375,202112,988,2408,816,2113,30,94,640,1596,670,1690
240380,202112,2375,6477,1784,5209,285,689,857,2580,1142,3269
240390,202112,1103,2571,793,2004,29,49,509,1202,538,1251
240400,202112,1620,3780,1236,3145,30,107,885,2098,915,2205
240410,202112,618,1756,502,1533,53,174,308,893,361,1067
240420,202112,4982,16419,4398,15215,442,1698,2706,9159,3148,10857
240430,202112,3717,9098,3071,8004,151,461,2340,5899,2491,6360
240440,202112,2731,5900,2324,5325,242,437,1750,4088,1992,4525
240450,202112,4762,12515,3710,10590,385,1077,2127,5857,2512,6934
240460,202112,3450,8909,3078,8326,275,712,2438,6630,2713,7342
240470,202112,3755,11069,2841,9183,710,2102,1137,3971,1847,6073
240480,202112,629,1652,418,1201,28,59,201,568,229,627
240485,202112,2337,6253,1869,5427,146,384,1247,3675,1393,4059
240490,202112,1709,4192,1331,3522,88,160,933,2520,1021,2680
240500,202112,2237,5928,1913,5362,105,274,1507,4240,1612,4514
240510,202112,1771,4588,1518,4198,89,262,1194,3264,1283,3526
240520,202112,1672,3765,1267,3217,101,187,895,2401,996,2588
240530,202112,2493,6482,2234,6079,81,219,1855,4965,1936,5184
240540,202112,2457,5876,2167,5442,66,124,1867,4712,1933,4836
240550,202112,786,2048,701,1896,13,53,606,1592,619,1645
240560,202112,3449,8514,2914,7802,302,668,2114,5829,2416,6497
240570,202112,2958,7505,1960,5383,321,852,649,1690,970,2542
240580,202112,8620,24513,7554,22597,817,2141,5690,17410,6507,19551
240590,202112,853,1989,745,1822,10,26,600,1430,610,1456
240600,202112,1930,5018,1424,4007,50,133,960,2591,1010,2724
240610,202112,4636,11730,3969,10571,142,378,3038,7913,3180,8291
240615,202112,1346,3339,1084,2890,106,250,740,1958,846,2208
240620,202112,1945,5207,1663,4741,128,290,1296,3759,1424,4049
240630,202112,2293,5944,2048,5547,173,338,1382,4001,1555,4339
240640,202112,1010,2595,793,2236,24,79,593,1634,617,1713
240650,202112,4341,11818,3678,10489,359,867,2529,7288,2888,8155
240660,202112,3311,8051,2949,7591,76,183,2666,6872,2742,7055
240670,202112,2697,7110,2140,6015,145,399,1417,3876,1562,4275
240680,202112,1713,4318,1370,3734,80,199,1021,2714,1101,2913
240690,202112,1167,2727,907,2292,15,54,746,1800,761,1854
240700,202112,2603,7291,2110,6389,101,303,1576,4731,1677,5034
240710,202112,17788,43556,14988,38902,1677,4221,9804,25152,11481,29373
240720,202112,5670,13438,4838,12260,640,1544,3191,8174,3831,9718
240725,202112,1209,3321,920,2779,41,123,624,1826,665,1949
240730,202112,2431,6469,1932,5519,57,155,1467,4131,1524,4286
240740,202112,2027,5299,1615,4484,73,209,1126,2966,1199,3175
240750,202112,2398,7473,2010,6638,269,908,1075,3570,1344,4478
240760,202112,1809,3940,1292,3171,94,115,989,2508,1083,2623
240770,202112,3472,9196,2904,8401,157,473,2338,6742,2495,7215
240780,202112,5031,13586,4164,12162,647,1750,2460,7438,3107,9188
240790,202112,942,2540,772,2240,15,61,586,1639,601,1700
240800,202112,54182,123894,42427,106405,5818,14009,22327,55899,28145,69908
240810,202112,99898,245737,85010,221848,8875,23682,56944,145427,65819,169109
240820,202112,6310,17963,5481,16482,791,2264,3303,10148,4094,12412
240830,202112,9181,25407,8085,23749,311,1022,6536,19095,6847,20117
240840,202112,1142,2772,905,2404,28,69,649,1664,677,1733
240850,202112,1529,4008,1070,3041,71,195,595,1635,666,1830
240860,202112,1438,3690,1080,3057,13,54,849,2311,862,2365
240870,202112,1155,2816,866,2332,176,479,432,1195,608,1674
240880,202112,1372,4194,1192,3844,79,300,875,2767,954,3067
240890,202112,4857,12657,3725,10568,493,1484,1931,5207,2424,6691
240895,202112,3081,9021,2799,8565,318,867,2096,6636,2414,7503
240910,202112,3741,9620,3154,8603,52,164,2587,6889,2639,7053
240920,202112,1076,2652,862,2325,109,212,468,1375,577,1587
240930,202112,3868,8489,3172,7627,252,363,2253,5868,2505,6231
240933,202112,1742,4171,1464,3774,33,110,1277,3225,1310,3335
240940,202112,6827,16002,5335,13505,738,1723,3006,7516,3744,9239
240950,202112,1170,3319,1012,3034,34,131,816,2371,850,2502
240960,202112,711,2114,634,1963,18,59,504,1526,522,1585
240970,202112,2015,4981,1616,4309,68,226,1321,3428,1389,3654
240980,202112,3593,10111,3183,9406,90,345,2620,7594,2710,7939
240990,202112,2834,7479,2497,6866,266,784,1757,4653,2023,5437
241000,202112,998,2515,781,2127,24,57,586,1553,610,1610
241010,202112,3057,9208,2751,8575,184,589,2049,6336,2233,6925
241020,202112,2280,5824,1725,4743,95,263,1187,3138,1282,3401
241025,202112,1881,5184,1506,4523,32,125,1112,3260,1144,3385
241030,202112,2596,7950,2075,6854,262,803,1281,4299,1543,5102
241040,202112,2319,7115,2019,6596,58,296,1573,5101,1631,5397
241050,202112,1481,4005,1189,3477,30,103,863,2465,893,2568
241060,202112,847,2248,732,2019,45,109,497,1348,542,1457
241070,202112,744,1904,620,1710,17,41,477,1280,494,1321
241080,202112,1195,3288,911,2709,32,115,649,1894,681,2009
241090,202112,2168,5960,1753,5253,58,237,1334,3887,1392,4124
241100,202112,1295,3412,972,2765,67,155,637,1779,704,1934
241105,202112,996,2915,805,2559,241,766,270,892,511,1658
241110,202112,1048,2805,780,2253,47,131,496,1374,543,1505
241120,202112,7970,21965,6682,19750,855,2412,3995,12196,4850,14608
241140,202112,3592,9165,2768,7548,182,449,1955,5241,2137,5690
241142,202112,832,2195,616,1786,29,88,374,1040,403,1128
241150,202112,6339,15643,5586,14475,225,492,4421,11399,4646,11891
241160,202112,1309,3415,1019,2882,163,479,558,1513,721,1992
241170,202112,1449,3560,1215,3158,43,126,987,2478,1030,2604
241180,202112,1137,2781,836,2226,118,332,376,970,494,1302
241190,202112,1246,3112,1038,2711,9,33,765,1918,774,1951
241200,202112,22382,55047,19432,50322,2887,7390,11641,29809,14528,37199
241210,202112,1612,4071,1155,3196,114,335,661,1790,775,2125
241220,202112,9866,27183,8657,25207,1871,5379,4033,12224,5904,17603
241230,202112,2997,7810,2630,7235,110,299,2174,5939,2284,6238
241240,202112,1347,3629,842,2548,91,275,276,835,367,1110
241250,202112,6084,16497,4903,14372,165,604,3680,10381,3845,10985
241255,202112,2578,7454,2262,6849,155,486,1650,4904,1805,5390
241260,202112,5314,13246,4235,11503,127,376,3388,9037,3515,9413
241270,202112,1742,4903,1444,4339,132,379,986,3004,1118,3383
241280,202112,2359,5624,2023,5034,76,170,1699,4167,1775,4337
241290,202112,3484,8257,2546,6768,78,200,1982,5159,2060,5359
241300,202112,1608,4144,1298,3609,28,81,873,2361,901,2442
241310,202112,2353,5509,2025,5048,30,73,1768,4451,1798,4524
241320,202112,1016,3170,871,2897,87,323,548,1816,635,2139
241330,202112,1873,4629,1472,4097,15,70,1298,3592,1313,3662
241335,202112,3702,9864,3227,9016,133,392,2626,7234,2759,7626
241340,202112,1688,4529,1319,3804,217,682,618,1675,835,2357
241350,202112,2326,6081,2023,5540,133,319,1517,4163,1650,4482
241355,202112,1457,3769,1173,3229,17,38,889,2419,906,2457
241360,202112,2199,5473,1625,4347,58,132,1194,3121,1252,3253
241370,202112,1470,3838,1143,3181,88,234,762,2053,850,2287
241380,202112,758,1944,585,1633,95,238,281,798,376,1036
241390,202112,2892,8132,2559,7634,234,548,1903,5861,2137,6409
241400,202112,3891,10343,3422,9629,232,649,2623,7374,2855,8023
241410,202112,2616,7493,2116,6476,286,891,1201,3671,1487,4562
241415,202112,1857,5056,1548,4472,42,131,1184,3325,1226,3456
241420,202112,2720,7900,2380,7327,446,1453,1371,4200,1817,5653
241430,202112,657,1688,460,1276,20,51,301,806,321,857
241440,202112,8415,24642,7502,23048,311,986,5956,18300,6267,19286
241445,202112,1370,3185,1187,2944,70,107,996,2589,1066,2696
241450,202112,3069,7057,2559,6254,360,737,1752,4385,2112,5122
241460,202112,4161,10816,3343,9157,270,651,2199,5938,2469,6589
241470,202112,1476,3825,1211,3426,27,80,1001,2831,1028,2911
241475,202112,1340,3526,1041,2973,17,63,792,2140,809,2203
241480,202112,3196,9520,2605,8258,788,2489,765,2728,1553,5217
241490,202112,764,1699,565,1415,19,38,426,1055,445,1093
241500,202112,825,2251,747,2156,3,10,710,2064,713,2074
250010,202112,2803,8016,2337,7066,49,168,1729,5110,1778,5278
250020,202112,1761,4470,1295,3602,54,96,926,2580,980,2676
250030,202112,7240,19262,6361,17919,688,1881,4556,12789,5244,14670
250040,202112,4596,12901,4003,11845,503,1291,2715,8047,3218,9338
250050,202112,3923,9982,3544,9492,127,374,2975,7985,3102,8359
250053,202112,1309,3526,1190,3346,90,211,879,2479,969,2690
250057,202112,742,2396,682,2308,7,33,629,2144,636,2177
250060,202112,6031,14929,5423,14164,400,907,4373,11599,4773,12506
250070,202112,4304,11530,3601,10352,18,73,2919,8185,2937,8258
250073,202112,826,2101,666,1853,12,26,542,1487,554,1513
250077,202112,2546,6254,1941,5297,41,132,1554,4168,1595,4300
250080,202112,5529,12921,4650,11822,62,194,4139,10387,4201,10581
250090,202112,3708,8465,3234,7849,60,143,2805,6701,2865,6844
250100,202112,3767,11004,3375,10302,179,524,2621,7886,2800,8410
250110,202112,5157,13893,4648,13171,321,970,3536,9960,3857,10930
250115,202112,796,1882,593,1569,9,39,467,1211,476,1250
250120,202112,1997,5593,1671,5069,23,114,1338,4014,1361,4128
250130,202112,5948,15375,5013,14065,54,269,4325,11945,4379,12214
250135,202112,1331,3490,1163,3206,16,48,1014,2787,1030,2835
250140,202112,2399,6719,2225,6505,110,370,1914,5603,2024,5973
250150,202112,4980,14928,4464,14072,136,500,3595,11141,3731,11641
250153,202112,1450,3728,1197,3356,42,97,939,2626,981,2723
250157,202112,2081,5607,1840,5210,60,193,1477,4106,1537,4299
250160,202112,4138,9856,3299,8725,53,135,2850,7549,2903,7684
250170,202112,2021,5040,1816,4755,19,61,1584,4080,1603,4141
250180,202112,22391,51210,19131,47095,885,2280,15144,36421,16029,38701
250190,202112,4449,11241,3741,10221,366,968,2633,7127,2999,8095
250200,202112,2298,5466,1953,5027,88,177,1642,4254,1730,4431
250205,202112,918,2752,784,2534,12,40,634,2038,646,2078
250210,202112,1601,4695,1438,4450,39,157,1149,3494,1188,3651
250215,202112,1743,4530,1457,4135,75,214,846,2432,921,2646
250220,202112,696,1878,549,1652,24,84,371,1100,395,1184
250230,202112,1798,3923,1267,3148,32,72,1005,2463,1037,2535
250240,202112,2605,7360,2292,6817,32,127,1969,5792,2001,5919
250250,202112,4891,13010,4278,12144,134,330,3615,10401,3749,10731
250260,202112,1753,4779,1476,4295,48,118,1143,3360,1191,3478
250270,202112,1267,3729,1156,3592,67,201,867,2790,934,2991
250280,202112,3823,9666,3412,9087,201,413,2645,7165,2846,7578
250290,202112,1674,4256,1428,3886,16,43,1141,3068,1157,3111
250300,202112,5795,14798,5210,14109,149,572,4444,11682,4593,12254
250310,202112,1267,3399,1049,3034,52,152,772,2234,824,2386
250320,202112,13385,28648,11599,26630,260,661,10494,23784,10754,24445
250330,202112,2567,6759,2149,6191,237,490,1622,4832,1859,5322
250340,202112,1259,3004,1103,2805,15,38,1004,2539,1019,2577
250350,202112,4329,11716,3787,10784,232,449,2972,8736,3204,9185
250355,202112,2184,6188,1951,5884,20,109,1773,5345,1793,5454
250360,202112,1943,5025,1741,4762,35,111,1483,3996,1518,4107
250370,202112,14823,36148,12335,32457,227,721,10528,27251,10755,27972
250375,202112,1311,3192,1060,2896,4,17,1001,2748,1005,2765
250380,202112,1728,4213,1586,4037,33,104,1409,3496,1442,3600
250390,202112,1964,4843,1647,4356,75,194,1340,3520,1415,3714
250400,202112,74611,178385,55489,149182,15637,45796,13703,39372,29340,85168
250403,202112,1969,5130,1750,4880,46,225,1410,3757,1456,3982
250407,202112,1454,3319,1100,2785,116,223,667,1870,783,2093
250410,202112,741,1885,633,1704,6,15,520,1358,526,1373
250415,202112,1991,5325,1739,4938,28,88,1490,4200,1518,4288
250420,202112,1263,3360,1127,3175,24,83,1027,2885,1051,2968
250430,202112,6649,15906,5642,14581,185,454,4582,11648,4767,12102
250435,202112,1685,4594,1335,4004,10,40,1015,2991,1025,3031
250440,202112,4865,12547,4213,11725,84,164,3704,10330,3788,10494
250450,202112,1862,4804,1527,4350,32,98,1254,3593,1286,3691
250460,202112,7728,20148,6835,18873,475,1273,5332,14736,5807,16009
250470,202112,1709,4231,1397,3746,78,202,1082,2856,1160,3058
250480,202112,4147,11062,3510,10284,36,113,3111,9202,3147,9315
250485,202112,763,1666,567,1391,48,82,397,959,445,1041
250490,202112,5329,12315,4728,11631,142,373,4210,10202,4352,10575
250500,202112,2120,5660,1891,5272,64,137,1533,4282,1597,4419
250510,202112,5723,13885,4905,12789,78,150,4268,11242,4346,11392
250520,202112,2062,5255,1762,4854,117,307,1300,3559,1417,3866
250523,202112,2228,5434,1960,5090,81,267,1624,4098,1705,4365
250527,202112,1795,4369,1617,4171,18,45,1450,3738,1468,3783
250530,202112,703,1734,600,1582,13,31,519,1364,532,1395
250535,202112,1457,4067,1302,3787,26,93,1047,2956,1073,3049
250540,202112,3288,7110,2746,6511,85,149,2425,5866,2510,6015
250550,202112,811,2527,713,2336,22,74,516,1669,538,1743
250560,202112,1872,4987,1632,4636,40,118,1373,3836,1413,3954
250570,202112,2898,8195,2471,7428,97,293,1913,5699,2010,5992
250580,202112,1111,2822,979,2641,50,159,817,2146,867,2305
250590,202112,954,2404,847,2250,18,49,731,1908,749,1957
250600,202112,8415,21658,6976,19728,260,752,5504,15490,5764,16242
250610,202112,3163,8607,2832,8126,115,371,2336,6688,2451,7059
250620,202112,913,2251,784,2040,27,55,558,1445,585,1500
250625,202112,2522,7073,2248,6627,33,150,1937,5591,1970,5741
250630,202112,11332,29578,9324,26179,1044,2909,5987,16456,7031,19365
250640,202112,3802,9821,3405,9308,72,280,3004,8097,3076,8377
250650,202112,1093,2488,907,2246,15,49,795,1924,810,1973
250660,202112,1710,4091,1350,3595,44,92,1100,2848,1144,2940
250670,202112,2512,7491,2284,7095,34,135,2001,6107,2035,6242
250680,202112,6273,14084,5630,13360,46,178,5281,12342,5327,12520
250690,202112,7270,15895,6119,14476,102,197,5423,12739,5525,12936
250700,202112,4725,12810,4113,11884,726,1984,2422,7175,3148,9159
250710,202112,4565,12855,3978,12013,302,823,2867,8786,3169,9609
250720,202112,2995,7728,2673,7277,25,127,2421,6527,2446,6654
250730,202112,4550,11525,3985,10758,164,479,3295,8713,3459,9192
250740,202112,2116,5061,1742,4569,112,236,1335,3562,1447,3798
250750,202112,117361,276868,99880,252393,8797,22420,71793,178630,80590,201050
250760,202112,2598,6217,2277,5711,62,157,1924,4714,1986,4871
250770,202112,4295,12420,3832,11798,525,1401,2599,8352,3124,9753
250780,202112,1928,4897,1625,4361,64,190,1292,3391,1356,3581
250790,202112,2699,7600,2340,7073,73,281,1775,5231,1848,5512
250800,202112,2625,6663,2298,6147,124,221,1824,4976,1948,5197
250810,202112,1413,3505,1180,3186,50,88,969,2685,1019,2773
250820,202112,2053,5586,1884,5398,28,113,1706,4848,1734,4961
250830,202112,6357,18260,5186,15907,235,734,3494,10375,3729,11109
250840,202112,813,2496,706,2290,19,62,529,1735,548,1797
250850,202112,1898,5382,1693,5027,29,111,1413,4106,1442,4217
250855,202112,1110,3009,962,2773,52,164,761,2170,813,2334
250860,202112,3659,10182,3005,9080,595,1634,1465,4631,2060,6265
250870,202112,1094,2888,919,2604,36,106,735,2066,771,2172
250880,202112,1731,4278,1440,3840,105,288,1065,2838,1170,3126
250890,202112,11207,26968,9873,25241,408,1264,8074,19798,8482,21062
250900,202112,3142,8131,2728,7416,100,226,2289,6174,2389,6400
250905,202112,2675,7096,2472,6823,56,148,2242,6214,2298,6362
250910,202112,6739,15742,5590,14457,70,179,4934,12812,5004,12991
250915,202112,2269,5109,1597,4389,28,57,1396,3927,1424,3984
250920,202112,3767,9186,3315,8510,298,631,2553,6578,2851,7209
250930,202112,2465,6398,2215,6076,40,171,1938,5182,1978,5353
250933,202112,1280,3615,1120,3315,38,134,877,2540,915,2674
250937,202112,772,2032,644,1827,24,76,505,1458,529,1534
250939,202112,2053,5051,1802,4738,68,146,1428,3765,1496,3911
250940,202112,4274,10949,3756,10283,25,70,3383,9264,3408,9334
250950,202112,1848,4627,1491,4156,28,101,1215,3330,1243,3431
250960,202112,1190,3400,1050,3179,21,92,851,2508,872,2600
250970,202112,8754,21897,7663,20135,200,544,6317,16282,6517,16826
250980,202112,2559,6488,2320,6150,18,84,2056,5313,2074,5397
250990,202112,2194,6406,1839,5794,72,236,1368,4278,1440,4514
251000,202112,2146,5879,1737,5181,26,88,1406,4174,1432,4262
251010,202112,2790,7539,2525,7124,23,79,2257,6385,2280,6464
251020,202112,1708,4569,1528,4284,30,127,1322,3641,1352,3768
251030,202112,1110,2843,907,2485,57,129,597,1648,654,1777
251040,202112,1994,5268,1690,4769,27,122,1422,3962,1449,4084
251050,202112,1108,2958,926,2613,48,154,666,1805,714,1959
251060,202112,1146,2377,865,2021,16,37,661,1539,677,1576
251065,202112,513,1351,387,1118,10,25,274,758,284,783
251070,202112,790,1950,655,1756,9,30,565,1478,574,1508
251080,202112,20564,49842,16642,43955,2659,7041,9428,25545,12087,32586
251090,202112,3035,8420,2570,7610,56,149,2041,6012,2097,6161
251100,202112,867,2666,757,2453,23,79,593,1844,616,1923
251110,202112,1891,4790,1596,4275,104,204,1170,3169,1274,3373
251120,202112,8279,21692,6968,20096,368,1073,5280,15309,5648,16382
251130,202112,4219,8942,3721,8377,48,111,3403,7615,3451,7726
251140,202112,4531,12233,4022,11522,63,220,3315,9406,3378,9626
251150,202112,2855,7968,2613,7579,55,232,2249,6368,2304,6600
251160,202112,2402,6606,2079,6130,24,119,1808,5223,1832,5342
251170,202112,1778,4506,1564,4233,21,65,1417,3797,1438,3862
251180,202112,2797,7199,2297,6499,167,421,1612,4594,1779,5015
251190,202112,4671,11825,4207,11297,40,178,3825,10090,3865,10268
251200,202112,4647,13025,4093,12328,64,236,3578,10828,3642,11064
251203,202112,1058,3263,965,3052,32,96,714,2212,746,2308
251207,202112,1203,3128,914,2667,18,66,636,1817,654,1883
251210,202112,8540,20355,6972,18234,443,837,5078,13814,5521,14651
251220,202112,1356,3089,1021,2649,93,178,734,2001,827,2179
251230,202112,5000,13454,4305,12217,111,316,3417,9492,3528,9808
251240,202112,3889,10434,3254,9339,238,528,2312,6687,2550,7215
251250,202112,11809,30104,10346,27616,743,1909,7689,19980,8432,21889
251260,202112,539,1436,486,1354,12,51,388,1047,400,1098
251270,202112,4539,13652,4058,12989,135,467,3266,10693,3401,11160
251272,202112,1370,3666,1253,3511,67,202,1035,2852,1102,3054
251274,202112,961,2578,773,2241,65,187,502,1404,567,1591
251275,202112,1360,3579,1143,3225,46,152,879,2419,925,2571
251276,202112,1386,3677,1200,3419,21,105,970,2672,991,2777
251278,202112,644,1676,579,1580,39,105,443,1216,482,1321
251280,202112,2429,6286,2209,5969,55,141,1865,4989,1920,5130
251290,202112,6862,14859,6263,14140,192,489,5577,12293,5769,12782
251300,202112,925,2640,833,2499,8,39,714,2128,722,2167
251310,202112,3020,8105,2628,7514,33,160,2185,6102,2218,6262
251315,202112,1897,5663,1711,5304,122,324,1280,3985,1402,4309
251320,202112,1728,4450,1272,3657,34,112,958,2697,992,2809
251330,202112,2255,5093,1844,4611,31,79,1621,4082,1652,4161
251335,202112,1184,3188,1057,2998,23,92,938,2608,961,2700
251340,202112,4064,9224,3238,8147,131,310,2512,6337,2643,6647
251350,202112,1137,3130,1038,2966,44,107,845,2410,889,2517
251360,202112,1985,5284,1596,4731,9,42,1315,3878,1324,3920
251365,202112,825,2106,648,1780,6,20,517,1395,523,1415
251370,202112,26461,67364,22608,61930,3638,9658,12493,35574,16131,45232
251380,202112,1399,3655,1188,3313,13,73,1021,2776,1034,2849
251385,202112,827,2042,639,1709,30,66,460,1204,490,1270
251390,202112,6747,18955,5946,17718,582,1657,3890,11764,4472,13421
251392,202112,1083,2843,914,2581,27,99,726,2021,753,2120
251394,202112,679,1864,546,1637,53,135,372,1124,425,1259
251396,202112,708,1863,597,1671,26,57,395,1088,421,1145
251398,202112,1083,2668,772,2129,19,59,572,1532,591,1591
251400,202112,1402,3156,1106,2762,18,61,904,2174,922,2235
251410,202112,1675,3752,1342,3287,20,75,1145,2692,1165,2767
251420,202112,2178,5353,1783,4884,35,125,1424,3821,1459,3946
251430,202112,1624,4775,1460,4490,29,135,1264,3859,1293,3994
251440,202112,1146,3115,924,2709,54,114,696,2109,750,2223
251445,202112,1680,4510,1546,4320,26,70,1333,3676,1359,3746
251450,202112,4479,13015,4001,12276,79,278,3344,10208,3423,10486
251455,202112,934,2721,855,2579,17,59,691,2044,708,2103
251460,202112,1012,2731,850,2481,54,176,631,1830,685,2006
251465,202112,497,1381,422,1234,5,20,324,915,329,935
251470,202112,1273,3386,951,2749,101,273,508,1419,609,1692
251480,202112,1088,2732,879,2372,15,51,685,1771,700,1822
251490,202112,2080,5245,1661,4667,95,221,1225,3493,1320,3714
251500,202112,2086,5655,1912,5434,41,138,1720,4880,1761,5018
251510,202112,2858,8184,2368,7223,115,357,1618,4802,1733,5159
251520,202112,1129,2778,863,2319,75,186,561,1474,636,1660
251530,202112,15363,35602,12379,31913,96,461,10984,27819,11080,28280
251540,202112,3290,8913,2953,8325,63,216,2513,6966,2576,7182
251550,202112,4229,9293,3371,8258,186,265,2747,6897,2933,7162
251560,202112,603,1779,538,1680,39,127,382,1144,421,1271
251570,202112,998,2739,820,2388,22,100,658,1859,680,1959
251580,202112,2093,4897,1871,4577,32,109,1605,3786,1637,3895
251590,202112,1727,4052,1454,3728,76,167,1211,3080,1287,3247
251593,202112,1016,2873,911,2694,94,249,572,1684,666,1933
251597,202112,2222,6016,1989,5704,11,61,1798,5103,1809,5164
251600,202112,6678,17508,5813,16180,311,760,4634,12871,4945,13631
251610,202112,3324,9171,2874,8352,314,758,1907,5727,2221,6485
251615,202112,1402,3334,1122,2919,24,61,914,2317,938,2378
251620,202112,20514,44857,15780,39112,68,223,13766,34285,13834,34508
251630,202112,5313,11807,4238,10320,252,539,3141,7593,3393,8132
251640,202112,2381,6144,2126,5754,20,86,1915,5092,1935,5178
251650,202112,4344,11001,3773,10266,125,318,3219,8754,3344,9072
251660,202112,3830,10975,3378,10202,56,219,2814,8388,2870,8607
251670,202112,4417,11900,3896,11185,30,141,3526,10029,3556,10170
251675,202112,799,1975,727,1891,88,195,526,1390,614,1585
251680,202112,2779,6906,2327,6323,45,124,1937,5287,1982,5411
251690,202112,3427,9195,2924,8345,99,232,2202,6297,2301,6529
251700,202112,2380,6346,1974,5816,37,142,1670,4812,1707,4954
251710,202112,863,2130,607,1621,45,125,345,857,390,982
251720,202112,1403,3845,1125,3371,12,47,875,2550,887,2597
251740,202112,632,1727,504,1488,38,132,347,985,385,1117
260005,202112,31769,65414,26257,58376,2314,4747,19512,42832,21826,47579
260010,202112,11004,27804,9090,24742,567,1464,5281,14566,5848,16030
260020,202112,7303,16398,6072,14658,63,243,5201,12312,5264,12555
260030,202112,7266,17862,6091,16173,109,323,5003,13133,5112,13456
260040,202112,8209,19858,6924,18084,502,1245,4960,13239,5462,14484
260050,202112,14915,37163,12417,34404,271,654,11393,31811,11664,32465
260060,202112,4482,10440,3844,9447,330,627,2841,7229,3171,7856
260070,202112,11486,27555,9873,25246,333,1029,8034,20013,8367,21042
260080,202112,6911,15312,5983,14107,111,270,5038,11722,5149,11992
260090,202112,5107,12507,4471,11653,407,1029,3377,8850,3784,9879
260100,202112,3159,8218,2654,7485,28,145,2241,6216,2269,6361
260105,202112,5311,14082,4769,13350,138,424,4063,11215,4201,11639
260110,202112,23643,63480,21030,59709,894,2690,17412,48813,18306,51503
260120,202112,15667,39447,13217,35920,1585,3978,8550,23670,10135,27648
260130,202112,3423,8178,3010,7595,186,419,2313,5761,2499,6180
260140,202112,13826,29679,11938,27452,627,1369,10038,22905,10665,24274
260150,202112,3777,8492,3279,7886,117,243,2862,6892,2979,7135
260160,202112,6907,17269,5844,15983,92,271,5334,14685,5426,14956
260170,202112,22399,50383,19072,45889,1086,2491,15157,36118,16243,38609
260180,202112,3773,9540,3253,8842,71,219,2818,7549,2889,7768
260190,202112,19733,38087,16667,34529,271,528,14816,30201,15087,30729
260200,202112,11834,27298,10184,25197,540,1020,8592,21628,9132,22648
260210,202112,12258,33139,10383,30130,308,913,8300,24046,8608,24959
260220,202112,11697,26048,10798,24926,213,455,9638,22019,9851,22474
260230,202112,11691,27154,10111,25092,279,604,8470,20896,8749,21500
260240,202112,2952,8485,2566,7757,86,306,1988,5915,2074,6221
260250,202112,2470,5986,2138,5490,120,227,1703,4377,1823,4604
260260,202112,13794,33949,12240,31643,481,1262,9777,24981,10258,26243
260270,202112,4745,10830,4170,10164,92,320,3601,8630,3693,8950
260280,202112,13178,38367,11863,36493,395,1516,10162,30832,10557,32348
260290,202112,44200,107218,37996,98393,4301,10996,25631,66295,29932,77291
260300,202112,10324,26682,8900,24712,200,665,7592,20986,7792,21651
260310,202112,5934,14186,5235,13329,437,855,3962,10433,4399,11288
260320,202112,8262,22928,7025,20860,201,548,5770,17170,5971,17718
260330,202112,2721,8006,2366,7284,65,202,1887,5676,1952,5878
260340,202112,2195,5638,1906,5221,19,70,1684,4513,1703,4583
260345,202112,28335,69270,23744,62703,3576,9851,12907,33169,16483,43020
260350,202112,6024,13412,5188,12468,42,114,4707,11247,4749,11361
260360,202112,2722,6744,2447,6256,41,120,1799,4510,1840,4630
260370,202112,5897,16166,5068,14778,196,548,3943,11391,4139,11939
260380,202112,5352,15042,4570,13777,164,438,3498,10467,3662,10905
260390,202112,5013,14384,4107,12566,207,566,2757,8321,2964,8887
260392,202112,3708,11140,3351,10682,77,432,2823,8982,2900,9414
260400,202112,20554,45039,17762,41408,511,1199,14266,32015,14777,33214
260410,202112,81350,188909,63958,164927,11887,31675,27732,74008,39619,105683
260415,202112,4710,11927,4050,10902,45,164,3414,9028,3459,9192
260420,202112,13154,26737,11156,24542,79,232,10444,22775,10523,23007
260430,202112,2973,8847,2515,7958,161,459,1698,5365,1859,5824
260440,202112,4054,9825,3595,9185,62,184,3117,7834,3179,8018
260450,202112,6007,14574,5359,13731,282,514,4488,11705,4770,12219
260460,202112,5661,15922,4812,14461,499,1589,2913,8607,3412,10196
260470,202112,5124,12998,4332,12087,86,187,3959,11184,4045,11371
260480,202112,4351,10813,3676,9883,353,875,2467,6807,2820,7682
260490,202112,5608,12559,4939,11623,25,107,4533,10497,4558,10604
260500,202112,6433,15348,5505,14056,419,892,3904,10097,4323,10989
260510,202112,10713,25195,8993,22808,77,270,7994,20027,8071,20297
260515,202112,4756,12076,3729,10212,139,325,2628,6937,2767,7262
260520,202112,17634,39535,15336,36647,726,1656,12686,29988,13412,31644
260530,202112,10437,28837,8854,26432,97,445,7713,22727,7810,23172
260540,202112,7616,16105,6726,15001,127,255,6101,13523,6228,13778
260545,202112,89,260,55,177,4,14,23,68,27,82
260550,202112,3420,8888,2763,7822,147,434,1918,5293,2065,5727
260560,202112,6264,15635,5241,14141,105,353,4427,11757,4532,12110
260570,202112,8410,21327,7419,20001,318,864,6125,16481,6443,17345
260580,202112,4751,10941,4270,10316,21,58,3922,9423,3943,9481
260590,202112,7521,15924,6369,14662,196,379,5535,12825,5731,13204
260600,202112,34060,84048,27866,74804,1222,3262,21286,56010,22508,59272
260610,202112,8035,19947,7131,18758,480,1184,5297,13999,5777,15183
260620,202112,18852,45553,16587,42380,1440,3868,12238,30645,13678,34513
260630,202112,2537,6607,2066,5872,39,112,1687,4720,1726,4832
260640,202112,24291,51723,20485,47389,833,1855,16972,38942,17805,40797
260650,202112,6637,16474,5337,14885,529,869,4237,12374,4766,13243
260660,202112,7540,18692,6566,17436,282,808,5614,14704,5896,15512
260670,202112,2433,6155,1978,5431,79,209,1414,3780,1493,3989
260680,202112,31345,71947,26426,65093,2294,5459,18234,44360,20528,49819
260690,202112,3719,9378,3086,8399,63,223,2446,6602,2509,6825
260700,202112,6788,17889,6254,17286,19,73,6069,16840,6088,16913
260710,202112,1469,3649,1241,3310,31,104,984,2602,1015,2706
260720,202112,28245,64463,23953,59116,2512,5802,17086,42970,19598,48772
260730,202112,8533,23236,7429,21712,225,687,6310,18240,6535,18927
260740,202112,1404,3888,1173,3509,17,73,927,2827,944,2900
260750,202112,7980,20396,6401,18417,244,438,5560,16530,5804,16968
260760,202112,6496,14239,5627,13231,136,294,4874,11454,5010,11748
260765,202112,8957,24270,7829,22731,456,1510,5602,15933,6058,17443
260770,202112,4189,10186,3452,8990,112,326,2760,7067,2872,7393
260775,202112,5749,14512,5034,13459,174,541,4027,10435,4201,10976
260780,202112,3955,11204,3526,10513,437,1285,2168,6395,2605,7680
260790,202112,134493,289046,111832,260128,17344,38457,69467,162159,86811,200616
260795,202112,3269,7863,2806,7274,119,282,2228,5846,2347,6128
260800,202112,5858,12799,5290,12034,206,487,4621,10233,4827,10720
260805,202112,3931,10539,3328,9519,194,571,2456,6949,2650,7520
260810,202112,7124,18194,6235,16567,441,1030,4697,12281,5138,13311
260820,202112,4780,10661,4243,10047,93,237,3556,8333,3649,8570
260825,202112,3183,8990,2801,8339,123,332,2109,6240,2232,6572
260830,202112,4580,12633,3801,11279,550,1369,2340,7281,2890,8650
260840,202112,4532,11112,4049,10463,276,567,3368,8819,3644,9386
260845,202112,4905,12239,4326,11272,273,739,3241,8263,3514,9002
260850,202112,5486,14234,4584,12571,367,1021,2942,7799,3309,8820
260860,202112,3647,9939,3129,9056,95,284,2540,7168,2635,7452
260870,202112,4769,10899,4084,10073,54,172,3683,8969,3737,9141
260875,202112,8097,18520,6539,16275,597,1334,4516,11461,5113,12795
260880,202112,10316,27838,8982,25598,380,1083,7189,20379,7569,21462
260890,202112,14135,34282,12172,31370,932,2256,8539,21661,9471,23917
260900,202112,5921,15673,4896,14238,311,871,3323,9651,3634,10522
260910,202112,3472,9037,3028,8389,120,310,2367,6538,2487,6848
260915,202112,5203,14909,4533,14124,43,189,4187,13056,4230,13245
260920,202112,3730,8384,3180,7795,118,214,2747,6823,2865,7037
260930,202112,4434,12486,3793,11374,178,562,2942,8594,3120,9156
260940,202112,16120,36544,13997,33625,1393,3233,10174,24154,11567,27387
260950,202112,7724,19636,6230,17136,362,1180,4139,10754,4501,11934
260960,202112,79563,168326,64816,149793,7376,16358,42154,96609,49530,112967
260970,202112,6177,15276,5479,14340,313,609,4041,10917,4354,11526
260980,202112,4892,13668,4288,12917,46,143,3928,11941,3974,12084
260990,202112,19478,50234,16451,46123,919,2280,12803,35760,13722,38040
261000,202112,17834,39645,15029,36161,459,1159,12257,28903,12716,30062
261010,202112,2466,6201,2134,5765,104,236,1819,4956,1923,5192
261020,202112,7151,17653,6214,16138,366,842,5016,12825,5382,13667
261030,202112,4300,12035,3773,11115,122,428,2992,8581,3114,9009
261040,202112,5842,15936,4767,13965,152,422,3669,10506,3821,10928
261050,202112,8749,20968,7932,19801,354,587,6429,16082,6783,16669
261060,202112,15314,36736,13331,34376,260,744,11270,28702,11530,29446
261070,202112,72051,151538,59839,135604,4358,9123,44393,99144,48751,108267
261080,202112,7204,16505,6514,15673,171,304,6010,14496,6181,14800
261090,202112,20921,47343,18583,44299,415,1094,16260,38186,16675,39280
261100,202112,9243,23812,8044,22074,589,1518,5959,16386,6548,17904
261110,202112,73995,197341,61924,175637,8325,24386,36873,103145,45198,127531
261120,202112,3887,9340,3361,8605,75,138,2912,7452,2987,7590
261130,202112,7785,18223,6801,16905,132,339,6009,14797,6141,15136
261140,202112,3930,8769,3502,8202,237,548,2696,6259,2933,6807
261150,202112,5754,14270,5083,13292,148,334,4342,11321,4490,11655
261153,202112,2068,5972,1729,5322,56,157,1165,3622,1221,3779
261160,202112,238864,527721,195408,469026,49062,120023,79639,196294,128701,316317
261170,202112,7210,16320,6288,15102,236,492,5309,12602,5545,13094
261180,202112,10082,24148,8806,22504,599,1304,6390,16632,6989,17936
261190,202112,4918,13647,4416,12848,132,555,3594,10152,3726,10707
261200,202112,3666,7995,3227,7419,183,410,2677,6064,2860,6474
261210,202112,2038,4786,1750,4384,82,180,1441,3578,1523,3758
261220,202112,15299,40165,12934,36052,1469,4082,7896,21682,9365,25764
261230,202112,4299,11727,3571,10768,35,115,3017,9187,3052,9302
261240,202112,6114,14107,5369,12977,378,728,4291,10387,4669,11115
261245,202112,4039,10746,3357,9566,63,279,2712,7449,2775,7728
261247,202112,3285,9206,2700,8177,190,516,1870,5679,2060,6195
261250,202112,25538,55342,22226,51503,3343,6918,14861,36140,18204,43058
261255,202112,4404,12336,3598,10790,134,477,2788,8178,2922,8655
261260,202112,13999,35284,12187,32956,263,881,10784,28822,11047,29703
261270,202112,4879,11243,4261,10490,223,468,3527,8691,3750,9159
261280,202112,2667,7205,2334,6656,72,231,1859,5171,1931,5402
261290,202112,3118,7709,2597,7124,64,215,2126,5872,2190,6087
261300,202112,13858,36183,11877,32972,392,1332,9210,24820,9602,26152
261310,202112,10021,23880,8594,21959,689,1761,6350,15939,7039,17700
261320,202112,6551,17491,5656,16050,64,244,4852,13579,4916,13823
261330,202112,6104,14271,5503,13499,113,344,4829,11598,4942,11942
261340,202112,4629,12181,4040,11439,126,420,3446,9647,3572,10067
261350,202112,9185,26267,8067,24366,139,466,6537,19620,6676,20086
261360,202112,8867,20172,7483,18230,322,758,5969,14186,6291,14944
261370,202112,26153,62365,21999,56749,2718,6412,13978,36691,16696,43103
261380,202112,4463,12550,3934,11660,439,1340,2640,7771,3079,9111
261390,202112,18060,49194,15186,44633,1197,3655,10157,29554,11354,33209
261400,202112,5016,14908,4376,13597,287,884,3202,9827,3489,10711
261410,202112,10416,24750,8550,21953,329,936,6985,17458,7314,18394
261420,202112,7919,22443,7154,21523,630,2104,5313,15911,5943,18015
261430,202112,3848,10087,3270,9210,46,171,2793,7696,2839,7867
261440,202112,1538,4432,1278,3939,48,195,923,2731,971,2926
261450,202112,15385,40313,13556,37578,186,612,11096,30870,11282,31482
261460,202112,8380,21573,7308,19939,296,785,5897,16061,6193,16846
261470,202112,4331,10432,3728,9603,37,119,3203,8206,3240,8325
261480,202112,5648,16288,4829,14919,256,796,3710,11325,3966,12121
261485,202112,5457,14669,4753,13591,409,1186,3484,9884,3893,11070
261500,202112,6681,16119,5822,14966,552,1120,3862,10535,4414,11655
261510,202112,1976,5685,1714,5262,61,205,1310,4036,1371,4241
261520,202112,2479,7290,2226,6797,63,200,1668,5053,1731,5253
261530,202112,13062,36022,10653,31824,874,2888,5833,16596,6707,19484
261540,202112,9409,25110,8530,23891,1445,3746,4541,13790,5986,17536
261550,202112,3961,10112,3437,9310,295,756,2437,6526,2732,7282
261560,202112,8707,24064,7563,22390,341,1035,5931,17566,6272,18601
261570,202112,3710,9667,2928,8373,202,587,1981,5591,2183,6178
261580,202112,7172,18231,6197,16900,88,389,5609,15106,5697,15495
261590,202112,2914,7089,2376,6334,81,233,1802,4751,1883,4984
261600,202112,5892,13590,5004,12339,302,581,3687,9153,3989,9734
261610,202112,2250,6365,1797,5530,125,421,1164,3581,1289,4002
261618,202112,2679,6407,2343,5936,209,485,1770,4459,1979,4944
261620,202112,4437,12156,4036,11569,836,2099,2539,7679,3375,9778
261630,202112,6427,17642,5437,15789,442,1341,3501,9840,3943,11181
261640,202112,40669,86411,34762,79270,2504,4157,25961,61604,28465,65761
261650,202112,4534,10495,3850,9649,272,563,2841,7234,3113,7797
270010,202112,4684,15041,4026,13918,118,635,3254,10952,3372,11587
270020,202112,4272,10056,3757,9418,143,429,3206,7793,3349,8222
270030,202112,36059,95198,30153,85783,3235,9103,20932,59227,24167,68330
270040,202112,11494,29076,9881,27155,404,1129,8337,22840,8741,23969
270050,202112,5791,13018,4908,12016,444,789,4071,10306,4515,11095
270060,202112,2371,5876,1989,5423,180,430,1519,4211,1699,4641
270070,202112,4946,13341,4293,12446,99,346,3641,10339,3740,10685
270080,202112,1559,4085,1320,3692,64,157,1005,2756,1069,2913
270090,202112,1873,5526,1690,5179,44,163,1425,4282,1469,4445
270100,202112,6192,14784,5366,13611,223,581,4531,11286,4754,11867
270110,202112,3506,7741,2850,6989,185,325,2233,5822,2418,6147
270120,202112,2734,7321,2371,6832,70,264,1979,5597,2049,5861
270130,202112,5396,13483,4667,12604,211,577,3936,10658,4147,11235
270135,202112,2124,4981,1793,4615,31,105,1658,4232,1689,4337
270140,202112,10079,23124,8103,20408,415,1108,6255,15095,6670,16203
270150,202112,2725,8131,2475,7778,6,31,2332,7314,2338,7345
270160,202112,6175,16437,5260,15361,142,467,4769,13953,4911,14420
270170,202112,3524,9981,2968,9215,181,715,2207,6583,2388,7298
270180,202112,2419,7222,2218,6969,32,176,2021,6268,2053,6444
270190,202112,1904,5172,1692,4917,17,74,1554,4491,1571,4565
270200,202112,2688,7754,2319,7219,122,348,1687,5321,1809,5669
270210,202112,6027,13769,5121,12740,57,188,4733,11638,4790,11826
270220,202112,1756,4379,1402,3868,180,500,907,2451,1087,2951
270230,202112,10424,26940,8716,24343,1037,2765,6011,16904,7048,19669
270235,202112,6321,18671,5483,17339,179,533,4576,14408,4755,14941
270240,202112,12348,31697,10208,28809,1012,2816,7316,20884,8328,23700
270250,202112,3046,7208,2689,6708,190,361,2176,5477,2366,5838
270255,202112,4787,13094,3781,11338,123,397,2918,8600,3041,8997
270260,202112,5733,16678,5193,15788,79,354,4549,13582,4628,13936
270270,202112,1104,2761,917,2531,112,268,672,1890,784,2158
270280,202112,4116,9542,3297,8532,558,755,2278,6455,2836,7210
270290,202112,8291,25014,7479,23730,106,499,6672,20941,6778,21440
270300,202112,4524,11333,3523,10237,220,484,2715,8176,2935,8660
270310,202112,7493,20052,6427,18444,72,336,5629,15807,5701,16143
270320,202112,5808,16606,5026,15129,294,875,3722,10890,4016,11765
270330,202112,4351,13381,3838,12611,237,886,3050,10003,3287,10889
270340,202112,1736,4398,1464,4033,52,101,1247,3431,1299,3532
270350,202112,2007,4480,1624,4037,136,320,1169,2950,1305,3270
270360,202112,2848,6837,2551,6507,81,169,2369,6065,2450,6234
270370,202112,1497,4388,1364,4149,30,119,1173,3519,1203,3638
270375,202112,3308,7514,2784,6942,25,68,2616,6530,2641,6598
270380,202112,5889,15605,4984,14474,577,1430,3475,10590,4052,12020
270390,202112,1296,3168,1035,2864,10,41,879,2448,889,2489
270400,202112,7029,17362,5912,15743,267,569,4739,12623,5006,13192
270410,202112,5035,13914,4372,12920,129,427,3694,10873,3823,11300
270420,202112,6225,17432,5612,16552,118,468,4920,14230,5038,14698
270430,202112,151887,344386,118859,302191,21662,56098,57926,149663,79588,205761
270440,202112,4999,12966,4349,12168,83,296,3862,10721,3945,11017
270450,202112,7694,19667,6748,18519,331,799,5565,15666,5896,16465
270460,202112,3915,8515,3338,7826,163,305,3003,7072,3166,7377
270470,202112,11983,31742,10440,29599,651,1864,8191,23282,8842,25146
270480,202112,3137,7982,2642,7287,98,303,2163,5866,2261,6169
270490,202112,993,2621,866,2467,46,127,696,1972,742,2099
270500,202112,5192,15105,4627,14173,250,729,3691,11214,3941,11943
270510,202112,6071,15291,5094,14064,413,1240,3802,10214,4215,11454
270520,202112,4412,11903,3504,10420,753,2268,1406,4381,2159,6649
270530,202112,1397,3875,1180,3537,66,173,824,2511,890,2684
270540,202112,2424,6424,2057,5953,80,190,1754,5095,1834,5285
270550,202112,7236,17810,5764,16189,762,1736,4064,11995,4826,13731
270560,202112,3179,7880,2675,7195,179,493,2113,5647,2292,6140
270570,202112,4778,12290,4108,11320,404,914,3176,8868,3580,9782
270580,202112,2461,6612,2221,6274,132,336,1890,5346,2022,5682
270590,202112,1636,4859,1508,4683,15,77,1430,4423,1445,4500
270600,202112,2941,8730,2666,8310,42,180,2377,7320,2419,7500
270610,202112,3845,9812,3340,9143,76,177,2972,8085,3048,8262
270620,202112,1344,3847,1235,3640,23,74,1075,3087,1098,3161
270630,202112,18844,44254,16244,40712,825,2069,13491,33315,14316,35384
270640,202112,5821,15853,5087,14699,186,618,4226,12033,4412,12651
270642,202112,2671,8325,2351,7830,159,594,1782,5873,1941,6467
270644,202112,3955,9487,3276,8615,519,1142,2232,6162,2751,7304
270650,202112,3488,9686,3042,9088,314,931,2318,6963,2632,7894
270660,202112,2066,5161,1768,4748,80,240,1352,3581,1432,3821
270670,202112,18196,39786,15283,36250,479,1107,13149,30547,13628,31654
270680,202112,5958,13565,5329,12880,133,193,4987,12217,5120,12410
270690,202112,10108,24004,8473,21940,379,944,6856,17619,7235,18563
270700,202112,572,1677,498,1551,46,135,351,1088,397,1223
270710,202112,6067,17205,5339,16084,367,1053,4168,12570,4535,13623
270720,202112,3900,10815,3469,10109,57,230,3084,8834,3141,9064
270730,202112,8663,18380,7578,17228,439,648,5875,14916,6314,15564
270740,202112,2489,6374,2196,6033,97,294,1826,4984,1923,5278
270750,202112,6040,15211,5279,14267,81,244,4694,12645,4775,12889
270760,202112,3559,9581,2994,8809,58,234,2511,7320,2569,7554
270770,202112,22749,54548,18391,49063,3597,8459,10320,29529,13917,37988
270780,202112,1952,5036,1808,4836,57,180,1624,4301,1681,4481
270790,202112,1799,4631,1514,4241,136,367,1122,3155,1258,3522
270800,202112,11745,30623,10581,28975,413,1214,8988,24458,9401,25672
270810,202112,3611,9678,2869,8498,216,613,2005,5914,2221,6527
270820,202112,1689,4853,1430,4443,37,150,1151,3506,1188,3656
270830,202112,5508,12656,4454,11373,157,446,3685,9251,3842,9697
270840,202112,8908,25685,7878,24190,173,728,6846,20670,7019,21398
270850,202112,9334,21399,8235,20113,829,1988,6644,16184,7473,18172
270860,202112,15495,33154,12339,29609,675,1368,9925,23905,10600,25273
270870,202112,2384,6456,1950,5756,283,736,1225,3827,1508,4563
270880,202112,8369,24259,7477,22911,166,618,6251,18839,6417,19457
270890,202112,3462,8991,2927,8227,268,717,1913,5402,2181,6119
270895,202112,3429,9922,3102,9503,65,351,2781,8343,2846,8694
270900,202112,1812,4549,1378,3868,26,62,1094,3055,1120,3117
270910,202112,4356,11985,3761,11083,110,285,3129,9148,3239,9433
270915,202112,10293,27943,8332,24811,701,2235,5713,16609,6414,18844
270920,202112,6209,17208,5628,16319,65,296,4938,13937,5003,14233
270930,202112,18651,41354,14495,36556,1995,4269,9523,25752,11518,30021
270940,202112,6861,17399,5798,16130,177,637,4646,12583,4823,13220
280010,202112,702,1938,563,1652,18,65,399,1079,417,1144
280020,202112,5285,12878,4453,11597,436,1048,3106,8113,3542,9161
280030,202112,86275,193034,69305,169414,13690,32874,33427,84113,47117,116987
280040,202112,3204,8288,2795,7681,296,735,1944,5359,2240,6094
280050,202112,4419,12072,3754,11031,775,2179,1872,5596,2647,7775
280060,202112,7172,17324,5680,15114,1047,2834,2750,7622,3797,10456
280067,202112,7521,17575,6378,15830,329,706,4707,11602,5036,12308
280070,202112,1923,5636,1779,5406,113,323,1462,4438,1575,4761
280100,202112,4335,10918,3640,9847,371,993,2420,6593,2791,7586
280110,202112,1579,3916,1370,3613,15,49,1237,3199,1252,3248
280120,202112,8115,22038,7177,20554,1047,2600,4804,14305,5851,16905
280130,202112,9502,21552,8288,19884,464,1110,6645,15888,7109,16998
280140,202112,5996,13556,5271,12571,363,765,4202,10151,4565,10916
280150,202112,4439,10754,3857,9968,550,1214,2726,7275,3276,8489
280160,202112,1290,3513,1093,3192,98,324,754,2141,852,2465
280170,202112,5501,13801,4925,13080,280,604,3941,10582,4221,11186
280190,202112,1422,2963,1269,2764,52,108,1085,2322,1137,2430
280200,202112,1363,3442,1127,3112,61,193,865,2346,926,2539
280210,202112,18620,43337,16163,39896,1982,4522,10245,25531,12227,30053
280220,202112,1789,4633,1505,4265,44,162,1241,3490,1285,3652
280230,202112,4590,11107,3781,9905,333,654,2586,6925,2919,7579
280240,202112,3493,9014,3096,8421,33,158,2700,7163,2733,7321
280250,202112,977,2235,811,1989,75,182,582,1394,657,1576
280260,202112,2380,5522,2083,5149,39,82,1895,4726,1934,4808
280270,202112,2590,6761,2280,6299,168,389,1826,5091,1994,5480
280280,202112,4268,12269,3789,11560,581,1506,2512,8112,3093,9618
280290,202112,20272,50130,17438,46179,1743,4362,11432,30701,13175,35063
280300,202112,13451,29776,11787,27998,524,890,8488,22511,9012,23401
280310,202112,1482,3703,1229,3290,38,103,936,2458,974,2561
280320,202112,9262,23878,7992,21981,1058,2660,5270,14527,6328,17187
280330,202112,5011,11909,4219,10809,292,734,3076,7905,3368,8639
280340,202112,5797,11833,4808,10747,268,388,4106,9432,4374,9820
280350,202112,28321,63311,24855,58730,1275,2793,19737,46072,21012,48865
280360,202112,5962,16019,5218,14809,679,1900,3160,9122,3839,11022
280370,202112,2374,5459,1926,4721,64,116,1533,3687,1597,3803
280380,202112,1096,2765,925,2546,76,171,641,1810,717,1981
280390,202112,3946,9190,3345,8276,244,452,2579,6464,2823,6916
280400,202112,4256,10021,3705,9286,605,1259,2320,6178,2925,7437
280410,202112,2731,6989,2254,6254,207,555,1389,3807,1596,4362
280420,202112,4629,11737,4240,11246,75,241,3911,10319,3986,10560
280430,202112,2282,5307,2006,4942,81,194,1643,3967,1724,4161
280440,202112,4523,11476,3981,10665,133,422,3386,8846,3519,9268
280445,202112,2488,6149,2229,5724,50,114,1724,4273,1774,4387
280450,202112,10592,24425,9066,22347,1779,4342,4415,11463,6194,15805
280460,202112,7339,16541,6644,15606,488,967,5483,12902,5971,13869
280470,202112,1805,4892,1528,4379,114,315,1089,3086,1203,3401
280480,202112,48332,111307,41782,102166,4016,9690,29095,69912,33111,79602
280490,202112,3950,10940,3334,9877,107,388,2520,7214,2627,7602
280500,202112,1079,2456,923,2246,27,68,791,1893,818,1961
280510,202112,2920,6748,2517,6195,63,186,2032,4859,2095,5045
280520,202112,1870,4395,1637,4074,108,210,1278,3196,1386,3406
280530,202112,2517,6150,2188,5692,198,414,1629,4310,1827,4724
280540,202112,9204,23962,8337,22736,292,834,7226,19591,7518,20425
280550,202112,7036,15733,5844,14069,151,489,4907,11404,5058,11893
280560,202112,7843,20561,7344,19816,107,373,6572,17481,6679,17854
280570,202112,6815,16006,5507,14389,302,737,3985,10614,4287,11351
280580,202112,6089,15239,5310,14118,531,1184,3875,10477,4406,11661
280590,202112,3016,6742,2588,6238,130,398,2017,4646,2147,5044
280600,202112,4085,10055,3633,9426,335,741,2567,6739,2902,7480
280610,202112,2745,6354,2441,5948,141,334,2009,4819,2150,5153
280620,202112,5960,13744,5122,12659,416,831,3699,9460,4115,10291
280630,202112,4317,11105,3977,10657,221,538,3215,8686,3436,9224
280640,202112,2518,6422,2215,6083,58,139,1990,5504,2048,5643
280650,202112,1283,3290,1049,2942,96,277,748,2027,844,2304
280660,202112,3963,8280,3413,7649,338,498,2727,6379,3065,6877
280670,202112,21008,46752,18076,42944,1677,3834,13364,31731,15041,35565
280680,202112,2999,6870,2574,6261,302,530,1752,4445,2054,4975
280690,202112,1007,2371,857,2185,55,126,680,1710,735,1836
280700,202112,1259,3002,1087,2756,30,68,865,2166,895,2234
280710,202112,16326,35273,13844,32455,863,1302,11479,27914,12342,29216
280720,202112,2824,6233,2333,5647,42,127,1778,4448,1820,4575
280730,202112,1137,2852,992,2626,71,192,726,1855,797,2047
280740,202112,15802,35894,13597,32615,1099,2506,9844,23199,10943,25705
280750,202112,3833,10253,3304,9342,214,552,2387,6681,2601,7233
280760,202112,7130,17721,6168,16318,765,1727,3896,10809,4661,12536
290010,202112,3349,6811,2192,5056,8,22,1836,4068,1844,4090
290020,202112,5665,14412,5148,13771,370,631,4286,11966,4656,12597
290030,202112,5058,10926,4106,9893,258,444,3377,8371,3635,8815
290035,202112,5574,11565,4535,10234,322,455,3513,8150,3835,8605
290040,202112,4841,10832,4111,9961,214,386,3014,8032,3228,8418
290050,202112,2192,6783,1848,6066,116,407,1285,4131,1401,4538
290060,202112,1486,3302,1093,2717,172,368,650,1657,822,2025
290070,202112,40802,85460,35211,78558,2206,4753,27352,60327,29558,65080
290080,202112,5818,16192,5042,15053,593,1691,3399,10378,3992,12069
290090,202112,2295,4266,1630,3554,20,50,1480,3209,1500,3259
290100,202112,10651,26342,8612,23385,1541,3787,4348,12599,5889,16386
290110,202112,5748,14276,5042,13177,674,1589,3170,8467,3844,10056
290115,202112,4336,12238,3677,11086,314,852,2775,8435,3089,9287
290120,202112,6990,16574,5826,14952,173,467,4935,12489,5108,12956
290130,202112,5018,11692,3899,10215,205,423,2915,7827,3120,8250
290135,202112,4676,10528,3810,9129,182,420,3017,6997,3199,7417
290140,202112,4754,11993,3691,10607,91,314,3158,9036,3249,9350
290150,202112,2770,6669,2362,6185,135,306,1818,4858,1953,5164
290160,202112,3798,8057,3372,7476,218,387,2777,6159,2995,6546
290170,202112,3549,8646,3136,8195,102,219,2814,7462,2916,7681
290180,202112,3221,8386,2662,7491,72,240,2216,6169,2288,6409
290190,202112,4705,12093,4158,11375,90,294,3518,9471,3608,9765
290195,202112,2536,6009,2028,5345,33,116,1731,4530,1764,4646
290200,202112,4465,11866,3566,10340,133,370,2695,7733,2828,8103
290205,202112,3788,9208,3366,8593,210,523,2619,6604,2829,7127
290210,202112,13897,36285,12275,33809,1078,2513,9394,26350,10472,28863
290220,202112,3147,7236,2757,6744,119,261,2272,5586,2391,5847
290225,202112,3395,6972,2583,6123,119,194,2237,5366,2356,5560
290230,202112,2914,6992,2674,6704,59,123,2408,6078,2467,6201
290240,202112,3971,9549,3141,8534,65,197,2676,7254,2741,7451
290250,202112,4178,11675,3456,10614,109,292,2837,8911,2946,9203
290260,202112,5729,13524,4833,12242,244,643,3982,9936,4226,10579
290265,202112,3741,10487,3033,9178,254,673,2066,6306,2320,6979
290270,202112,11366,37596,10517,36169,687,2444,8239,28446,8926,30890
290280,202112,6542,18896,5626,17067,295,985,4081,12191,4376,13176
290290,202112,10552,29657,8590,26131,775,2458,5763,17282,6538,19740
290300,202112,4456,11697,3278,9484,203,574,2300,6644,2503,7218
290310,202112,1847,4104,1479,3671,27,118,1282,3098,1309,3216
290320,202112,27626,68545,22189,60464,4952,12684,10577,30752,15529,43436
290323,202112,4110,10526,3501,9560,115,266,2725,7485,2840,7751
290327,202112,4505,12351,3840,11091,357,910,2668,7742,3025,8652
290330,202112,2526,4940,1996,4377,53,68,1762,3961,1815,4029
290340,202112,6349,14851,4845,13055,591,1425,3370,9403,3961,10828
290350,202112,5100,13726,4233,12248,289,748,2928,8559,3217,9307
290360,202112,5176,13098,4513,12241,127,289,3904,10682,4031,10971
290370,202112,5481,12830,4018,10905,213,474,2833,7819,3046,8293
290380,202112,6054,15316,5010,13902,109,223,4290,12083,4399,12306
290390,202112,15754,43028,12963,38548,1483,4070,8265,25114,9748,29184
290395,202112,3212,8623,2557,7510,66,247,1956,5667,2022,5914
290400,202112,4031,10446,3255,9186,134,387,2486,6901,2620,7288
290405,202112,4974,13761,4218,12469,411,1120,2771,8460,3182,9580
290410,202112,6022,15692,4601,13450,106,415,3497,10036,3603,10451
290420,202112,3369,8737,2783,7823,91,262,2238,6213,2329,6475
290430,202112,3649,9121,3008,8133,213,591,2181,5733,2394,6324
290440,202112,3055,7229,2210,5928,110,230,1540,4274,1650,4504
290450,202112,3867,9094,3071,7931,109,248,2421,6201,2530,6449
290460,202112,13191,35748,11000,31722,2510,7209,4105,12038,6615,19247
290470,202112,5043,11452,3720,9653,573,1390,1967,5323,2540,6713
290475,202112,7006,19569,5896,17677,56,286,4945,14572,5001,14858
290480,202112,1943,4683,1589,4181,75,226,1148,2889,1223,3115
290485,202112,4933,13712,4326,12868,105,431,3699,10848,3804,11279
290490,202112,9827,22033,8843,20702,463,949,7129,16820,7592,17769
290500,202112,4489,12769,3516,10745,605,1897,1443,4333,2048,6230
290510,202112,3772,8934,3148,8134,55,176,2808,7182,2863,7358
290515,202112,3802,10365,3292,9650,38,130,2989,8878,3027,9008
290520,202112,12767,34570,9926,29204,865,2302,5760,16949,6625,19251
290530,202112,5212,14506,4373,13156,105,412,3705,11051,3810,11463
290540,202112,3662,9182,3310,8799,42,131,3097,8216,3139,8347
290550,202112,4448,11405,3880,10742,18,75,3581,10023,3599,10098
290560,202112,6628,16651,5020,14327,389,1293,3304,9117,3693,10410
290570,202112,47112,112486,41709,105671,2356,5853,33767,84955,36123,90808
290580,202112,8835,23834,7607,22092,792,1990,5359,16342,6151,18332
290590,202112,7291,21915,6134,19874,155,492,4942,16178,5097,16670
290600,202112,20418,54634,17625,50141,1064,2656,13749,39448,14813,42104
290610,202112,2727,8147,2142,6945,96,309,1494,4849,1590,5158
290620,202112,6472,17909,5579,16438,312,801,4589,13605,4901,14406
290630,202112,10050,22951,8011,20350,780,1829,5888,15284,6668,17113
290640,202112,2960,7200,2270,6218,136,315,1568,4538,1704,4853
290650,202112,14148,33642,12568,31854,2107,4845,8763,23123,10870,27968
290660,202112,3965,9857,3243,8737,72,186,2468,6750,2540,6936
290670,202112,7589,19176,6480,17466,369,953,5120,13907,5489,14860
290680,202112,11672,31028,9745,28215,196,885,8076,23046,8272,23931
290682,202112,5086,12588,4421,11698,163,299,3707,9975,3870,10274
290685,202112,3766,8175,2743,6715,478,1018,1359,3702,1837,4720
290687,202112,7186,18257,5858,16084,773,1951,3676,10399,4449,12350
290689,202112,3030,8074,2287,6733,201,617,1506,4474,1707,5091
290690,202112,5741,14429,4648,12922,279,762,3415,9368,3694,10130
290700,202112,2982,7336,2653,6928,38,147,2373,6152,2411,6299
290710,202112,9028,23925,7708,22120,278,722,6450,18624,6728,19346
290720,202112,19786,52072,17891,49152,954,2649,14399,39137,15353,41786
290730,202112,7310,16947,6246,15706,320,608,4860,12443,5180,13051
290740,202112,1135,2864,900,2501,23,66,780,2154,803,2220
290750,202112,12884,29728,11174,27045,694,1645,8584,20157,9278,21802
290755,202112,2166,5889,1734,5125,122,298,1164,3519,1286,3817
290760,202112,4006,11265,3286,9941,165,396,2217,6920,2382,7316
290770,202112,2811,8450,2565,8149,55,190,2156,7011,2211,7201
290780,202112,8436,20484,7260,18944,269,526,5601,15039,5870,15565
290790,202112,5239,13585,4528,12545,214,501,3701,10415,3915,10916
290800,202112,7463,14667,5254,12118,338,615,3947,9240,4285,9855
290810,202112,5528,13945,4487,12450,113,276,3426,9738,3539,10014
290820,202112,5416,13695,4891,12962,290,679,3613,9741,3903,10420
290830,202112,4729,10762,4161,9963,47,155,3546,8194,3593,8349
290840,202112,18677,47325,15909,43089,2119,4690,10272,29536,12391,34226
290850,202112,8247,17816,7288,16782,546,848,6044,14330,6590,15178
290860,202112,6504,17649,5641,16658,331,796,4613,14095,4944,14891
290870,202112,5107,13451,3861,11105,316,760,2525,7352,2841,8112
290880,202112,1532,3596,1233,3217,174,395,702,2008,876,2403
290890,202112,9902,19389,8862,18241,203,393,8231,16872,8434,17265
290900,202112,2607,6560,2019,5550,152,344,1205,3337,1357,3681
290910,202112,5484,12556,4157,10587,41,100,3568,9007,3609,9107
290920,202112,5537,13332,4904,12578,134,178,4522,11901,4656,12079
290930,202112,7926,21445,6398,18791,219,746,4926,14149,5145,14895
290940,202112,3791,10378,3195,9510,183,543,2525,7544,2708,8087
290950,202112,1529,3750,1246,3323,81,180,858,2318,939,2498
290960,202112,6109,14880,5432,14043,246,520,4531,11761,4777,12281
290970,202112,3351,9753,2738,8626,103,366,2120,6683,2223,7049
290980,202112,13729,31305,11579,28130,786,1993,7525,17742,8311,19735
290990,202112,10019,26154,8882,24356,297,1028,7429,19788,7726,20816
291000,202112,3616,8917,2774,7852,124,320,2232,6411,2356,6731
291005,202112,16513,39378,14587,36905,1567,3448,11175,28660,12742,32108
291010,202112,3228,9538,2610,8205,165,518,1647,5049,1812,5567
291020,202112,1361,3205,1103,2773,30,91,811,1910,841,2001
291030,202112,2701,6274,1921,4973,125,275,1216,3081,1341,3356
291040,202112,5740,15082,4715,13625,164,503,3705,10721,3869,11224
291050,202112,9224,21916,7978,20238,1044,2483,5556,14083,6600,16566
291060,202112,7520,20107,6467,18711,396,1251,4983,14342,5379,15593
291070,202112,17059,44068,14220,39595,380,1195,11623,32077,12003,33272
291072,202112,28154,66842,20736,54778,3243,8801,10054,26101,13297,34902
291075,202112,5827,13810,5269,12968,111,243,4430,10679,4541,10922
291077,202112,1791,4574,1389,3870,82,148,956,2707,1038,2855
291080,202112,127761,297587,101596,261701,27799,71187,31094,87783,58893,158970
291085,202112,5999,14544,4897,12904,174,462,4077,10706,4251,11168
291090,202112,2233,4048,1662,3414,47,78,1413,2872,1460,2950
291100,202112,3442,7204,2373,5947,101,258,1836,4570,1937,4828
291110,202112,6395,18293,5402,16631,271,916,4216,12622,4487,13538
291120,202112,8433,19416,7145,17795,382,822,5511,13747,5893,14569
291125,202112,2396,4091,1807,3429,90,143,1476,2829,1566,2972
291130,202112,3460,9523,2555,7763,57,259,1955,5713,2012,5972
291140,202112,5128,13226,3686,10670,593,1484,2120,6185,2713,7669
291150,202112,2701,5615,2078,4927,6,18,1978,4688,1984,4706
291160,202112,5425,14321,4509,13009,457,1281,2954,8523,3411,9804
291165,202112,2286,6085,1685,4897,26,106,1216,3403,1242,3509
291170,202112,22855,55612,19012,49247,1125,2944,12619,31890,13744,34834
291180,202112,6965,15146,5165,12793,223,499,4166,10286,4389,10785
291185,202112,3322,8386,2932,7785,168,366,2260,6095,2428,6461
291190,202112,8338,19435,6925,17653,262,654,5612,14372,5874,15026
291200,202112,2970,7878,2185,6384,63,187,1428,3989,1491,4176
291210,202112,7843,15901,5790,13569,234,511,4229,10062,4463,10573
291220,202112,4758,12481,4300,11821,332,850,3227,8941,3559,9791
291230,202112,4876,9906,3716,8642,54,107,3382,7922,3436,8029
291240,202112,4361,10895,3671,9755,75,231,3129,8216,3204,8447
291250,202112,3571,10115,2772,8659,166,465,1744,5505,1910,5970
291260,202112,1555,3504,1287,3159,21,63,1070,2632,1091,2695
291270,202112,6034,14526,4736,12688,359,870,3480,9480,3839,10350
291280,202112,2930,6756,2176,5695,213,491,1367,3565,1580,4056
291290,202112,5978,15322,4559,13152,469,1324,2961,8535,3430,9859
291300,202112,4095,10605,3230,9177,107,316,2476,6889,2583,7205
291310,202112,5446,13994,4668,12619,219,550,3871,10415,4090,10965
291320,202112,6698,17494,5212,14869,1200,3161,2473,7553,3673,10714
291330,202112,2024,4903,1681,4338,68,164,1287,3245,1355,3409
291340,202112,4607,11397,3692,9860,134,312,2694,7190,2828,7502
291345,202112,3059,8675,2750,8214,107,324,2271,6817,2378,7141
291350,202112,7386,17250,5755,15319,61,182,5034,13525,5095,13707
291360,202112,40678,88393,32230,78421,4276,9151,20045,51269,24321,60420
291370,202112,8693,22776,7665,21171,739,1963,5519,15039,6258,17002
291380,202112,3898,9850,3432,9229,107,327,2921,7786,3028,8113
291390,202112,13678,28423,10473,24903,536,1094,8551,20422,9087,21516
291400,202112,15796,36846,13123,32957,1497,3324,8436,22159,9933,25483
291410,202112,3198,8139,2499,6934,35,124,1864,5092,1899,5216
291420,202112,2057,4830,1595,4261,17,68,1425,3792,1442,3860
291430,202112,2871,7733,2462,7052,110,339,1907,5332,2017,5671
291440,202112,6863,18867,5930,17369,320,878,4564,13522,4884,14400
291450,202112,10805,23848,8898,21693,89,155,7996,19858,8085,20013
291460,202112,17058,43064,14936,39963,762,2073,11306,29907,12068,31980
291465,202112,9576,22780,7491,20395,155,604,6458,17422,6613,18026
291470,202112,19193,40491,16040,36877,895,1734,12045,28340,12940,30074
291480,202112,48129,100867,36333,85198,4035,9365,20663,47891,24698,57256
291490,202112,6091,14526,5278,13613,154,408,4749,12220,4903,12628
291500,202112,5441,12571,4549,11414,54,174,4198,10546,4252,10720
291510,202112,4705,10976,3489,9433,43,194,2961,7893,3004,8087
291520,202112,4878,10601,3710,9085,248,565,2815,6924,3063,7489
291530,202112,2508,5428,1801,4533,282,637,1094,2938,1376,3575
291535,202112,3716,10423,3169,9440,179,485,2383,7377,2562,7862
291540,202112,2344,5032,1622,4175,96,215,1313,3414,1409,3629
291550,202112,6256,13441,4881,11739,542,1037,3294,8146,3836,9183
291560,202112,19370,44596,14148,37742,1789,4380,7809,22121,9598,26501
291570,202112,2475,5650,1913,4981,78,163,1574,4264,1652,4427
291580,202112,6908,16930,5432,14980,374,848,3884,10787,4258,11635
291590,202112,2427,5519,2136,5192,84,245,1909,4556,1993,4801
291600,202112,5790,12842,4468,10865,467,1119,2979,7055,3446,8174
291610,202112,5975,14917,5355,14233,59,202,4923,13043,4982,13245
291620,202112,3303,7129,2476,6218,156,322,1874,4863,2030,5185
291630,202112,3745,7678,2832,6530,266,565,2136,4964,2402,5529
291640,202112,18065,41675,13778,35613,2084,4740,6578,17511,8662,22251
291650,202112,9540,22834,8396,21486,587,972,6996,18447,7583,19419
291660,202112,2156,5120,1575,4243,124,362,1027,2610,1151,2972
291670,202112,2154,5490,1799,4972,136,338,1270,3595,1406,3933
291680,202112,4374,10158,3537,8976,499,1175,2155,5656,2654,6831
291685,202112,5115,11941,4088,10549,220,417,3132,8304,3352,8721
291690,202112,4357,9210,3060,7361,542,997,2039,5127,2581,6124
291700,202112,9331,25645,8232,23792,327,983,6778,19238,7105,20221
291710,202112,5804,12867,4378,10915,490,1000,2974,7533,3464,8533
291720,202112,4688,13562,3895,12001,817,2503,1995,6167,2812,8670
291730,202112,6824,16251,5875,15007,328,845,4861,12387,5189,13232
291733,202112,2968,7325,2494,6697,75,170,1822,5190,1897,5360
291735,202112,3074,7977,2431,6866,57,120,1862,5278,1919,5398
291740,202112,4222,10565,3079,8429,111,208,2129,5853,2240,6061
291750,202112,22039,49880,17992,43969,2453,5370,11166,28288,13619,33658
291760,202112,11570,31300,9060,27356,2696,9125,2172,6592,4868,15717
291770,202112,7895,20133,6581,17878,312,907,5023,13222,5335,14129
291780,202112,5438,13950,4892,13197,102,310,4270,11415,4372,11725
291790,202112,2965,7675,2694,7335,251,515,2029,5744,2280,6259
291800,202112,33854,79963,25813,68409,4839,11894,11837,32987,16676,44881
291810,202112,11079,25193,9318,23048,417,866,7678,19378,8095,20244
291820,202112,4109,10340,3568,9634,96,254,2868,7769,2964,8023
291830,202112,4890,10861,3999,9668,282,464,3069,7601,3351,8065
291835,202112,7050,20162,5621,17505,573,1712,3688,11686,4261,13398
291840,202112,50222,133343,43640,123175,4049,12037,31328,87807,35377,99844
291845,202112,2897,6954,2322,6255,114,284,1953,5339,2067,5623
291850,202112,4482,11863,3750,10693,132,349,3059,8800,3191,9149
291855,202112,2348,4396,1833,3831,28,66,1679,3499,1707,3565
291860,202112,2387,6075,1662,4699,32,70,1107,3038,1139,3108
291870,202112,1376,3330,936,2566,34,86,651,1758,685,1844
291875,202112,3160,9198,2713,8282,44,164,2018,5955,2062,6119
291880,202112,5973,16088,5107,14679,285,703,3771,11020,4056,11723
291890,202112,1762,3486,1156,2779,222,458,645,1598,867,2056
291900,202112,1436,3230,1086,2718,18,61,875,2123,893,2184
291905,202112,2531,6329,2065,5615,87,275,1604,4204,1691,4479
291910,202112,3397,7871,2878,7245,47,150,2507,6452,2554,6602
291915,202112,7761,21119,6300,18676,192,570,4725,14205,4917,14775
291920,202112,30905,75214,26516,69298,2028,5799,19631,49963,21659,55762
291930,202112,2645,6687,2269,6181,224,595,1576,4362,1800,4957
291940,202112,4186,10149,2823,7893,285,702,1599,4535,1884,5237
291950,202112,9658,28483,8119,25609,308,987,5601,17592,5909,18579
291955,202112,17133,41429,15226,38988,1326,3406,11896,30490,13222,33896
291960,202112,3683,8555,3076,7765,224,375,2397,6319,2621,6694
291970,202112,4921,11764,4115,10768,170,471,3100,8167,3270,8638
291980,202112,10739,28834,8662,25374,1155,2811,5346,16414,6501,19225
291990,202112,2475,6148,2029,5603,19,72,1875,5161,1894,5233
291992,202112,4347,9954,3585,8979,377,749,2751,7164,3128,7913
291995,202112,2357,6026,1919,5331,60,207,1500,4064,1560,4271
292000,202112,2827,6327,2301,5702,93,257,1849,4579,1942,4836
292010,202112,6107,13727,4967,12096,131,326,4212,10054,4343,10380
292020,202112,5070,13562,4258,12170,162,501,3352,9315,3514,9816
292030,202112,2121,6021,1884,5598,126,388,1221,3544,1347,3932
292040,202112,4868,11625,3806,10088,240,520,2906,7880,3146,8400
292045,202112,4385,10733,3293,9154,31,82,2972,8377,3003,8459
292050,202112,6986,18529,5655,16275,271,810,3705,10527,3976,11337
292060,202112,12215,26854,11295,25709,453,897,9980,22449,10433,23346
292070,202112,6062,15066,5279,14147,356,866,4430,11875,4786,12741
292080,202112,3578,8150,2950,7355,51,157,2704,6676,2755,6833
292090,202112,4780,10033,3400,8354,251,530,2548,6328,2799,6858
292100,202112,13630,30836,11625,28370,2054,4595,6436,16688,8490,21283
292105,202112,3835,9110,3333,8439,69,149,2823,7151,2892,7300
292110,202112,6639,15006,4713,12139,888,2320,2457,6304,3345,8624
292120,202112,7566,18498,6247,16295,424,1096,4569,11766,4993,12862
292130,202112,3658,8444,3027,7671,172,415,2281,5772,2453,6187
292140,202112,5836,12616,4947,11377,162,348,4314,9843,4476,10191
292145,202112,2772,7191,2314,6432,119,268,1818,5091,1937,5359
292150,202112,16033,40596,13881,37184,259,911,11604,30434,11863,31345
292160,202112,3159,7374,2373,6372,31,75,1943,5479,1974,5554
292170,202112,9519,23723,7996,21335,419,1159,6136,16002,6555,17161
292180,202112,3137,8165,2312,6648,155,416,1454,4126,1609,4542
292190,202112,3085,7819,2620,7150,176,486,1918,5303,2094,5789
292200,202112,9814,22860,7338,19413,1483,3852,3255,9143,4738,12995
292205,202112,3892,10557,3360,9768,69,262,2901,8396,2970,8658
292210,202112,6997,15390,5667,13732,86,285,5149,12379,5235,12664
292220,202112,2352,5233,2020,4737,82,165,1562,3559,1644,3724
292225,202112,3462,9611,3056,9012,54,213,2689,7806,2743,8019
292230,202112,9451,21475,8464,20238,194,545,7364,17327,7558,17872
292240,202112,5111,14135,4450,12966,314,872,3142,9131,3456,10003
292250,202112,6352,15422,5705,14498,311,759,4488,11280,4799,12039
292260,202112,3494,8911,3109,8417,77,195,2715,7364,2792,7559
292265,202112,3747,9631,3111,8673,50,219,2563,6978,2613,7197
292270,202112,4512,9968,3579,8864,154,309,2888,7210,3042,7519
292273,202112,2997,6167,2390,5431,75,128,1724,4198,1799,4326
292275,202112,1744,4431,1383,3950,60,170,1052,3036,1112,3206
292280,202112,2827,6355,2281,5730,121,208,1871,4896,1992,5104
292285,202112,2795,6367,2218,5600,83,165,1821,4632,1904,4797
292290,202112,8066,20038,6344,17662,182,481,5228,14573,5410,15054
292300,202112,10978,26317,8674,23287,967,2665,5823,15716,6790,18381
292303,202112,3149,8575,2721,7914,94,186,2271,6717,2365,6903
292305,202112,2368,6194,2164,5915,50,156,1929,5196,1979,5352
292310,202112,7457,17427,6468,16236,101,282,5755,14250,5856,14532
292320,202112,6468,16824,5155,14487,191,595,3901,10690,4092,11285
292330,202112,2993,6144,2446,5539,144,222,1870,4479,2014,4701
292335,202112,5159,12881,4528,11957,257,563,3752,10091,4009,10654
292340,202112,5652,15600,4644,13692,238,646,3365,9886,3603,10532
292350,202112,2693,7032,2249,6429,95,279,1806,5211,1901,5490
292360,202112,5331,13575,4445,12102,222,633,3211,8649,3433,9282
292370,202112,10877,24960,9322,22931,119,317,8655,21108,8774,21425
292380,202112,7234,19585,6441,18182,485,1323,4812,13497,5297,14820
292390,202112,5003,9063,3715,7598,198,268,3220,6658,3418,6926
292400,202112,23844,64832,20504,59655,2104,5792,13879,40936,15983,46728
292405,202112,4839,11272,4068,10096,91,209,3418,8350,3509,8559
292410,202112,2347,5393,1966,4911,65,133,1751,4395,1816,4528
292420,202112,4051,10808,3623,10198,78,262,3179,8777,3257,9039
292430,202112,5306,15106,4035,12780,319,964,2649,8441,2968,9405
292440,202112,9136,27827,8402,26753,102,456,7531,23882,7633,24338
292450,202112,4387,11858,3409,10012,104,315,2657,7748,2761,8063
292460,202112,5770,14339,4787,12797,236,575,3801,10068,4037,10643
292465,202112,2875,6983,2452,6448,85,166,1636,4755,1721,4921
292467,202112,2109,5554,1855,5212,330,767,1196,3597,1526,4364
292470,202112,3161,7747,2434,6628,88,147,1828,5048,1916,5195
292480,202112,6670,15083,5422,13581,66,213,4946,12279,5012,12492
292490,202112,2640,5988,2211,5396,105,169,1778,4366,1883,4535
292500,202112,7474,18708,5955,16216,399,1068,4114,11123,4513,12191
292510,202112,14776,36999,11521,31984,682,1782,8069,22492,8751,24274
292520,202112,7815,18645,6875,17256,445,1164,5450,13454,5895,14618
292525,202112,6600,14893,5412,13565,131,254,4806,12208,4937,12462
292530,202112,33033,82821,25881,71177,5347,15019,12052,33259,17399,48278
292540,202112,4771,8408,3772,7351,159,242,3392,6657,3551,6899
292550,202112,8602,21579,6559,19149,480,1239,4581,14319,5061,15558
292560,202112,4689,11459,3942,10417,146,371,2941,7698,3087,8069
292570,202112,3951,9911,3297,8771,51,181,2796,7233,2847,7414
292575,202112,7045,19681,6450,18901,861,2340,4623,13905,5484,16245
292580,202112,8122,19569,6699,17497,115,290,5739,14803,5854,15093
292590,202112,7789,20128,6518,17885,362,994,5157,13934,5519,14928
292593,202112,3017,7328,2494,6458,73,172,2088,5374,2161,5546
292595,202112,5859,14817,5033,13801,139,421,4301,11723,4440,12144
292600,202112,11864,30480,10271,28122,577,1321,8113,22431,8690,23752
292610,202112,4660,11375,3980,10248,158,356,3128,8087,3286,8443
292620,202112,6923,17965,5667,16449,147,289,5107,15159,5254,15448
292630,202112,9574,22128,7664,19120,1078,2441,4507,11597,5585,14038
292640,202112,8673,24274,7481,22342,263,803,5335,16100,5598,16903
292650,202112,4591,11137,4080,10466,101,228,3712,9453,3813,9681
292660,202112,11941,31300,10061,28512,583,1566,7360,21215,7943,22781
292665,202112,2269,6463,1941,6034,76,202,1586,5050,1662,5252
292670,202112,3742,9912,2903,8364,156,455,1946,5493,2102,5948
292680,202112,4323,10792,3411,9226,151,353,2581,6819,2732,7172
292690,202112,2807,7000,1941,5604,208,537,1149,3489,1357,4026
292700,202112,10837,27956,9435,25818,797,1726,6562,18601,7359,20327
292710,202112,2888,8134,2689,7876,56,134,2463,7265,2519,7399
292720,202112,9619,21790,8125,20071,247,543,6495,16421,6742,16964
292730,202112,5349,11665,4858,10924,407,672,3876,9030,4283,9702
292740,202112,354249,814027,307157,748295,41983,100211,197157,477630,239140,577841
292750,202112,6820,16859,6011,15739,217,501,4888,12969,5105,13470
292760,202112,4235,11462,3698,10549,180,459,2777,7857,2957,8316
292770,202112,7121,17409,5761,15549,802,2118,3772,10480,4574,12598
292780,202112,2267,4269,1692,3589,91,177,1347,2756,1438,2933
292790,202112,4161,8565,3142,7461,174,350,2583,6197,2757,6547
292800,202112,12050,29256,10285,26586,525,1229,8318,21459,8843,22688
292805,202112,3975,9019,3125,7936,135,305,2480,6300,2615,6605
292810,202112,12067,28922,9668,25263,746,1580,7128,18460,7874,20040
292820,202112,7588,20508,5552,17089,396,1204,3881,11800,4277,13004
292830,202112,3093,7066,2630,6512,90,195,2242,5613,2332,5808
292840,202112,9558,23768,8081,21795,150,425,7154,19064,7304,19489
292850,202112,2747,6810,2306,6177,187,434,1561,4225,1748,4659
292860,202112,17828,37696,16051,35620,642,1294,13761,30442,14403,31736
292870,202112,20968,48706,18195,44896,1088,2466,12942,31403,14030,33869
292880,202112,12194,31914,10393,29186,310,998,8174,22217,8484,23215
292890,202112,7824,20428,6908,19145,156,554,6092,16767,6248,17321
292895,202112,3381,6840,2523,5594,110,217,2049,4513,2159,4730
292900,202112,2867,7344,2605,6954,42,155,2192,5692,2234,5847
292905,202112,4679,11442,3729,10028,106,313,2887,7644,2993,7957
292910,202112,5107,13346,4664,12728,174,435,3685,9949,3859,10384
292920,202112,10407,27610,9666,26613,295,968,8387,22798,8682,23766
292925,202112,5606,15442,4653,13700,285,723,3278,9700,3563,10423
292930,202112,6970,19389,6027,17693,608,1768,3766,10957,4374,12725
292935,202112,2647,6213,2078,5581,14,63,1872,5054,1886,5117
292937,202112,2916,7148,2465,6544,71,181,1909,5099,1980,5280
292940,202112,3202,7677,2539,6685,300,642,1665,4602,1965,5244
292950,202112,10132,24908,8829,23020,561,1182,6616,17287,7177,18469
292960,202112,5664,13103,4736,11800,169,336,3781,9408,3950,9744
292970,202112,4092,11119,3625,10444,73,249,3031,8800,3104,9049
292975,202112,4577,9616,4063,9043,197,307,3608,8174,3805,8481
292980,202112,3802,8456,3113,7472,66,178,2663,6294,2729,6472
292990,202112,12249,32376,10218,28895,575,1671,7659,21224,8234,22895
293000,202112,2891,6632,2481,6014,52,157,2014,4844,2066,5001
293010,202112,19711,48103,15868,42271,2038,5439,9807,26161,11845,31600
293015,202112,9376,27042,7425,23357,528,1561,5056,16240,5584,17801
293020,202112,10379,29071,9340,27601,120,399,8427,24962,8547,25361
293030,202112,5524,13996,4228,12013,123,316,2894,8524,3017,8840
293040,202112,4781,11729,3984,10619,83,215,3476,9243,3559,9458
293050,202112,24732,56878,21756,52528,1503,3353,16184,38810,17687,42163
293060,202112,3960,9997,3175,8535,189,507,2272,5931,2461,6438
293070,202112,27840,63802,24606,59743,2093,5086,18517,44767,20610,49853
293075,202112,3946,11569,3437,10738,85,393,2893,8986,2978,9379
293076,202112,3744,8767,3398,8361,66,124,3030,7561,3096,7685
293077,202112,6901,18136,5530,16008,537,1550,3354,10312,3891,11862
293080,202112,5019,14263,4265,12951,77,344,3497,10419,3574,10763
293090,202112,3398,9609,2616,8281,202,569,1762,5659,1964,6228
293100,202112,6207,15730,5146,13874,319,760,3941,10688,4260,11448
293105,202112,4099,12404,3552,11296,272,823,2445,7775,2717,8598
293110,202112,2590,6101,2163,5494,68,188,1777,4441,1845,4629
293120,202112,4990,12481,4504,11755,409,692,3578,9704,3987,10396
293130,202112,3947,10428,3413,9754,46,176,3035,8594,3081,8770
293135,202112,33206,74917,24490,63361,4159,11343,10300,27190,14459,38533
293140,202112,2745,5530,2403,5123,78,112,2078,4437,2156,4549
293150,202112,5599,16261,4599,14411,304,939,3171,9960,3475,10899
293160,202112,4066,9553,3480,8914,294,463,2854,7770,3148,8233
293170,202112,5379,10569,4709,9762,96,186,4201,8659,4297,8845
293180,202112,4736,12695,3942,11268,70,237,3187,8891,3257,9128
293190,202112,15475,39618,13523,36886,110,455,12127,32808,12237,33263
293200,202112,9495,21895,7713,19124,237,545,6365,15647,6602,16192
293210,202112,5564,13920,4762,12691,392,961,3558,9555,3950,10516
293220,202112,5675,13575,4210,11190,783,2032,2120,5739,2903,7771
293230,202112,4369,10357,3244,8853,257,658,2272,6360,2529,7018
293240,202112,4859,12110,3921,10615,94,157,2922,8368,3016,8525
293245,202112,4153,10712,3763,10145,164,390,3169,8496,3333,8886
293250,202112,6335,14315,5108,12690,267,646,4078,10078,4345,10724
293260,202112,5077,12706,4184,11322,168,348,2934,8113,3102,8461
293270,202112,7784,16415,6161,14674,486,635,4764,12380,5250,13015
293280,202112,4807,12068,4180,11170,282,613,3186,8719,3468,9332
293290,202112,17107,45470,15158,42442,1767,4889,10345,29078,12112,33967
293300,202112,6438,14749,5535,13429,403,880,4036,9841,4439,10721
293305,202112,4490,10328,3874,9547,80,174,3507,8660,3587,8834
293310,202112,2350,5679,1987,5124,42,118,1616,4089,1658,4207
293315,202112,4495,10033,3684,8857,214,433,3031,7283,3245,7716
293317,202112,2950,6480,2607,5993,206,330,1990,4633,2196,4963
293320,202112,13088,30007,11632,28394,208,521,10603,25732,10811,26253
293325,202112,1934,4557,1503,4002,243,603,914,2491,1157,3094
293330,202112,70752,184859,57867,162949,9344,27039,29074,80100,38418,107139
293340,202112,2327,6299,1901,5558,142,393,1247,3641,1389,4034
293345,202112,3975,10074,3174,8866,486,1071,1898,5957,2384,7028
293350,202112,6762,18498,5778,17299,59,256,5242,15847,5301,16103
293360,202112,16152,38891,13843,35850,214,804,12392,31524,12606,32328
310010,202112,1055,2291,697,1807,58,181,261,646,319,827
310020,202112,3174,8073,2417,6748,443,1301,775,2041,1218,3342
310030,202112,2053,5575,1582,4743,248,798,1001,2918,1249,3716
310040,202112,916,2294,717,1949,69,227,380,909,449,1136
310050,202112,1566,4475,1315,4082,113,419,884,2658,997,3077
310060,202112,3409,9136,2934,8506,127,382,2373,6872,2500,7254
310070,202112,346,780,251,646,11,24,184,471,195,495
310080,202112,765,1996,552,1613,76,237,273,767,349,1004
310090,202112,5240,12818,4322,11357,206,583,3383,8696,3589,9279
310100,202112,3893,9956,3300,9024,77,303,2792,7425,2869,7728
310110,202112,5109,12801,3950,10868,655,1977,2011,5260,2666,7237
310120,202112,683,1581,441,1200,52,158,245,604,297,762
310130,202112,398,1001,341,916,26,94,263,674,289,768
310140,202112,322,859,230,710,40,146,103,288,143,434
310150,202112,6425,15733,4828,12902,498,1517,2519,6248,3017,7765
310160,202112,9936,23536,7375,19444,1240,3418,3044,7925,4284,11343
310163,202112,1214,3446,960,2945,176,573,292,814,468,1387
310170,202112,10316,24708,8287,21624,731,1822,5784,15172,6515,16994
310180,202112,2082,4820,1503,3910,151,435,949,2374,1100,2809
310190,202112,2954,8173,2423,7243,547,1806,436,1223,983,3029
310200,202112,2216,6104,1651,5064,199,681,834,2466,1033,3147
310205,202112,1168,3091,925,2705,120,391,544,1601,664,1992
310210,202112,2681,7008,2189,6127,126,331,1529,4160,1655,4491
310220,202112,1325,3465,1017,2854,90,244,655,1782,745,2026
310230,202112,2395,6333,1923,5475,235,717,1196,3190,1431,3907
310240,202112,1099,3096,931,2810,55,182,640,1864,695,2046
310250,202112,1154,2892,944,2564,18,62,714,1896,732,1958
310260,202112,3544,8824,2359,6703,633,2087,762,1758,1395,3845
310270,202112,2954,6794,2367,6018,77,208,1986,5046,2063,5254
310280,202112,2717,6020,2170,5256,196,520,1451,3353,1647,3873
310285,202112,1981,6045,1652,5452,154,531,1022,3348,1176,3879
310290,202112,1430,3622,1217,3266,163,519,736,1780,899,2299
310300,202112,1769,4787,1473,4278,143,491,854,2309,997,2800
310310,202112,350,816,232,615,43,108,114,292,157,400
310320,202112,555,1343,391,1086,17,63,238,623,255,686
310330,202112,526,1213,318,840,50,142,119,282,169,424
310340,202112,8895,22081,7082,19002,956,2499,3592,9727,4548,12226
310350,202112,14116,33029,9881,26283,1539,4350,4798,12184,6337,16534
310360,202112,615,1326,496,1177,22,55,326,754,348,809
310370,202112,1337,3989,1146,3641,202,709,343,1183,545,1892
310375,202112,922,2203,656,1813,111,317,350,963,461,1280
310380,202112,419,940,238,661,28,82,118,308,146,390
310390,202112,554,1571,443,1359,81,270,161,441,242,711
310400,202112,12451,29422,9195,24441,729,2245,5970,15187,6699,17432
310410,202112,1142,3206,620,2048,59,215,232,692,291,907
310420,202112,5186,12938,3751,10367,484,1473,1710,4325,2194,5798
310430,202112,1827,4739,1252,3685,224,720,500,1268,724,1988
310440,202112,718,1808,500,1415,52,168,261,688,313,856
310445,202112,1481,4018,1086,3250,81,240,754,2210,835,2450
310450,202112,4797,11662,3665,9894,142,467,2835,7442,2977,7909
310460,202112,1912,4910,1474,4118,202,623,584,1469,786,2092
310470,202112,3900,8425,3018,7264,372,767,2039,5084,2411,5851
310480,202112,1087,2701,843,2306,102,294,491,1282,593,1576
310490,202112,3069,8021,2421,6975,270,910,1361,3620,1631,4530
310500,202112,1508,3949,1144,3357,180,587,616,1733,796,2320
310510,202112,2358,5951,1636,4621,278,853,691,1921,969,2774
310520,202112,1245,3121,919,2539,162,418,443,1257,605,1675
310530,202112,818,2010,555,1558,79,247,194,443,273,690
310540,202112,3253,8898,2676,7842,503,1619,1247,3347,1750,4966
310550,202112,1376,3302,990,2663,75,241,586,1446,661,1687
310560,202112,17194,43226,12343,34518,1696,5084,5441,13675,7137,18759
310570,202112,1130,2845,899,2521,47,160,693,1904,740,2064
310590,202112,4543,11405,3636,9750,211,634,2228,5596,2439,6230
310600,202112,1474,4131,1196,3551,148,495,641,1783,789,2278
310610,202112,517,1373,335,1067,118,399,42,128,160,527
310620,202112,211068,514428,156993,417428,18012,55150,84783,203865,102795,259015
310630,202112,5020,13161,3880,10929,505,1425,2229,6151,2734,7576
310640,202112,1360,3685,1111,3228,155,529,584,1553,739,2082
310650,202112,2654,6987,1958,5682,139,420,1237,3444,1376,3864
310660,202112,1480,3770,1218,3404,32,84,1049,2914,1081,2998
310665,202112,1509,3655,1232,3277,17,59,1008,2725,1025,2784
310670,202112,65734,161406,55351,144024,4825,14010,38457,94964,43282,108974
310680,202112,839,1880,696,1683,20,71,595,1382,615,1453
310690,202112,2346,5625,1726,4650,112,343,1094,2770,1206,3113
310700,202112,526,1111,406,962,14,37,304,694,318,731
310710,202112,6566,17619,4780,14932,896,3249,784,2171,1680,5420
310720,202112,1157,2559,904,2243,33,104,687,1636,720,1740
310730,202112,11053,27685,9436,25195,378,1193,7134,18533,7512,19726
310740,202112,7118,18701,5218,14956,677,2134,2200,5683,2877,7817
310750,202112,1413,3209,1089,2751,105,317,632,1437,737,1754
310760,202112,746,1811,526,1477,41,121,307,853,348,974
310770,202112,1142,2987,798,2461,77,275,410,1159,487,1434
310780,202112,4560,10352,3769,9324,162,387,2924,7257,3086,7644
310790,202112,1951,5955,1666,5334,307,1034,268,716,575,1750
310800,202112,2557,7318,1868,5935,329,1273,111,275,440,1548
310810,202112,1443,3397,1199,3007,57,141,863,2083,920,2224
310820,202112,1285,3174,786,2349,164,499,180,562,344,1061
310825,202112,2829,7894,2275,7005,44,241,1885,5630,1929,5871
310830,202112,2127,5683,1581,4662,277,957,666,1817,943,2774
310840,202112,2342,6138,1782,5204,358,1201,502,1258,860,2459
310850,202112,1494,4000,1245,3636,30,135,971,2733,1001,2868
310855,202112,3353,8514,2605,7313,187,544,1858,5149,2045,5693
310860,202112,7317,20265,5944,17720,630,1751,3620,10983,4250,12734
310870,202112,1016,2342,807,2050,52,127,594,1486,646,1613
310880,202112,1038,3020,828,2596,112,333,456,1427,568,1760
310890,202112,2394,6667,1535,4918,255,880,226,612,481,1492
310900,202112,4243,11442,2999,8784,476,1488,1292,3468,1768,4956
310910,202112,2358,5538,1664,4440,153,462,398,959,551,1421
310920,202112,2033,5064,1552,4359,163,483,966,2653,1129,3136
310925,202112,1091,2750,886,2436,41,143,664,1730,705,1873
310930,202112,6087,15140,4317,12334,892,2466,1846,5648,2738,8114
310940,202112,7344,16320,5965,14362,186,486,4725,11105,4911,11591
310945,202112,1419,3499,1114,3000,167,470,600,1547,767,2017
310950,202112,2039,5868,1345,4322,211,740,389,1055,600,1795
310960,202112,783,2011,443,1305,76,258,100,265,176,523
310970,202112,1250,3593,881,2831,225,773,138,407,363,1180
310980,202112,366,834,203,558,19,56,112,304,131,360
310990,202112,1451,3771,1155,3274,143,414,649,1779,792,2193
311000,202112,4168,11155,3101,9433,779,2370,1247,3784,2026,6154
311010,202112,1043,2725,845,2380,196,607,407,1129,603,1736
311020,202112,1250,3077,808,2286,47,141,442,1199,489,1340
311030,202112,1935,4654,1391,3757,302,925,576,1440,878,2365
311040,202112,313,941,253,812,81,274,72,205,153,479
311050,202112,3248,7832,2439,6627,387,1194,1202,3084,1589,4278
311060,202112,3580,8857,2669,7216,346,1071,1100,2726,1446,3797
311070,202112,2585,6143,1903,5103,163,561,1129,2817,1292,3378
311080,202112,1244,2719,1000,2346,50,145,791,1755,841,1900
311090,202112,2502,7444,2039,6583,447,1528,633,2025,1080,3553
311100,202112,2616,7149,1582,5070,278,985,334,908,612,1893
311110,202112,3944,7915,2224,5513,474,1192,667,1699,1141,2891
311115,202112,1509,3181,1264,2867,82,147,1008,2284,1090,2431
311120,202112,7542,19093,5821,16069,873,2645,2169,5257,3042,7902
311130,202112,2033,5164,1543,4491,105,360,923,2617,1028,2977
311140,202112,1614,3866,1272,3392,90,269,895,2345,985,2614
311150,202112,1574,4819,1216,4108,159,574,628,2057,787,2631
311160,202112,4293,11796,3098,9612,640,2153,1072,3159,1712,5312
311170,202112,992,2453,800,2190,57,159,493,1432,550,1591
311180,202112,1498,3245,983,2507,188,478,439,1121,627,1599
311190,202112,936,2543,700,2078,113,399,267,653,380,1052
311200,202112,2327,6037,1679,4791,306,949,602,1522,908,2471
311205,202112,971,2679,808,2385,31,118,541,1486,572,1604
311210,202112,1118,3110,974,2908,122,318,683,2131,805,2449
311220,202112,842,2173,711,1938,31,94,506,1287,537,1381
311230,202112,8681,24726,6575,20519,1196,3831,2355,7487,3551,11318
311240,202112,1165,2884,906,2519,185,508,405,1133,590,1641
311250,202112,1334,3626,1040,3079,186,551,412,1126,598,1677
311260,202112,2984,7019,1928,5203,259,780,892,2122,1151,2902
311265,202112,1390,3444,1023,2845,40,141,726,1969,766,2110
311270,202112,3209,9147,2786,8465,151,590,2019,5893,2170,6483
311280,202112,1200,3077,631,1928,98,337,117,301,215,638
311290,202112,1993,5788,1811,5427,136,391,1211,3636,1347,4027
311300,202112,5028,13244,4144,11786,160,522,3345,9317,3505,9839
311310,202112,616,1640,519,1466,32,97,349,947,381,1044
311320,202112,3501,10233,3023,9217,294,1036,1590,4385,1884,5421
311330,202112,6302,15149,4995,13100,538,1406,2753,7340,3291,8746
311340,202112,11474,30629,9065,26425,2046,6361,2760,7567,4806,13928
311350,202112,2615,6122,1894,4861,198,510,1035,2418,1233,2928
311360,202112,1182,2800,799,2254,189,611,274,783,463,1394
311370,202112,5174,12032,3848,9986,305,938,2383,5742,2688,6680
311380,202112,394,1164,285,936,62,200,134,455,196,655
311390,202112,1875,5488,1497,4980,656,2425,346,1039,1002,3464
311400,202112,1718,4519,1263,3660,234,707,357,878,591,1585
311410,202112,1995,5592,1596,4957,219,756,891,2661,1110,3417
311420,202112,1682,4746,1217,3807,220,777,355,928,575,1705
311430,202112,4742,12017,3187,9015,464,1334,1229,3340,1693,4674
311440,202112,3276,8683,2500,7407,689,2348,495,1365,1184,3713
311450,202112,2003,5790,1462,4761,364,1323,328,888,692,2211
311455,202112,1120,2429,773,1924,128,333,380,939,508,1272
311460,202112,589,1725,390,1301,74,286,80,212,154,498
311470,202112,561,1650,370,1221,92,345,45,140,137,485
311480,202112,1182,2808,966,2477,82,195,725,1856,807,2051
311490,202112,276,794,209,672,30,118,92,257,122,375
311500,202112,516,1233,405,1067,24,78,267,679,291,757
311510,202112,3586,8825,2532,7070,300,914,1139,2924,1439,3838
311520,202112,685,1820,600,1664,80,263,342,924,422,1187
311530,202112,9345,21129,6175,16152,1484,4163,1696,4273,3180,8436
311535,202112,904,2368,625,1792,94,283,247,649,341,932
311540,202112,536,1606,478,1500,61,203,341,1045,402,1248
311545,202112,2117,5846,1824,5394,112,321,1390,4100,1502,4421
311547,202112,1637,3866,1425,3552,52,116,1103,2725,1155,2841
311550,202112,3183,8301,2571,7236,366,1119,1109,2943,1475,4062
311560,202112,332,689,215,515,79,179,53,118,132,297
311570,202112,1653,3726,1164,3048,39,109,893,2373,932,2482
311580,202112,2365,4382,1625,3498,217,376,1029,2257,1246,2633
311590,202112,575,1464,467,1304,95,282,245,674,340,956
311600,202112,1747,3966,1451,3572,129,346,1111,2666,1240,3012
311610,202112,2463,7286,2042,6484,133,499,1311,4029,1444,4528
311615,202112,3569,9473,2863,8334,97,318,2316,6617,2413,6935
311620,202112,535,1314,429,1173,112,345,240,617,352,962
311630,202112,1431,3789,1187,3314,144,410,709,1939,853,2349
311640,202112,792,2069,631,1808,71,237,327,853,398,1090
311650,202112,2083,5004,1672,4370,205,548,1006,2565,1211,3113
311660,202112,3190,8864,2377,7249,317,1067,649,1591,966,2658
311670,202112,1732,4237,1279,3432,148,432,605,1593,753,2025
311680,202112,2410,6392,1832,5375,134,378,1309,3838,1443,4216
311690,202112,660,1367,510,1175,40,81,378,908,418,989
311700,202112,2300,5317,1789,4593,10,51,1516,3784,1526,3835
311710,202112,1678,4639,1220,3836,309,1059,383,1190,692,2249
311720,202112,456,1289,368,1131,40,139,191,591,231,730
311730,202112,4085,10159,2731,7505,700,2092,781,2021,1481,4113
311740,202112,1033,2565,857,2323,86,209,686,1916,772,2125
311750,202112,4300,12111,3465,10629,334,1109,2236,6569,2570,7678
311760,202112,716,1943,578,1702,72,247,242,589,314,836
311770,202112,2362,6433,1853,5538,290,871,824,2351,1114,3222
311780,202112,1484,4094,1095,3352,165,557,392,1055,557,1612
311783,202112,2454,6253,1997,5504,29,131,1634,4335,1663,4466
311787,202112,904,2501,705,2055,101,320,314,793,415,1113
311790,202112,1617,4295,1071,3268,225,754,315,879,540,1633
311800,202112,5512,15893,4375,13466,868,2769,623,1514,1491,4283
311810,202112,1004,2864,789,2491,49,162,529,1650,578,1812
311820,202112,893,2075,684,1766,58,179,444,1073,502,1252
311830,202112,9121,25008,6396,19205,1729,5482,850,2467,2579,7949
311840,202112,4062,9690,3294,8613,251,656,2452,6396,2703,7052
311850,202112,390,988,315,856,12,31,213,544,225,575
311860,202112,70932,170958,55101,144046,6648,18891,33006,81278,39654,100169
311870,202112,2001,5145,1431,4175,253,851,591,1564,844,2415
311880,202112,6988,17125,5830,15517,381,806,4283,11750,4664,12556
311890,202112,1872,4261,1453,3694,63,185,1077,2587,1140,2772
311900,202112,801,1973,604,1708,69,196,356,1020,425,1216
311910,202112,4455,10855,3388,9444,636,1741,1606,4649,2242,6390
311920,202112,2291,5729,1848,5096,113,258,1201,3407,1314,3665
311930,202112,4483,9952,3268,8290,892,2409,1168,2790,2060,5199
311940,202112,17183,42937,12469,34157,1742,5169,5590,14152,7332,19321
311950,202112,2552,6420,1927,5357,143,408,1211,3369,1354,3777
311960,202112,520,1247,409,1077,49,153,216,507,265,660
311970,202112,461,1432,334,1121,52,215,83,233,135,448
311980,202112,498,1292,265,842,24,82,106,318,130,400
311990,202112,567,1306,360,987,73,234,140,340,213,574
311995,202112,1007,2735,534,1646,18,64,74,142,92,206
312000,202112,855,1976,647,1670,58,136,427,1110,485,1246
312010,202112,1102,2824,870,2460,33,104,621,1673,654,1777
312015,202112,1490,4087,1323,3822,44,155,1072,3018,1116,3173
312020,202112,1852,5494,1316,4285,208,693,275,801,483,1494
312030,202112,2207,5106,1913,4782,14,56,1808,4506,1822,4562
312040,202112,893,2564,645,2076,100,305,272,861,372,1166
312050,202112,1293,3812,1047,3346,211,832,375,1054,586,1886
312060,202112,1021,2379,667,1895,169,483,277,786,446,1269
312070,202112,982,2674,710,2138,28,95,436,1218,464,1313
312080,202112,2961,7041,2274,6034,133,363,1551,3925,1684,4288
312083,202112,1006,2473,777,2127,54,181,574,1512,628,1693
312087,202112,2719,6684,2209,5905,54,120,1797,4836,1851,4956
312090,202112,11634,29193,9217,25404,1188,3564,4966,12948,6154,16512
312100,202112,1695,4658,1362,4046,83,312,882,2471,965,2783
312110,202112,1084,3229,891,2835,165,608,351,995,516,1603
312120,202112,1081,2860,744,2279,185,643,219,547,404,1190
312125,202112,1952,4748,1661,4353,102,275,1311,3347,1413,3622
312130,202112,1180,2769,876,2262,76,221,396,927,472,1148
312140,202112,753,2128,625,1869,104,343,279,773,383,1116
312150,202112,514,1355,437,1208,29,83,281,727,310,810
312160,202112,10012,25825,7729,21868,872,2638,3865,10393,4737,13031
312170,202112,968,2443,738,2024,39,116,483,1281,522,1397
312180,202112,1493,3805,1202,3283,147,403,651,1733,798,2136
312190,202112,763,2013,574,1673,64,219,267,719,331,938
312200,202112,4830,12616,3787,10942,705,1927,1844,5369,2549,7296
312210,202112,1469,3170,1090,2642,44,126,844,1994,888,2120
312220,202112,1720,5042,1489,4628,99,322,989,3074,1088,3396
312230,202112,17499,43078,12297,33881,2540,7929,3386,7744,5926,15673
312235,202112,2162,5143,1708,4508,146,380,1213,3122,1359,3502
312240,202112,818,2519,631,2129,133,460,182,592,315,1052
312245,202112,2941,7013,2442,6274,45,92,2099,5361,2144,5453
312247,202112,1109,2478,816,2069,108,305,499,1226,607,1531
312250,202112,1003,2599,624,1857,84,263,217,620,301,883
312260,202112,1037,2625,834,2322,34,122,658,1746,692,1868
312270,202112,763,2056,588,1705,31,114,322,857,353,971
312280,202112,444,1260,345,1086,89,301,63,178,152,479
312290,202112,915,2542,750,2258,139,463,245,679,384,1142
312300,202112,1124,3303,765,2416,184,632,137,350,321,982
312310,202112,1041,2950,829,2534,119,390,419,1224,538,1614
312320,202112,2213,5452,1616,4439,355,986,332,914,687,1900
312330,202112,957,2627,788,2282,84,271,473,1313,557,1584
312340,202112,277,689,200,568,29,116,110,266,139,382
312350,202112,282,561,209,482,20,50,148,331,168,381
312352,202112,1636,4793,1439,4422,140,434,786,2613,926,3047
312360,202112,3373,9348,2527,7789,440,1492,954,2693,1394,4185
312370,202112,2070,5127,1710,4532,166,496,1086,2735,1252,3231
312380,202112,2355,5116,1956,4611,9,31,1748,4047,1757,4078
312385,202112,1373,3530,1054,2962,260,789,260,756,520,1545
312390,202112,2062,5614,1507,4567,217,749,414,1069,631,1818
312400,202112,3160,8619,2662,7797,746,2402,814,2402,1560,4804
312410,202112,13739,35689,11220,31584,1784,5109,6513,17887,8297,22996
312420,202112,4275,10811,3496,9542,710,2105,1734,4541,2444,6646
312430,202112,8758,21963,7146,19191,283,879,5306,13834,5589,14713
312440,202112,1034,3200,847,2804,370,1310,142,445,512,1755
312450,202112,1364,3845,1041,3271,273,907,353,1129,626,2036
312460,202112,492,1195,356,992,52,146,201,565,253,711
312470,202112,507,1210,317,870,30,95,104,240,134,335
312480,202112,1118,2713,800,2243,84,273,426,1123,510,1396
312490,202112,2482,5557,1994,4879,164,451,1203,2866,1367,3317
312500,202112,1124,2610,933,2357,37,128,709,1767,746,1895
312510,202112,4484,11655,3248,9319,753,2042,841,2395,1594,4437
312520,202112,302,743,233,639,45,138,115,308,160,446
312530,202112,734,1641,621,1511,30,70,481,1218,511,1288
312540,202112,1723,4511,1187,3500,141,425,652,1864,793,2289
312550,202112,860,2193,656,1796,47,143,427,1087,474,1230
312560,202112,2029,5161,1628,4537,83,221,1171,3268,1254,3489
312570,202112,2707,6081,2051,5270,487,1197,916,2504,1403,3701
312580,202112,650,1714,451,1313,56,191,196,516,252,707
312590,202112,1667,4613,1283,3833,117,404,750,2043,867,2447
312595,202112,2224,6106,1836,5490,272,736,1064,3411,1336,4147
312600,202112,1306,3061,792,2061,112,356,171,477,283,833
312610,202112,7717,18920,5202,14334,719,2181,1866,4565,2585,6746
312620,202112,2673,6629,2001,5694,57,176,1583,4571,1640,4747
312630,202112,338,916,243,744,36,137,90,260,126,397
312640,202112,566,1500,410,1237,36,135,209,603,245,738
312650,202112,2249,5365,1582,4155,69,191,1148,2831,1217,3022
312660,202112,1408,3271,1077,2728,98,238,717,1747,815,1985
312670,202112,5675,13828,4734,12369,145,523,3666,9097,3811,9620
312675,202112,1368,3345,1118,2990,52,148,917,2416,969,2564
312680,202112,1566,4092,1365,3776,44,156,1159,3115,1203,3271
312690,202112,3108,6398,2381,5520,43,110,1982,4588,2025,4698
312695,202112,1090,2729,913,2447,45,86,728,1941,773,2027
312700,202112,2198,5610,1619,4572,141,472,934,2491,1075,2963
312705,202112,1571,3505,1358,3201,11,38,1266,2957,1277,2995
312707,202112,1521,4153,1140,3507,71,267,734,2162,805,2429
312710,202112,7212,16164,4473,11941,1075,3022,1262,3541,2337,6563
312720,202112,1162,2933,868,2472,88,263,551,1493,639,1756
312730,202112,1732,3949,1224,3255,99,286,749,1937,848,2223
312733,202112,1451,3714,1091,3046,29,105,752,1956,781,2061
312735,202112,813,2056,634,1700,73,194,379,951,452,1145
312737,202112,860,1829,624,1501,62,164,430,1003,492,1167
312738,202112,815,1966,587,1579,58,167,354,895,412,1062
312740,202112,459,1133,275,825,54,186,65,139,119,325
312750,202112,1641,4543,1218,3743,192,617,529,1521,721,2138
312760,202112,1939,5469,1389,4330,242,749,519,1562,761,2311
312770,202112,48143,112230,30493,82116,5657,16383,10607,27169,16264,43552
312780,202112,2606,7327,2206,6659,269,818,1384,4138,1653,4956
312790,202112,261,602,138,396,2,7,39,78,41,85
312800,202112,5570,14816,4292,12416,735,2289,1981,5411,2716,7700
312810,202112,1681,4373,1137,3471,284,951,381,1056,665,2007
312820,202112,1896,4825,1538,4212,85,243,1112,3002,1197,3245
312825,202112,1513,3310,1309,3050,24,49,1136,2598,1160,2647
312830,202112,2991,8127,1878,5900,355,1194,498,1477,853,2671
312840,202112,1564,3923,1232,3385,82,260,738,1909,820,2169
312850,202112,1066,2429,753,1974,21,80,494,1194,515,1274
312860,202112,1171,2919,804,2360,195,571,185,511,380,1082
312870,202112,6553,16972,4144,12393,647,1989,1099,3012,1746,5001
312880,202112,1569,3800,1218,3218,61,158,708,1895,769,2053
312890,202112,2423,5786,1806,4794,138,333,974,2578,1112,2911
312900,202112,1392,3404,1137,3064,116,355,638,1790,754,2145
312910,202112,1617,2927,900,1993,198,372,356,817,554,1189
312920,202112,1039,2702,726,2202,114,412,266,704,380,1116
312930,202112,2593,6096,1966,5163,405,1073,885,2397,1290,3470
312940,202112,1096,2844,876,2539,62,225,531,1461,593,1686
312950,202112,3315,7844,2235,6137,423,1306,935,2420,1358,3726
312960,202112,1966,4944,1646,4461,99,234,1210,3396,1309,3630
312965,202112,1771,4571,1468,4113,162,393,935,2674,1097,3067
312970,202112,1600,4300,1285,3799,156,526,793,2219,949,2745
312980,202112,27015,71162,21786,61844,4122,12417,9990,26505,14112,38922
312990,202112,564,1344,382,1040,56,167,198,495,254,662
313000,202112,503,1389,371,1152,23,100,230,661,253,761
313005,202112,2707,7463,2283,6766,140,365,1642,4776,1782,5141
313010,202112,5850,15214,4653,13271,736,2288,2739,7627,3475,9915
313020,202112,1178,3456,864,2766,136,467,184,513,320,980
313030,202112,1230,2682,844,2141,60,197,585,1413,645,1610
313040,202112,907,2693,750,2388,34,143,474,1454,508,1597
313050,202112,1942,5130,1356,4227,206,760,402,1109,608,1869
313055,202112,2085,5293,1835,4923,303,811,1235,3333,1538,4144
313060,202112,1055,2512,756,2002,146,471,173,413,319,884
313065,202112,1747,4959,1535,4607,33,117,1227,3588,1260,3705
313070,202112,1003,2555,777,2184,81,233,451,1234,532,1467
313080,202112,419,1145,311,939,51,173,110,272,161,445
313090,202112,5712,14216,4843,12863,386,1068,3274,8642,3660,9710
313100,202112,1416,3541,1103,3091,30,109,830,2263,860,2372
313110,202112,1591,4040,1174,3325,104,350,637,1644,741,1994
313115,202112,3031,8222,2418,7063,262,910,1343,3572,1605,4482
313120,202112,4085,9385,3015,7985,198,579,2030,5396,2228,5975
313130,202112,34693,85558,26220,70258,2548,7733,15057,37707,17605,45440
313140,202112,740,1557,478,1199,28,72,355,885,383,957
313150,202112,1485,4059,1106,3389,322,1065,189,527,511,1592
313160,202112,1346,3253,1054,2825,24,80,803,2078,827,2158
313170,202112,12149,33023,8959,27057,1446,4664,3309,8993,4755,13657
313180,202112,2475,6276,1816,4953,304,741,1003,2761,1307,3502
313190,202112,4785,13230,3450,10526,576,1864,1215,3376,1791,5240
313200,202112,1239,3191,1066,2887,11,37,918,2418,929,2455
313210,202112,4264,11423,3508,10122,421,1226,2101,5895,2522,7121
313220,202112,1916,4836,1279,3599,178,541,559,1389,737,1930
313230,202112,3047,8247,2460,7504,44,132,2024,6332,2068,6464
313240,202112,11298,26779,7553,20930,945,3000,3820,9763,4765,12763
313250,202112,6677,18880,5065,15401,956,2876,2204,6414,3160,9290
313260,202112,804,1963,581,1589,68,244,302,719,370,963
313270,202112,6401,14905,5229,13331,598,1261,3692,9815,4290,11076
313280,202112,497,1327,327,991,39,140,139,397,178,537
313290,202112,1080,3234,821,2769,189,718,309,1020,498,1738
313300,202112,1856,4813,1410,4055,313,972,413,1047,726,2019
313310,202112,1389,3984,1099,3379,166,580,344,885,510,1465
313320,202112,2200,5639,1584,4659,275,903,565,1714,840,2617
313330,202112,4459,11172,3391,9572,154,464,2257,6349,2411,6813
313340,202112,1577,3426,1158,2848,77,211,845,2040,922,2251
313350,202112,3234,8633,2161,6268,229,746,888,2226,1117,2972
313360,202112,1675,3974,1144,3119,165,570,612,1503,777,2073
313370,202112,1695,4485,1370,3866,197,587,563,1448,760,2035
313375,202112,1995,5061,1282,3735,241,755,299,778,540,1533
313380,202112,7048,17020,5177,13643,751,2255,2607,6053,3358,8308
313390,202112,855,2619,742,2422,56,242,500,1564,556,1806
313400,202112,4016,9414,3092,8113,118,298,2345,6074,2463,6372
313410,202112,1517,3718,1138,3069,109,310,742,1917,851,2227
313420,202112,16926,36815,9126,23925,2086,6125,1215,3054,3301,9179
313430,202112,1100,2968,876,2522,95,350,499,1267,594,1617
313440,202112,6785,14156,4706,11502,256,650,3367,8129,3623,8779
313450,202112,805,2059,572,1611,100,297,205,489,305,786
313460,202112,2356,6413,1866,5629,356,1215,849,2454,1205,3669
313470,202112,3016,7419,2390,6498,173,469,1707,4660,1880,5129
313480,202112,1120,3114,682,2158,52,183,244,706,296,889
313490,202112,3233,7830,1733,5062,363,1154,477,1317,840,2471
313500,202112,609,1593,442,1236,34,91,194,499,228,590
313505,202112,10879,27514,9257,25299,349,1035,7446,20340,7795,21375
313507,202112,1537,3804,1244,3355,37,137,992,2592,1029,2729
313510,202112,15447,40733,12059,34161,1332,3642,5952,16409,7284,20051
313520,202112,16121,42324,12867,36810,612,1836,9734,27291,10346,29127
313530,202112,624,1774,468,1442,54,187,165,428,219,615
313535,202112,2506,6732,2047,5866,266,681,1249,3598,1515,4279
313540,202112,900,2531,723,2124,119,369,323,854,442,1223
313545,202112,1228,3875,1040,3514,114,415,575,1854,689,2269
313550,202112,2029,5768,1703,5026,222,720,1054,3006,1276,3726
313560,202112,2986,5518,2241,4629,63,99,1920,3979,1983,4078
313570,202112,1080,2961,886,2614,198,589,369,1087,567,1676
313580,202112,6446,15390,5055,13114,441,1158,3203,8175,3644,9333
313590,202112,1202,3131,970,2794,182,541,505,1540,687,2081
313600,202112,4463,11079,3727,9968,87,257,3225,8481,3312,8738
313610,202112,1133,2706,914,2337,92,255,592,1433,684,1688
313620,202112,5816,14837,4604,12684,462,1490,2837,7430,3299,8920
313630,202112,9533,22190,6824,18155,679,2064,4120,10590,4799,12654
313640,202112,1339,2759,852,2150,120,298,493,1257,613,1555
313650,202112,1775,5151,1390,4511,92,349,887,2911,979,3260
313652,202112,891,2534,796,2358,76,233,571,1625,647,1858
313655,202112,1227,2924,951,2574,63,171,668,1821,731,1992
313657,202112,1233,3126,967,2702,25,82,737,1947,762,2029
313660,202112,1088,2892,892,2553,69,239,610,1658,679,1897
313665,202112,5703,14374,4541,12354,405,1210,2966,7636,3371,8846
313670,202112,56162,133353,37120,101350,4826,14368,17726,45256,22552,59624
313680,202112,1143,2885,947,2565,47,122,662,1753,709,1875
313690,202112,976,2806,699,2256,132,479,210,617,342,1096
313695,202112,1986,5029,1479,4193,102,286,959,2810,1061,3096
313700,202112,3044,9146,2634,8611,215,650,2026,6712,2241,7362
313710,202112,1594,3467,1142,2869,81,212,768,1937,849,2149
313720,202112,6524,17188,4670,13402,619,1866,1960,5093,2579,6959
313730,202112,1532,3206,1126,2679,92,165,718,1747,810,1912
313740,202112,1790,6212,1498,5458,295,1217,308,972,603,2189
313750,202112,2261,5754,1787,4947,292,904,930,2367,1222,3271
313753,202112,2339,5517,1554,4210,169,523,811,2106,980,2629
313760,202112,6133,16306,4777,13716,815,2608,2271,5998,3086,8606
313770,202112,4386,11766,3477,10338,202,534,2596,7878,2798,8412
313780,202112,4367,11045,3267,9284,314,941,991,2949,1305,3890
313790,202112,596,1664,526,1538,69,213,315,893,384,1106
313800,202112,1500,3221,1098,2670,89,239,621,1437,710,1676
313810,202112,1807,4315,1464,3833,46,148,1167,2971,1213,3119
313820,202112,19142,47523,12119,32785,1985,5437,3122,8094,5107,13531
313830,202112,429,1209,308,944,55,189,114,318,169,507
313835,202112,954,2674,789,2386,63,221,439,1244,502,1465
313840,202112,8361,21103,6536,18132,1376,4107,1485,4218,2861,8325
313850,202112,1054,2488,837,2196,143,424,401,957,544,1381
313860,202112,2886,7314,2185,6047,278,892,1059,2635,1337,3527
313862,202112,1338,2778,662,1804,37,106,312,854,349,960
313865,202112,2765,6997,2271,6211,92,268,1715,4557,1807,4825
313867,202112,1509,4414,1252,3942,245,750,621,2033,866,2783
313868,202112,1845,5316,1513,4692,48,165,1159,3481,1207,3646
313870,202112,1116,2766,749,2113,105,296,303,775,408,1071
313880,202112,2062,5165,1525,4248,167,530,813,2069,980,2599
313890,202112,2373,4723,1780,3967,38,93,1384,2998,1422,3091
313900,202112,5222,14203,3732,11154,845,2714,946,2479,1791,5193
313910,202112,770,2173,582,1802,96,318,123,367,219,685
313920,202112,3124,8976,2598,7902,479,1449,1308,3994,1787,5443
313925,202112,1766,4215,1427,3646,152,380,969,2453,1121,2833
313930,202112,5195,14421,4209,12710,250,824,2864,8484,3114,9308
313940,202112,9982,27631,7501,23415,858,3132,1870,6487,2728,9619
313950,202112,5845,12290,4483,10632,271,767,3103,7341,3374,8108
313960,202112,6177,14304,4141,10921,754,2228,1311,3060,2065,5288
313970,202112,1653,4250,1405,3841,22,63,936,2497,958,2560
313980,202112,1330,3385,886,2711,146,491,368,1059,514,1550
313990,202112,2119,6370,1582,5193,298,1134,699,2038,997,3172
314000,202112,10975,26545,8962,23191,637,1978,5990,15151,6627,17129
314010,202112,1529,3524,1206,3086,36,107,922,2273,958,2380
314015,202112,2213,5812,1737,5006,182,613,1013,2770,1195,3383
314020,202112,568,1487,390,1181,85,311,68,228,153,539
314030,202112,871,2379,678,2023,98,280,319,947,417,1227
314040,202112,627,1671,517,1473,76,246,271,736,347,982
314050,202112,2065,5276,1526,4285,127,425,892,2313,1019,2738
314053,202112,2113,5960,1679,5102,307,886,924,2923,1231,3809
314055,202112,2375,5982,2005,5432,39,146,1683,4532,1722,4678
314060,202112,1419,3615,1073,3066,31,96,759,2144,790,2240
314070,202112,5249,13611,4145,11661,742,2087,1985,5466,2727,7553
314080,202112,2274,5668,1590,4529,161,501,725,1881,886,2382
314085,202112,2515,6553,2039,5853,187,517,1238,3602,1425,4119
314090,202112,5357,13391,4616,12319,308,810,3076,8528,3384,9338
314100,202112,3213,7551,2480,6535,46,131,1850,4905,1896,5036
314110,202112,5473,14653,4421,12671,551,1713,2399,6305,2950,8018
314120,202112,754,1714,338,967,60,197,102,261,162,458
314130,202112,710,1824,466,1374,20,64,286,822,306,886
314140,202112,4910,12945,3924,11164,465,1317,2095,5844,2560,7161
314150,202112,1605,3879,1174,3149,78,208,784,2065,862,2273
314160,202112,2511,6165,1847,4993,219,649,856,2263,1075,2912
314170,202112,1001,2684,809,2308,37,140,546,1435,583,1575
314180,202112,5953,15598,4773,13735,373,1079,2860,8263,3233,9342
314190,202112,681,1649,510,1404,80,254,272,695,352,949
314200,202112,3191,8592,2638,7677,176,507,1818,5214,1994,5721
314210,202112,2245,5592,1781,4778,261,738,748,1922,1009,2660
314220,202112,1665,4360,1293,3744,223,731,564,1502,787,2233
314225,202112,1168,3258,954,2868,88,237,649,1940,737,2177
314230,202112,913,2284,747,2062,70,210,481,1346,551,1556
314240,202112,1164,3029,902,2629,187,565,364,1061,551,1626
314250,202112,504,1411,316,994,48,138,121,351,169,489
314260,202112,1191,2966,934,2614,169,504,454,1234,623,1738
314270,202112,3563,9603,2943,8631,74,245,2200,6398,2274,6643
314280,202112,3795,8513,2607,6706,281,805,1529,3691,1810,4496
314290,202112,4833,11952,4031,10549,347,901,2761,7086,3108,7987
314300,202112,2178,5941,1403,4308,263,894,457,1230,720,2124
314310,202112,4155,10620,2786,8264,788,2601,380,939,1168,3540
314315,202112,1042,3172,879,2836,42,152,623,1966,665,2118
314320,202112,3425,8922,2291,6813,381,1256,868,2388,1249,3644
314330,202112,55822,150786,42578,127476,10669,32931,9276,28842,19945,61773
314340,202112,2722,6621,1751,4913,319,1030,464,1122,783,2152
314345,202112,1534,4293,1241,3774,111,320,821,2463,932,2783
314350,202112,886,2355,579,1790,124,399,131,330,255,729
314360,202112,588,1659,382,1225,57,179,117,335,174,514
314370,202112,797,2032,642,1804,59,178,421,1139,480,1317
314380,202112,1217,3202,809,2495,185,660,191,564,376,1224
314390,202112,15746,38120,10736,29314,1569,4687,3995,9566,5564,14253
314400,202112,4267,12332,3304,10446,830,2743,1212,3997,2042,6740
314410,202112,3123,8494,2169,6627,295,1066,614,1889,909,2955
314420,202112,881,2091,649,1723,26,91,445,1125,471,1216
314430,202112,8673,19894,6122,15776,934,2485,2858,7053,3792,9538
314435,202112,2018,5234,1564,4497,197,581,902,2551,1099,3132
314437,202112,962,2353,691,1917,67,193,379,1040,446,1233
314440,202112,662,1842,473,1475,153,533,87,206,240,739
314450,202112,1569,3972,1298,3522,168,457,702,1849,870,2306
314460,202112,3473,10114,2587,8322,604,2061,711,2133,1315,4194
314465,202112,2411,6609,2053,5940,48,145,1601,4510,1649,4655
314467,202112,1004,2541,850,2286,23,70,667,1717,690,1787
314470,202112,2473,6774,2038,5918,348,1073,944,2546,1292,3619
314480,202112,8390,22340,6345,18121,952,3006,2626,6603,3578,9609
314490,202112,1157,2896,849,2290,61,169,557,1449,618,1618
314500,202112,1847,4272,1333,3595,360,910,436,1249,796,2159
314505,202112,2271,5224,1856,4652,86,222,1407,3408,1493,3630
314510,202112,2176,5479,1551,4529,333,1075,670,1879,1003,2954
314520,202112,5840,17027,4465,14294,874,3040,781,2217,1655,5257
314530,202112,5770,17418,5151,16291,272,1011,3863,11923,4135,12934
314535,202112,2817,6848,2267,6061,92,292,1780,4748,1872,5040
314537,202112,1252,3403,957,2937,50,154,689,2087,739,2241
314540,202112,450,1079,319,869,21,64,194,499,215,563
314545,202112,2086,4736,1870,4488,30,68,1639,4014,1669,4082
314550,202112,804,1872,573,1516,35,116,339,815,374,931
314560,202112,5081,14340,3738,11427,470,1628,1496,3990,1966,5618
314570,202112,335,909,237,726,33,108,109,339,142,447
314580,202112,491,1427,390,1226,98,300,136,426,234,726
314585,202112,708,2086,545,1734,58,210,253,768,311,978
314587,202112,2373,6072,1833,5215,514,1407,851,2451,1365,3858
314590,202112,4570,11821,3429,9754,414,1318,1634,4237,2048,5555
314600,202112,2009,5258,1214,3765,236,766,131,378,367,1144
314610,202112,9883,23717,7256,19841,972,3120,3478,9630,4450,12750
314620,202112,2465,5498,1981,4892,48,141,1673,4112,1721,4253
314625,202112,1641,4277,1409,3955,22,113,1214,3342,1236,3455
314630,202112,5739,13783,4670,12329,118,433,3851,10076,3969,10509
314640,202112,783,1750,583,1438,55,155,374,843,429,998
314650,202112,901,2031,585,1535,54,166,343,799,397,965
314655,202112,1660,4411,1194,3601,184,520,579,1786,763,2306
314660,202112,353,780,244,594,12,28,164,383,176,411
314670,202112,1771,3848,1230,3089,25,72,852,2080,877,2152
314675,202112,1816,4516,1535,4064,74,207,1200,3111,1274,3318
314690,202112,2185,5783,1646,4979,391,1280,581,1757,972,3037
314700,202112,12141,32003,8214,24669,1360,4400,3243,9273,4603,13673
314710,202112,8820,23836,6462,18906,920,2954,2487,6316,3407,9270
314720,202112,2401,6918,1692,5443,299,1018,367,1078,666,2096
314730,202112,2610,6558,1854,5215,300,904,664,1698,964,2602
314740,202112,3332,9019,2617,7755,365,1084,1332,3847,1697,4931
314750,202112,301,800,231,658,28,83,134,337,162,420
314760,202112,2067,5890,1339,4279,230,819,325,804,555,1623
314770,202112,1136,3194,652,2024,67,210,206,594,273,804
314780,202112,388,943,270,757,36,120,149,373,185,493
314790,202112,12943,33139,9230,26354,1579,5073,3762,9937,5341,15010
314795,202112,1634,4124,1386,3706,27,112,1124,2883,1151,2995
314800,202112,11938,29566,7675,21819,1278,3914,2222,5548,3500,9462
314810,202112,10177,25915,7485,21310,1899,5672,2422,6758,4321,12430
314820,202112,1395,3218,1088,2758,65,207,704,1688,769,1895
314830,202112,1826,5081,1524,4548,175,538,826,2408,1001,2946
314840,202112,924,2775,722,2413,46,202,508,1615,554,1817
314850,202112,2449,5155,1983,4580,44,124,1735,3975,1779,4099
314860,202112,3528,9707,2951,8693,147,564,2127,6050,2274,6614
314870,202112,6984,15887,5307,13801,216,546,4023,10630,4239,11176
314875,202112,2005,5714,1771,5399,244,617,1309,4167,1553,4784
314880,202112,888,2092,686,1780,41,119,428,1084,469,1203
314890,202112,482,1382,375,1164,58,196,171,487,229,683
314900,202112,889,2207,675,1842,83,244,314,822,397,1066
314910,202112,1820,4932,1345,4155,203,734,663,1898,866,2632
314915,202112,2262,6432,1884,5753,122,362,1231,3715,1353,4077
314920,202112,541,1352,370,1105,21,53,243,744,264,797
314930,202112,6215,16882,4758,14137,745,2458,2001,5410,2746,7868
314940,202112,443,1026,371,910,39,91,242,571,281,662
314950,202112,608,1478,423,1191,30,103,234,600,264,703
314960,202112,936,2099,730,1774,26,73,545,1257,571,1330
314970,202112,1130,3238,867,2715,140,469,389,1126,529,1595
314980,202112,1784,4401,1370,3791,202,633,753,2004,955,2637
314990,202112,2816,7905,2036,6170,391,1202,445,1229,836,2431
314995,202112,1786,4769,1430,4136,24,91,980,2660,1004,2751
315000,202112,1197,2955,866,2445,76,217,542,1497,618,1714
315010,202112,422,1104,330,955,48,167,172,467,220,634
315015,202112,2549,6782,2208,6212,210,703,1467,3995,1677,4698
315020,202112,829,2361,589,1834,57,217,282,816,339,1033
315030,202112,675,1720,466,1349,113,342,96,237,209,579
315040,202112,1013,2575,838,2281,105,319,543,1395,648,1714
315050,202112,1304,3201,970,2678,55,200,539,1405,594,1605
315053,202112,1268,3150,944,2599,63,175,561,1481,624,1656
315057,202112,1926,5424,1544,4790,144,393,996,3272,1140,3665
315060,202112,663,1926,487,1568,98,318,119,368,217,686
315070,202112,650,1590,481,1304,110,313,175,427,285,740
315080,202112,3443,8965,2663,7573,132,408,1892,5125,2024,5533
315090,202112,862,2508,644,2102,81,286,271,832,352,1118
315100,202112,1478,4180,982,3051,128,466,449,1203,577,1669
315110,202112,2257,5154,1643,4242,140,343,884,2302,1024,2645
315120,202112,13759,30637,10209,25415,1258,2784,5781,14882,7039,17666
315130,202112,1790,4761,1511,4282,150,486,660,1741,810,2227
315140,202112,3202,8575,2525,7384,476,1550,1239,3373,1715,4923
315150,202112,4705,11168,3363,9047,457,1431,1612,4227,2069,5658
315160,202112,2009,4762,1355,3726,265,764,632,1692,897,2456
315170,202112,1457,4472,1033,3459,199,726,279,874,478,1600
315180,202112,18891,44739,10887,30195,1358,4182,3849,9284,5207,13466
315190,202112,2356,5028,1850,4374,269,620,1257,3037,1526,3657
315200,202112,4472,12037,3335,10093,867,2833,851,2513,1718,5346
315210,202112,9660,23995,6771,18166,705,2046,3446,8305,4151,10351
315213,202112,1166,3002,1010,2781,20,60,836,2255,856,2315
315217,202112,2994,8238,2274,7039,76,296,1555,4624,1631,4920
315220,202112,9083,23857,7180,20628,622,1687,3875,11308,4497,12995
315230,202112,3208,7107,2645,6350,228,412,1728,4519,1956,4931
315240,202112,2598,7249,2156,6490,462,1438,994,3002,1456,4440
315250,202112,15179,39547,11110,31954,1672,5110,4735,12861,6407,17971
315260,202112,979,2588,557,1727,91,273,40,108,131,381
315270,202112,961,2668,710,2183,99,318,260,698,359,1016
315280,202112,3156,7696,2004,5677,494,1486,383,1058,877,2544
315290,202112,1267,3025,760,2226,183,600,235,663,418,1263
315300,202112,716,1728,518,1426,42,128,339,926,381,1054
315310,202112,1342,3481,1023,2910,64,209,636,1662,700,1871
315320,202112,686,1952,485,1560,59,210,195,580,254,790
315330,202112,835,2608,483,1714,72,271,162,515,234,786
315340,202112,3204,7536,2225,6054,397,1093,1010,2711,1407,3804
315350,202112,1791,4570,1467,4072,128,428,982,2642,1110,3070
315360,202112,1891,5322,1460,4452,200,650,642,1800,842,2450
315370,202112,598,1591,486,1383,75,204,236,657,311,861
315380,202112,278,749,186,556,31,99,23,53,54,152
315390,202112,1292,3501,1040,3045,117,414,576,1537,693,1951
315400,202112,4439,11423,3521,9817,372,1116,2113,5557,2485,6673
315410,202112,2656,5819,1961,4806,374,1011,408,1037,782,2048
315415,202112,1532,4036,1236,3577,264,887,420,1183,684,2070
315420,202112,1624,4365,1127,3448,202,642,251,721,453,1363
315430,202112,3904,9201,2748,7485,447,1391,1256,3242,1703,4633
315440,202112,1119,2855,879,2464,76,235,511,1343,587,1578
315445,202112,2120,4804,1568,4024,75,230,1224,3072,1299,3302
315450,202112,2489,6492,2024,5732,262,635,1245,3576,1507,4211
315460,202112,44317,116195,36786,103033,4360,13979,22061,57509,26421,71488
315470,202112,729,1948,509,1430,50,144,268,716,318,860
315480,202112,1317,3602,926,2789,148,468,355,1007,503,1475
315490,202112,3124,7573,2209,6129,264,744,905,2326,1169,3070
315500,202112,566,1465,359,1025,40,139,190,471,230,610
315510,202112,1384,3428,1165,3126,8,28,1033,2712,1041,2740
315520,202112,1113,2828,926,2541,46,129,729,1944,775,2073
315530,202112,692,1808,562,1584,94,296,340,903,434,1199
315540,202112,1779,4545,1202,3459,93,308,520,1408,613,1716
315550,202112,1989,5175,1321,3931,240,818,372,1091,612,1909
315560,202112,6888,19622,5891,17860,349,960,4087,12501,4436,13461
315570,202112,2286,5796,1817,5012,229,711,916,2328,1145,3039
315580,202112,3411,7677,2656,6501,409,1064,998,2287,1407,3351
315590,202112,1049,2477,836,2162,46,147,577,1384,623,1531
315600,202112,2716,7942,1910,6368,374,1124,851,3086,1225,4210
315610,202112,1073,2610,804,2138,110,358,386,890,496,1248
315620,202112,559,1441,429,1243,45,137,223,652,268,789
315630,202112,1151,2951,871,2435,118,361,421,1068,539,1429
315640,202112,388,932,289,809,27,97,180,478,207,575
315645,202112,1055,2615,737,2111,149,470,196,528,345,998
315650,202112,1843,4170,1492,3685,48,117,1192,2879,1240,2996
315660,202112,2424,5952,1846,4937,128,346,1262,3284,1390,3630
315670,202112,15517,40509,11889,33948,2108,6371,5552,14912,7660,21283
315680,202112,3418,9332,2559,7751,308,1060,1363,3919,1671,4979
315690,202112,3917,9316,2419,6800,500,1383,610,1862,1110,3245
315700,202112,9121,23888,6879,19532,959,2854,3257,8710,4216,11564
315710,202112,2002,4722,1442,3889,64,186,1000,2623,1064,2809
315720,202112,4724,12581,3885,11101,169,633,2778,7585,2947,8218
315725,202112,2411,5959,1859,5078,224,571,1146,3264,1370,3835
315727,202112,624,1554,472,1302,69,222,211,551,280,773
315730,202112,659,1909,569,1740,94,316,209,566,303,882
315733,202112,1463,3561,1093,2948,178,529,435,1073,613,1602
315737,202112,1263,3372,969,2805,31,108,693,1920,724,2028
315740,202112,859,2338,692,2005,65,209,458,1249,523,1458
315750,202112,1343,3371,1072,2953,92,255,687,1905,779,2160
315760,202112,1243,2842,1077,2621,46,139,896,2115,942,2254
315765,202112,2076,5164,1697,4673,30,104,1517,4179,1547,4283
315770,202112,1088,2901,850,2570,326,1091,166,442,492,1533
315780,202112,33388,87362,27870,77490,1540,5030,19129,50349,20669,55379
315790,202112,3788,11248,3217,10192,558,1814,1704,5575,2262,7389
315800,202112,1412,4545,1060,3704,139,539,400,1202,539,1741
315810,202112,1435,3397,1191,2990,62,157,930,2281,992,2438
315820,202112,2942,7256,2342,6449,250,642,1589,4445,1839,5087
315830,202112,1318,3786,883,2812,86,282,281,761,367,1043
315840,202112,955,2213,679,1737,51,159,371,847,422,1006
315850,202112,1289,3555,1011,3085,178,543,512,1496,690,2039
315860,202112,542,1471,384,1196,62,208,134,359,196,567
315870,202112,501,1319,393,1136,21,66,285,797,306,863
315880,202112,1197,2929,849,2322,113,325,284,720,397,1045
315890,202112,1877,5070,1528,4596,403,1310,711,2151,1114,3461
315895,202112,6894,17944,5146,14568,495,1545,2670,6968,3165,8513
315900,202112,839,2126,715,1950,71,204,512,1352,583,1556
315910,202112,565,1497,476,1365,72,199,317,909,389,1108
315920,202112,1521,3768,883,2576,128,450,295,760,423,1210
315930,202112,1214,2597,820,2031,139,323,355,884,494,1207
315935,202112,1020,2959,807,2545,158,488,285,898,443,1386
315940,202112,667,1712,528,1512,69,204,278,768,347,972
315950,202112,1241,3301,1030,2968,110,314,758,2178,868,2492
315960,202112,6034,16315,4159,12571,1030,3437,716,1557,1746,4994
315970,202112,607,1575,487,1415,56,172,317,938,373,1110
315980,202112,4568,9554,2570,6360,465,1189,1029,2307,1494,3496
315990,202112,3762,9413,2942,8002,360,995,1581,4156,1941,5151
316000,202112,736,1702,570,1465,52,165,328,787,380,952
316010,202112,825,2216,613,1835,64,203,283,741,347,944
316020,202112,1005,2832,804,2441,107,335,452,1291,559,1626
316030,202112,2938,7846,2260,6631,284,796,1400,4236,1684,5032
316040,202112,2841,7842,2083,6403,338,1183,569,1507,907,2690
316045,202112,2271,5494,2093,5277,91,149,1836,4748,1927,4897
316050,202112,423,1138,327,976,49,125,172,486,221,611
316060,202112,754,1765,558,1507,18,69,407,1050,425,1119
316070,202112,5916,15702,4823,13658,839,2351,2256,6216,3095,8567
316080,202112,823,2487,647,2128,164,574,101,286,265,860
316090,202112,467,1251,369,1065,47,145,196,491,243,636
316095,202112,1396,4150,1083,3378,267,891,400,1158,667,2049
316100,202112,2621,7308,1911,5841,323,1086,720,1967,1043,3053
316105,202112,893,2225,720,1953,39,126,486,1363,525,1489
316110,202112,14836,40309,12382,36238,805,2563,8678,24972,9483,27535
316120,202112,1327,3555,871,2539,132,400,302,700,434,1100
316130,202112,1350,2965,897,2219,75,223,548,1282,623,1505
316140,202112,1322,3397,839,2486,108,335,343,1007,451,1342
316150,202112,2309,5036,1831,4331,195,555,886,1960,1081,2515
316160,202112,1083,2785,871,2404,36,114,628,1685,664,1799
316165,202112,954,2205,756,1908,112,325,454,1070,566,1395
316170,202112,1346,3157,1034,2702,48,155,740,1824,788,1979
316180,202112,1608,4382,1123,3432,176,585,279,766,455,1351
316190,202112,2889,7928,1705,5125,244,776,683,1811,927,2587
316200,202112,3663,10047,2858,8667,543,1717,1022,3016,1565,4733
316210,202112,5324,15185,3703,11383,1139,3916,225,516,1364,4432
316220,202112,705,2069,482,1604,81,306,64,249,145,555
316225,202112,1688,3721,1271,3072,43,159,977,2171,1020,2330
316230,202112,491,1281,380,1093,57,176,185,515,242,691
316240,202112,5963,16586,5197,15220,395,1195,3844,11092,4239,12287
316245,202112,3416,10307,3080,9746,104,530,2474,7494,2578,8024
316250,202112,11748,27236,8706,22388,1704,4688,3205,8124,4909,12812
316255,202112,3178,8476,2749,7799,177,443,2002,5824,2179,6267
316257,202112,1521,3498,1109,2808,84,230,737,1772,821,2002
316260,202112,2470,5755,1962,4960,223,524,1102,2823,1325,3347
316265,202112,1192,3124,935,2683,15,49,715,1993,730,2042
316270,202112,3969,11668,3403,10476,484,1560,1781,5214,2265,6774
316280,202112,3216,8540,2716,7617,329,1002,1517,4092,1846,5094
316290,202112,3919,10411,3157,8965,402,1227,1186,3225,1588,4452
316292,202112,6073,15254,4839,13281,649,1786,3028,8081,3677,9867
316294,202112,945,2688,720,2312,107,415,197,563,304,978
316295,202112,3629,9844,2960,8696,158,549,2061,5766,2219,6315
316300,202112,1082,2938,859,2591,33,101,600,1795,633,1896
316310,202112,850,2208,576,1723,138,448,125,322,263,770
316320,202112,729,1964,526,1616,104,351,133,393,237,744
316330,202112,1145,2861,876,2413,54,163,671,1806,725,1969
316340,202112,1050,2749,787,2279,90,313,439,1199,529,1512
316350,202112,1434,3837,1189,3419,165,468,745,2119,910,2587
316360,202112,693,1754,580,1569,44,121,454,1234,498,1355
316370,202112,6160,15083,4751,12675,594,1798,2398,5707,2992,7505
316380,202112,1834,4260,1446,3705,73,139,997,2569,1070,2708
316390,202112,810,2146,587,1759,247,839,81,206,328,1045
316400,202112,1294,3523,853,2650,104,339,296,818,400,1157
316410,202112,1228,3207,1028,2910,48,152,848,2333,896,2485
316420,202112,2106,5524,1827,5161,31,104,1515,4179,1546,4283
316430,202112,938,2352,651,1879,101,343,280,713,381,1056
316440,202112,921,2736,736,2395,122,454,194,557,316,1011
316443,202112,599,1605,442,1311,91,294,108,309,199,603
316447,202112,2215,5604,1917,5146,27,80,1670,4437,1697,4517
316450,202112,2287,6536,1744,5412,253,833,1015,3024,1268,3857
316460,202112,1345,3355,1091,2956,116,346,719,1842,835,2188
316470,202112,7748,21386,5671,17094,818,2750,2372,6394,3190,9144
316480,202112,215,560,187,525,44,129,93,249,137,378
316490,202112,347,920,246,735,39,123,83,206,122,329
316500,202112,1354,4011,920,3005,189,689,205,593,394,1282
316510,202112,856,2675,683,2332,116,399,345,1179,461,1578
316520,202112,1460,3426,1134,2891,145,436,568,1301,713,1737
316530,202112,1219,3099,891,2514,96,334,445,1133,541,1467
316540,202112,1049,2567,855,2285,97,275,468,1146,565,1421
316550,202112,1480,4074,1252,3665,31,114,998,2891,1029,3005
316553,202112,4871,13713,3538,10612,445,1446,1518,3979,1963,5425
316555,202112,2822,8196,2520,7783,75,235,2130,6582,2205,6817
316556,202112,562,1330,434,1105,27,72,272,615,299,687
316557,202112,1189,3462,1023,3205,337,1162,365,1072,702,2234
316560,202112,366,992,268,846,44,152,115,342,159,494
316570,202112,1503,4080,1255,3649,305,875,405,1259,710,2134
316580,202112,421,865,268,622,41,99,137,300,178,399
316590,202112,1431,3504,991,2672,184,417,505,1334,689,1751
316600,202112,1017,2954,869,2665,135,425,471,1436,606,1861
316610,202112,648,1911,533,1731,51,183,321,1007,372,1190
316620,202112,2358,5791,2061,5364,101,267,1651,4278,1752,4545
316630,202112,1667,4787,1384,4262,381,1183,499,1728,880,2911
316640,202112,166,446,135,399,25,87,55,131,80,218
316650,202112,1146,3349,927,3010,81,270,603,1939,684,2209
316660,202112,204,473,91,246,12,37,23,41,35,78
316670,202112,1869,4577,1421,3876,380,1077,412,1088,792,2165
316680,202112,2456,6128,1827,4950,124,373,1306,3403,1430,3776
316690,202112,1513,4111,1137,3432,184,598,479,1394,663,1992
316695,202112,1077,3027,893,2700,29,95,608,1813,637,1908
316700,202112,439,938,362,851,11,32,305,695,316,727
316710,202112,3530,10797,2777,9263,430,1560,1345,4307,1775,5867
316720,202112,22707,59633,17015,48896,2706,8276,7676,20627,10382,28903
316730,202112,531,1311,429,1134,48,132,220,541,268,673
316740,202112,841,2317,729,2142,87,286,466,1373,553,1659
316750,202112,435,1205,332,1023,69,222,136,400,205,622
316760,202112,3841,11607,3258,10498,1164,4117,975,3045,2139,7162
316770,202112,1727,3710,1313,3165,34,77,1063,2621,1097,2698
316780,202112,599,1702,474,1464,179,589,93,269,272,858
316790,202112,776,2036,569,1624,79,251,151,400,230,651
316800,202112,6973,18780,5562,16237,723,2206,2613,7438,3336,9644
316805,202112,1178,2426,954,2176,52,139,772,1737,824,1876
316810,202112,680,1810,500,1477,70,225,305,867,375,1092
316820,202112,352,811,195,537,18,64,96,247,114,311
316830,202112,901,2235,707,1925,77,209,431,1171,508,1380
316840,202112,3047,7462,2429,6454,177,564,1773,4493,1950,5057
316850,202112,2184,5374,1628,4434,200,619,869,2183,1069,2802
316860,202112,22259,54451,16453,45669,2371,7575,7816,20752,10187,28327
316870,202112,8980,23174,6783,19048,862,2661,3345,8660,4207,11321
316880,202112,1065,2741,880,2472,135,432,480,1279,615,1711
316890,202112,1239,2719,755,2082,84,299,484,1254,568,1553
316900,202112,2570,6608,2041,5609,416,1184,698,1808,1114,2992
316905,202112,536,1548,432,1343,105,353,184,583,289,936
316910,202112,1002,2505,636,1872,139,445,100,262,239,707
316920,202112,1955,4554,1409,3757,185,543,800,2028,985,2571
316930,202112,9106,24796,6981,21044,1542,4847,2212,6196,3754,11043
316935,202112,4578,11841,3393,9670,564,1788,1424,3701,1988,5489
316940,202112,6912,19531,5409,16508,747,2473,2421,6821,3168,9294
316950,202112,2070,4644,1609,4016,45,126,1356,3340,1401,3466
316960,202112,5512,11954,3988,9917,355,952,2766,6721,3121,7673
316970,202112,4263,11263,3650,10186,543,1508,1613,4258,2156,5766
316980,202112,769,2228,593,1898,170,613,107,329,277,942
316990,202112,13577,35169,10106,28248,2242,6744,1749,4439,3991,11183
317000,202112,2681,7490,2365,7046,229,509,1738,5312,1967,5821
317005,202112,2787,7445,2199,6265,344,1020,1171,3231,1515,4251
317010,202112,26548,61052,16981,46371,2979,9044,7079,19215,10058,28259
317020,202112,70198,163883,42617,116023,7562,22341,14360,35702,21922,58043
317030,202112,731,1855,578,1645,15,51,447,1249,462,1300
317040,202112,12060,29407,8473,23334,1842,5395,2833,8088,4675,13483
317043,202112,961,2057,694,1692,50,128,512,1217,562,1345
317047,202112,1239,2894,859,2285,57,157,570,1460,627,1617
317050,202112,1302,3886,932,3041,121,441,373,1033,494,1474
317052,202112,2607,6834,2094,6036,247,689,1354,3901,1601,4590
317057,202112,2153,4694,1598,3862,22,74,1186,2774,1208,2848
317060,202112,565,1460,349,1020,49,157,143,369,192,526
317065,202112,1206,3443,989,3028,64,171,618,1802,682,1973
317070,202112,7934,21559,5823,17482,906,3031,2115,5852,3021,8883
317075,202112,1060,2639,800,2201,97,304,428,1098,525,1402
317080,202112,6858,15428,5116,12678,1242,3299,1895,4560,3137,7859
317090,202112,5169,14151,4568,13200,394,936,3304,9704,3698,10640
317100,202112,2788,6470,1839,4932,416,1134,667,1777,1083,2911
317103,202112,2431,5993,2077,5499,63,267,1683,4286,1746,4553
317107,202112,1597,4030,1215,3336,61,183,770,1909,831,2092
317110,202112,699,1605,370,1084,71,245,118,340,189,585
317115,202112,1173,3243,987,2903,89,254,619,1814,708,2068
317120,202112,18603,47659,15256,42236,1068,3509,10057,26298,11125,29807
317130,202112,12495,28210,8290,21347,1223,3434,3052,7721,4275,11155
317140,202112,1016,2331,799,1999,49,135,552,1401,601,1536
317150,202112,1046,2429,807,2129,31,89,649,1675,680,1764
317160,202112,3865,8915,2570,6884,132,351,1391,3860,1523,4211
317170,202112,2056,4991,1540,4069,182,533,851,2014,1033,2547
317180,202112,2116,6308,1549,4973,298,961,400,1158,698,2119
317190,202112,1253,3296,927,2764,207,613,414,1225,621,1838
317200,202112,6672,17035,4970,13697,976,2861,1343,3322,2319,6183
317210,202112,1294,3031,996,2622,35,128,728,1931,763,2059
317220,202112,314,904,269,819,53,171,134,398,187,569
320010,202112,5057,14259,3926,11963,436,1463,2340,6866,2776,8329
320013,202112,2279,5951,1585,4601,242,714,699,2139,941,2853
320016,202112,3167,7858,2479,6803,215,560,1748,4829,1963,5389
320020,202112,4576,11495,3401,9460,604,1854,1406,3931,2010,5785
320030,202112,1883,5074,1215,3743,212,704,417,1216,629,1920
320035,202112,2100,5455,1722,4823,384,1208,834,2213,1218,3421
320040,202112,4762,13025,3953,11560,539,1632,2193,6132,2732,7764
320050,202112,1898,4246,1634,3858,225,586,933,2121,1158,2707
320060,202112,15226,40034,11290,32081,1779,5363,5112,13349,6891,18712
320070,202112,1868,4917,1338,3881,199,645,558,1431,757,2076
320080,202112,6166,15373,4326,11716,853,2421,1596,4036,2449,6457
320090,202112,9322,23990,6183,17605,1380,4168,2189,5722,3569,9890
320100,202112,3457,8989,2812,7874,433,1287,1485,4142,1918,5429
320110,202112,2342,5302,1645,4210,222,586,885,2148,1107,2734
320115,202112,2331,6979,2000,6433,823,2765,610,2071,1433,4836
320120,202112,27446,67607,19402,53261,2606,7646,9394,24097,12000,31743
320130,202112,56647,148907,46440,130492,5478,16650,27745,74744,33223,91394
320140,202112,4106,10904,2815,8357,399,1366,1214,3440,1613,4806
320150,202112,15701,39204,11205,30845,2588,7844,1489,3599,4077,11443
320160,202112,6960,18574,5145,15147,785,2488,2259,6462,3044,8950
320170,202112,1950,5402,1387,4282,374,1141,468,1572,842,2713
320180,202112,785,2382,626,2073,199,719,149,444,348,1163
320190,202112,3225,9916,2487,8299,585,2124,550,1634,1135,3758
320200,202112,1445,3829,984,3004,219,742,281,834,500,1576
320210,202112,4873,12052,3731,10101,593,1730,1903,4830,2496,6560
320220,202112,3644,9099,2816,7737,420,1225,1469,3819,1889,5044
320225,202112,1528,4565,1048,3455,357,1255,211,675,568,1930
320230,202112,5811,15248,4383,12849,960,2968,1467,4246,2427,7214
320240,202112,18705,45759,13917,38113,3447,10211,3829,10329,7276,20540
320245,202112,3468,9839,2604,8018,815,2669,387,1134,1202,3803
320250,202112,2929,7632,1983,5506,427,1349,692,1623,1119,2972
320255,202112,2167,6415,1870,5870,497,1650,846,2673,1343,4323
320260,202112,1587,4334,983,3018,193,652,247,623,440,1275
320265,202112,2592,7739,2052,6642,819,2882,261,794,1080,3676
320270,202112,2451,6789,1891,5665,460,1502,594,1763,1054,3265
320280,202112,8415,21354,6830,18684,1474,4133,3388,9003,4862,13136
320290,202112,1491,4298,955,3033,225,785,222,643,447,1428
320300,202112,4548,12874,3627,11031,923,3102,1160,3291,2083,6393
320305,202112,5728,15516,4362,12824,807,2535,1998,5667,2805,8202
320310,202112,2479,6513,1728,4968,308,968,741,1986,1049,2954
320313,202112,2736,6542,1863,4955,358,1038,517,1182,875,2220
320316,202112,1786,4781,1355,4044,237,720,671,2007,908,2727
320320,202112,24757,62571,17506,49919,4145,12182,5907,16874,10052,29056
320330,202112,3127,8198,2413,6924,408,1229,1256,3613,1664,4842
320332,202112,9126,23607,7205,20055,1516,4583,3102,8288,4618,12871
320334,202112,2022,5522,1381,4176,259,928,322,715,581,1643
320335,202112,1726,4885,1196,3670,226,818,342,942,568,1760
320340,202112,5586,13238,4628,11847,553,1484,2695,6942,3248,8426
320350,202112,5906,13997,4161,10925,433,1263,2294,5587,2727,6850
320360,202112,1548,3850,1145,3106,139,373,543,1429,682,1802
320370,202112,2944,8609,2166,6937,594,2038,640,1972,1234,4010
320380,202112,3002,7593,2479,6743,291,878,1508,3948,1799,4826
320390,202112,8353,21454,6095,16990,1242,3734,2338,6061,3580,9795
320400,202112,3618,9875,2664,7840,728,2302,801,2195,1529,4497
320405,202112,5761,14389,4351,11909,600,1762,2293,6032,2893,7794
320410,202112,5317,13231,4011,11118,778,2071,1832,5327,2610,7398
320420,202112,3941,9658,3006,8098,597,1761,1003,2541,1600,4302
320425,202112,2375,5539,1811,4587,160,404,1108,2747,1268,3151
320430,202112,3559,8700,2798,7364,419,1176,1623,4080,2042,5256
320435,202112,2428,7321,1881,6171,622,2206,585,1906,1207,4112
320440,202112,1691,4535,1252,3697,213,658,530,1471,743,2129
320450,202112,2058,5627,1603,4769,294,1011,745,2023,1039,3034
320455,202112,4937,14494,3294,10650,733,2608,796,2243,1529,4851
320460,202112,2333,6629,1674,5257,411,1417,429,1219,840,2636
320465,202112,1569,4221,1153,3429,237,712,528,1579,765,2291
320470,202112,4181,10997,3052,8667,593,1819,890,2271,1483,4090
320480,202112,2238,5509,1814,4800,202,579,1184,3013,1386,3592
320490,202112,26535,64893,19895,53449,3330,9244,8645,22973,11975,32217
320495,202112,1536,4075,1119,3251,265,882,282,735,547,1617
320500,202112,60263,154659,48279,134179,6274,18962,28429,75002,34703,93964
320501,202112,5232,14662,3916,12250,1058,3686,1072,3281,2130,6967
320503,202112,2561,7146,1638,5218,488,1661,366,1110,854,2771
320506,202112,2977,8676,2182,6911,631,2151,175,549,806,2700
320510,202112,12363,31849,10046,27935,1032,3229,6300,16614,7332,19843
320515,202112,1949,5246,1507,4346,388,1237,478,1299,866,2536
320517,202112,2391,6884,1909,5866,558,1850,597,1784,1155,3634
320520,202112,43526,108462,32539,89778,5023,15269,14355,37511,19378,52780
320530,202112,37951,95767,29933,81684,2438,7730,19037,48564,21475,56294
330010,202112,26882,66705,22389,59488,2290,6742,15752,40295,18042,47037
330015,202112,1562,3671,1246,3217,198,576,728,1773,926,2349
330020,202112,21536,52127,18105,47210,2535,7112,12363,31662,14898,38774
330022,202112,2122,5514,1662,4765,278,802,837,2406,1115,3208
330023,202112,6323,14237,4882,12269,647,1795,3072,7441,3719,9236
330025,202112,7839,17399,4864,12571,946,2721,1402,3302,2348,6023
330030,202112,11448,29214,8850,25102,742,2497,5776,15480,6518,17977
330040,202112,17370,43246,14089,37848,919,2864,10071,25743,10990,28607
330045,202112,97111,217504,80809,197026,5951,14062,65101,157708,71052,171770
330050,202112,3099,7785,2376,6597,423,1286,1257,3271,1680,4557
330060,202112,6139,15183,4801,12858,885,2588,2016,4898,2901,7486
330070,202112,27608,65494,22615,58464,3004,8386,14264,36221,17268,44607
330080,202112,10249,24208,8739,22106,1057,2819,5882,14689,6939,17508
330090,202112,3670,7456,2618,6029,148,360,1877,4309,2025,4669
330093,202112,3040,7007,2287,5989,131,357,1743,4502,1874,4859
330095,202112,1575,4133,1213,3477,131,382,687,1856,818,2238
330100,202112,79915,200127,68705,183900,3390,10608,54053,141909,57443,152517
330110,202112,2342,6190,1873,5447,252,776,1138,3198,1390,3974
330115,202112,2979,6838,2115,5493,329,914,1111,2768,1440,3682
330120,202112,3940,8203,3007,7035,192,522,2267,5071,2459,5593
330130,202112,4770,12307,3906,11034,477,1386,2535,7067,3012,8453
330140,202112,4275,10338,3452,9193,336,1052,2462,6302,2798,7354
330150,202112,2673,6700,2110,5817,362,1001,1097,2928,1459,3929
330160,202112,1553,4042,1171,3364,246,733,584,1598,830,2331
330170,202112,131993,307191,107898,274891,14904,36902,73294,188323,88198,225225
330180,202112,2218,5038,1726,4371,87,255,1259,3078,1346,3333
330185,202112,11527,27050,9674,24524,487,1490,7955,19620,8442,21110
330187,202112,5452,12884,4334,11075,668,1730,2545,6405,3213,8135
330190,202112,42456,95244,36262,86804,2118,5497,29429,69122,31547,74619
330200,202112,18510,44399,15185,40275,2861,7042,9565,26248,12426,33290
330205,202112,2484,5901,1881,4915,141,390,1266,3172,1407,3562
330210,202112,3696,8703,2738,7088,355,944,1421,3495,1776,4439
330220,202112,14395,33873,10424,27306,1842,5404,4300,10299,6142,15703
330225,202112,4367,10497,3353,8981,199,643,2440,6363,2639,7006
330227,202112,19582,44744,16519,41032,702,1714,14177,34875,14879,36589
330230,202112,2308,4929,1531,3937,148,404,822,2088,970,2492
330240,202112,27032,66439,22648,59804,2013,6081,16369,41814,18382,47895
330245,202112,1897,4523,1163,3259,250,674,409,1148,659,1822
330250,202112,45002,108063,37298,96784,5445,14654,24080,61574,29525,76228
330260,202112,5593,12727,4282,10954,294,880,3257,8021,3551,8901
330270,202112,36563,81115,22480,57800,3169,8791,9709,23410,12878,32201
330280,202112,2723,6645,2090,5599,220,643,1302,3300,1522,3943
330285,202112,29174,65619,23308,57257,1297,3717,18170,43090,19467,46807
330290,202112,4629,10539,3743,9374,322,964,2816,6728,3138,7692
330300,202112,6390,14329,4741,12026,349,979,3366,8257,3715,9236
330310,202112,3000,6972,2192,5670,167,356,1488,3830,1655,4186
330320,202112,19377,43072,15101,37722,1861,4093,10735,27346,12596,31439
330330,202112,49198,102556,38597,88257,3090,7666,28208,62622,31298,70288
330340,202112,20282,46099,14699,37524,2077,6056,7740,18220,9817,24276
330350,202112,166422,364064,138562,330320,7532,18637,116864,275645,124396,294282
330360,202112,8089,18820,6922,17400,277,626,5823,14641,6100,15267
330370,202112,5639,15245,4378,13128,1012,2997,1856,5730,2868,8727
330380,202112,6532,16256,5010,13607,602,2001,3003,7625,3605,9626
330385,202112,4486,12079,3672,10913,729,2393,1903,5454,2632,7847
330390,202112,31194,78871,24226,67337,2905,9276,14984,38950,17889,48226
330395,202112,3595,8388,2930,7552,148,447,2230,5589,2378,6036
330400,202112,3836,9587,3273,8701,148,514,2510,6283,2658,6797
330410,202112,3802,9403,2751,7635,496,1503,1351,3478,1847,4981
330411,202112,3164,8248,2469,6999,163,535,1726,4656,1889,5191
330412,202112,1830,4876,1502,4334,134,424,998,2721,1132,3145
330414,202112,26443,63667,21633,57104,1426,4037,16655,43081,18081,47118
330415,202112,5398,13752,3993,11287,431,1258,2263,6173,2694,7431
330420,202112,14105,33633,10231,27419,1054,3228,5774,14307,6828,17535
330430,202112,10958,24713,9272,22452,286,875,7653,17964,7939,18839
330440,202112,3158,7868,2416,6636,283,897,1515,3973,1798,4870
330450,202112,1588,4253,1267,3710,142,433,734,2087,876,2520
330452,202112,20204,48842,16177,42650,1797,5280,10732,27176,12529,32456
330455,202112,653733,1467108,518718,1276460,64563,167973,350266,841289,414829,1009262
330460,202112,1286,3334,975,2890,172,538,513,1484,685,2022
330470,202112,6124,14327,4423,11733,1200,3306,1343,3568,2543,6874
330475,202112,10731,26078,8680,23449,1234,3844,5660,14725,6894,18569
330480,202112,6515,16078,5474,14564,463,1303,3778,9726,4241,11029
330490,202112,125145,276106,101748,244691,11179,27485,72651,172554,83830,200039
330500,202112,8776,20317,7321,18362,652,1795,5378,13195,6030,14990
330510,202112,46740,109778,35296,93776,5046,14436,22498,58512,27544,72948
330513,202112,1445,3490,1182,3148,218,594,654,1783,872,2377
330515,202112,2824,7232,2293,6484,371,1166,1338,3606,1709,4772
330520,202112,13429,33336,11103,29794,1131,3422,7436,19206,8567,22628
330530,202112,1868,4340,1372,3613,246,702,655,1711,901,2413
330540,202112,3212,8064,2467,6812,631,1763,903,2490,1534,4253
330550,202112,11477,26706,8931,23389,1960,5686,4457,11443,6417,17129
330555,202112,21107,42022,17579,37908,724,1660,14858,32254,15582,33914
330560,202112,4515,11297,3636,9871,580,1548,2169,5762,2749,7310
330570,202112,3051,7854,2626,7242,449,1333,1664,4534,2113,5867
330575,202112,6335,15458,5460,13999,345,961,4408,10942,4753,11903
330580,202112,21462,53859,17135,46174,2469,7258,9375,23665,11844,30923
330590,202112,1633,4160,1360,3806,256,710,827,2381,1083,3091
330600,202112,14109,35062,11443,30778,872,2714,7644,19763,8516,22477
330610,202112,10695,26975,8639,23766,826,2488,5767,15463,6593,17951
330615,202112,2344,6045,1862,5388,367,1031,1136,3388,1503,4419
330620,202112,4643,12460,3638,10755,729,2297,1563,4370,2292,6667
330630,202112,29313,70014,23082,60308,1289,4006,16813,42026,18102,46032
350010,202112,2353,6101,1358,3992,276,870,280,619,556,1489
350020,202112,767,1910,445,1302,52,156,148,402,200,558
350030,202112,3883,10391,2983,8864,662,2199,1416,3843,2078,6042
350040,202112,823,2284,479,1549,64,242,146,353,210,595
350050,202112,1569,3721,1051,2841,209,640,372,809,581,1449
350055,202112,1002,2560,798,2242,105,311,455,1218,560,1529
350060,202112,263,651,148,413,20,67,60,151,80,218
350070,202112,3545,9151,2345,6976,448,1448,825,2165,1273,3613
350075,202112,667,1846,501,1530,172,553,75,238,247,791
350080,202112,722,1844,493,1449,62,210,204,538,266,748
350090,202112,640,1473,393,1060,71,197,162,411,233,608
350100,202112,2676,6809,1879,5451,111,405,1204,3244,1315,3649
350110,202112,536,1299,379,1032,19,56,240,634,259,690
350115,202112,1318,3699,1066,3185,173,583,539,1440,712,2023
350120,202112,700,1611,396,1076,33,106,215,518,248,624
350130,202112,3523,9071,2749,7624,511,1417,1315,3408,1826,4825
350140,202112,826,2210,583,1757,47,180,317,858,364,1038
350150,202112,567,1657,457,1447,100,314,131,384,231,698
350160,202112,12743,31795,8728,24265,1119,3487,5115,13359,6234,16846
350170,202112,2703,7344,2248,6369,330,1048,1195,3047,1525,4095
350180,202112,1105,2599,622,1726,74,229,263,662,337,891
350190,202112,3279,9119,2223,6749,363,1272,976,2482,1339,3754
350200,202112,496,1348,379,1127,18,55,252,700,270,755
350210,202112,6585,14918,4548,11726,465,1331,2881,7039,3346,8370
350220,202112,3205,8567,2200,6596,448,1371,734,2002,1182,3373
350230,202112,1094,2693,906,2432,166,484,514,1312,680,1796
350240,202112,684,1919,439,1349,94,295,105,276,199,571
350250,202112,3581,9535,2642,7961,656,2103,810,2347,1466,4450
350260,202112,923,2067,597,1542,65,184,356,863,421,1047
350270,202112,5042,12884,4007,10967,537,1638,2213,5545,2750,7183
350275,202112,2736,7092,2194,6280,286,907,1413,3852,1699,4759
350280,202112,20192,45181,12566,32803,1936,5252,5355,13239,7291,18491
350290,202112,3416,9205,2353,7048,423,1350,952,2635,1375,3985
350300,202112,719,1859,537,1523,59,174,317,836,376,1010
350310,202112,1042,2841,780,2336,115,394,352,958,467,1352
350315,202112,649,1573,442,1236,28,90,240,606,268,696
350320,202112,17333,43353,12870,35471,2370,7204,5409,13680,7779,20884
350330,202112,15276,36427,11084,28670,1070,3081,7158,17392,8228,20473
350335,202112,417,1140,320,954,41,133,147,416,188,549
350340,202112,1315,3279,810,2357,117,401,357,921,474,1322
350350,202112,805,1949,622,1750,68,220,386,1066,454,1286
350360,202112,1156,3340,888,2798,194,629,330,1037,524,1666
350370,202112,749,1806,528,1390,169,431,162,408,331,839
350380,202112,4965,13291,3573,10393,1010,2884,963,2837,1973,5721
350390,202112,12048,30359,9491,26094,1534,4494,5095,13284,6629,17778
350395,202112,478,1180,248,736,28,83,92,246,120,329
350400,202112,9140,21741,6421,17355,1603,4628,1722,4573,3325,9201
350410,202112,11305,30556,8404,25058,1623,5299,3341,9164,4964,14463
350420,202112,943,2427,630,1787,90,268,170,408,260,676
350430,202112,752,1916,592,1675,70,228,359,929,429,1157
350440,202112,2266,5472,1841,4834,161,413,1199,3066,1360,3479
350450,202112,7101,19125,5486,16324,1142,3721,2226,6158,3368,9879
350460,202112,2095,5286,1220,3546,169,519,466,1217,635,1736
350470,202112,279,687,219,584,12,37,159,408,171,445
350480,202112,1082,2591,724,1994,142,448,189,430,331,878
350490,202112,2140,5386,1524,4394,323,979,513,1303,836,2282
350500,202112,698,1840,509,1504,53,171,226,626,279,797
350510,202112,1311,3233,996,2687,103,314,602,1531,705,1845
350520,202112,2478,7109,1939,6091,272,960,861,2420,1133,3380
350530,202112,3239,7994,2437,6458,229,688,1455,3563,1684,4251
350535,202112,1633,4275,1383,3910,203,605,823,2271,1026,2876
350540,202112,2147,4833,1612,4068,168,430,1072,2593,1240,3023
350550,202112,9162,22105,6371,17448,642,2105,3703,9242,4345,11347
350560,202112,4135,11132,3317,9755,264,857,2214,6241,2478,7098
350570,202112,28871,77474,23552,67581,3958,12473,12255,33396,16213,45869
350580,202112,2295,5928,1437,4207,367,1143,314,779,681,1922
350590,202112,5385,14128,3952,10986,499,1566,2338,5978,2837,7544
350600,202112,37520,85395,23624,61589,3420,10041,11018,26117,14438,36158
350610,202112,7727,20347,5495,16005,792,2578,2778,7497,3570,10075
350620,202112,466,1161,283,862,27,87,156,438,183,525
350630,202112,1702,4075,1255,3317,78,256,840,2041,918,2297
350635,202112,10838,25485,8077,21147,980,2836,5071,12614,6051,15450
350640,202112,1001,2637,542,1641,83,233,152,392,235,625
350650,202112,9468,24453,6569,18836,1153,3566,2644,6989,3797,10555
350660,202112,5049,12625,3912,10769,638,1669,2136,5896,2774,7565
350670,202112,1869,4928,1520,4415,199,584,943,2749,1142,3333
350680,202112,1204,3168,820,2470,141,428,329,949,470,1377
350690,202112,1417,3563,1009,2870,145,458,540,1476,685,1934
350700,202112,5294,12979,3938,10869,848,2595,1800,4722,2648,7317
350710,202112,3180,8332,2683,7463,467,1476,1405,3583,1872,5059
350715,202112,832,2301,703,2086,119,396,350,928,469,1324
350720,202112,173,435,127,362,17,46,47,116,64,162
350730,202112,661,1770,550,1572,27,90,400,1080,427,1170
350740,202112,1888,4802,1309,3675,231,703,478,1196,709,1899
350745,202112,652,1608,375,1100,27,105,172,448,199,553
350750,202112,11230,28642,8800,24416,1496,4794,4218,10467,5714,15261
350760,202112,16790,40387,12315,32732,2254,6697,5700,13481,7954,20178
350770,202112,1161,2774,700,1974,49,148,425,1152,474,1300
350775,202112,771,1728,535,1383,70,171,270,702,340,873
350780,202112,2602,6106,1889,5091,378,1172,592,1885,970,3057
350790,202112,2286,5940,1455,4369,272,825,403,1011,675,1836
350800,202112,3876,10698,3302,9710,273,877,2294,6518,2567,7395
350810,202112,3173,7397,2428,6318,461,1115,1094,2875,1555,3990
350820,202112,1014,2321,589,1574,79,245,277,663,356,908
350830,202112,935,2509,534,1643,81,257,157,391,238,648
350840,202112,3680,10505,2824,8922,585,2074,1232,3534,1817,5608
350850,202112,8838,23444,6980,20088,1319,4061,3532,9498,4851,13559
350860,202112,3944,10090,3394,9340,107,377,2665,7250,2772,7627
350870,202112,2895,7742,2170,6581,251,851,1294,3781,1545,4632
350880,202112,1492,4074,1187,3483,295,924,288,805,583,1729
350890,202112,561,1443,359,1026,50,153,129,316,179,469
350900,202112,9216,23847,6245,17722,1094,3327,2703,6971,3797,10298
350910,202112,1005,2341,854,2121,93,242,625,1520,718,1762
350920,202112,13255,31741,11216,28478,406,1260,9317,22762,9723,24022
350925,202112,4446,11688,3180,9479,563,1857,1543,4190,2106,6047
350930,202112,1588,4072,1120,3173,72,220,681,1871,753,2091
350940,202112,2472,6249,1919,5355,187,584,1224,3219,1411,3803
350945,202112,960,2619,742,2204,119,368,366,1003,485,1371
350950,202112,100176,249333,77473,207257,9556,27733,48083,122331,57639,150064
350960,202112,6923,18273,5365,15360,690,2220,3105,8406,3795,10626
350970,202112,3783,10258,2720,8303,754,2538,645,1647,1399,4185
350980,202112,710,1857,569,1596,136,399,259,716,395,1115
350990,202112,2045,5393,1544,4588,330,1084,550,1546,880,2630
350995,202112,909,2707,822,2535,60,218,577,1698,637,1916
351000,202112,3144,8134,2124,6178,471,1403,633,1802,1104,3205
351010,202112,414,992,261,732,35,112,116,303,151,415
351015,202112,983,2847,810,2488,121,389,374,1030,495,1419
351020,202112,9326,24556,7059,20713,1668,4783,3034,8745,4702,13528
351030,202112,3115,8922,2489,7691,350,1161,1376,4104,1726,5265
351040,202112,5501,13246,4604,11900,227,677,3783,9504,4010,10181
351050,202112,18507,43791,13641,36391,2489,7030,6538,17024,9027,24054
351060,202112,53792,130986,41420,110134,3904,11525,28290,72202,32194,83727
351070,202112,1478,3578,841,2507,208,658,117,340,325,998
351080,202112,2949,6931,2142,5961,233,753,1407,3713,1640,4466
351090,202112,349,965,261,807,48,148,77,234,125,382
351100,202112,2973,7778,1954,5771,397,1238,559,1634,956,2872
351110,202112,6713,16751,4524,12786,700,2201,2086,5490,2786,7691
351120,202112,790,2051,559,1646,80,262,201,547,281,809
351130,202112,1218,3105,572,1710,101,320,143,373,244,693
351140,202112,2438,6582,1828,5446,376,1260,798,2072,1174,3332
351150,202112,3098,8594,2109,6481,274,929,789,2166,1063,3095
351160,202112,1210,3617,877,2853,155,567,204,515,359,1082
351170,202112,1484,3954,1274,3593,129,409,863,2309,992,2718
351190,202112,1090,2962,749,2289,142,435,250,720,392,1155
351200,202112,1729,4013,1300,3408,92,277,931,2292,1023,2569
351210,202112,1691,4050,1081,2934,76,249,636,1564,712,1813
351220,202112,3700,9887,3173,9034,301,862,2183,6085,2484,6947
351230,202112,2080,5374,1578,4502,285,913,784,2014,1069,2927
351240,202112,2608,6503,1618,4477,388,1142,503,1237,891,2379
351250,202112,1182,3043,704,2086,61,189,271,793,332,982
351260,202112,984,2384,718,1910,163,451,233,573,396,1024
351270,202112,561,1478,388,1128,43,140,184,453,227,593
351280,202112,4254,10848,3257,8996,654,1820,1318,3547,1972,5367
351290,202112,1379,3337,981,2648,123,372,616,1577,739,1949
351300,202112,21276,55452,14993,43637,2522,7890,6846,18765,9368,26655
351310,202112,3787,9013,2896,7634,139,462,2166,5419,2305,5881
351320,202112,998,2813,717,2248,121,399,217,595,338,994
351330,202112,513,1244,413,1054,23,78,284,633,307,711
351340,202112,7090,19054,5754,16683,1460,4221,2515,7314,3975,11535
351350,202112,13142,31812,10879,28208,916,2557,8124,20328,9040,22885
351360,202112,4166,10702,3430,9618,678,2107,1550,3964,2228,6071
351370,202112,2224,6010,1476,4451,323,1053,404,1084,727,2137
351380,202112,50966,119669,36114,94210,4119,11563,21628,53589,25747,65152
351385,202112,438,1098,179,540,27,78,58,150,85,228
351390,202112,1429,3398,896,2618,114,384,528,1453,642,1837
351400,202112,1076,2863,884,2489,112,310,571,1551,683,1861
351410,202112,2872,7698,2053,6104,347,1030,798,2295,1145,3325
351420,202112,538,1280,308,866,39,107,180,469,219,576
351430,202112,1050,2710,844,2373,58,159,608,1660,666,1819
351440,202112,3726,9555,2486,7054,447,1354,694,1662,1141,3016
351450,202112,1860,4800,1245,3679,243,811,252,534,495,1345
351460,202112,976,2441,777,2136,156,431,439,1192,595,1623
351470,202112,1307,3208,1035,2761,78,262,699,1740,777,2002
351480,202112,2667,7519,2074,6536,366,1266,916,2652,1282,3918
351490,202112,2206,6011,1907,5483,63,256,1570,4355,1633,4611
351492,202112,380,997,324,880,7,21,250,660,257,681
351495,202112,216,542,169,456,14,34,106,282,120,316
351500,202112,43620,103022,33408,86315,4703,12637,20558,50880,25261,63517
351510,202112,13806,32925,10125,26803,1104,3365,6479,16278,7583,19643
351512,202112,523,1365,382,1061,71,203,130,332,201,535
351515,202112,3557,7910,2204,5731,397,1165,578,1541,975,2706
351518,202112,2733,6684,1818,5088,234,740,948,2320,1182,3060
351519,202112,681,1815,417,1301,72,229,69,186,141,415
351520,202112,1378,3369,614,1816,56,185,296,789,352,974
351530,202112,380,972,223,643,39,122,98,231,137,353
351535,202112,1943,4666,1388,3712,211,609,691,1739,902,2348
351540,202112,2882,6940,1940,5279,209,666,899,2135,1108,2801
351550,202112,7923,19237,5429,14767,526,1631,3070,7669,3596,9300
351560,202112,502,1393,392,1176,88,287,107,296,195,583
351565,202112,277,755,217,646,39,125,57,136,96,261
351570,202112,23857,61138,18311,50316,1712,5110,11798,30984,13510,36094
351580,202112,243,608,139,421,16,42,63,195,79,237
351590,202112,542,1214,281,751,25,90,163,396,188,486
351600,202112,1445,3810,1115,3176,137,426,594,1573,731,1999
351610,202112,802,1859,502,1334,31,84,288,720,319,804
351620,202112,25594,65704,18700,54060,2808,9239,8814,22992,11622,32231
351630,202112,31141,78167,25079,68054,2941,8688,16550,42883,19491,51571
351640,202112,19388,48631,15234,41351,1335,4242,10509,26978,11844,31220
351650,202112,396,1049,196,614,26,82,53,148,79,230
351660,202112,774,2091,504,1530,76,236,103,260,179,496
351670,202112,6663,17369,4377,12468,940,2614,1724,4596,2664,7210
351680,202112,467,1260,317,937,44,140,79,182,123,322
351685,202112,448,1244,367,1115,99,293,123,352,222,645
351690,202112,1259,3103,709,2033,92,311,317,818,409,1129
351700,202112,1429,3466,1051,2831,221,603,496,1254,717,1857
351710,202112,841,2164,625,1764,55,181,362,926,417,1107
351720,202112,1611,4046,1082,3116,171,524,464,1226,635,1750
351730,202112,1035,2621,852,2341,73,218,515,1346,588,1564
351740,202112,3673,8992,2935,7608,499,1406,1509,3533,2008,4939
351750,202112,1717,4281,1018,3032,170,546,426,1185,596,1731
351760,202112,3580,9645,2680,7938,516,1732,1133,3005,1649,4737
351770,202112,2039,5656,1652,4936,262,846,966,2751,1228,3597
351780,202112,1287,3187,772,2242,103,358,318,846,421,1204
351790,202112,1489,3505,1180,3077,191,518,689,1791,880,2309
351800,202112,554,1246,281,739,35,101,116,250,151,351
351810,202112,1165,3000,967,2705,94,232,629,1686,723,1918
351820,202112,2999,8074,2159,6450,513,1688,554,1466,1067,3154
351830,202112,4882,12589,3706,10545,327,1041,2339,6298,2666,7339
351840,202112,9745,25678,7389,21395,874,2879,4233,11294,5107,14173
351850,202112,1642,4403,1078,3280,150,520,385,959,535,1479
351860,202112,2879,8015,2203,6777,343,1159,1208,3675,1551,4834
351870,202112,26496,65301,19851,54408,4622,13122,8019,22072,12641,35194
351880,202112,153361,378171,116464,315709,21534,64943,61787,157316,83321,222259
351885,202112,1026,2627,805,2268,52,177,558,1498,610,1675
351890,202112,935,2383,602,1827,113,367,124,315,237,682
351900,202112,1273,3258,967,2800,124,337,581,1671,705,2008
351905,202112,494,1347,351,1066,30,102,179,481,209,583
351907,202112,23385,59537,18307,50658,1922,6009,11937,31334,13859,37343
351910,202112,1821,4555,1296,3459,105,314,769,1833,874,2147
351920,202112,958,2521,724,2057,114,359,306,776,420,1135
351925,202112,975,2494,751,2098,93,303,410,1045,503,1348
351930,202112,3516,9511,3149,8838,506,1470,2207,6072,2713,7542
351940,202112,1149,2908,836,2356,131,399,403,1115,534,1514
351950,202112,1839,4001,1402,3376,67,187,1020,2355,1087,2542
351960,202112,5532,13573,4064,11002,935,2676,1716,4358,2651,7034
351970,202112,8541,23752,6824,20816,1026,3560,3850,11167,4876,14727
351980,202112,1116,2603,730,1964,101,318,414,995,515,1313
351990,202112,1601,3693,1179,3064,47,169,615,1395,662,1564
352000,202112,2899,7957,2499,7139,262,837,1663,4443,1925,5280
352010,202112,2539,6450,2057,5666,522,1604,445,1254,967,2858
352020,202112,1553,4085,1196,3469,173,576,566,1512,739,2088
352030,202112,6405,16253,5031,14009,808,2442,2740,7280,3548,9722
352040,202112,4336,10697,3052,8236,494,1452,1083,2575,1577,4027
352042,202112,3568,8341,2424,6531,366,1119,1288,3303,1654,4422
352044,202112,2310,5968,1365,4169,199,695,294,809,493,1504
352050,202112,14215,36752,9460,27422,2116,6958,1929,4708,4045,11666
352060,202112,813,2128,604,1742,103,318,259,673,362,991
352070,202112,991,1987,645,1531,48,132,370,797,418,929
352080,202112,509,1280,308,883,32,108,102,261,134,369
352090,202112,1671,4763,1388,4223,161,560,673,1837,834,2397
352100,202112,3836,10437,3053,8950,600,1930,1362,3770,1962,5700
352110,202112,715,2011,527,1636,112,358,209,606,321,964
352115,202112,602,1588,496,1422,75,237,279,774,354,1011
352120,202112,948,2665,763,2304,79,202,456,1279,535,1481
352130,202112,2222,6002,1447,4139,225,640,599,1611,824,2251
352140,202112,1252,3349,900,2655,162,494,381,1101,543,1595
352150,202112,962,2473,744,2108,84,264,499,1355,583,1619
352160,202112,1071,2589,778,2109,72,237,436,1129,508,1366
352170,202112,3233,8385,2579,7142,291,872,1610,4175,1901,5047
352180,202112,2645,6925,2006,5778,434,1391,694,1786,1128,3177
352190,202112,1408,3662,1124,3229,186,471,599,1776,785,2247
352200,202112,342,1032,246,840,31,115,84,282,115,397
352210,202112,22224,50258,17451,43821,923,2620,13779,33721,14702,36341
352215,202112,725,1816,597,1611,85,244,330,866,415,1110
352220,202112,25540,60312,18434,48230,2927,8466,9803,23365,12730,31831
352230,202112,16600,45585,12875,38681,3061,10078,4469,12280,7530,22358
352240,202112,10982,27415,8427,23209,1826,5505,3573,9185,5399,14690
352250,202112,25518,68494,20545,60121,2893,9100,12922,36865,15815,45965
352260,202112,5423,13214,3712,9928,557,1711,2130,5070,2687,6781
352265,202112,1003,2724,885,2552,129,395,568,1582,697,1977
352270,202112,1683,4852,1267,3961,250,835,448,1275,698,2110
352280,202112,2540,6201,1918,5309,213,687,1129,2906,1342,3593
352290,202112,1444,3950,1151,3417,138,441,619,1646,757,2087
352300,202112,967,2484,656,1853,79,246,360,950,439,1196
352310,202112,44351,114897,33236,95910,7434,22059,15407,44321,22841,66380
352320,202112,7238,18037,5615,15052,747,2234,3167,7625,3914,9859
352330,202112,2549,6367,1964,5555,271,915,1196,3132,1467,4047
352340,202112,7152,18447,5373,15162,836,2645,2701,6984,3537,9629
352350,202112,2506,6805,1971,5664,159,546,1278,3448,1437,3994
352360,202112,1435,3694,1155,3188,92,296,842,2217,934,2513
352370,202112,1153,3158,992,2889,23,93,809,2304,832,2397
352380,202112,925,2413,692,2005,166,480,230,639,396,1119
352390,202112,16179,38991,11079,29975,1739,5116,6003,15234,7742,20350
352400,202112,3885,10587,3161,9222,664,2218,1393,3768,2057,5986
352410,202112,3764,9352,2884,7883,222,720,1828,4765,2050,5485
352420,202112,888,2168,642,1816,130,398,242,636,372,1034
352430,202112,9027,21556,6617,17406,1071,3195,3438,8462,4509,11657
352440,202112,20478,54270,15373,44436,3473,10414,5527,15337,9000,25751
352450,202112,854,2027,456,1346,60,191,177,483,237,674
352460,202112,3331,8752,2353,7017,454,1448,997,2805,1451,4253
352470,202112,3608,9024,2761,7645,273,880,1751,4535,2024,5415
352480,202112,4590,10644,3079,7985,421,1291,1503,3413,1924,4704
352490,202112,871,2416,698,2111,110,372,323,911,433,1283
352500,202112,11605,29099,7930,22318,2977,9286,1049,1720,4026,11006
352510,202112,4275,11380,3246,9544,587,1816,1620,4579,2207,6395
352520,202112,3123,7884,2424,6734,403,1274,1382,3466,1785,4740
352530,202112,12181,30352,8376,23232,1390,4300,3058,7228,4448,11528
352540,202112,618,1762,460,1432,67,219,166,472,233,691
352550,202112,1061,2836,735,2231,119,414,259,692,378,1106
352560,202112,650,1741,511,1485,67,218,301,798,368,1016
352570,202112,2571,7080,1678,5189,350,1184,204,454,554,1638
352580,202112,668,1692,559,1491,50,153,377,959,427,1112
352585,202112,374,999,272,818,19,71,172,477,191,548
352590,202112,14286,36702,10140,28941,2326,7281,4798,12587,7124,19868
352600,202112,2065,5473,1624,4685,154,485,1031,2797,1185,3282
352610,202112,2948,7927,2215,6683,417,1429,949,2635,1366,4064
352620,202112,6164,14970,4682,12852,1304,3536,1873,5232,3177,8768
352630,202112,919,2208,688,1879,109,349,334,853,443,1202
352640,202112,3270,8166,2382,6579,233,655,1397,3664,1630,4319
352650,202112,646,1765,447,1344,65,214,176,492,241,706
352660,202112,1179,3352,984,2956,101,324,613,1760,714,2084
352670,202112,10816,28072,7471,21599,1645,5297,2714,6994,4359,12291
352680,202112,3496,9937,2448,7595,390,1401,1131,3074,1521,4475
352690,202112,29424,72026,23162,61611,1233,3873,16867,42952,18100,46825
352700,202112,743,1825,552,1541,120,377,212,567,332,944
352710,202112,5794,14526,4169,11596,992,2980,1714,4425,2706,7405
352720,202112,9300,23982,7319,20370,2121,6149,2623,6819,4744,12968
352725,202112,607,1409,345,943,21,58,192,488,213,546
352730,202112,5725,16509,5160,15231,602,1930,2378,6047,2980,7977
352740,202112,2504,5887,1906,5003,186,567,1138,2783,1324,3350
352750,202112,473,1167,301,862,44,142,132,321,176,463
352760,202112,1837,4935,1429,4148,127,356,803,2321,930,2677
352770,202112,981,2530,692,1977,117,352,305,805,422,1157
352780,202112,701,1927,503,1523,110,295,125,397,235,692
352790,202112,469,1198,350,970,31,90,155,375,186,465
352800,202112,1467,4231,1014,3207,231,772,171,411,402,1183
352810,202112,1311,3014,849,2216,169,444,443,1109,612,1553
352820,202112,487,1335,356,1101,77,244,69,189,146,433
352830,202112,629,1549,306,895,29,89,96,229,125,318
352840,202112,4309,11813,3503,10362,1020,3301,1281,3604,2301,6905
352850,202112,12074,28581,8463,22805,2116,6246,3061,7349,5177,13595
352860,202112,1154,3123,878,2630,146,474,336,934,482,1408
352870,202112,935,2286,657,1744,64,189,407,1026,471,1215
352880,202112,1849,4338,1292,3354,211,571,544,1355,755,1926
352885,202112,338,880,259,748,26,68,155,439,181,507
352890,202112,753,1778,504,1271,45,135,308,667,353,802
352900,202112,19994,50642,13225,37355,2060,6076,5625,14788,7685,20864
352910,202112,430,1111,249,739,21,66,93,224,114,290
352920,202112,2912,7245,2177,6009,117,374,1530,4048,1647,4422
352930,202112,6317,16599,4774,13594,814,2550,2293,6063,3107,8613
352940,202112,25390,65848,18989,52887,3251,9810,9704,25252,12955,35062
352950,202112,609,1582,385,1159,90,275,87,230,177,505
352960,202112,809,2079,479,1403,66,216,150,342,216,558
352965,202112,266,735,177,565,38,118,42,125,80,243
352970,202112,3240,7535,2526,6375,188,534,1806,4434,1994,4968
352980,202112,1469,3684,1157,3226,289,878,574,1556,863,2434
352990,202112,4676,12287,3516,10371,636,2041,1783,5052,2419,7093
353000,202112,516,1366,301,877,40,133,78,172,118,305
353010,202112,2834,6871,1883,5110,344,1078,823,2006,1167,3084
353020,202112,3772,9550,2252,6455,326,1016,802,2160,1128,3176
353030,202112,4993,12267,3439,9605,748,2287,934,2450,1682,4737
353040,202112,720,1621,506,1300,119,302,228,561,347,863
353050,202112,5666,15631,4023,12272,715,2328,1886,5478,2601,7806
353060,202112,52389,130079,43264,115568,2954,9082,32615,84052,35569,93134
353070,202112,11061,30404,8096,24028,1320,4288,3596,9634,4916,13922
353080,202112,4904,12889,3260,9723,554,1889,1282,3281,1836,5170
353090,202112,656,1889,530,1639,30,104,348,1030,378,1134
353100,202112,322,835,152,466,28,90,41,103,69,193
353110,202112,8114,20484,6513,18238,1558,4403,2974,8832,4532,13235
353120,202112,445,1100,339,920,45,155,170,394,215,549
353130,202112,2855,6555,1813,4740,423,1235,644,1468,1067,2703
353140,202112,2971,7122,2207,5860,91,306,1624,4116,1715,4422
353150,202112,1708,4124,1229,3343,260,738,506,1297,766,2035
353160,202112,695,1754,495,1412,60,173,227,586,287,759
353170,202112,584,1511,437,1298,77,241,200,605,277,846
353180,202112,11046,26285,8667,22489,1645,4308,4955,12456,6600,16764
353190,202112,3725,9680,2907,8054,383,1133,1688,4350,2071,5483
353200,202112,1941,5076,1113,3422,166,568,362,990,528,1558
353205,202112,464,1349,392,1197,55,178,197,575,252,753
353210,202112,981,2158,646,1622,18,41,473,1157,491,1198
353215,202112,419,1093,328,928,45,143,152,396,197,539
353220,202112,813,2133,540,1588,102,304,110,296,212,600
353230,202112,857,2280,668,1988,184,574,217,601,401,1175
353240,202112,2525,6636,2103,5970,276,907,1274,3455,1550,4362
353250,202112,1293,2877,810,2102,103,296,447,1101,550,1397
353260,202112,1259,2855,708,1946,99,292,331,842,430,1134
353270,202112,763,1915,638,1700,62,183,430,1077,492,1260
353280,202112,758,1990,538,1611,137,402,141,409,278,811
353282,202112,1953,5334,1634,4776,170,534,1028,2842,1198,3376
353284,202112,395,876,223,573,20,74,114,252,134,326
353286,202112,197,474,118,341,20,55,35,87,55,142
353290,202112,1559,4028,945,2820,171,500,281,750,452,1250
353300,202112,2328,6034,1710,4845,269,890,770,1895,1039,2785
353310,202112,431,1025,321,842,20,64,214,527,234,591
353320,202112,739,1784,627,1628,11,39,511,1294,522,1333
353325,202112,742,2099,526,1627,112,332,179,540,291,872
353330,202112,671,1672,447,1262,61,173,220,570,281,743
353340,202112,3363,8900,2552,7326,475,1520,1263,3269,1738,4789
353350,202112,4064,9943,2920,7796,675,1829,919,2225,1594,4054
353360,202112,712,1931,556,1637,57,181,331,935,388,1116
353370,202112,608,1686,505,1521,46,149,351,1023,397,1172
353380,202112,321,913,256,794,29,99,119,337,148,436
353390,202112,6950,16776,5212,13905,429,1289,3287,8292,3716,9581
353400,202112,542,1416,411,1172,74,229,167,397,241,626
353410,202112,553,1444,416,1197,70,194,233,669,303,863
353420,202112,470,1196,293,830,63,174,33,82,96,256
353430,202112,2464,6554,1935,5596,333,1069,973,2641,1306,3710
353440,202112,73990,192318,54865,155556,8310,25436,30532,81448,38842,106884
353450,202112,409,1018,282,803,34,114,141,359,175,473
353460,202112,3572,9399,2671,7750,314,973,883,2408,1197,3381
353470,202112,9411,24044,6806,19145,1105,3487,3070,7896,4175,11383
353475,202112,1801,4401,1223,3292,155,469,632,1530,787,1999
353480,202112,1715,4422,1392,3881,54,185,1027,2759,1081,2944
353490,202112,1181,3012,810,2316,106,329,384,1033,490,1362
353500,202112,1110,2586,804,2109,163,448,450,1129,613,1577
353510,202112,925,2616,658,2026,152,483,192,501,344,984
353520,202112,1104,2789,702,2082,69,233,347,927,416,1160
353530,202112,2648,6748,2100,5765,254,804,1174,2980,1428,3784
353540,202112,2259,5911,1854,5272,280,829,1081,2955,1361,3784
353550,202112,6414,15929,5201,13980,775,2114,3047,7864,3822,9978
353560,202112,2514,6457,1931,5585,505,1577,613,1582,1118,3159
353570,202112,702,1794,491,1422,71,235,219,575,290,810
353580,202112,2371,6099,1805,4999,404,1101,803,2156,1207,3257
353590,202112,775,1939,544,1536,71,211,294,820,365,1031
353600,202112,1813,4415,1371,3655,177,462,741,1938,918,2400
353610,202112,740,2111,530,1683,92,359,191,546,283,905
353620,202112,3093,7820,2229,6370,410,1279,776,1994,1186,3273
353625,202112,595,1454,385,1088,34,105,209,570,243,675
353630,202112,1543,4487,1316,4035,209,688,613,1746,822,2434
353640,202112,1423,3601,1140,3162,149,407,654,1783,803,2190
353650,202112,8266,21568,6333,18003,754,2297,3642,9715,4396,12012
353657,202112,411,1052,302,872,29,96,140,363,169,459
353660,202112,1411,2920,974,2338,295,736,399,913,694,1649
353670,202112,4444,11934,3450,10019,655,2135,1602,4213,2257,6348
353680,202112,757,1924,566,1657,75,247,330,894,405,1141
353690,202112,465,1207,225,674,21,77,56,143,77,220
353700,202112,2227,5607,1828,4958,126,405,1345,3493,1471,3898
353710,202112,5686,12676,3416,8655,423,1104,1756,3915,2179,5019
353715,202112,471,1234,281,853,8,28,107,297,115,325
353720,202112,2168,5501,1661,4717,274,848,885,2395,1159,3243
353730,202112,4709,12042,3631,10143,453,1486,2061,5264,2514,6750
353740,202112,2192,5596,1556,4489,354,1125,536,1370,890,2495
353750,202112,991,2893,723,2384,152,540,190,591,342,1131
353760,202112,14461,31920,11152,27557,2385,5839,5716,14068,8101,19907
353770,202112,720,2058,431,1398,65,233,59,167,124,400
353780,202112,6298,16283,5076,14104,1072,3289,2609,6696,3681,9985
353790,202112,3068,8906,2247,7176,526,1835,444,1219,970,3054
353800,202112,20411,51571,16103,44631,2484,7067,8702,23979,11186,31046
353810,202112,1331,3492,886,2579,126,410,384,1054,510,1464
353820,202112,1905,4972,1288,3772,254,820,402,1069,656,1889
353830,202112,681,1668,499,1376,81,233,223,579,304,812
353850,202112,1728,4605,1341,3890,269,794,509,1420,778,2214
353860,202112,2896,7607,2207,6461,492,1629,1007,2626,1499,4255
353870,202112,32710,83323,23555,65884,3017,9223,12334,31525,15351,40748
353880,202112,3362,9002,2652,7684,213,694,1641,4530,1854,5224
353890,202112,3180,6642,2300,5365,178,463,1608,3465,1786,3928
353900,202112,784,2137,580,1740,77,266,242,663,319,929
353910,202112,2813,7465,2371,6775,201,653,1694,4725,1895,5378
353920,202112,2082,5554,1512,4499,350,1135,343,843,693,1978
353930,202112,4949,12848,3393,9894,556,1856,1452,3681,2008,5537
353940,202112,1296,3627,909,2854,144,488,309,859,453,1347
353950,202112,3507,9212,2676,7658,575,1722,1269,3429,1844,5151
353960,202112,882,2220,622,1733,143,398,199,522,342,920
353970,202112,689,1608,518,1351,44,133,367,937,411,1070
353980,202112,17560,43008,13719,36483,815,2546,10059,25477,10874,28023
353990,202112,998,2383,608,1685,113,337,285,743,398,1080
354000,202112,2776,6521,1564,4225,347,948,266,677,613,1625
354010,202112,359,912,254,743,49,149,131,375,180,524
354020,202112,4032,10539,3189,8851,659,1997,1453,3663,2112,5660
354025,202112,761,2043,500,1535,66,224,144,415,210,639
354030,202112,538,1149,299,769,61,167,141,336,202,503
354040,202112,865,1949,564,1476,32,93,415,1041,447,1134
354050,202112,1009,2803,716,2268,154,543,250,737,404,1280
354060,202112,3814,10437,2702,8086,471,1529,1127,2999,1598,4528
354070,202112,4210,10626,2862,8007,459,1463,1303,3162,1762,4625
354075,202112,3055,8329,2440,7224,359,1077,1397,4061,1756,5138
354080,202112,1518,4058,1020,3073,183,586,326,864,509,1450
354085,202112,467,929,374,813,0,0,293,588,293,588
354090,202112,1742,4762,1496,4271,91,276,1155,3209,1246,3485
354100,202112,21579,56287,15086,45133,3246,10340,5878,17377,9124,27717
354105,202112,1512,3727,1054,2917,124,361,515,1304,639,1665
354110,202112,468,1297,339,1046,60,187,113,330,173,517
354120,202112,1473,3858,1018,2902,221,669,329,827,550,1496
354130,202112,5932,15266,3919,11365,939,2838,225,427,1164,3265
354140,202112,21298,51458,14697,39333,2263,6726,6713,16279,8976,23005
354150,202112,3114,7232,2405,6120,506,1336,934,2345,1440,3681
354160,202112,3062,8565,2328,7124,595,1986,735,2013,1330,3999
354165,202112,738,2112,566,1775,88,325,298,857,386,1182
354170,202112,2031,5467,1682,4824,117,379,1006,2736,1123,3115
354180,202112,432,1167,324,951,48,147,165,437,213,584
354190,202112,1696,4646,1188,3593,72,239,611,1746,683,1985
354200,202112,944,2230,722,1886,68,201,481,1172,549,1373
354210,202112,981,2522,802,2234,55,174,556,1449,611,1623
354220,202112,3363,8768,2541,7187,388,1188,1335,3539,1723,4727
354230,202112,859,2068,700,1879,32,102,529,1378,561,1480
354240,202112,1895,5132,1262,3842,212,674,414,1129,626,1803
354250,202112,667,1600,421,1176,87,257,122,312,209,569
354260,202112,8759,22249,6688,18670,1175,3598,3208,8422,4383,12020
354270,202112,1082,3133,889,2755,176,522,342,1014,518,1536
354280,202112,878,2102,752,1920,65,190,519,1231,584,1421
354290,202112,997,3069,839,2749,135,425,428,1449,563,1874
354300,202112,3764,10694,3165,9591,769,2342,1332,3973,2101,6315
354310,202112,777,2238,639,1978,147,475,250,723,397,1198
354320,202112,1049,2479,691,1880,96,297,291,698,387,995
354323,202112,526,1225,328,864,56,134,134,330,190,464
354325,202112,1604,4645,1107,3519,188,599,320,980,508,1579
354330,202112,10284,25232,7129,18999,840,2529,4331,10670,5171,13199
354340,202112,37132,90741,25962,71453,3383,10566,14839,38697,18222,49263
354350,202112,1289,3210,1026,2783,166,467,573,1482,739,1949
354360,202112,667,1653,407,1229,94,281,93,275,187,556
354370,202112,1067,2944,861,2617,130,420,525,1531,655,1951
354380,202112,706,1819,518,1515,85,328,152,346,237,674
354390,202112,15365,36181,10311,27377,1669,4781,5079,12559,6748,17340
354400,202112,1704,5282,1338,4435,227,769,470,1535,697,2304
354410,202112,6941,17675,5297,14521,942,2831,2702,6869,3644,9700
354420,202112,1621,4082,1200,3328,150,450,722,1866,872,2316
354425,202112,2960,7067,2113,5594,466,1265,840,2215,1306,3480
354430,202112,1639,4247,1279,3689,109,326,799,2195,908,2521
354440,202112,657,1651,435,1220,67,200,193,498,260,698
354450,202112,485,1263,286,889,42,139,93,241,135,380
354460,202112,915,2272,620,1756,96,289,293,809,389,1098
354470,202112,490,1218,336,928,19,64,165,385,184,449
354480,202112,1412,3101,921,2326,88,212,571,1367,659,1579
354490,202112,868,2486,638,1990,115,386,283,800,398,1186
354500,202112,2332,6323,1868,5582,543,1673,450,1367,993,3040
354510,202112,778,2111,636,1850,42,132,373,984,415,1116
354515,202112,391,1070,274,832,42,136,107,314,149,450
354520,202112,7522,19995,5342,15430,656,2210,3023,8034,3679,10244
354530,202112,4899,13399,3829,11343,1004,2946,1251,3839,2255,6785
354540,202112,1451,3679,1061,2983,223,647,395,1073,618,1720
354550,202112,641,1667,504,1406,78,238,275,716,353,954
354560,202112,2462,5818,1343,3692,178,494,702,1759,880,2253
354570,202112,1332,3273,545,1506,101,278,76,201,177,479
354580,202112,9073,23474,6032,17623,923,2899,2986,8288,3909,11187
354600,202112,2208,5552,1749,4756,231,649,1089,2812,1320,3461
354610,202112,475,1198,276,804,27,85,136,375,163,460
354620,202112,519,1403,319,1015,35,139,139,406,174,545
354625,202112,327,870,197,621,38,134,42,97,80,231
354630,202112,2401,6850,1958,5995,631,2004,375,1070,1006,3074
354640,202112,3723,10253,2805,8463,392,1309,1207,3322,1599,4631
354650,202112,938,2404,749,2095,93,249,411,1144,504,1393
354660,202112,3905,8968,2104,5971,185,638,978,2478,1163,3116
354670,202112,1157,3132,810,2435,157,517,303,836,460,1353
354680,202112,5786,14586,4365,12299,919,2764,2245,6348,3164,9112
354690,202112,544,1637,389,1297,74,269,128,395,202,664
354700,202112,1009,2623,708,2036,88,278,372,974,460,1252
354710,202112,540,1413,382,1105,47,143,169,431,216,574
354720,202112,323,758,146,420,66,184,24,76,90,260
354730,202112,10848,29849,8335,25049,1100,3616,4781,13722,5881,17338
354740,202112,336,895,136,430,15,52,29,77,44,129
354750,202112,3017,7549,1941,5529,266,808,826,2068,1092,2876
354760,202112,2332,6062,1664,4840,356,1128,575,1469,931,2597
354765,202112,388,1027,165,516,18,62,47,132,65,194
354770,202112,2701,6529,1961,5182,314,884,916,2274,1230,3158
354780,202112,62296,152509,47863,124544,3916,11642,32325,78456,36241,90098
354790,202112,1082,2882,840,2490,71,228,526,1494,597,1722
354800,202112,2807,7092,2125,5944,534,1525,877,2288,1411,3813
354805,202112,1470,3288,1037,2657,119,289,618,1499,737,1788
354810,202112,680,1944,410,1377,59,234,121,375,180,609
354820,202112,1036,2874,729,2290,104,358,213,529,317,887
354830,202112,525,1249,331,907,68,199,101,258,169,457
354840,202112,970,2385,603,1636,57,162,325,810,382,972
354850,202112,22882,57326,16180,45585,1607,5154,10076,26751,11683,31905
354860,202112,1849,4958,1170,3563,180,595,392,1081,572,1676
354870,202112,65894,162499,51142,135433,4880,14260,33218,82679,38098,96939
354880,202112,6353,15335,3169,8725,342,1075,1271,2854,1613,3929
354890,202112,17158,42364,13308,35864,1822,5471,7486,19536,9308,25007
354900,202112,435,1067,287,807,61,191,96,212,157,403
354910,202112,6449,16645,3996,12163,865,2797,828,2300,1693,5097
354920,202112,558,1450,279,887,39,131,65,168,104,299
354925,202112,319,884,186,594,24,80,46,131,70,211
354930,202112,411,990,277,753,32,98,129,322,161,420
354940,202112,2586,7411,1904,5952,612,2063,477,1331,1089,3394
354950,202112,1644,4047,1313,3608,54,187,978,2557,1032,2744
354960,202112,961,2489,715,2113,74,247,379,1040,453,1287
354970,202112,4527,12188,3560,10566,364,1240,2314,6623,2678,7863
354980,202112,36490,84886,25045,65297,2522,7781,15613,37705,18135,45486
354990,202112,77357,188426,56759,151361,4235,13074,38069,94819,42304,107893
354995,202112,3126,6719,2378,5751,146,413,1812,4218,1958,4631
355000,202112,1695,4077,1266,3444,215,665,617,1516,832,2181
355010,202112,4365,11453,2765,8069,894,2658,394,1172,1288,3830
355020,202112,3908,10517,2872,8692,564,1922,1216,3389,1780,5311
355030,202112,1495666,3603087,1094647,2836198,156020,443276,576094,1371050,732114,1814326
355040,202112,3297,7789,2544,6804,257,710,1887,5007,2144,5717
355050,202112,1120,2432,833,2038,193,540,341,734,534,1274
355060,202112,6804,17674,4983,14340,774,2565,2566,6682,3340,9247
355070,202112,10762,26495,8770,23312,996,3019,5612,13933,6608,16952
355080,202112,1030,2874,654,2177,132,476,103,280,235,756
355090,202112,1329,3602,1053,3144,208,665,471,1294,679,1959
355100,202112,24079,61019,18809,53165,2792,8357,11474,31869,14266,40226
355110,202112,953,2567,695,2161,159,571,90,249,249,820
355120,202112,785,2000,562,1677,66,193,249,728,315,921
355130,202112,875,1925,455,1170,30,99,295,693,325,792
355140,202112,2139,4639,1798,4177,90,237,1497,3387,1587,3624
355150,202112,4722,12004,3749,10298,416,1259,2367,6228,2783,7487
355160,202112,2397,6370,1731,5196,398,1293,434,1183,832,2476
355170,202112,12191,29754,9566,25410,1670,4751,5077,13053,6747,17804
355180,202112,3075,7889,2196,6441,403,1334,949,2527,1352,3861
355190,202112,1994,5142,1565,4450,438,1223,725,2227,1163,3450
355200,202112,874,2613,740,2395,212,733,294,922,506,1655
355210,202112,3262,8649,2505,7097,454,1421,1184,3115,1638,4536
355220,202112,51847,132758,41354,112795,7861,22867,19275,48514,27136,71381
355230,202112,1248,3080,679,1971,130,379,233,629,363,1008
355240,202112,27103,70026,19131,54330,2215,6866,10835,28728,13050,35594
355250,202112,41134,106473,30779,86666,7746,22762,11895,31874,19641,54636
355255,202112,698,1702,379,1129,54,164,132,375,186,539
355260,202112,1661,3867,1185,3108,118,381,728,1753,846,2134
355270,202112,1237,3541,964,3003,209,681,384,1094,593,1775
355280,202112,34093,84036,24637,66695,2981,8772,13327,33676,16308,42448
355290,202112,1004,2622,774,2233,159,430,322,897,481,1327
355300,202112,1440,4093,1159,3562,213,692,447,1276,660,1968
355310,202112,1004,2706,751,2278,94,285,427,1299,521,1584
355320,202112,562,1440,423,1184,74,231,173,391,247,622
355330,202112,3191,7910,2464,6647,112,381,1888,4855,2000,5236
355340,202112,4423,9688,3375,8299,449,1060,2015,5048,2464,6108
355350,202112,1461,4037,1097,3341,207,653,439,1283,646,1936
355360,202112,1293,3190,991,2726,107,309,598,1601,705,1910
355365,202112,385,972,203,653,46,146,29,101,75,247
355370,202112,5685,14258,4395,12194,1030,2602,1882,5748,2912,8350
355380,202112,3085,8042,2332,6666,403,1265,861,2121,1264,3386
355385,202112,1559,3960,1292,3582,105,342,827,2086,932,2428
355390,202112,887,2381,637,1841,131,408,247,630,378,1038
355395,202112,2098,5632,1486,4407,238,751,538,1379,776,2130
355400,202112,10040,27785,7942,23646,1810,6029,2952,7803,4762,13832
355410,202112,25178,67651,15748,48108,3018,10079,4519,13266,7537,23345
355420,202112,657,2042,546,1838,131,481,153,478,284,959
355430,202112,3951,9738,2976,7988,613,1681,1379,3619,1992,5300
355440,202112,807,2146,503,1516,83,248,134,376,217,624
355450,202112,3570,9005,2400,6732,351,1077,1069,2671,1420,3748
355460,202112,546,1291,335,936,32,110,164,407,196,517
355465,202112,485,1224,384,1064,49,146,223,600,272,746
355470,202112,1209,3022,700,2014,183,580,188,462,371,1042
355475,202112,379,858,314,774,14,33,242,578,256,611
355480,202112,4348,11663,3512,10391,513,1705,2213,6397,2726,8102
355490,202112,999,2609,554,1699,50,173,270,748,320,921
355495,202112,902,2444,663,2045,78,289,243,661,321,950
355500,202112,7443,18638,4598,13173,674,2098,1750,4562,2424,6660
355510,202112,1511,3603,977,2712,153,448,390,976,543,1424
355520,202112,401,909,203,580,40,112,63,180,103,292
355530,202112,377,869,146,420,8,28,68,175,76,203
355535,202112,557,1480,431,1283,84,298,201,554,285,852
355540,202112,11983,28799,9922,25915,1220,3500,6870,17330,8090,20830
355550,202112,649,1880,534,1650,63,218,293,829,356,1047
355560,202112,1236,3134,704,2091,157,531,28,81,185,612
355570,202112,315,841,164,508,24,82,38,99,62,181
355580,202112,1295,3038,797,2200,143,465,279,672,422,1137
355590,202112,180,456,139,389,17,55,85,225,102,280
355600,202112,1671,4022,1094,3037,167,494,349,964,516,1458
355610,202112,1978,4761,1320,3621,145,431,704,1788,849,2219
355620,202112,5515,14211,4106,11430,417,1381,2310,5844,2727,7225
355630,202112,2679,7035,1918,5647,296,910,1029,2887,1325,3797
355635,202112,968,2764,712,2255,109,376,226,650,335,1026
355640,202112,3570,9540,2427,7314,511,1528,656,2001,1167,3529
355645,202112,4413,11971,3219,9872,471,1578,1725,5051,2196,6629
355650,202112,6929,18347,5344,15430,1298,3918,1595,4099,2893,8017
355660,202112,1519,3822,1049,2998,162,490,289,815,451,1305
355670,202112,4198,10998,2888,8088,354,1171,1482,3602,1836,4773
355680,202112,3118,8334,1466,4489,322,1098,92,267,414,1365
355690,202112,855,2433,564,1870,122,454,6,11,128,465
355695,202112,285,784,171,522,13,52,40,89,53,141
355700,202112,8139,22557,6706,19431,993,3159,3813,10358,4806,13517
355710,202112,10047,23343,6732,17311,913,2660,3406,7652,4319,10312
355715,202112,512,1361,282,848,63,198,43,109,106,307
355720,202112,1559,4262,1236,3691,182,575,674,1889,856,2464
355730,202112,1014,2713,831,2384,122,394,431,1153,553,1547
410010,202112,1331,3638,1023,2995,188,611,247,666,435,1277
410020,202112,1124,3244,845,2623,275,801,184,553,459,1354
410030,202112,1658,4401,1416,4028,202,592,772,2244,974,2836
410040,202112,14138,38024,10320,30814,2205,7022,3175,8724,5380,15746
410045,202112,857,2268,617,1789,99,317,238,615,337,932
410050,202112,2430,5965,1678,4677,257,818,632,1629,889,2447
410060,202112,2217,6095,1731,5156,374,1186,517,1456,891,2642
410070,202112,2119,5227,1571,4250,258,767,599,1447,857,2214
410080,202112,1419,3726,1008,2984,253,782,176,504,429,1286
410090,202112,1188,2928,1009,2650,113,278,565,1570,678,1848
410100,202112,2105,5875,1381,4185,213,707,121,353,334,1060
410105,202112,527,1313,307,888,35,101,113,308,148,409
410110,202112,3544,8639,2493,6695,343,980,1171,2936,1514,3916
410115,202112,603,1527,435,1234,51,154,169,427,220,581
410120,202112,2892,7630,2502,7073,503,1450,1377,3816,1880,5266
410130,202112,1367,3546,1177,3189,229,706,591,1499,820,2205
410140,202112,18005,42873,11860,31930,2080,6148,3205,7791,5285,13939
410150,202112,17810,41223,9129,24465,1527,4531,2276,5367,3803,9898
410160,202112,3214,8694,2583,7586,589,1846,849,2451,1438,4297
410165,202112,698,1832,560,1554,66,206,308,793,374,999
410170,202112,3105,7843,2044,5620,437,1282,115,314,552,1596
410180,202112,16648,45304,12794,37566,1873,5958,6322,17082,8195,23040
410185,202112,468,1329,341,1009,53,174,111,286,164,460
410190,202112,2364,5758,1712,4602,338,958,428,1062,766,2020
410200,202112,6331,13997,3498,9166,552,1629,470,1193,1022,2822
410210,202112,3457,8429,2205,6219,345,1096,718,1697,1063,2793
410220,202112,578,1463,382,1103,60,187,103,268,163,455
410230,202112,1942,5109,1468,4172,223,689,614,1555,837,2244
410240,202112,5600,14398,3816,10924,693,2211,528,1344,1221,3555
410250,202112,2671,6310,1977,5207,148,450,957,2454,1105,2904
410260,202112,2005,4910,1253,3512,170,492,578,1554,748,2046
410270,202112,517,1347,376,1091,49,167,142,392,191,559
410275,202112,664,1822,470,1405,79,254,188,510,267,764
410280,202112,2549,6556,1695,4897,200,655,714,1875,914,2530
410290,202112,3605,9844,2462,7444,767,2262,535,1621,1302,3883
410300,202112,751,1810,589,1553,61,186,277,649,338,835
410302,202112,366,923,213,634,18,57,105,301,123,358
410304,202112,1376,3421,1152,3003,125,349,725,1802,850,2151
410305,202112,1820,4267,1271,3477,107,344,815,2130,922,2474
410310,202112,2881,7727,2342,6737,293,966,1320,3668,1613,4634
410315,202112,709,1610,450,1198,161,435,98,269,259,704
410320,202112,1109,3029,746,2298,110,378,117,331,227,709
410322,202112,690,1797,356,1034,41,120,151,381,192,501
410330,202112,1636,3918,1119,2955,182,492,314,823,496,1315
410335,202112,907,2373,681,1952,107,320,274,721,381,1041
410337,202112,888,2151,620,1629,89,236,211,508,300,744
410340,202112,538,1497,360,1069,26,80,157,374,183,454
410345,202112,2745,7072,1513,4423,309,937,419,1076,728,2013
410347,202112,811,2058,594,1661,63,215,191,525,254,740
410350,202112,1745,4189,1257,3402,146,436,613,1516,759,1952
410360,202112,4488,10999,3398,9080,523,1460,1302,3394,1825,4854
410370,202112,14951,39172,9640,26929,1102,3319,4004,9710,5106,13029
410380,202112,1802,4375,1307,3515,226,656,398,940,624,1596
410390,202112,2948,7145,1987,5497,378,1170,708,1716,1086,2886
410395,202112,997,2752,795,2345,164,488,288,867,452,1355
410400,202112,7558,19032,5707,15551,778,2257,2972,7589,3750,9846
410405,202112,932,2122,652,1704,100,299,313,762,413,1061
410410,202112,1367,3541,1278,3405,147,475,822,2267,969,2742
410420,202112,12273,32399,9212,26304,1397,4415,3935,10043,5332,14458
410425,202112,3678,9950,2520,7570,411,1313,911,2460,1322,3773
410430,202112,14133,34645,9893,26918,1453,4362,3654,9129,5107,13491
410440,202112,2486,7122,2116,6441,333,1130,1078,3184,1411,4314
410442,202112,2619,7546,2047,6312,531,1684,518,1490,1049,3174
410445,202112,2427,6746,1742,5403,321,1126,257,866,578,1992
410450,202112,1635,3927,1224,3287,233,670,462,1166,695,1836
410460,202112,2402,5825,1749,4694,216,621,796,2013,1012,2634
410465,202112,3038,8500,2383,7275,440,1414,779,2196,1219,3610
410470,202112,2362,6283,1642,4990,400,1408,207,671,607,2079
410480,202112,41525,97782,22866,64767,3320,10424,5540,13216,8860,23640
410490,202112,12434,33307,8903,26121,1547,4833,3579,9650,5126,14483
410500,202112,2017,5122,1346,3874,243,769,343,829,586,1598
410510,202112,1947,4759,1321,3622,259,670,377,1058,636,1728
410520,202112,3216,9748,2820,8964,949,3148,783,2524,1732,5672
410530,202112,1738,4126,797,2189,104,309,204,447,308,756
410540,202112,3024,7970,2072,6057,332,1063,855,2353,1187,3416
410550,202112,8249,21452,5489,15574,903,2792,1476,3514,2379,6306
410560,202112,1652,4225,1195,3305,248,730,377,874,625,1604
410570,202112,2807,7391,2038,6056,568,2027,193,569,761,2596
410580,202112,29351,73900,21490,59703,3518,10648,9926,25528,13444,36176
410590,202112,1696,4687,1181,3505,149,460,354,866,503,1326
410600,202112,1917,4935,1478,4086,339,908,422,1252,761,2160
410610,202112,766,1921,573,1573,62,204,270,679,332,883
410620,202112,2761,7538,1893,5582,409,1273,246,709,655,1982
410630,202112,2737,6904,1787,5022,301,1014,409,915,710,1929
410640,202112,5220,12002,3581,9137,750,2192,426,1086,1176,3278
410645,202112,1192,3216,977,2946,266,838,487,1469,753,2307
410650,202112,2601,6863,1788,5239,340,1039,652,1743,992,2782
410655,202112,949,2237,664,1738,34,87,331,825,365,912
410657,202112,657,1761,392,1176,54,170,102,249,156,419
410660,202112,3794,9313,2261,6048,386,1070,715,1714,1101,2784
410670,202112,1090,2663,663,1864,133,363,206,528,339,891
410680,202112,2687,7833,1831,5729,423,1324,258,824,681,2148
410685,202112,565,1409,420,1163,103,314,151,377,254,691
410690,202112,147280,348598,99676,261876,14890,44071,40958,94655,55848,138726
410700,202112,2636,6542,2179,5830,441,1195,925,2374,1366,3569
410710,202112,954,2359,623,1744,110,326,264,665,374,991
410712,202112,695,1888,573,1667,99,324,275,754,374,1078
410715,202112,921,2598,560,1770,62,201,223,669,285,870
410720,202112,3648,9085,2955,7848,455,1427,832,2141,1287,3568
410725,202112,1211,2906,718,1994,146,432,101,228,247,660
410730,202112,792,2056,609,1714,123,405,123,337,246,742
410740,202112,929,2526,682,2054,86,294,279,826,365,1120
410750,202112,1952,4720,1553,4006,257,705,733,1804,990,2509
410752,202112,392,942,217,607,27,81,107,271,134,352
410753,202112,372,1073,262,826,39,135,60,169,99,304
410754,202112,1156,2897,950,2588,68,163,654,1867,722,2030
410755,202112,613,1539,437,1201,55,153,196,490,251,643
410760,202112,3953,10002,2851,8004,624,2027,762,1992,1386,4019
410765,202112,16421,44231,12775,37108,2190,6851,3120,7874,5310,14725
410770,202112,1136,2636,797,2063,75,175,399,1053,474,1228
410773,202112,1374,3538,1202,3277,124,378,775,2042,899,2420
410775,202112,1651,3945,1439,3632,55,167,986,2398,1041,2565
410780,202112,689,1673,461,1245,66,190,135,334,201,524
410785,202112,767,1936,581,1622,90,283,186,513,276,796
410790,202112,996,2754,831,2449,205,608,65,143,270,751
410800,202112,3657,8008,2928,6958,50,147,1914,4402,1964,4549
410810,202112,486,1256,366,1025,31,97,147,350,178,447
410820,202112,1046,2889,545,1602,98,310,101,239,199,549
410830,202112,44851,104930,30963,81949,6109,17767,12191,29924,18300,47691
410832,202112,1110,2855,890,2465,101,324,531,1369,632,1693
410840,202112,9565,23421,5612,15983,1083,3297,1443,3770,2526,7067
410845,202112,1244,3002,959,2564,167,458,406,1044,573,1502
410850,202112,2341,6475,2039,5937,346,1032,922,2648,1268,3680
410855,202112,822,2011,527,1446,61,176,238,586,299,762
410860,202112,4818,11470,3788,9807,241,766,2425,5938,2666,6704
410865,202112,1558,4346,1330,3927,140,436,752,2292,892,2728
410870,202112,1312,3434,1064,3016,108,322,669,1865,777,2187
410880,202112,5010,12954,3445,10104,533,1576,503,1560,1036,3136
410890,202112,1104,2978,849,2494,163,527,283,778,446,1305
410895,202112,1083,3314,906,2940,279,1002,221,654,500,1656
410900,202112,919,2398,634,1851,96,289,153,369,249,658
410910,202112,452,1024,278,700,12,44,147,326,159,370
410920,202112,934,2219,683,1814,93,280,331,846,424,1126
410930,202112,1845,4589,1267,3580,292,948,212,565,504,1513
410940,202112,25033,65904,18217,53891,3638,11744,5872,16699,9510,28443
410950,202112,2053,5818,1842,5489,82,233,1502,4463,1584,4696
410960,202112,8541,20359,5978,16179,1362,4085,2265,6067,3627,10152
410965,202112,1270,3093,863,2349,77,234,535,1418,612,1652
410970,202112,4443,11675,3131,9103,670,2310,432,1021,1102,3331
410975,202112,1483,3504,1133,2973,127,361,551,1396,678,1757
410980,202112,8213,19967,5322,14845,572,1746,2424,6093,2996,7839
410990,202112,1534,3577,1044,2803,204,639,410,1071,614,1710
411000,202112,738,1931,522,1535,72,234,163,410,235,644
411005,202112,503,1221,292,781,52,157,95,216,147,373
411007,202112,2682,7085,2000,5822,447,1399,675,1858,1122,3257
411010,202112,4521,13184,3554,11250,842,2913,349,997,1191,3910
411020,202112,2515,6873,2036,6029,578,1742,518,1510,1096,3252
411030,202112,818,1979,572,1480,50,159,291,656,341,815
411040,202112,1059,2644,560,1581,66,210,168,391,234,601
411050,202112,2141,6464,1733,5577,383,1343,282,762,665,2105
411060,202112,2274,5895,1482,4255,282,903,311,830,593,1733
411065,202112,453,1136,286,808,35,105,116,309,151,414
411070,202112,8153,20032,6429,17168,830,2396,3351,8641,4181,11037
411080,202112,1983,5180,1637,4593,376,1246,378,1001,754,2247
411090,202112,872,2286,569,1693,46,168,138,364,184,532
411095,202112,2865,6585,1585,4280,209,588,367,899,576,1487
411100,202112,1314,3336,925,2622,94,308,333,934,427,1242
411110,202112,691,1756,329,981,31,91,23,50,54,141
411120,202112,1468,3850,1204,3387,292,987,338,834,630,1821
411125,202112,5649,16037,5005,14849,1190,3436,2238,6979,3428,10415
411130,202112,775,2002,546,1574,104,269,184,603,288,872
411140,202112,2428,7141,2012,6287,594,1959,529,1640,1123,3599
411150,202112,4324,10677,2895,7799,500,1549,256,512,756,2061
411155,202112,1068,2699,672,1960,106,319,301,803,407,1122
411160,202112,401,902,272,710,28,69,69,182,97,251
411170,202112,828,2321,634,1906,141,448,232,657,373,1105
411180,202112,6127,15718,4777,13427,747,2232,2291,5982,3038,8214
411190,202112,2035,5083,1504,4104,209,608,609,1482,818,2090
411200,202112,5222,13728,3788,11074,871,2842,869,2153,1740,4995
411210,202112,3574,7881,2449,6067,438,1178,850,2000,1288,3178
411220,202112,957,2379,662,1820,147,451,182,465,329,916
411230,202112,921,2393,674,1932,133,412,215,578,348,990
411240,202112,1732,4019,1181,3059,137,416,580,1379,717,1795
411250,202112,2426,6230,1754,5012,348,1172,520,1378,868,2550
411260,202112,353,869,231,637,23,67,99,243,122,310
411270,202112,2147,5584,1586,4467,226,658,746,1932,972,2590
411275,202112,1610,3609,1122,2825,139,417,563,1298,702,1715
411280,202112,1437,3800,978,2925,252,768,143,384,395,1152
411290,202112,897,2289,569,1660,68,204,289,809,357,1013
411295,202112,1347,3338,960,2607,120,344,421,1059,541,1403
411300,202112,1105,2738,720,1993,79,248,320,758,399,1006
411310,202112,961,2154,746,1861,101,263,329,787,430,1050
411320,202112,5902,14741,4288,11868,632,1880,1869,4607,2501,6487
411325,202112,1543,4202,1267,3690,266,743,589,1810,855,2553
411330,202112,3571,9357,2592,7573,601,1893,729,2134,1330,4027
411340,202112,901,2427,531,1607,91,290,138,384,229,674
411342,202112,1132,2682,619,1674,105,295,194,474,299,769
411345,202112,1217,3018,929,2555,59,176,667,1832,726,2008
411350,202112,3140,8177,2035,5950,476,1529,350,879,826,2408
411360,202112,796,1863,582,1531,63,183,265,633,328,816
411370,202112,64862,156825,47194,126607,3510,11046,27903,69051,31413,80097
411373,202112,1524,3769,1232,3336,126,356,635,1761,761,2117
411375,202112,1203,2953,844,2276,135,370,320,843,455,1213
411380,202112,1229,2789,839,2060,50,136,534,1208,584,1344
411390,202112,1622,4350,1263,3575,193,587,483,1186,676,1773
411400,202112,2553,6134,1908,4946,155,480,1030,2494,1185,2974
411410,202112,2954,8012,2176,6383,440,1428,465,1260,905,2688
411420,202112,4717,11211,2530,7082,331,1064,473,948,804,2012
411430,202112,3999,10394,3010,8551,593,1849,981,2533,1574,4382
411435,202112,461,1237,290,886,55,158,83,229,138,387
411440,202112,2728,7392,2181,6365,455,1414,638,1744,1093,3158
411450,202112,2602,6779,1956,5698,230,686,1110,3239,1340,3925
411460,202112,4694,11874,2907,8413,409,1351,571,1411,980,2762
411470,202112,880,2170,647,1745,109,325,243,576,352,901
411480,202112,5730,14745,4131,11745,680,2279,1576,3970,2256,6249
411490,202112,1759,4427,1346,3750,150,490,589,1442,739,1932
411500,202112,1431,3719,971,2755,153,471,192,432,345,903
411510,202112,2486,6066,1985,5248,329,1034,573,1545,902,2579
411520,202112,36670,88194,21724,59032,2471,7693,8718,20799,11189,28492
411530,202112,1029,2608,615,1832,101,320,95,233,196,553
411535,202112,541,1540,354,1098,46,168,106,294,152,462
411540,202112,2790,6696,1927,5156,111,360,1093,2858,1204,3218
411545,202112,965,2717,811,2448,72,231,517,1559,589,1790
411550,202112,770,1895,570,1531,97,253,116,320,213,573
411560,202112,2162,5819,1205,3738,131,448,68,159,199,607
411570,202112,7753,17597,5245,13846,1178,3346,1021,2683,2199,6029
411573,202112,825,2178,678,1918,130,376,280,748,410,1124
411575,202112,2168,5721,1604,4604,276,818,427,1169,703,1987
411580,202112,5235,11954,3172,8745,440,1466,566,1346,1006,2812
411585,202112,646,1886,308,978,51,154,57,173,108,327
411590,202112,451,1202,334,975,40,119,175,475,215,594
411600,202112,366,892,226,663,36,105,73,204,109,309
411605,202112,1673,3807,1072,2864,145,472,517,1392,662,1864
411610,202112,2841,6463,2022,5030,63,208,1417,3282,1480,3490
411620,202112,3002,7738,2516,6991,380,1133,1345,3718,1725,4851
411630,202112,880,2192,550,1584,57,195,200,504,257,699
411640,202112,497,1256,342,920,40,112,103,244,143,356
411650,202112,219,624,144,459,27,91,30,71,57,162
411660,202112,989,2476,697,1918,64,183,267,669,331,852
411670,202112,1587,3702,1077,2761,120,321,557,1302,677,1623
411680,202112,1530,3992,1153,3262,203,655,413,1103,616,1758
411690,202112,4259,10522,3187,8675,704,1880,804,2387,1508,4267
411695,202112,679,1987,468,1440,51,169,187,532,238,701
411700,202112,1836,4606,1209,3409,255,748,192,523,447,1271
411705,202112,2471,7014,2076,6334,431,1209,1110,3680,1541,4889
411710,202112,2178,5414,1480,4098,324,900,376,986,700,1886
411720,202112,1167,2693,816,2071,131,336,313,770,444,1106
411721,202112,1088,2620,818,2130,137,331,261,671,398,1002
411722,202112,977,2569,547,1619,94,307,181,440,275,747
411725,202112,1324,3615,872,2716,201,676,172,503,373,1179
411727,202112,1600,4319,1036,3105,225,673,90,245,315,918
411729,202112,703,1687,396,1078,55,184,132,302,187,486
411730,202112,5747,14732,4444,12258,835,2503,2038,5425,2873,7928
411740,202112,552,1407,293,846,81,209,53,142,134,351
411745,202112,866,2417,599,1822,66,239,152,351,218,590
411750,202112,6188,15899,4483,12574,573,1725,2137,5590,2710,7315
411760,202112,7462,19278,5759,16387,1729,5125,1025,3346,2754,8471
411770,202112,3404,9523,2452,7446,518,1694,441,1173,959,2867
411780,202112,2837,7800,2445,7091,677,2051,793,2332,1470,4383
411790,202112,3125,7377,1786,4966,349,1095,463,1087,812,2182
411800,202112,1212,3406,847,2516,138,457,161,411,299,868
411810,202112,1715,4336,1273,3473,224,640,524,1314,748,1954
411820,202112,13473,36721,11029,32479,2587,8154,4830,13749,7417,21903
411830,202112,574,1393,427,1131,103,287,61,168,164,455
411840,202112,13389,34747,9168,26007,1445,4412,2620,6597,4065,11009
411845,202112,655,1821,394,1219,60,213,96,252,156,465
411850,202112,8175,20219,5513,15513,1286,3875,1028,2620,2314,6495
411860,202112,754,2045,542,1609,74,222,119,316,193,538
411870,202112,634,1791,444,1379,91,284,95,283,186,567
411880,202112,2498,5978,1777,4825,258,762,676,1715,934,2477
411885,202112,1190,3040,861,2443,124,411,264,649,388,1060
411890,202112,1527,3976,1098,3192,189,620,111,300,300,920
411900,202112,895,2384,562,1682,127,399,103,300,230,699
411910,202112,1172,3340,853,2692,183,680,310,879,493,1559
411915,202112,16724,40385,11509,30852,1665,4893,4832,11622,6497,16515
411920,202112,1280,3554,1042,3088,222,760,386,1044,608,1804
411925,202112,526,1356,378,1087,80,238,158,419,238,657
411930,202112,5364,15502,4472,13861,1816,6144,289,1083,2105,7227
411940,202112,3540,9992,2741,8303,628,1917,935,2568,1563,4485
411950,202112,15803,41526,13051,36960,1592,5089,7810,21033,9402,26122
411960,202112,6540,16807,5146,14073,980,2820,2020,5289,3000,8109
411965,202112,519,1385,369,1082,53,170,170,460,223,630
411970,202112,1269,2791,976,2400,191,434,410,1168,601,1602
411980,202112,1592,3746,1150,3031,295,771,415,1069,710,1840
411990,202112,41642,105901,26928,79381,4848,15695,9658,26634,14506,42329
411995,202112,4511,10761,3461,9121,978,2803,857,2153,1835,4956
412000,202112,1966,4469,1361,3454,36,114,956,2254,992,2368
412010,202112,672,1988,495,1592,76,259,118,322,194,581
412015,202112,576,1583,464,1381,71,210,249,744,320,954
412020,202112,474,1296,297,926,41,148,128,371,169,519
412030,202112,648,1805,487,1509,68,214,178,533,246,747
412033,202112,1009,2595,721,2026,92,261,262,621,354,882
412035,202112,765,2034,490,1533,69,229,241,714,310,943
412040,202112,738,1939,407,1244,57,164,53,149,110,313
412050,202112,1688,4127,1138,3113,251,739,242,667,493,1406
412060,202112,7876,22051,6474,19258,1734,5758,1601,4535,3335,10293
412065,202112,666,1814,488,1455,99,321,118,340,217,661
412070,202112,1340,3395,1030,2793,129,374,393,965,522,1339
412080,202112,2507,6644,1746,5159,249,784,601,1560,850,2344
412085,202112,345,831,119,365,14,44,24,57,38,101
412090,202112,6713,16773,4904,13495,1085,3143,1802,4990,2887,8133
412100,202112,1903,4883,1395,3965,451,1442,296,872,747,2314
412110,202112,994,2552,635,1822,86,266,213,570,299,836
412120,202112,2308,6347,1740,5282,356,1211,438,1106,794,2317
412125,202112,710,1966,476,1467,90,271,93,281,183,552
412130,202112,866,2094,588,1582,92,237,145,395,237,632
412135,202112,656,1708,319,941,49,159,93,231,142,390
412140,202112,1955,4642,1357,3608,190,591,306,768,496,1359
412150,202112,3001,7544,2467,6559,572,1553,1074,2677,1646,4230
412160,202112,959,2907,527,1735,63,231,53,127,116,358
412170,202112,4700,12512,3926,11254,713,2317,1673,4386,2386,6703
412175,202112,1418,3913,1176,3502,268,840,459,1351,727,2191
412180,202112,1821,4910,1341,4039,163,548,570,1579,733,2127
412190,202112,3606,8824,2635,7114,320,950,1079,2840,1399,3790
412200,202112,2028,5692,1333,4126,336,1116,181,522,517,1638
412210,202112,720,1659,443,1204,59,184,178,427,237,611
412215,202112,3474,9148,2555,7335,635,1805,952,2873,1587,4678
412217,202112,1053,2683,872,2358,36,93,624,1617,660,1710
412220,202112,6036,16570,4957,14623,1381,3974,1382,4336,2763,8310
412230,202112,2895,8209,2250,6977,337,1195,513,1353,850,2548
412240,202112,8197,20789,5213,14882,884,2707,1517,3833,2401,6540
412250,202112,2173,5461,1591,4337,373,1060,291,714,664,1774
412260,202112,1392,3583,1047,2891,175,486,309,807,484,1293
412265,202112,1006,2613,797,2255,174,511,334,892,508,1403
412270,202112,1083,2909,698,2102,86,287,266,734,352,1021
412280,202112,448,1188,347,1018,89,266,89,243,178,509
412290,202112,1110,2767,783,2194,126,388,266,681,392,1069
412300,202112,1795,4573,1260,3639,250,748,279,815,529,1563
412310,202112,772,2151,584,1767,99,350,169,464,268,814
412320,202112,825,2069,525,1461,47,154,147,404,194,558
412330,202112,1697,4404,1166,3426,249,770,393,1166,642,1936
412340,202112,1337,3546,892,2591,112,369,115,309,227,678
412350,202112,3265,8372,2099,6063,375,1186,396,1008,771,2194
412360,202112,288,766,210,600,6,28,140,374,146,402
412370,202112,899,2491,610,1878,119,399,81,234,200,633
412380,202112,1650,4402,1162,3437,291,896,110,362,401,1258
412382,202112,515,1231,341,947,37,132,158,357,195,489
412385,202112,2423,6380,1964,5521,660,1775,566,1770,1226,3545
412390,202112,2675,6246,2144,5433,355,957,727,1816,1082,2773
412395,202112,755,2069,546,1606,80,199,230,686,310,885
412400,202112,983,2524,706,1991,133,419,202,535,335,954
412402,202112,2485,5958,1710,4698,440,1199,254,743,694,1942
412405,202112,3354,8634,2185,6479,529,1758,158,445,687,2203
412410,202112,6755,17150,4926,14130,777,2594,1569,4136,2346,6730
412420,202112,572,1410,379,1019,27,75,188,434,215,509
412430,202112,618,1533,333,947,36,106,134,351,170,457
412440,202112,3025,7815,2050,6025,476,1457,451,1329,927,2786
412450,202112,536,1502,354,1043,42,123,30,58,72,181
412460,202112,1178,2955,917,2516,167,500,403,1041,570,1541
412470,202112,1653,5002,1349,4326,288,976,289,904,577,1880
412480,202112,1176,2989,788,2196,136,409,276,665,412,1074
412490,202112,1413,3369,1101,2817,137,357,563,1340,700,1697
412500,202112,2170,5329,1629,4343,328,916,468,1113,796,2029
412510,202112,2071,6122,1421,4512,323,1062,171,477,494,1539
412520,202112,1407,3494,794,2238,177,479,114,309,291,788
412530,202112,734,1896,526,1480,77,249,111,294,188,543
412535,202112,856,2205,581,1673,113,362,108,243,221,605
412540,202112,1230,3055,889,2459,93,324,291,851,384,1175
412545,202112,729,1854,505,1414,87,262,134,357,221,619
412550,202112,37404,96829,26626,75540,4050,12421,11117,28289,15167,40710
412555,202112,311,805,209,586,24,77,66,149,90,226
412560,202112,5397,14948,4044,11888,738,2350,1178,3430,1916,5780
412570,202112,4759,11742,2775,7935,473,1564,370,1036,843,2600
412575,202112,1118,2747,898,2382,130,367,473,1183,603,1550
412580,202112,1594,3988,1129,3120,88,274,621,1613,709,1887
412590,202112,435,1132,242,735,29,93,30,78,59,171
412600,202112,1764,4550,1356,3781,161,498,668,1717,829,2215
412610,202112,920,2408,656,1848,82,245,289,702,371,947
412620,202112,1362,3448,1048,2974,194,630,341,881,535,1511
412625,202112,9373,24285,5789,17162,797,2632,344,953,1141,3585
412627,202112,1188,3272,774,2419,144,494,214,655,358,1149
412630,202112,3017,8625,2162,6801,384,1260,589,1664,973,2924
412635,202112,460,1216,305,881,35,112,100,224,135,336
412640,202112,1110,2863,656,1910,85,257,164,406,249,663
412650,202112,1812,4779,1421,4002,234,754,542,1313,776,2067
412660,202112,2795,6994,2026,5551,238,688,740,1816,978,2504
412665,202112,423,1021,323,846,75,204,127,321,202,525
412667,202112,1924,4916,1397,3870,197,592,597,1584,794,2176
412670,202112,912,2108,594,1593,111,326,152,382,263,708
412680,202112,2238,5764,1548,4475,182,620,539,1336,721,1956
412690,202112,1235,3186,862,2457,151,463,275,716,426,1179
412700,202112,2044,5253,1706,4720,219,664,927,2491,1146,3155
412710,202112,6280,17724,4617,14177,825,2782,1188,3112,2013,5894
412720,202112,1285,3618,1003,3017,146,476,257,628,403,1104
412730,202112,2750,7012,1935,5428,319,1028,757,1935,1076,2963
412740,202112,2073,5656,1427,4356,214,711,185,588,399,1299
412750,202112,4284,10874,3478,9693,337,1022,2214,5899,2551,6921
412760,202112,3128,8282,2594,7382,487,1538,1377,3663,1864,5201
412770,202112,11652,29521,6281,18829,795,2557,1316,3230,2111,5787
412780,202112,1269,3289,967,2746,198,621,354,949,552,1570
412785,202112,2321,5328,1644,4218,196,490,1065,2698,1261,3188
412788,202112,1522,4181,1241,3690,343,1013,446,1297,789,2310
412790,202112,1449,3740,848,2540,122,411,268,682,390,1093
412795,202112,1343,3406,727,2158,111,341,121,339,232,680
412796,202112,2444,6727,2031,5999,440,1359,602,1627,1042,2986
412800,202112,3965,9435,2780,7263,286,863,1325,3045,1611,3908
412810,202112,13294,33383,8716,24204,1035,3330,3500,8544,4535,11874
412820,202112,6649,17787,4692,13851,1127,3546,1316,3813,2443,7359
412830,202112,359,994,259,786,34,96,66,189,100,285
412840,202112,2010,4833,1438,3756,155,459,707,1662,862,2121
412850,202112,2944,7524,2165,6202,295,908,943,2555,1238,3463
412853,202112,1642,4035,1361,3532,185,542,708,1595,893,2137
412855,202112,1450,3670,842,2405,111,370,203,479,314,849
412860,202112,799,1963,544,1542,85,259,269,699,354,958
412862,202112,710,1725,478,1333,100,280,171,454,271,734
412863,202112,1360,3922,1191,3603,299,951,389,1125,688,2076
412865,202112,748,1990,545,1580,163,493,115,338,278,831
412870,202112,917,2337,663,1922,185,588,161,507,346,1095
412880,202112,953,2517,652,1934,124,397,154,403,278,800
420005,202112,439,1255,259,841,32,101,123,401,155,502
420010,202112,3520,8397,2317,6363,130,372,1709,4726,1839,5098
420020,202112,467,1411,307,995,45,171,76,186,121,357
420030,202112,103,361,64,262,18,85,16,62,34,147
420040,202112,563,1645,340,1151,62,235,28,80,90,315
420050,202112,753,1689,504,1255,106,285,267,598,373,883
420055,202112,170,513,91,320,22,93,24,75,46,168
420060,202112,125,346,81,239,9,29,19,47,28,76
420070,202112,799,2321,589,1876,110,356,239,741,349,1097
420075,202112,84,213,45,135,6,23,11,17,17,40
420080,202112,420,1152,320,922,74,243,120,322,194,565
420090,202112,452,1364,284,970,64,228,54,158,118,386
420100,202112,1372,3389,1149,3056,67,190,922,2417,989,2607
420110,202112,277,865,244,795,41,139,126,404,167,543
420120,202112,632,1678,431,1251,56,179,227,581,283,760
420125,202112,381,1122,261,853,67,238,82,247,149,485
420127,202112,332,854,135,409,18,62,52,146,70,208
420130,202112,4061,10926,3122,9381,479,1688,1382,3751,1861,5439
420140,202112,4134,10797,3065,8978,830,2718,565,1663,1395,4381
420150,202112,699,1733,487,1378,48,163,287,774,335,937
420160,202112,193,454,71,215,8,28,20,59,28,87
420165,202112,170,478,106,338,21,62,35,95,56,157
420170,202112,288,877,192,635,31,114,61,170,92,284
420180,202112,173,543,105,368,15,55,26,86,41,141
420190,202112,224,665,130,430,28,103,49,155,77,258
420195,202112,1695,4243,1283,3601,317,1015,376,978,693,1993
420200,202112,5796,13749,3649,9807,458,1458,1614,3727,2072,5185
420205,202112,2107,5494,1438,4138,212,651,748,2120,960,2771
420207,202112,2125,5350,1330,3849,201,650,548,1457,749,2107
420208,202112,346,961,202,679,63,221,44,120,107,341
420209,202112,164,510,106,327,13,45,54,149,67,194
420210,202112,3643,9122,2567,7357,363,1209,1330,3591,1693,4800
420213,202112,850,2477,709,2199,146,511,276,799,422,1310
420215,202112,226,662,157,504,36,127,41,121,77,248
420220,202112,320,938,201,678,29,127,87,260,116,387
420230,202112,5692,14920,4361,12455,582,1822,2375,6402,2957,8224
420240,202112,15641,42522,10066,29663,1191,4014,4845,12333,6036,16347
420243,202112,419,1128,345,987,59,193,215,584,274,777
420245,202112,1669,4174,1252,3453,98,331,792,2030,890,2361
420250,202112,484,1315,416,1202,53,174,269,740,322,914
420253,202112,485,1148,342,942,37,93,194,538,231,631
420257,202112,165,417,104,310,13,50,59,173,72,223
420260,202112,1188,2992,880,2578,108,375,612,1749,720,2124
420270,202112,584,1503,306,883,38,124,117,306,155,430
420280,202112,1418,4086,1130,3484,188,663,464,1342,652,2005
420285,202112,131,299,69,198,10,44,25,44,35,88
420287,202112,475,1068,340,888,82,225,131,344,213,569
420290,202112,5232,14534,4036,11899,545,1815,2339,6376,2884,8191
420300,202112,7961,21998,4647,14180,831,2794,1494,3938,2325,6732
420310,202112,869,1960,466,1253,41,128,267,665,308,793
420315,202112,834,2264,564,1810,89,307,274,857,363,1164
420320,202112,5782,15038,4154,12381,1099,3642,1090,3006,2189,6648
420325,202112,362,1008,258,801,34,112,107,305,141,417
420330,202112,1034,2965,657,2156,105,386,203,607,308,993
420340,202112,1015,2730,759,2267,162,488,165,424,327,912
420350,202112,1257,3149,935,2587,78,257,648,1748,726,2005
420360,202112,3104,8277,1666,5195,293,1004,115,341,408,1345
420370,202112,1341,3430,1094,3017,75,257,806,2126,881,2383
420380,202112,4715,12019,3188,9241,619,1892,1284,3475,1903,5367
420390,202112,1113,2674,775,2001,133,389,312,582,445,971
420395,202112,1257,3502,864,2695,135,471,137,297,272,768
420400,202112,1102,2971,771,2308,123,423,350,984,473,1407
420410,202112,608,1561,473,1286,37,110,338,899,375,1009
420415,202112,314,891,228,712,54,187,89,285,143,472
420417,202112,619,1788,487,1525,109,356,208,666,317,1022
420419,202112,146,514,115,440,40,163,8,32,48,195
420420,202112,13005,33203,8712,25287,2302,7535,2573,6765,4875,14300
420425,202112,670,1763,460,1319,32,107,245,672,277,779
420430,202112,3319,8690,1992,5853,425,1318,684,1812,1109,3130
420435,202112,291,737,150,468,22,86,72,207,94,293
420440,202112,738,1914,464,1353,129,387,149,407,278,794
420445,202112,270,641,180,482,30,83,76,173,106,256
420450,202112,813,2341,581,1828,88,335,215,572,303,907
420455,202112,2192,5115,1612,4258,313,830,731,1908,1044,2738
420460,202112,9932,25854,7515,21410,1017,3269,3936,10621,4953,13890
420470,202112,647,1655,339,1026,64,224,70,166,134,390
420475,202112,74,197,31,100,7,25,4,11,11,36
420480,202112,5563,13409,3473,9993,641,1993,1299,3660,1940,5653
420490,202112,398,1085,276,821,50,158,112,319,162,477
420500,202112,1398,3715,904,2827,144,508,418,1269,562,1777
420510,202112,166,467,87,285,12,50,24,70,36,120
420515,202112,89,245,57,175,9,38,18,55,27,93
420517,202112,785,2111,658,1873,80,234,397,1129,477,1363
420519,202112,325,775,235,642,20,64,146,397,166,461
420520,202112,284,747,147,482,17,60,9,25,26,85
420530,202112,853,2433,583,1841,77,292,234,632,311,924
420535,202112,238,684,101,330,17,58,42,128,59,186
420540,202112,41890,98800,27908,75053,3796,11432,10673,24772,14469,36204
420543,202112,229,662,173,533,25,77,78,218,103,295
420545,202112,1368,4018,1029,3274,190,670,351,1006,541,1676
420550,202112,3835,9892,2533,7731,362,1292,1161,3547,1523,4839
420555,202112,318,897,228,709,25,83,130,387,155,470
420560,202112,411,1010,277,810,52,157,161,477,213,634
420570,202112,2725,7020,2095,5864,325,1011,998,2677,1323,3688
420580,202112,1869,4791,1310,3878,274,861,380,1110,654,1971
420590,202112,2956,7829,1792,5309,278,971,504,1141,782,2112
420600,202112,1140,3179,887,2712,96,369,542,1566,638,1935
420610,202112,414,1180,271,869,67,215,95,320,162,535
420620,202112,825,1965,567,1556,122,349,215,574,337,923
420630,202112,976,2912,721,2295,85,295,418,1261,503,1556
420640,202112,528,1404,268,871,86,280,48,145,134,425
420650,202112,3911,10097,2492,7188,354,1140,1030,2551,1384,3691
420660,202112,455,1156,287,801,55,151,61,158,116,309
420665,202112,721,1845,476,1424,86,277,205,553,291,830
420670,202112,1336,3650,834,2580,122,468,287,735,409,1203
420675,202112,196,508,117,359,16,63,62,175,78,238
420680,202112,320,721,170,512,27,89,86,248,113,337
420690,202112,891,2567,556,1799,67,265,156,420,223,685
420700,202112,2884,7434,2211,6317,209,671,1413,3896,1622,4567
420710,202112,1138,3152,896,2641,96,356,531,1372,627,1728
420720,202112,1312,3531,961,2919,152,506,509,1441,661,1947
420730,202112,3380,8625,2531,7230,431,1367,1338,3631,1769,4998
420740,202112,519,1519,285,1000,56,215,18,69,74,284
420750,202112,2111,5950,1375,4271,225,830,543,1502,768,2332
420757,202112,88,215,40,121,3,5,20,63,23,68
420760,202112,328,926,179,541,35,122,54,134,89,256
420765,202112,505,1417,254,814,28,93,134,415,162,508
420768,202112,1416,3847,1234,3553,145,399,914,2644,1059,3043
420770,202112,436,1199,196,687,22,87,55,183,77,270
420775,202112,297,850,201,634,39,139,74,193,113,332
420780,202112,1012,2821,589,1832,92,304,84,235,176,539
420785,202112,215,563,158,447,13,50,75,170,88,220
420790,202112,1106,3196,834,2645,147,518,469,1413,616,1931
420800,202112,702,1707,385,1095,83,261,172,469,255,730
420810,202112,1560,4647,1287,4112,326,1213,530,1445,856,2658
420820,202112,13813,34019,10020,27800,1688,5185,4667,12003,6355,17188
420830,202112,4905,12570,3641,10339,628,1895,1524,4126,2152,6021
420840,202112,511,1536,257,948,57,210,20,79,77,289
420845,202112,2781,6981,1796,5225,332,1182,744,1999,1076,3181
420850,202112,1164,3609,730,2479,116,426,169,502,285,928
420860,202112,392,1015,224,709,35,113,57,158,92,271
420870,202112,836,2309,607,1858,147,474,193,536,340,1010
420880,202112,1125,3314,870,2786,173,648,335,967,508,1615
420890,202112,8539,22897,5337,16233,726,2409,1851,4943,2577,7352
420895,202112,185,529,118,357,29,88,37,112,66,200
420900,202112,1619,3924,982,2824,129,443,450,1107,579,1550
420910,202112,34702,89952,22415,66467,3167,10627,9270,24061,12437,34688
420915,202112,536,1874,396,1477,65,243,210,793,275,1036
420917,202112,475,1192,215,587,37,98,102,279,139,377
420920,202112,88,228,39,125,2,5,10,31,12,36
420930,202112,17740,44841,12702,36045,2108,6575,5822,15485,7930,22060
420940,202112,3422,8226,2098,5967,452,1449,439,988,891,2437
420945,202112,153,433,112,341,20,68,44,124,64,192
420950,202112,376,1058,226,716,29,107,61,175,90,282
420960,202112,1125,2719,800,2174,114,358,376,922,490,1280
420970,202112,2555,6736,1735,5240,446,1388,473,1451,919,2839
420980,202112,287,952,247,863,110,393,57,204,167,597
420985,202112,343,961,186,629,41,153,48,143,89,296
420990,202112,348,1058,195,682,31,103,40,137,71,240
421000,202112,583,1706,430,1377,90,303,95,261,185,564
421003,202112,483,1133,165,478,3,8,19,43,22,51
421005,202112,85,241,60,199,16,53,22,74,38,127
421010,202112,3574,9491,2565,7615,459,1552,749,1923,1208,3475
421020,202112,408,1233,323,1073,46,182,157,484,203,666
421030,202112,888,2512,680,2110,170,595,258,726,428,1321
421040,202112,682,1603,420,1200,33,103,263,736,296,839
421050,202112,1118,2962,746,2157,139,427,288,749,427,1176
421055,202112,181,489,103,312,17,59,57,157,74,216
421060,202112,714,2021,500,1568,87,310,246,700,333,1010
421070,202112,701,2060,422,1351,59,211,171,501,230,712
421080,202112,523,1483,428,1303,47,177,242,704,289,881
421085,202112,396,1104,166,559,16,49,27,72,43,121
421090,202112,279,714,154,428,13,45,53,128,66,173
421100,202112,838,1862,371,1088,82,266,100,237,182,503
421105,202112,1697,4473,1195,3536,173,554,582,1611,755,2165
421110,202112,1220,3135,983,2783,81,252,624,1836,705,2088
421120,202112,1120,3281,775,2520,116,402,216,600,332,1002
421125,202112,302,772,217,621,73,243,73,176,146,419
421130,202112,5377,15229,4396,13259,961,3242,2197,6206,3158,9448
421140,202112,362,968,228,682,40,118,88,239,128,357
421145,202112,456,1214,294,867,68,210,80,207,148,417
421150,202112,714,1943,480,1470,73,253,206,558,279,811
421160,202112,554,1514,420,1253,61,211,253,702,314,913
421165,202112,236,679,144,458,27,90,58,171,85,261
421170,202112,1147,3072,968,2782,140,395,605,1776,745,2171
421175,202112,997,2412,595,1782,111,378,270,773,381,1151
421180,202112,414,1068,230,702,37,138,111,302,148,440
421185,202112,334,839,230,632,28,85,128,335,156,420
421187,202112,281,855,177,590,30,99,60,196,90,295
421189,202112,413,1159,322,978,53,168,122,344,175,512
421190,202112,12635,33280,8742,25862,1488,4716,3398,9127,4886,13843
421200,202112,752,2050,615,1819,94,332,349,971,443,1303
421205,202112,200,519,143,427,26,86,65,184,91,270
421210,202112,1158,2856,663,2009,122,387,226,675,348,1062
421220,202112,1454,4196,1127,3529,260,900,370,1018,630,1918
421223,202112,328,880,204,655,48,150,101,326,149,476
421225,202112,900,2557,768,2339,114,411,474,1411,588,1822
421227,202112,742,2060,475,1498,80,272,218,712,298,984
421230,202112,614,1567,397,1160,83,274,140,396,223,670
421240,202112,309,880,152,515,16,66,31,91,47,157
421250,202112,2232,5509,1587,4475,190,579,941,2552,1131,3131
421260,202112,230,717,53,191,11,51,5,14,16,65
421265,202112,763,1923,667,1789,23,56,579,1541,602,1597
421270,202112,374,991,168,560,33,114,53,158,86,272
421280,202112,2165,5608,1621,4710,220,764,915,2497,1135,3261
421290,202112,1049,2843,521,1565,108,350,102,265,210,615
421300,202112,294,755,139,446,12,46,19,57,31,103
421310,202112,215,613,147,481,31,101,68,219,99,320
421315,202112,257,648,174,482,43,119,51,143,94,262
421320,202112,647,2020,345,1138,31,87,34,59,65,146
421330,202112,662,1913,474,1516,94,335,123,343,217,678
421335,202112,373,1117,298,984,55,199,128,405,183,604
421340,202112,1472,3960,1051,3208,180,622,499,1403,679,2025
421350,202112,1658,4169,1076,3168,203,656,401,1116,604,1772
421360,202112,2407,6256,1444,4335,290,972,506,1324,796,2296
421370,202112,793,2466,496,1678,84,305,153,424,237,729
421380,202112,891,2258,768,2067,97,297,459,1172,556,1469
421390,202112,169,445,65,216,15,41,23,67,38,108
421400,202112,477,1303,310,968,52,189,162,460,214,649
421410,202112,193,506,89,298,23,76,25,86,48,162
421415,202112,194,538,135,388,19,62,48,113,67,175
421420,202112,600,1571,478,1340,43,136,291,786,334,922
421430,202112,102,317,73,244,11,38,16,47,27,85
421440,202112,692,1824,414,1288,74,229,164,488,238,717
421450,202112,501,1432,286,943,30,111,42,137,72,248
421460,202112,369,1116,197,733,11,43,18,52,29,95
421470,202112,332,897,214,655,29,88,75,246,104,334
421480,202112,2924,7673,1953,5713,333,1145,794,2107,1127,3252
421490,202112,118,394,69,256,11,39,12,41,23,80
421500,202112,2271,6482,1535,4929,358,1316,353,974,711,2290
421505,202112,317,849,264,774,33,119,172,478,205,597
421507,202112,449,1214,257,812,52,187,96,273,148,460
421510,202112,385,1038,245,709,39,113,122,317,161,430
421520,202112,511,1343,320,914,37,104,152,388,189,492
421530,202112,303,884,170,586,24,103,31,79,55,182
421535,202112,415,1067,254,767,40,140,129,371,169,511
421540,202112,329,752,178,518,25,84,60,155,85,239
421545,202112,652,1903,489,1610,101,405,234,703,335,1108
421550,202112,2186,5670,1751,4989,339,1027,939,2638,1278,3665
421555,202112,174,528,69,247,7,28,9,15,16,43
421560,202112,93,310,63,235,9,39,23,77,32,116
421565,202112,992,2464,682,1980,175,572,238,642,413,1214
421567,202112,478,1439,334,1069,97,336,99,289,196,625
421568,202112,338,975,233,732,41,149,85,240,126,389
421569,202112,156,441,73,236,9,28,44,144,53,172
421570,202112,1429,3824,1017,2969,214,681,344,895,558,1576
421575,202112,301,861,226,664,28,93,114,306,142,399
421580,202112,4667,12355,2993,8923,418,1434,1146,2871,1564,4305
421590,202112,175,515,129,414,32,112,47,145,79,257
421600,202112,608,1581,411,1169,78,254,145,352,223,606
421605,202112,729,1887,527,1564,103,286,251,783,354,1069
421610,202112,1082,2838,722,2157,126,409,213,618,339,1027
421620,202112,4100,10643,2541,7827,478,1681,832,2415,1310,4096
421625,202112,139,380,70,211,8,25,23,58,31,83
421630,202112,2818,7239,1810,5315,308,1060,652,1611,960,2671
421635,202112,278,734,194,561,14,43,120,317,134,360
421640,202112,708,1874,518,1592,113,387,214,642,327,1029
421650,202112,2644,7058,1801,5518,385,1342,585,1592,970,2934
421660,202112,11586,31353,8219,24760,1157,3900,3786,10327,4943,14227
421670,202112,798,2232,575,1713,99,333,266,746,365,1079
421680,202112,1284,3230,1003,2772,126,382,683,1749,809,2131
421690,202112,1476,4079,1012,3121,177,602,329,978,506,1580
421700,202112,589,1710,421,1335,86,303,127,371,213,674
421710,202112,209,645,104,334,18,59,31,88,49,147
421715,202112,132,336,99,268,22,61,58,150,80,211
421720,202112,2137,5653,1253,3765,294,936,315,818,609,1754
421725,202112,276,662,158,464,18,53,73,184,91,237
421730,202112,431,1190,256,729,39,116,136,347,175,463
421740,202112,825,2295,550,1706,119,385,166,466,285,851
421750,202112,911,2114,448,1272,92,281,179,479,271,760
421755,202112,173,471,95,286,15,50,39,102,54,152
421760,202112,1071,2748,730,2135,136,425,244,600,380,1025
421770,202112,2536,6524,1803,5263,455,1253,625,1949,1080,3202
421775,202112,218,561,134,400,18,56,55,150,73,206
421780,202112,888,2540,579,1876,109,384,238,695,347,1079
421790,202112,907,2421,510,1660,102,351,202,636,304,987
421795,202112,178,493,125,365,22,70,38,99,60,169
421800,202112,2909,7597,2135,6174,270,887,1238,3365,1508,4252
421810,202112,651,1752,441,1359,46,163,251,760,297,923
421820,202112,1053,3004,652,2038,105,375,232,597,337,972
421825,202112,1440,3821,1280,3585,95,294,963,2629,1058,2923
421830,202112,1936,5398,1537,4652,301,983,518,1502,819,2485
421835,202112,250,600,168,470,34,117,73,184,107,301
421840,202112,213,673,148,526,23,87,36,114,59,201
421850,202112,398,1105,228,765,53,201,53,137,106,338
421860,202112,320,885,188,611,32,109,64,182,96,291
421870,202112,4864,11905,3580,9510,471,1496,1979,4641,2450,6137
421875,202112,330,957,137,422,19,58,32,81,51,139
421880,202112,706,1959,472,1444,92,312,136,386,228,698
421885,202112,246,663,156,463,35,109,59,154,94,263
421890,202112,933,2663,696,2193,110,418,395,1167,505,1585
421895,202112,424,1052,366,976,37,103,250,703,287,806
421900,202112,1098,2875,847,2366,105,326,415,1048,520,1374
421910,202112,336,967,218,685,27,99,48,117,75,216
421915,202112,409,1135,250,772,58,179,45,129,103,308
421917,202112,613,1376,348,1035,122,377,78,242,200,619
421920,202112,401,1194,285,960,112,390,80,274,192,664
421930,202112,2824,7005,1550,4596,328,1092,551,1395,879,2487
421935,202112,425,1284,342,1113,70,231,191,619,261,850
421940,202112,395,1121,181,565,27,89,43,102,70,191
421950,202112,3281,8090,1856,5377,358,1118,457,1130,815,2248
421960,202112,184,448,96,286,14,52,29,66,43,118
421970,202112,2037,5131,1303,3637,241,787,536,1299,777,2086
421985,202112,318,862,206,641,25,77,83,242,108,319
422000,202112,2038,5085,1654,4498,148,479,1145,3052,1293,3531
430003,202112,596,1557,393,1195,73,227,173,523,246,750
430005,202112,276,732,175,546,26,89,84,255,110,344
430010,202112,1879,4299,1480,3690,307,756,818,2072,1125,2828
430020,202112,612,1364,458,1158,49,142,300,720,349,862
430030,202112,1038,2380,589,1585,150,420,201,498,351,918
430040,202112,10996,25188,6753,17944,1763,4912,1095,2990,2858,7902
430045,202112,504,1236,365,982,29,89,254,660,283,749
430047,202112,254,546,97,258,22,50,27,76,49,126
430050,202112,920,2275,554,1546,109,328,163,420,272,748
430055,202112,285,684,143,391,18,56,72,171,90,227
430057,202112,87,181,32,86,9,28,6,13,15,41
430060,202112,19106,49173,14899,42526,2891,8547,7150,20121,10041,28668
430063,202112,843,2286,692,1984,154,434,363,1048,517,1482
430064,202112,1199,3113,884,2499,178,517,406,1125,584,1642
430066,202112,100,209,71,166,9,24,55,122,64,146
430070,202112,752,1912,142,447,21,76,23,50,44,126
430080,202112,959,2309,578,1563,103,326,307,704,410,1030
430085,202112,969,2081,580,1463,98,249,263,641,361,890
430087,202112,888,2084,742,1894,69,170,525,1340,594,1510
430090,202112,491,1258,183,591,18,77,44,126,62,203
430100,202112,949,2221,579,1545,100,304,168,377,268,681
430105,202112,1363,3475,924,2716,128,425,448,1263,576,1688
430107,202112,183,522,98,300,17,52,28,74,45,126
430110,202112,2361,5763,1738,4818,329,934,778,2109,1107,3043
430120,202112,1330,3727,876,2622,152,452,390,1147,542,1599
430130,202112,3752,8243,2779,6894,881,2223,498,1504,1379,3727
430140,202112,1078,2694,757,2115,162,435,377,1027,539,1462
430150,202112,590,1498,324,970,71,221,87,269,158,490
430155,202112,251,634,121,360,19,57,24,59,43,116
430160,202112,21804,48770,17178,42303,1909,4959,10587,25615,12496,30574
430163,202112,3436,7716,2417,6155,70,227,1838,4573,1908,4800
430165,202112,326,800,109,340,13,32,17,47,30,79
430170,202112,995,2582,353,1175,57,196,44,117,101,313
430175,202112,764,2063,653,1840,152,393,305,893,457,1286
430180,202112,706,1687,532,1385,85,203,294,786,379,989
430185,202112,725,1818,367,1054,103,262,49,149,152,411
430187,202112,835,1736,608,1454,65,160,379,894,444,1054
430190,202112,1516,3736,1196,3233,242,702,555,1409,797,2111
430192,202112,129,339,45,129,7,21,9,21,16,42
430195,202112,464,1315,74,245,8,28,13,30,21,58
430200,202112,1154,3249,907,2803,297,959,200,662,497,1621
430205,202112,489,1194,438,1102,13,43,397,979,410,1022
430210,202112,6633,16759,4395,12048,699,2054,1265,2724,1964,4778
430215,202112,333,837,212,599,34,96,81,230,115,326
430220,202112,674,1654,215,699,26,85,52,142,78,227
430222,202112,220,576,156,455,24,72,47,138,71,210
430223,202112,272,687,210,584,16,40,120,327,136,367
430225,202112,16,32,10,23,0,0,7,16,7,16
430230,202112,2074,5438,1713,4887,139,438,1275,3567,1414,4005
430235,202112,409,1109,260,789,47,154,65,166,112,320
430237,202112,542,1233,406,1014,16,45,317,775,333,820
430240,202112,1433,3271,807,2190,91,282,409,1002,500,1284
430245,202112,764,2029,597,1715,124,366,315,922,439,1288
430250,202112,995,2312,717,1870,250,693,55,123,305,816
430258,202112,147,403,105,315,7,16,55,161,62,177
430260,202112,736,1855,498,1412,60,197,280,799,340,996
430265,202112,237,668,158,515,29,90,56,194,85,284
430270,202112,3163,7464,2498,6446,369,1048,1601,3968,1970,5016
430280,202112,5449,12243,3820,9530,750,1913,1679,4088,2429,6001
430290,202112,2362,5280,1936,4782,79,228,1602,3860,1681,4088
430300,202112,11052,26485,8360,21935,1298,3715,4457,11230,5755,14945
430310,202112,13432,32295,9245,24666,1170,3432,4675,11566,5845,14998
430320,202112,1093,2652,613,1722,63,168,359,1009,422,1177
430330,202112,735,1733,441,1166,89,240,161,392,250,632
430340,202112,652,1490,425,1125,66,166,259,672,325,838
430350,202112,8759,20779,6741,17384,720,2040,4307,10464,5027,12504
430355,202112,347,935,129,410,14,48,18,46,32,94
430360,202112,927,2151,606,1598,115,353,224,546,339,899
430367,202112,369,799,216,543,43,129,107,242,150,371
430370,202112,566,1475,230,670,36,100,60,141,96,241
430380,202112,727,1746,347,1044,74,246,95,276,169,522
430390,202112,3697,8622,2308,6154,439,1300,291,538,730,1838
430400,202112,1080,2263,815,1908,68,182,488,1099,556,1281
430410,202112,574,1314,403,1042,56,150,263,661,319,811
430420,202112,2843,7195,2201,5895,404,1188,1196,2989,1600,4177
430430,202112,613,1514,270,817,61,172,52,168,113,340
430435,202112,1675,4101,1275,3453,233,660,639,1712,872,2372
430440,202112,4158,10901,3315,9496,306,943,2114,6016,2420,6959
430450,202112,7187,17174,5746,14674,1233,3277,2687,6585,3920,9862
430460,202112,37737,92240,28318,76726,4322,12768,14803,38247,19125,51015
430461,202112,236,614,78,238,14,50,33,80,47,130
430462,202112,338,860,173,529,32,101,44,120,76,221
430463,202112,6818,17330,5012,14009,955,2981,2303,6069,3258,9050
430465,202112,475,1177,378,996,67,192,234,595,301,787
430466,202112,4833,11648,3835,10096,768,2089,1931,4817,2699,6906
430467,202112,519,1220,361,979,52,165,195,478,247,643
430468,202112,1373,3269,1098,2867,81,247,799,2030,880,2277
430469,202112,605,1617,87,258,11,34,19,41,30,75
430470,202112,6053,15160,4016,11526,1099,3424,970,2565,2069,5989
430471,202112,598,1648,494,1460,81,245,284,806,365,1051
430480,202112,677,1843,429,1312,58,191,102,257,160,448
430485,202112,177,454,71,208,20,57,11,30,31,87
430490,202112,455,1135,242,714,26,94,114,287,140,381
430495,202112,416,1089,276,831,44,135,118,331,162,466
430500,202112,1043,2607,729,2075,240,737,199,515,439,1252
430510,202112,29671,74249,21169,58230,3405,10383,9700,24489,13105,34872
430511,202112,382,1034,142,455,14,47,18,54,32,101
430512,202112,1054,2287,820,1940,185,450,296,703,481,1153
430513,202112,839,2027,396,1101,69,198,182,466,251,664
430515,202112,403,1089,292,869,41,117,154,456,195,573
430517,202112,1272,3606,965,2924,162,480,530,1609,692,2089
430520,202112,1450,3531,771,2111,135,386,181,431,316,817
430530,202112,1028,2505,429,1248,71,212,112,314,183,526
430535,202112,3814,9470,2753,7540,379,1063,1397,3674,1776,4737
430537,202112,424,1287,365,1153,26,79,278,880,304,959
430540,202112,641,1508,361,1026,70,199,172,481,242,680
430543,202112,1066,1829,636,1326,76,161,236,566,312,727
430544,202112,791,2156,544,1620,131,402,167,483,298,885
430545,202112,2623,6371,1967,5392,309,854,1116,3063,1425,3917
430550,202112,367,1009,263,788,54,169,95,263,149,432
430558,202112,119,278,56,156,7,14,21,60,28,74
430560,202112,300,687,151,438,27,86,52,138,79,224
430570,202112,914,2197,655,1730,116,352,298,692,414,1044
430580,202112,877,2127,627,1746,174,512,249,726,423,1238
430583,202112,202,494,40,122,4,12,11,23,15,35
430585,202112,233,568,122,341,18,44,41,103,59,147
430587,202112,212,553,158,462,22,71,62,168,84,239
430590,202112,1424,3372,1173,2993,85,248,924,2299,1009,2547
430593,202112,22,65,14,40,2,4,6,17,8,21
430595,202112,439,1093,119,372,12,34,20,48,32,82
430597,202112,470,1166,244,713,27,79,71,171,98,250
430600,202112,2095,5323,873,2450,139,408,186,467,325,875
430605,202112,1382,3492,1009,2818,119,357,493,1326,612,1683
430607,202112,664,1452,479,1171,39,96,328,783,367,879
430610,202112,6067,13744,4058,10757,1060,3234,909,2291,1969,5525
430613,202112,297,682,85,246,10,26,21,53,31,79
430620,202112,697,1664,520,1341,82,242,303,693,385,935
430630,202112,444,1185,126,389,23,74,32,79,55,153
430632,202112,471,1200,207,595,38,100,78,215,116,315
430635,202112,600,1342,452,1092,45,115,335,798,380,913
430637,202112,478,1117,365,950,37,112,247,623,284,735
430640,202112,1160,3029,776,2245,119,356,308,817,427,1173
430642,202112,380,1017,275,789,47,133,130,349,177,482
430645,202112,163,385,68,181,14,40,20,40,34,80
430650,202112,1854,4938,1454,4274,435,1248,562,1838,997,3086
430655,202112,324,776,193,530,28,88,97,232,125,320
430660,202112,5515,13539,4213,11428,861,2422,1923,5143,2784,7565
430670,202112,673,1581,506,1299,74,194,248,637,322,831
430673,202112,565,1255,245,671,43,116,91,228,134,344
430675,202112,257,738,62,217,6,17,11,33,17,50
430676,202112,5620,13457,4515,11796,603,1644,2818,7210,3421,8854
430680,202112,1122,2883,662,1949,193,545,153,430,346,975
430690,202112,3112,8041,2461,6882,841,2435,696,1909,1537,4344
430692,202112,220,658,172,577,11,36,131,450,142,486
430693,202112,1002,2564,607,1800,117,385,149,419,266,804
430695,202112,427,1043,259,711,37,95,133,355,170,450
430697,202112,469,1118,353,945,76,190,178,515,254,705
430700,202112,8352,19812,5162,13979,1052,3040,1216,2916,2268,5956
430705,202112,413,951,202,568,23,62,81,205,104,267
430710,202112,1814,3716,1260,2988,153,414,752,1714,905,2128
430720,202112,859,1982,419,1204,58,166,206,566,264,732
430730,202112,1056,2799,740,2191,94,268,369,1067,463,1335
430740,202112,707,1875,362,1149,59,189,96,312,155,501
430745,202112,393,997,273,749,64,204,105,234,169,438
430750,202112,1601,3870,1079,2952,306,878,363,952,669,1830
430755,202112,473,1139,306,806,28,81,168,405,196,486
430760,202112,2281,5433,1762,4649,366,1052,813,2035,1179,3087
430770,202112,7108,17215,5545,14839,661,1992,3556,9120,4217,11112
430780,202112,2080,5045,1314,3738,199,640,630,1705,829,2345
430781,202112,497,1340,289,863,71,200,87,233,158,433
430783,202112,361,817,219,597,31,95,124,315,155,410
430786,202112,34,118,24,91,4,17,4,16,8,33
430790,202112,4932,11682,3500,9224,372,1153,2141,5232,2513,6385
430800,202112,808,1781,610,1505,49,116,394,971,443,1087
430805,202112,384,960,252,692,13,44,176,458,189,502
430807,202112,583,1409,337,943,39,118,166,416,205,534
430810,202112,788,1853,348,995,43,146,120,287,163,433
430820,202112,1281,3422,761,2367,124,398,230,665,354,1063
430825,202112,294,705,105,268,14,33,36,91,50,124
430830,202112,1866,4986,1503,4289,199,507,977,2785,1176,3292
430840,202112,1123,2612,752,2020,116,279,469,1288,585,1567
430843,202112,183,430,84,225,7,19,31,71,38,90
430845,202112,511,1179,337,905,39,115,184,463,223,578
430850,202112,2451,6193,1681,4747,284,879,606,1778,890,2657
430860,202112,998,2326,472,1309,57,182,218,517,275,699
430865,202112,559,1397,385,1085,100,296,91,247,191,543
430870,202112,598,1551,255,794,39,130,70,191,109,321
430880,202112,1572,3467,1086,2728,167,422,611,1483,778,1905
430885,202112,174,463,93,295,10,35,53,164,63,199
430890,202112,1090,2597,711,1954,54,206,133,345,187,551
430900,202112,3272,6906,2302,5545,159,508,1614,3613,1773,4121
430905,202112,940,2280,617,1677,106,307,257,665,363,972
430910,202112,2271,5971,1718,4854,263,836,817,2013,1080,2849
430912,202112,533,1463,369,1127,45,128,224,702,269,830
430915,202112,523,1531,376,1225,130,407,101,347,231,754
430920,202112,25617,63148,19987,53794,2565,7514,12190,31829,14755,39343
430925,202112,90,202,38,113,4,12,19,55,23,67
430930,202112,11545,26329,7719,20520,1402,3668,3405,9277,4807,12945
430940,202112,1084,2716,675,1896,124,368,221,565,345,933
430950,202112,881,1897,566,1377,40,131,381,840,421,971
430955,202112,413,1060,114,319,23,62,34,72,57,134
430957,202112,178,587,159,546,30,95,94,329,124,424
430960,202112,1461,3381,837,2257,158,444,333,842,491,1286
430965,202112,1618,3766,1254,3200,68,180,945,2455,1013,2635
430970,202112,399,931,216,585,33,105,109,259,142,364
430975,202112,536,1510,409,1224,79,254,183,525,262,779
430980,202112,416,926,243,639,21,63,120,277,141,340
430990,202112,604,1641,401,1189,63,201,170,484,233,685
430995,202112,585,1450,442,1223,70,195,232,626,302,821
431000,202112,1465,3401,606,1734,109,350,38,90,147,440
431010,202112,2549,6559,1757,5177,325,1022,548,1417,873,2439
431020,202112,8474,18100,5037,12940,946,2783,1840,4107,2786,6890
431030,202112,366,989,182,603,37,138,23,75,60,213
431033,202112,4169,9490,2737,7238,558,1528,1006,2618,1564,4146
431036,202112,342,746,73,213,7,24,21,43,28,67
431040,202112,948,2312,610,1728,70,227,308,788,378,1015
431041,202112,456,1034,321,828,31,75,183,471,214,546
431043,202112,340,832,203,582,37,122,103,281,140,403
431046,202112,110,281,43,128,6,16,9,25,15,41
431050,202112,1399,3303,978,2617,192,522,427,1186,619,1708
431053,202112,719,1808,401,1175,73,233,131,326,204,559
431055,202112,624,1455,508,1272,62,137,363,910,425,1047
431057,202112,235,668,136,438,31,103,43,127,74,230
431060,202112,6093,14674,4108,11359,930,2837,1230,3214,2160,6051
431065,202112,422,1016,310,832,43,118,156,410,199,528
431070,202112,441,1158,267,788,61,202,64,170,125,372
431075,202112,228,639,134,425,31,106,39,131,70,237
431080,202112,604,1605,418,1211,68,222,155,420,223,642
431085,202112,814,2057,516,1398,56,157,279,742,335,899
431087,202112,432,1168,347,1000,41,121,202,571,243,692
431090,202112,420,968,164,491,24,74,43,137,67,211
431100,202112,3755,8015,2635,6564,322,803,1523,3781,1845,4584
431110,202112,1500,3362,1027,2542,203,542,460,1020,663,1562
431112,202112,665,1711,548,1505,40,143,400,1023,440,1166
431113,202112,433,1114,359,976,59,162,189,504,248,666
431115,202112,1001,2769,783,2371,75,289,506,1439,581,1728
431120,202112,2853,7127,1985,5509,509,1515,529,1362,1038,2877
431123,202112,390,1043,256,747,59,156,136,406,195,562
431125,202112,1084,2885,828,2417,281,811,318,972,599,1783
431127,202112,203,547,69,225,7,24,10,29,17,53
431130,202112,3236,7913,2447,6667,365,1050,1349,3598,1714,4648
431140,202112,6197,14392,3730,9765,437,1217,1588,3595,2025,4812
431142,202112,571,1404,432,1178,50,134,279,767,329,901
431150,202112,1105,2825,813,2305,148,461,373,1029,521,1490
431160,202112,717,1949,475,1429,115,354,112,324,227,678
431162,202112,564,1379,338,963,39,127,170,434,209,561
431164,202112,182,421,48,148,5,13,8,21,13,34
431170,202112,471,1257,337,986,97,287,87,243,184,530
431171,202112,748,1671,623,1509,172,355,338,873,510,1228
431173,202112,466,1163,339,978,90,300,118,315,208,615
431175,202112,1377,3108,872,2260,144,356,332,831,476,1187
431177,202112,880,2261,682,1945,114,397,425,1140,539,1537
431179,202112,347,748,104,299,15,44,30,84,45,128
431180,202112,2385,5915,1458,4097,341,988,431,1120,772,2108
431190,202112,619,1531,265,755,34,98,80,189,114,287
431198,202112,417,1175,335,1017,79,245,126,401,205,646
431200,202112,379,935,94,246,19,53,12,26,31,79
431205,202112,227,598,120,367,36,115,33,107,69,222
431210,202112,679,1545,542,1357,148,374,205,553,353,927
431213,202112,277,719,209,585,10,32,117,316,127,348
431215,202112,663,1544,319,906,32,100,152,396,184,496
431217,202112,170,436,118,335,19,62,53,126,72,188
431220,202112,587,1476,371,1067,37,117,197,518,234,635
431225,202112,1576,3599,1219,3028,124,318,843,2081,967,2399
431230,202112,721,1963,571,1643,96,276,319,882,415,1158
431235,202112,181,484,21,73,2,4,4,19,6,23
431237,202112,368,1127,291,950,54,202,136,413,190,615
431238,202112,34,96,28,83,3,9,14,35,17,44
431240,202112,5090,11976,4066,10363,456,1290,2602,6269,3058,7559
431242,202112,289,707,254,651,36,101,167,407,203,508
431244,202112,379,937,186,524,26,87,69,164,95,251
431245,202112,1389,3153,887,2301,68,181,485,1204,553,1385
431247,202112,298,717,180,483,27,83,81,184,108,267
431250,202112,1871,4515,1399,3880,308,857,684,2062,992,2919
431260,202112,290,767,176,550,23,82,62,187,85,269
431261,202112,277,813,219,704,14,48,125,379,139,427
431262,202112,343,941,173,560,13,44,106,340,119,384
431265,202112,1657,3847,692,1965,82,262,224,538,306,800
431267,202112,253,627,164,443,5,16,118,300,123,316
431270,202112,2972,6460,1596,4133,346,900,476,1294,822,2194
431275,202112,130,358,72,223,22,66,16,49,38,115
431280,202112,240,634,75,235,4,15,14,33,18,48
431290,202112,374,1103,251,798,49,169,35,91,84,260
431295,202112,75,181,27,75,7,20,4,9,11,29
431300,202112,314,821,69,211,9,25,23,58,32,83
431301,202112,300,846,70,226,11,34,9,26,20,60
431303,202112,661,1652,407,1136,23,79,187,462,210,541
431306,202112,2425,5641,1498,4081,183,546,652,1586,835,2132
431308,202112,31,86,28,80,10,34,14,38,24,72
431310,202112,579,1524,414,1181,50,134,194,515,244,649
431320,202112,710,1900,400,1258,73,223,113,309,186,532
431330,202112,1868,4307,962,2678,152,471,390,962,542,1433
431333,202112,225,583,122,355,21,64,43,105,64,169
431335,202112,38,113,21,75,5,13,1,3,6,16
431337,202112,2961,7409,2295,6358,318,1042,1457,3819,1775,4861
431339,202112,467,1158,346,954,97,278,126,330,223,608
431340,202112,19601,46752,13753,36942,1955,5865,6802,16902,8757,22767
431342,202112,443,989,326,803,31,62,242,599,273,661
431344,202112,408,1012,242,707,27,83,111,312,138,395
431346,202112,222,539,80,248,13,42,19,47,32,89
431349,202112,805,1938,505,1316,97,244,237,596,334,840
431350,202112,4642,11361,3532,9512,430,1323,2015,5135,2445,6458
431360,202112,601,1399,300,832,93,266,66,181,159,447
431365,202112,2244,4987,1780,4349,123,359,1387,3301,1510,3660
431370,202112,5027,11619,3719,9570,774,2039,1782,4662,2556,6701
431380,202112,909,2362,745,2103,72,196,483,1373,555,1569
431390,202112,2812,6785,1787,4949,172,572,952,2303,1124,2875
431395,202112,1527,3539,1148,2977,210,539,622,1630,832,2169
431400,202112,315,867,177,559,31,99,36,100,67,199
431402,202112,947,2055,710,1702,94,215,470,1115,564,1330
431403,202112,218,593,165,487,33,100,69,197,102,297
431405,202112,5332,13463,4180,11559,693,2110,2084,5380,2777,7490
431406,202112,603,1622,417,1233,83,240,167,513,250,753
431407,202112,540,1394,392,1085,72,216,232,620,304,836
431410,202112,19133,45915,13242,35842,1740,5319,7305,18304,9045,23623
431413,202112,244,661,57,191,5,17,11,35,16,52
431415,202112,756,1790,487,1341,83,270,219,531,302,801
431417,202112,607,1306,400,977,60,164,218,501,278,665
431420,202112,1729,3739,1313,3187,150,367,791,1857,941,2224
431430,202112,615,1540,312,943,46,148,99,262,145,410
431440,202112,32984,74499,23353,59734,3892,10654,9864,23364,13756,34018
431442,202112,144,409,72,246,17,65,11,32,28,97
431445,202112,384,1059,106,334,10,24,14,37,24,61
431446,202112,289,810,216,664,33,118,106,309,139,427
431447,202112,803,2034,445,1284,85,256,125,367,210,623
431449,202112,821,2084,518,1470,98,254,192,564,290,818
431450,202112,2398,4755,1872,4011,75,177,1512,3148,1587,3325
431454,202112,38,124,30,104,5,19,13,41,18,60
431455,202112,622,1427,310,800,30,79,160,377,190,456
431460,202112,3086,7139,2113,5443,543,1436,563,1450,1106,2886
431470,202112,1450,3915,1056,3093,203,586,388,1142,591,1728
431475,202112,256,679,56,188,4,15,7,13,11,28
431477,202112,449,1122,267,766,42,110,101,269,143,379
431478,202112,228,597,52,158,8,23,5,13,13,36
431480,202112,3650,8766,2911,7623,749,1921,1355,3602,2104,5523
431490,202112,116189,265497,88650,223507,5720,17069,65290,157311,71010,174380
431500,202112,516,1288,385,1048,68,195,194,508,262,703
431505,202112,263,622,181,502,14,45,126,344,140,389
431507,202112,342,802,141,411,42,128,18,44,60,172
431510,202112,1732,4282,1177,3209,290,836,383,1049,673,1885
431513,202112,237,513,127,331,48,104,21,58,69,162
431514,202112,123,310,95,261,5,14,63,160,68,174
431515,202112,504,1214,372,988,85,231,212,519,297,750
431517,202112,58,167,46,134,5,15,23,62,28,77
431520,202112,404,988,172,505,16,53,80,208,96,261
431530,202112,5354,11373,3218,8142,660,1609,1128,2890,1788,4499
431531,202112,212,496,134,352,19,41,51,128,70,169
431532,202112,575,1301,354,909,65,191,148,371,213,562
431535,202112,264,692,117,360,23,73,22,61,45,134
431540,202112,1846,5726,1701,5530,67,235,1364,4482,1431,4717
431545,202112,375,943,77,225,6,18,23,62,29,80
431550,202112,2280,5558,1647,4401,269,765,835,2118,1104,2883
431555,202112,707,1571,423,1101,46,130,234,604,280,734
431560,202112,26435,61126,17714,47441,3504,9474,6133,17215,9637,26689
431570,202112,4647,10772,3939,9749,500,1257,2798,6768,3298,8025
431575,202112,348,821,286,727,85,187,127,336,212,523
431580,202112,611,1563,393,1138,43,141,206,557,249,698
431590,202112,674,1812,499,1449,111,311,166,481,277,792
431595,202112,385,1018,245,725,39,114,88,236,127,350
431600,202112,1625,3765,1171,3085,224,639,512,1291,736,1930
431610,202112,1486,3635,1008,2781,183,469,471,1351,654,1820
431620,202112,506,1274,248,689,47,132,108,276,155,408
431630,202112,1379,3326,661,1873,99,284,254,684,353,968
431640,202112,6795,15386,5778,14102,604,1505,4177,10235,4781,11740
431642,202112,661,1501,402,1024,52,111,181,444,233,555
431643,202112,393,946,182,515,17,45,55,149,72,194
431645,202112,1983,4230,1567,3682,44,133,1315,3045,1359,3178
431647,202112,316,752,107,313,9,20,29,74,38,94
431650,202112,135,354,95,287,8,25,40,106,48,131
431660,202112,935,2401,443,1357,58,207,106,273,164,480
431670,202112,1279,2964,754,2015,132,381,336,805,468,1186
431673,202112,244,632,96,318,9,31,16,35,25,66
431675,202112,404,1028,111,372,13,45,20,61,33,106
431680,202112,9010,21954,6622,17643,1504,4083,2868,7384,4372,11467
431690,202112,26504,62949,18328,48473,3324,9398,8418,21626,11742,31024
431695,202112,219,518,119,338,23,75,59,145,82,220
431697,202112,489,1114,377,946,51,116,220,567,271,683
431700,202112,1466,3588,1182,3088,212,497,624,1684,836,2181
431710,202112,14481,32920,10376,27139,1489,4187,5775,14994,7264,19181
431720,202112,7138,16935,4294,11679,1036,2931,836,2051,1872,4982
431725,202112,33,82,25,68,6,20,11,25,17,45
431730,202112,4368,10059,2785,7613,592,1701,998,2811,1590,4512
431740,202112,5649,12860,3774,9805,924,2788,1014,2288,1938,5076
431750,202112,8218,20599,6210,17410,1532,4455,2236,6203,3768,10658
431755,202112,343,917,86,274,14,33,14,46,28,79
431760,202112,5682,12474,3915,9685,451,1252,2396,5574,2847,6826
431770,202112,2087,4622,1587,3970,165,387,1121,2778,1286,3165
431775,202112,210,523,107,321,22,71,19,43,41,114
431780,202112,2310,5453,1508,4019,233,658,606,1576,839,2234
431790,202112,819,2100,530,1526,91,245,218,635,309,880
431795,202112,295,719,139,411,26,74,35,96,61,170
431800,202112,8782,20229,5532,15175,1267,4140,470,1333,1737,5473
431805,202112,290,707,69,239,2,9,4,9,6,18
431810,202112,3508,7883,2230,5619,413,1070,1002,2391,1415,3461
431820,202112,2287,5838,1750,4982,466,1436,668,1888,1134,3324
431830,202112,9468,20190,7020,16901,1852,5279,1306,3086,3158,8365
431840,202112,2865,7068,2298,6173,320,892,1478,3951,1798,4843
431842,202112,518,1270,188,558,30,97,72,193,102,290
431843,202112,341,893,246,699,31,92,113,304,144,396
431844,202112,204,540,71,230,16,58,17,58,33,116
431845,202112,533,1364,370,1043,47,116,207,588,254,704
431846,202112,292,720,252,662,13,33,220,577,233,610
431848,202112,165,414,88,251,10,29,21,41,31,70
431849,202112,415,1007,82,241,9,26,15,31,24,57
431850,202112,4486,11554,3444,9601,789,2395,1132,3012,1921,5407
431860,202112,661,1530,361,962,61,175,205,532,266,707
431861,202112,97,262,61,182,10,33,20,56,30,89
431862,202112,499,1530,411,1375,75,282,200,627,275,909
431870,202112,23096,55974,18456,48855,2016,5993,11535,29202,13551,35195
431880,202112,4145,10321,2956,8235,396,1273,1487,3912,1883,5185
431890,202112,5021,12241,3179,8764,871,2555,540,1653,1411,4208
431900,202112,1042,2550,677,1899,112,340,329,849,441,1189
431910,202112,804,1836,298,792,39,110,91,194,130,304
431912,202112,527,1351,412,1156,80,240,245,682,325,922
431915,202112,1152,2631,904,2247,47,118,679,1659,726,1777
431920,202112,1301,2902,1070,2605,37,83,915,2214,952,2297
431930,202112,723,1829,491,1400,176,491,157,472,333,963
431935,202112,87,226,61,171,15,39,14,35,29,74
431936,202112,322,885,186,552,37,109,87,246,124,355
431937,202112,154,384,97,276,13,35,41,105,54,140
431940,202112,3208,7297,1953,5070,157,428,1132,2797,1289,3225
431950,202112,2137,5330,1678,4598,369,1055,676,1816,1045,2871
431960,202112,3180,7496,2414,6151,644,1736,648,1637,1292,3373
431970,202112,414,1020,184,521,39,121,39,90,78,211
431971,202112,83,202,35,107,4,16,7,14,11,30
431973,202112,502,1573,406,1387,49,150,273,954,322,1104
431975,202112,119,245,30,87,4,14,7,16,11,30
431980,202112,1109,2717,862,2327,134,412,497,1241,631,1653
431990,202112,6169,14418,4452,11983,432,1397,2551,6589,2983,7986
432000,202112,13404,30630,9794,25089,1916,5129,4838,12080,6754,17209
432010,202112,2900,6572,1945,5013,370,998,761,1818,1131,2816
432020,202112,1839,4709,1132,3205,259,781,301,812,560,1593
432023,202112,570,1337,280,766,43,121,116,273,159,394
432026,202112,1045,2790,782,2288,204,598,249,743,453,1341
432030,202112,444,1003,243,646,19,53,145,355,164,408
432032,202112,351,866,240,648,23,67,137,336,160,403
432035,202112,690,1882,604,1740,182,489,251,785,433,1274
432040,202112,1165,2709,432,1305,57,194,179,471,236,665
432045,202112,179,484,115,352,17,57,46,130,63,187
432050,202112,590,1403,434,1139,78,218,204,532,282,750
432055,202112,653,1665,448,1296,146,432,95,265,241,697
432057,202112,177,471,140,376,7,17,76,191,83,208
432060,202112,449,1082,137,432,29,100,30,81,59,181
432065,202112,224,608,165,485,39,118,59,172,98,290
432067,202112,810,2225,684,1945,70,224,496,1354,566,1578
432070,202112,1776,4374,1236,3383,218,664,540,1367,758,2031
432080,202112,5230,11759,3951,9841,613,1750,1883,4417,2496,6167
432085,202112,407,1075,303,906,63,201,142,412,205,613
432090,202112,2542,6117,1482,4091,292,800,631,1651,923,2451
432100,202112,1021,2495,501,1491,105,334,81,200,186,534
432110,202112,2249,5662,1595,4511,360,1116,218,578,578,1694
432120,202112,3548,9132,2847,7986,457,1394,1361,3611,1818,5005
432130,202112,2798,6727,2325,6027,648,1716,1023,2676,1671,4392
432132,202112,230,634,118,377,19,66,57,163,76,229
432135,202112,1054,2388,705,1800,82,212,477,1213,559,1425
432140,202112,1844,5179,1421,4352,181,589,886,2641,1067,3230
432143,202112,1554,3941,1179,3358,81,239,750,2096,831,2335
432145,202112,1878,4852,1203,3481,169,510,396,960,565,1470
432146,202112,112,306,85,268,26,95,27,79,53,174
432147,202112,515,1362,304,937,104,315,52,159,156,474
432149,202112,471,1122,239,657,25,67,100,244,125,311
432150,202112,3682,8869,2746,7269,547,1521,1220,3136,1767,4657
432160,202112,5950,14701,4378,12229,1004,3078,1387,3843,2391,6921
432162,202112,237,517,40,114,5,18,12,22,17,40
432163,202112,160,375,30,80,0,0,6,8,6,8
432166,202112,678,1817,535,1534,102,338,192,478,294,816
432170,202112,1645,4326,1132,3394,196,636,468,1308,664,1944
432180,202112,3233,7477,1776,4790,301,869,702,1631,1003,2500
432183,202112,403,1125,287,873,59,207,104,286,163,493
432185,202112,873,2209,505,1510,55,171,228,656,283,827
432190,202112,2087,4919,1472,3955,131,411,920,2332,1051,2743
432195,202112,982,2436,646,1810,130,345,253,713,383,1058
432200,202112,3762,9011,2757,7462,329,942,1717,4571,2046,5513
432210,202112,419,1080,269,791,54,174,116,299,170,473
432215,202112,667,1855,601,1756,52,119,435,1300,487,1419
432218,202112,266,640,118,325,15,49,47,104,62,153
432220,202112,3855,8789,2723,6940,530,1334,1258,3202,1788,4536
432225,202112,117,313,79,238,12,34,48,143,60,177
432230,202112,812,1883,425,1177,56,158,176,449,232,607
432232,202112,524,1252,336,938,63,173,139,353,202,526
432234,202112,287,706,136,385,27,61,22,57,49,118
432235,202112,45,128,19,60,6,21,4,12,10,33
432237,202112,322,804,285,744,18,33,229,594,247,627
432240,202112,17679,41280,12997,35042,1211,2985,8168,23093,9379,26078
432250,202112,6065,16577,4498,13476,1086,3366,1891,5657,2977,9023
432252,202112,492,1150,316,821,35,90,173,421,208,511
432253,202112,933,2678,623,1909,150,502,56,152,206,654
432254,202112,709,1639,209,610,28,70,32,88,60,158
432255,202112,107,276,61,177,3,9,30,80,33,89
432260,202112,5550,13718,4113,11080,1066,2965,1524,3936,2590,6901
432270,202112,2194,5705,1787,4966,511,1504,531,1402,1042,2906
432280,202112,1483,3592,769,2223,104,340,269,644,373,984
432285,202112,147,437,25,75,2,6,5,14,7,20
432290,202112,376,998,225,659,66,209,53,119,119,328
432300,202112,28909,69686,21758,58328,2615,8020,13533,34550,16148,42570
432310,202112,931,2372,667,1894,67,191,458,1303,525,1494
432320,202112,201,461,80,242,7,26,27,69,34,95
432330,202112,222,498,70,220,10,25,7,24,17,49
432335,202112,167,476,60,208,9,33,13,41,22,74
432340,202112,347,859,154,500,17,54,43,142,60,196
432345,202112,799,1700,686,1566,15,36,582,1304,597,1340
432350,202112,361,891,187,558,30,90,63,190,93,280
432360,202112,233,686,43,148,3,7,13,42,16,49
432370,202112,349,813,215,590,25,73,129,342,154,415
432375,202112,493,1186,370,952,98,256,145,375,243,631
432377,202112,167,509,33,109,2,7,8,15,10,22
432380,202112,2001,5270,1377,4123,211,671,685,1996,896,2667
500020,202112,3362,8004,2299,6276,227,713,1423,3722,1650,4435
500025,202112,1229,2974,766,2109,87,229,381,1015,468,1244
500060,202112,8599,23595,5895,17964,720,2282,3417,10602,4137,12884
500070,202112,4953,12092,3516,9694,660,1895,1508,4179,2168,6074
500080,202112,1729,4104,1041,2861,187,591,394,951,581,1542
500085,202112,2120,5192,1489,4092,398,1148,639,1635,1037,2783
500090,202112,2245,5725,1514,4469,215,685,480,1530,695,2215
500100,202112,3924,9663,2964,8092,427,1296,1462,3703,1889,4999
500110,202112,9515,23292,6398,18406,1272,3890,2151,6997,3423,10887
500124,202112,2256,6282,1799,5547,315,859,949,3095,1264,3954
500150,202112,1504,3263,997,2551,150,431,487,1177,637,1608
500190,202112,5419,13679,3483,9923,713,2017,976,2623,1689,4640
500200,202112,2853,6445,1940,4912,168,433,1217,2976,1385,3409
500210,202112,5115,11655,3613,9663,1124,2886,1432,4023,2556,6909
500215,202112,1508,4020,1100,3272,100,328,637,1875,737,2203
500220,202112,3191,8400,2229,6677,401,1254,896,2583,1297,3837
500230,202112,2131,4800,1626,4102,209,505,1072,2669,1281,3174
500240,202112,4376,12448,3136,9879,443,1488,1324,4237,1767,5725
500260,202112,3511,7315,2286,5690,294,756,1300,3079,1594,3835
500270,202112,151251,347531,93449,251427,13565,39883,37335,91860,50900,131743
500280,202112,1491,3654,1001,2883,179,539,467,1336,646,1875
500290,202112,3953,9378,2357,6564,337,1058,791,1889,1128,2947
500295,202112,3984,9390,2589,6939,439,1317,1064,2480,1503,3797
500310,202112,1069,2107,733,1693,115,247,383,901,498,1148
500315,202112,4229,11016,3393,9810,269,799,2466,7219,2735,8018
500320,202112,21676,55792,14834,44482,3727,11472,4755,15435,8482,26907
500325,202112,5751,12387,3971,9916,500,1243,2398,6006,2898,7249
500330,202112,7186,15819,4695,12238,540,1428,2344,6356,2884,7784
500345,202112,2183,5222,1473,4104,292,846,558,1533,850,2379
500348,202112,2526,6298,1862,5164,233,679,1110,3088,1343,3767
500350,202112,1370,3656,770,2363,101,294,301,900,402,1194
500370,202112,29669,73878,21376,60455,2515,8134,11445,31522,13960,39656
500375,202112,2725,6966,1823,5120,259,808,679,1712,938,2520
500380,202112,3678,8931,2566,7072,752,2205,432,1239,1184,3444
500390,202112,685,1407,419,1071,62,180,240,598,302,778
500400,202112,1684,4191,1105,3065,202,623,367,912,569,1535
500410,202112,2573,6021,1797,4895,192,492,997,2870,1189,3362
500430,202112,2960,7019,2022,5638,298,931,823,2458,1121,3389
500440,202112,1679,3888,907,2599,139,418,306,936,445,1354
500450,202112,1761,4207,1076,3009,170,495,301,777,471,1272
500460,202112,3974,10213,2351,7029,410,1349,644,1805,1054,3154
500470,202112,2689,7028,1687,5015,440,1441,372,975,812,2416
500480,202112,2205,6593,1830,6001,170,502,1345,4515,1515,5017
500490,202112,1221,2737,710,1966,116,390,174,474,290,864
500500,202112,4499,11485,2897,8905,734,2691,279,902,1013,3593
500510,202112,740,1814,482,1346,38,102,296,801,334,903
500515,202112,1753,4455,1350,3811,177,544,776,2082,953,2626
500520,202112,3600,10151,2747,8678,668,2067,1163,3980,1831,6047
500525,202112,1033,2879,814,2560,81,273,512,1593,593,1866
500540,202112,5149,12986,2990,9075,705,2630,290,776,995,3406
500560,202112,5675,14991,4527,13544,286,827,3666,11201,3952,12028
500568,202112,4806,10223,2945,7429,800,1922,865,2297,1665,4219
500570,202112,8699,19709,5696,14749,868,2533,2644,6248,3512,8781
500580,202112,3354,8515,2433,6901,613,1748,988,2858,1601,4606
500600,202112,3733,9079,2696,7431,609,1760,991,2830,1600,4590
500620,202112,8640,21963,5839,16687,1006,3031,2526,6830,3532,9861
500625,202112,569,1496,377,1120,62,189,112,310,174,499
500627,202112,864,2230,528,1634,103,319,146,436,249,755
500630,202112,7947,17449,4430,11728,896,2554,1241,3237,2137,5791
500635,202112,3090,9525,2378,8566,172,586,1608,6404,1780,6990
500640,202112,1923,4040,1252,3148,48,135,830,2023,878,2158
500660,202112,20701,50261,14180,40807,4046,13200,3517,10438,7563,23638
500690,202112,2769,7136,1808,5536,463,1602,492,1496,955,3098
500710,202112,3341,8586,2475,7089,621,1897,727,1953,1348,3850
500720,202112,5454,13432,3602,10312,793,2420,1143,3274,1936,5694
500730,202112,1192,2842,638,1826,126,354,147,437,273,791
500740,202112,5023,11604,3280,8940,505,1440,1521,3960,2026,5400
500750,202112,1112,2749,767,2163,103,263,318,843,421,1106
500755,202112,1100,2791,651,1945,100,328,164,438,264,766
500769,202112,5627,13460,3162,8907,567,1729,431,1114,998,2843
500770,202112,1474,3902,999,3100,175,605,314,944,489,1549
500780,202112,1287,3059,825,2294,159,491,214,535,373,1026
500790,202112,7632,19751,5638,16237,1185,3659,2278,6492,3463,10151
500793,202112,2199,5407,1596,4393,360,1044,538,1369,898,2413
500795,202112,2881,6943,2256,6123,148,356,1726,4920,1874,5276
500797,202112,814,2047,521,1515,162,472,143,438,305,910
500800,202112,3704,8187,2274,6043,615,1968,330,925,945,2893
500830,202112,19823,47959,13474,36595,2859,8178,4428,11400,7287,19578
500840,202112,1532,3633,961,2579,129,347,406,1035,535,1382
510010,202112,1937,4248,1336,3486,136,292,923,2422,1059,2714
510020,202112,4457,10829,2351,6714,398,1224,658,1648,1056,2872
510025,202112,7357,17272,4612,12970,619,1882,2203,5911,2822,7793
510030,202112,3279,6966,2194,5367,312,753,1149,2693,1461,3446
510035,202112,1297,3305,833,2585,147,471,409,1389,556,1860
510040,202112,2563,5543,1916,4711,208,466,1170,3041,1378,3507
510050,202112,2354,4742,1595,3776,241,597,988,2333,1229,2930
510060,202112,1452,3571,918,2617,135,415,261,693,396,1108
510080,202112,1547,3895,1057,3127,201,642,493,1362,694,2004
510100,202112,706,1588,502,1272,68,174,284,688,352,862
510120,202112,290,519,162,367,10,18,122,276,132,294
510125,202112,2215,5458,1758,4787,165,582,995,2513,1160,3095
510130,202112,1655,4042,1138,3224,234,679,393,1157,627,1836
510140,202112,3261,8160,2179,6794,819,2849,632,2029,1451,4878
510160,202112,1886,4685,1416,4083,125,345,1106,3247,1231,3592
510170,202112,5230,13271,3901,11136,861,2552,1638,4587,2499,7139
510180,202112,15803,34222,10331,26533,2127,5929,3705,10334,5832,16263
510185,202112,1894,4830,1207,3830,449,1464,208,926,657,2390
510190,202112,2296,6341,1454,4941,380,1438,249,891,629,2329
510250,202112,18729,45478,13849,38154,2436,6967,7077,19986,9513,26953
510260,202112,1875,7904,1572,7391,247,1243,954,4943,1201,6186
510263,202112,3569,9871,2155,6881,358,1261,412,1140,770,2401
510267,202112,5814,16185,3297,10536,539,1837,505,1330,1044,3167
510268,202112,1380,3433,997,2784,121,359,493,1312,614,1671
510269,202112,1093,2883,687,2112,150,522,243,686,393,1208
510270,202112,3220,8822,2199,7026,348,1256,880,2770,1228,4026
510279,202112,1924,4846,1136,3456,170,551,374,1038,544,1589
510285,202112,1202,3070,791,2344,205,697,228,609,433,1306
510300,202112,4012,9816,3003,8484,451,1229,1788,5362,2239,6591
510305,202112,1541,4149,954,3041,180,590,216,753,396,1343
510310,202112,1039,2465,712,1943,195,557,198,563,393,1120
510320,202112,3983,9551,2790,7564,596,1787,653,1695,1249,3482
510325,202112,4599,13136,3262,10616,874,3035,825,2709,1699,5744
510330,202112,2706,7907,1791,6300,319,1137,603,2516,922,3653
510335,202112,5099,14392,3839,12325,619,2084,1911,6215,2530,8299
510336,202112,472,1295,342,1097,47,143,183,653,230,796
510337,202112,1528,4275,991,3330,347,1292,216,734,563,2026
510340,202112,101054,220498,66884,171700,14923,43924,22597,54807,37520,98731
510343,202112,1205,2990,775,2241,118,400,360,970,478,1370
510345,202112,1327,3695,994,3042,169,501,435,1319,604,1820
510350,202112,3304,8134,2237,6387,525,1494,886,2552,1411,4046
510360,202112,2152,4281,1348,3347,83,136,946,2542,1029,2678
510370,202112,1851,5105,1371,4314,178,618,838,2680,1016,3298
510380,202112,633,1490,364,1044,61,207,151,427,212,634
510385,202112,1270,4146,931,3533,85,370,625,2469,710,2839
510390,202112,1407,3488,945,2931,294,904,293,1111,587,2015
510395,202112,754,1612,506,1252,25,59,338,880,363,939
510410,202112,5203,13774,3748,11303,687,2146,1885,5908,2572,8054
510420,202112,2657,5352,1802,4235,179,369,1174,2805,1353,3174
510450,202112,607,1446,341,985,78,229,66,189,144,418
510452,202112,878,2438,651,2015,79,252,392,1176,471,1428
510454,202112,1055,2800,794,2362,93,260,486,1524,579,1784
510455,202112,1032,2694,695,2067,143,467,251,676,394,1143
510460,202112,2050,5028,1506,4210,240,707,788,2082,1028,2789
510480,202112,5216,12222,3529,9207,599,1715,1427,3494,2026,5209
510490,202112,1814,4524,1354,3946,265,727,795,2386,1060,3113
510500,202112,1638,3929,1000,2930,210,641,269,778,479,1419
510510,202112,4016,10924,2845,8948,677,2369,882,2858,1559,5227
510515,202112,5632,13905,3718,10559,759,2430,1184,2955,1943,5385
510517,202112,1556,3833,1022,3025,315,1067,180,489,495,1556
510520,202112,2412,4751,1336,3406,130,321,592,1671,722,1992
510523,202112,1346,3087,954,2500,152,415,587,1519,739,1934
510525,202112,8249,21891,6030,17603,937,2921,2760,7552,3697,10473
510530,202112,567,1454,414,1231,29,99,272,805,301,904
510550,202112,2621,7365,1928,6197,372,1255,932,2950,1304,4205
510558,202112,2478,6474,1833,5501,261,719,865,2885,1126,3604
510560,202112,1750,4892,1072,3572,207,744,235,836,442,1580
510562,202112,6241,15032,4519,12129,1000,2723,1645,4785,2645,7508
510590,202112,3147,7692,2317,6610,163,471,1672,4918,1835,5389
510600,202112,1545,3319,1040,2593,152,379,529,1295,681,1674
510610,202112,2786,6525,1889,5353,292,876,998,2809,1290,3685
510615,202112,2999,7153,2092,5739,312,946,1194,3252,1506,4198
510617,202112,1068,3139,842,2782,83,315,592,2010,675,2325
510618,202112,1303,3375,931,2771,197,640,423,1246,620,1886
510619,202112,832,2049,475,1411,67,188,88,230,155,418
510620,202112,1493,3324,699,2025,185,637,34,70,219,707
510621,202112,1698,4407,1018,3134,224,757,261,704,485,1461
510622,202112,5283,14217,3568,10691,1134,3652,471,1294,1605,4946
510623,202112,2941,7126,2128,5833,485,1425,698,1915,1183,3340
510624,202112,1714,4369,860,2772,98,349,185,526,283,875
510625,202112,3353,7853,1898,5338,320,1012,498,1403,818,2415
510626,202112,1561,3713,975,2787,246,806,193,549,439,1355
510627,202112,689,1711,371,1114,90,308,89,274,179,582
510628,202112,1597,3543,1047,2835,257,728,392,1067,649,1795
510629,202112,1799,4894,1263,3926,249,849,365,1149,614,1998
510630,202112,3637,9761,2178,7033,479,1658,394,1423,873,3081
510631,202112,610,1421,445,1176,19,43,338,924,357,967
510637,202112,3942,9055,2790,7400,667,1943,848,2289,1515,4232
510642,202112,5901,16011,4507,13915,981,3362,2132,6551,3113,9913
510645,202112,1130,2157,703,1641,202,424,275,700,477,1124
510650,202112,7551,18393,5921,16612,686,1716,3882,12383,4568,14099
510665,202112,1890,4027,1182,2915,257,590,426,1174,683,1764
510670,202112,458,975,266,700,32,84,151,403,183,487
510675,202112,6707,17854,4523,13819,1105,3777,778,2217,1883,5994
510677,202112,2375,5961,1662,4910,239,779,893,2607,1132,3386
510680,202112,752,1868,424,1270,78,263,110,278,188,541
510682,202112,1668,4607,1216,3887,385,1403,316,945,701,2348
510685,202112,524,1456,364,1140,52,162,191,614,243,776
510700,202112,4323,9940,3007,8170,257,763,2305,6220,2562,6983
510704,202112,11754,27185,7848,20650,1848,5193,1817,4634,3665,9827
510706,202112,2368,6789,1618,5530,339,1190,674,2557,1013,3747
510710,202112,3107,7435,1986,5313,460,1236,572,1480,1032,2716
510715,202112,652,1380,465,1135,27,67,282,678,309,745
510718,202112,2462,5536,1467,4189,359,999,574,1982,933,2981
510719,202112,492,1009,293,741,37,99,168,396,205,495
510720,202112,959,2156,642,1707,132,366,266,689,398,1055
510724,202112,930,2484,655,1969,93,290,335,965,428,1255
510726,202112,1075,1938,594,1357,66,161,312,722,378,883
510729,202112,650,1491,297,840,28,89,82,253,110,342
510730,202112,3149,7387,2140,5860,302,921,1077,2833,1379,3754
510735,202112,1204,3241,929,2859,90,308,689,2107,779,2415
510740,202112,1073,2567,692,1879,108,298,358,929,466,1227
510757,202112,514,1620,397,1437,133,501,116,399,249,900
510760,202112,48070,103151,28967,74278,6047,17291,9048,21161,15095,38452
510770,202112,4480,9807,3081,8059,181,418,2133,5862,2314,6280
510774,202112,395,966,285,803,46,132,150,426,196,558
510775,202112,686,1771,430,1346,93,308,84,248,177,556
510776,202112,607,1456,430,1150,72,209,191,486,263,695
510777,202112,1681,4297,1211,3690,163,526,824,2495,987,3021
510779,202112,844,2174,627,1825,59,155,383,1191,442,1346
510780,202112,4225,10381,3119,8802,716,1993,1326,4232,2042,6225
510785,202112,2136,5424,1240,3850,359,1156,188,689,547,1845
510787,202112,3174,8734,2013,6368,517,1722,145,440,662,2162
510788,202112,604,1361,416,1081,64,163,189,561,253,724
510790,202112,20297,50420,12889,37379,2963,9379,1802,4805,4765,14184
510792,202112,10306,27719,6337,20023,1273,4465,1097,3118,2370,7583
510794,202112,1286,3413,911,2793,302,1018,157,412,459,1430
510795,202112,9920,24921,6716,19289,1415,4522,1901,5133,3316,9655
510800,202112,1672,4226,1122,3311,318,985,117,302,435,1287
510805,202112,1635,4385,1139,3510,237,807,418,1176,655,1983
510810,202112,714,1399,466,1080,148,339,139,373,287,712
510820,202112,849,1559,486,1117,27,68,276,639,303,707
510830,202112,968,2182,731,1887,43,93,555,1512,598,1605
510835,202112,629,1475,421,1174,48,148,264,712,312,860
510840,202112,62295,128785,42972,105219,8750,19905,20678,55779,29428,75684
510850,202112,2012,4813,1240,3617,389,1288,102,254,491,1542
510860,202112,2683,6757,1669,5078,488,1759,218,648,706,2407
510880,202112,822,2218,609,1840,159,511,165,506,324,1017
510885,202112,702,1642,460,1288,92,267,114,330,206,597
510890,202112,838,2305,630,1953,159,518,264,819,423,1337
510895,202112,1393,3485,901,2660,155,561,400,1089,555,1650
520005,202112,3239,8122,2527,7203,754,2153,870,2961,1624,5114
520010,202112,2752,7402,1965,5891,439,1472,646,1720,1085,3192
520013,202112,3567,8661,2338,6490,543,1516,634,1925,1177,3441
520015,202112,540,1307,391,1089,96,263,146,435,242,698
520017,202112,1328,3234,980,2715,252,708,355,941,607,1649
520020,202112,486,1045,375,914,23,69,309,737,332,806
520025,202112,36571,98144,30984,90333,4015,11810,20659,60581,24674,72391
520030,202112,6390,15317,5209,13716,338,892,3981,10449,4319,11341
520050,202112,444,1035,265,710,24,52,155,436,179,488
520055,202112,2006,4699,1264,3269,191,431,608,1563,799,1994
520060,202112,1794,4553,1248,3599,267,913,291,793,558,1706
520080,202112,1955,4936,1498,4318,275,769,694,2239,969,3008
520082,202112,1002,2430,730,1982,89,267,335,942,424,1209
520085,202112,1081,2632,846,2278,171,470,403,1082,574,1552
520090,202112,904,1739,636,1447,82,138,454,1094,536,1232
520110,202112,40505,105508,27909,84342,7445,25671,2837,7857,10282,33528
520120,202112,242,558,137,379,12,39,61,159,73,198
520130,202112,4267,9940,3293,8419,656,1696,1334,3481,1990,5177
520140,202112,46964,120789,32513,96006,10991,35176,3740,11541,14731,46717
520145,202112,639,1422,429,1122,84,238,202,481,286,719
520150,202112,684,1553,505,1331,71,188,256,682,327,870
520160,202112,921,2127,634,1629,120,298,220,612,340,910
520170,202112,5045,10166,3377,8263,215,607,2527,6111,2742,6718
520180,202112,2691,6886,2175,6130,327,1019,1255,3451,1582,4470
520215,202112,1861,4361,1332,3568,262,727,545,1418,807,2145
520235,202112,775,1690,517,1321,59,164,279,712,338,876
520250,202112,1662,4087,1183,3311,357,1067,272,884,629,1951
520260,202112,861,1955,542,1455,98,259,207,570,305,829
520280,202112,894,1996,692,1698,129,306,341,873,470,1179
520310,202112,1106,2305,690,1689,176,482,198,522,374,1004
520320,202112,1895,4907,1440,4174,185,537,814,2423,999,2960
520330,202112,5032,12718,3779,10641,591,1860,1895,5164,2486,7024
520340,202112,2639,5615,1626,4241,174,408,966,2629,1140,3037
520350,202112,3035,7100,2142,5765,604,1718,785,2185,1389,3903
520355,202112,2020,5381,1431,4217,415,1269,174,436,589,1705
520357,202112,850,2011,621,1660,47,99,456,1262,503,1361
520360,202112,766,1934,583,1636,135,400,192,539,327,939
520380,202112,1521,3723,919,2632,139,399,345,924,484,1323
520390,202112,1189,2622,729,2023,217,664,157,468,374,1132
520393,202112,680,1544,433,1142,64,168,174,440,238,608
520396,202112,940,2340,792,2125,55,127,537,1438,592,1565
520400,202112,1689,3999,1295,3473,123,364,942,2511,1065,2875
520410,202112,2244,4761,1475,3627,200,539,790,1816,990,2355
520420,202112,410,915,318,776,24,60,245,575,269,635
520425,202112,1686,4024,912,2519,243,735,115,302,358,1037
520430,202112,2474,5501,1452,3929,260,800,92,237,352,1037
520440,202112,3198,7529,1795,4987,405,1215,388,1017,793,2232
520450,202112,13495,31062,9257,24817,2832,8345,1949,5485,4781,13830
520455,202112,773,2060,557,1719,156,474,136,463,292,937
520460,202112,1106,2484,856,2164,99,210,632,1663,731,1873
520465,202112,873,2125,722,1928,61,188,552,1421,613,1609
520470,202112,2264,5500,1729,4799,503,1457,627,1927,1130,3384
520480,202112,955,2564,663,2071,163,538,214,638,377,1176
520485,202112,1656,4680,1333,4214,202,638,751,2331,953,2969
520490,202112,4391,11562,3299,9837,809,2457,1489,4615,2298,7072
520495,202112,1662,3553,1256,3005,80,194,964,2325,1044,2519
520500,202112,1593,3952,1148,3147,189,549,588,1587,777,2136
520505,202112,861,1826,612,1517,61,154,426,1053,487,1207
520510,202112,8303,20080,5704,16100,1039,3328,2035,5677,3074,9005
520520,202112,1293,3120,976,2638,237,680,366,986,603,1666
520530,202112,2615,6899,1917,5661,383,1173,894,2763,1277,3936
520540,202112,3207,8153,2087,5997,390,1193,542,1463,932,2656
520545,202112,1336,3217,1042,2759,270,645,420,1193,690,1838
520547,202112,1161,2931,887,2452,184,528,437,1202,621,1730
520549,202112,15669,39958,13000,36143,1639,4773,8679,23758,10318,28531
520551,202112,5004,12916,4170,11700,460,1410,2917,7997,3377,9407
520552,202112,864,2156,695,1934,161,426,361,1089,522,1515
520570,202112,583,1285,382,970,100,213,123,357,223,570
520580,202112,2384,5182,1778,4478,231,584,1142,2889,1373,3473
520590,202112,1395,3315,946,2583,263,732,280,766,543,1498
520620,202112,8915,23095,7029,20299,1528,4588,3382,9846,4910,14434
520630,202112,918,2242,655,1808,59,152,295,825,354,977
520640,202112,2596,6111,1957,5038,464,1163,775,2112,1239,3275
520650,202112,1104,2373,780,1921,141,351,370,976,511,1327
520660,202112,587,1407,315,920,49,164,81,241,130,405
520670,202112,1002,2639,844,2416,71,214,577,1633,648,1847
520680,202112,863,2013,663,1706,106,264,341,920,447,1184
520690,202112,330,761,219,590,78,203,51,144,129,347
520710,202112,457,1076,324,860,18,48,212,540,230,588
520725,202112,1508,3514,1013,2677,137,428,567,1429,704,1857
520735,202112,897,2115,609,1637,137,341,225,647,362,988
520740,202112,2644,5706,1993,4899,357,816,1001,2743,1358,3559
520750,202112,737,1717,520,1384,85,235,254,646,339,881
520753,202112,1379,3606,1023,2943,169,519,423,1134,592,1653
520760,202112,1456,3082,1230,2813,31,62,1122,2598,1153,2660
520780,202112,1595,3675,1143,3025,141,366,594,1576,735,1942
520790,202112,3682,8520,2560,6734,410,1038,1306,3595,1716,4633
520800,202112,17783,44315,13838,38536,1971,5489,8202,23542,10173,29031
520810,202112,1381,2810,1050,2438,183,388,642,1660,825,2048
520815,202112,616,1850,457,1503,88,300,118,403,206,703
520830,202112,1977,4123,1404,3455,121,254,1061,2630,1182,2884
520840,202112,2991,7660,2408,6895,820,2672,663,1951,1483,4623
520850,202112,765,1794,567,1509,153,495,197,509,350,1004
520860,202112,8036,20746,5956,17247,1383,4251,2327,6509,3710,10760
520870,202112,127647,289476,88083,229346,17662,49134,33773,85216,51435,134350
520880,202112,8500,23523,6558,19950,1368,4367,2376,7145,3744,11512
520890,202112,4688,10587,3207,8299,494,1413,1513,3775,2007,5188
520910,202112,4986,12112,3213,9128,696,2162,798,2152,1494,4314
520915,202112,784,2094,487,1451,109,346,149,414,258,760
520920,202112,4794,10367,3410,8653,624,1519,1561,4366,2185,5885
520929,202112,720,1679,553,1450,61,137,302,841,363,978
520940,202112,1027,2654,790,2308,50,109,606,1787,656,1896
520945,202112,532,1153,384,958,98,231,170,430,268,661
520960,202112,1201,2696,936,2314,318,737,349,978,667,1715
520970,202112,3090,7979,2369,6835,485,1605,527,1668,1012,3273
520980,202112,826,1902,603,1597,100,260,255,664,355,924
520990,202112,3150,7975,2521,7184,354,902,1674,4916,2028,5818
520993,202112,1224,2801,834,2192,142,404,416,1073,558,1477
520995,202112,2592,6318,1937,5396,365,1039,655,1975,1020,3014
521000,202112,9708,24747,6360,18522,1150,3500,1710,4827,2860,8327
521010,202112,3889,9862,2867,8069,315,867,1544,4319,1859,5186
521015,202112,826,2020,582,1589,42,128,374,975,416,1103
521020,202112,3976,9780,2321,6587,590,1805,224,643,814,2448
521030,202112,612,1311,448,1065,37,77,306,740,343,817
521040,202112,8515,20277,6285,16785,1441,3909,2299,6558,3740,10467
521056,202112,967,2477,748,2145,254,708,187,609,441,1317
521060,202112,1066,2759,767,2190,147,443,277,790,424,1233
521080,202112,1184,2482,622,1627,89,249,284,677,373,926
521090,202112,3292,8616,2135,6250,461,1517,205,603,666,2120
521100,202112,1999,4379,1476,3651,242,564,909,2304,1151,2868
521120,202112,4966,11521,3724,9964,350,834,1688,5412,2038,6246
521130,202112,1072,2389,550,1448,24,65,274,768,298,833
521140,202112,1541,3815,1149,3123,119,332,637,1695,756,2027
521150,202112,13410,28835,8386,21658,1711,4927,3429,9062,5140,13989
521160,202112,766,1523,518,1180,83,160,300,685,383,845
521170,202112,1144,2588,845,2140,94,263,473,1149,567,1412
521180,202112,8417,21974,6828,19304,1197,3492,3404,9459,4601,12951
521190,202112,11608,27859,6959,20246,1694,5199,1521,4552,3215,9751
521200,202112,744,1727,520,1383,57,151,318,838,375,989
521205,202112,677,1606,519,1364,24,60,400,1004,424,1064
521210,202112,802,2055,447,1304,76,241,105,231,181,472
521220,202112,3995,9281,2707,7330,437,1267,1196,3275,1633,4542
521225,202112,419,879,305,750,61,136,181,464,242,600
521230,202112,1476,3629,1280,3382,421,1114,568,1655,989,2769
521250,202112,35337,88431,27900,77799,9386,26644,9160,27267,18546,53911
521260,202112,570,1290,426,1077,74,181,224,564,298,745
521270,202112,1986,4714,1732,4419,123,259,1300,3398,1423,3657
521280,202112,1924,4993,1435,4193,316,998,562,1668,878,2666
521290,202112,587,1283,404,1049,48,138,252,633,300,771
521295,202112,1265,2705,992,2407,110,218,785,1979,895,2197
521300,202112,2005,4812,1558,4180,290,733,898,2528,1188,3261
521305,202112,743,1697,537,1414,81,195,297,802,378,997
521308,202112,5184,13175,3573,10231,359,1044,2120,5891,2479,6935
521310,202112,9477,23463,6572,18478,1238,3805,2951,7838,4189,11643
521340,202112,430,955,305,770,25,62,199,505,224,567
521350,202112,2164,5374,1648,4597,155,467,1141,3119,1296,3586
521370,202112,1323,3278,808,2411,213,718,82,262,295,980
521375,202112,1469,3590,998,2823,207,593,277,898,484,1491
521377,202112,1589,3298,1169,2779,145,242,861,2213,1006,2455
521380,202112,6629,17086,4245,12698,511,1639,920,2971,1431,4610
521385,202112,734,1699,557,1459,69,167,279,813,348,980
521390,202112,764,1861,528,1490,143,456,142,429,285,885
521400,202112,3091,6923,2483,6205,276,642,1716,4405,1992,5047
521405,202112,1525,3800,1059,2958,141,406,569,1558,710,1964
521410,202112,902,2254,693,1904,116,310,355,1010,471,1320
521440,202112,1389,3265,1037,2750,338,958,325,873,663,1831
521450,202112,4287,12265,3094,9906,802,2540,631,2244,1433,4784
521460,202112,6135,15358,4338,12207,1185,3498,1267,3593,2452,7091
521470,202112,770,1947,507,1456,69,196,206,585,275,781
521480,202112,462,1095,288,781,63,162,91,235,154,397
521483,202112,2510,5835,1744,4695,362,989,741,2051,1103,3040
521486,202112,1890,4396,1423,3738,113,233,962,2580,1075,2813
521487,202112,429,1001,307,838,63,164,153,442,216,606
521490,202112,954,2475,710,2067,39,126,493,1386,532,1512
521500,202112,2286,5495,1729,4692,113,383,1192,3102,1305,3485
521520,202112,811,1818,598,1514,102,223,285,758,387,981
521523,202112,12983,37479,10584,33696,2884,9615,3099,10188,5983,19803
521525,202112,1172,2641,896,2255,90,237,606,1495,696,1732
521530,202112,2493,6237,1531,4317,314,862,381,1076,695,1938
521540,202112,883,2205,614,1767,105,334,256,759,361,1093
521550,202112,1779,4363,951,2708,159,525,225,657,384,1182
521560,202112,5349,13193,3729,11001,984,2771,1463,4833,2447,7604
521565,202112,706,1653,497,1314,93,234,230,608,323,842
521570,202112,3801,10064,2589,7732,460,1660,129,378,589,2038
521580,202112,530,1244,316,870,42,121,122,304,164,425
521590,202112,767,1686,562,1402,92,238,309,752,401,990
521600,202112,453,1163,291,856,27,64,132,387,159,451
521630,202112,1834,3842,1157,2894,266,697,354,902,620,1599
521640,202112,2109,4788,1377,3697,260,745,471,1237,731,1982
521645,202112,594,1491,370,1084,144,400,49,129,193,529
521680,202112,1344,3771,1023,3189,271,927,194,622,465,1549
521690,202112,586,1393,487,1261,66,184,298,766,364,950
521710,202112,3598,8580,2308,6444,367,1153,660,1623,1027,2776
521720,202112,2505,5485,1665,4270,244,628,911,2366,1155,2994
521730,202112,3982,10550,3070,9044,785,2727,791,1927,1576,4654
521740,202112,4331,10846,3278,9266,902,2724,758,2243,1660,4967
521760,202112,16233,42219,12653,36873,2763,8644,4916,15475,7679,24119
521770,202112,3464,7888,2319,6114,608,1734,534,1466,1142,3200
521800,202112,7185,18346,5200,15111,1253,3718,1963,6272,3216,9990
521805,202112,958,1978,658,1601,179,427,281,744,460,1171
521810,202112,714,1636,512,1360,107,269,276,772,383,1041
521830,202112,5947,15755,4765,13942,311,1005,3467,9939,3778,10944
521839,202112,887,2037,649,1648,97,271,398,930,495,1201
521850,202112,6840,15141,4206,11190,967,2673,683,1898,1650,4571
521860,202112,1719,4493,1171,3473,187,595,355,985,542,1580
521870,202112,752,2024,534,1599,95,326,138,346,233,672
521878,202112,798,1990,565,1545,57,187,327,823,384,1010
521880,202112,20761,49812,14339,39757,3671,10543,4817,13399,8488,23942
521890,202112,3610,8953,2413,6859,621,1852,543,1446,1164,3298
521900,202112,1475,3386,773,2210,188,541,32,90,220,631
521910,202112,1476,3049,1036,2529,148,349,536,1389,684,1738
521920,202112,562,1419,406,1165,61,202,208,561,269,763
521925,202112,813,2038,585,1688,96,297,302,858,398,1155
521930,202112,5918,13757,3901,10754,1090,2834,1305,4219,2395,7053
521935,202112,1127,2613,768,2000,83,231,423,1041,506,1272
521940,202112,1413,2967,899,2257,182,510,400,962,582,1472
521945,202112,700,1775,525,1466,93,269,274,778,367,1047
521950,202112,816,1907,570,1528,129,342,229,633,358,975
521960,202112,763,1911,518,1460,51,159,282,730,333,889
521970,202112,3078,6849,2319,5947,229,495,1643,4484,1872,4979
521971,202112,794,1840,552,1464,150,362,140,386,290,748
521973,202112,1603,3987,1325,3615,91,186,1068,2959,1159,3145
521975,202112,13265,33788,10827,30396,2136,5959,6195,17630,8331,23589
521980,202112,2651,6005,2031,5191,165,400,1515,3979,1680,4379
521990,202112,1245,3272,1007,2883,219,660,433,1235,652,1895
522000,202112,2898,7308,2273,6519,440,1278,1219,3714,1659,4992
522005,202112,374,865,266,698,55,148,114,300,169,448
522010,202112,4560,10926,3265,8827,657,1903,1196,3107,1853,5010
522015,202112,1119,2808,820,2349,259,696,282,853,541,1549
522020,202112,5858,13428,3815,10266,804,2277,1418,4022,2222,6299
522026,202112,879,2242,559,1677,88,302,158,401,246,703
522028,202112,534,1289,365,1004,88,259,108,293,196,552
522040,202112,3648,7769,2608,6382,302,809,1781,4260,2083,5069
522045,202112,19433,51648,14421,43054,3280,10371,3985,11615,7265,21986
522050,202112,1280,3189,870,2472,163,511,325,833,488,1344
522060,202112,3182,8054,2261,6561,306,890,1133,3410,1439,4300
522068,202112,1982,4797,1581,4320,116,265,1266,3535,1382,3800
522070,202112,782,1769,638,1570,11,26,553,1336,564,1362
522100,202112,822,2015,554,1568,75,217,283,779,358,996
522108,202112,1173,2665,922,2314,58,138,749,1861,807,1999
522119,202112,1894,4380,1500,3881,222,574,822,2252,1044,2826
522130,202112,485,1177,360,1010,41,111,246,712,287,823
522140,202112,22966,57663,16234,45772,3733,11136,4765,12637,8498,23773
522145,202112,856,2029,600,1653,174,466,231,656,405,1122
522150,202112,1150,2714,786,2119,200,542,211,583,411,1125
522155,202112,1123,2754,868,2378,184,425,481,1403,665,1828
522157,202112,712,1546,579,1384,22,53,476,1164,498,1217
522160,202112,6245,15572,3985,11485,1032,3235,347,1106,1379,4341
522170,202112,2843,7092,2154,6079,364,998,1204,3493,1568,4491
522180,202112,635,1483,411,1066,67,182,113,308,180,490
522185,202112,21819,51861,15446,43135,5660,17460,3059,9246,8719,26706
522190,202112,841,1907,580,1475,129,336,228,558,357,894
522200,202112,1871,5040,1287,3962,290,927,254,768,544,1695
522205,202112,1841,4251,1368,3589,193,507,762,2026,955,2533
522220,202112,1401,3256,1036,2743,142,349,635,1753,777,2102
522230,202112,1365,3265,1098,2884,195,610,573,1470,768,2080
530010,202112,200983,527099,165861,475076,23057,71157,101042,282822,124099,353979
110001,202111,4292,11632,2858,8967,633,2134,1008,3208,1641,5342
110002,202111,14286,35771,10277,29048,2695,8139,2651,7584,5346,15723
110003,202111,659,1917,499,1584,127,420,158,456,285,876
110004,202111,13288,33246,8828,25533,1772,5533,2681,7639,4453,13172
110005,202111,2670,6744,1855,5429,385,1207,484,1524,869,2731
110006,202111,1789,4901,1104,3471,169,585,222,660,391,1245
110007,202111,1385,3475,882,2620,277,861,211,778,488,1639
110008,202111,3710,9434,2707,8016,336,923,1698,5507,2034,6430
110009,202111,4773,12792,3002,9563,631,2154,1108,3524,1739,5678
110010,202111,8476,25290,6277,21203,1307,4412,2965,11051,4272,15463
110011,202111,7771,19964,5256,15510,1654,5234,720,2217,2374,7451
110012,202111,16942,41159,10220,29631,2212,6930,1044,3182,3256,10112
110013,202111,5810,16159,4017,12626,1538,5185,423,1466,1961,6651
110014,202111,4180,10698,2825,8115,533,1627,1235,3455,1768,5082
110015,202111,6131,15298,3749,10802,731,2344,1014,2591,1745,4935
110018,202111,4100,10062,2411,7142,412,1422,604,1815,1016,3237
110020,202111,83253,191180,60469,160322,14370,38854,22983,68332,37353,107186
110025,202111,5651,13285,3775,10113,688,1972,1760,4648,2448,6620
110026,202111,575,1412,409,1168,92,286,156,484,248,770
110028,202111,7677,18787,4685,13511,1064,3407,586,1684,1650,5091
110029,202111,1683,4019,990,2821,203,593,378,1108,581,1701
110030,202111,14022,31628,8518,23428,1784,5701,1206,3652,2990,9353
110032,202111,3657,9911,2184,6832,688,2174,355,1224,1043,3398
110033,202111,3902,11703,2923,9879,972,3339,715,2722,1687,6061
110034,202111,3488,7963,2299,6338,730,2309,666,2018,1396,4327
110037,202111,1769,5060,1285,4176,304,988,537,1799,841,2787
110040,202111,3159,8474,2265,6857,556,1815,705,2056,1261,3871
110045,202111,5179,14379,3712,11707,985,3356,1131,3733,2116,7089
110050,202111,1884,4974,1285,3913,394,1334,156,433,550,1767
110060,202111,961,2756,643,2010,168,556,148,444,316,1000
110070,202111,1674,5010,1181,3911,322,1145,248,757,570,1902
110080,202111,6992,15742,5250,13656,1101,2763,2877,8143,3978,10906
110090,202111,627,1670,430,1313,81,263,124,383,205,646
110092,202111,1360,3800,948,3020,194,621,428,1470,622,2091
110094,202111,3069,8752,2230,7116,844,2900,224,751,1068,3651
110100,202111,1803,5145,1395,4368,403,1331,509,1650,912,2981
110110,202111,1901,4979,1348,4104,458,1475,258,888,716,2363
110120,202111,1379,3817,1030,3149,230,764,362,1087,592,1851
110130,202111,3031,7328,1749,4949,130,386,170,412,300,798
110140,202111,2327,6581,1628,5192,353,1193,502,1614,855,2807
110143,202111,1420,3779,1002,2964,304,921,170,511,474,1432
110145,202111,992,2522,592,1766,137,406,203,645,340,1051
110146,202111,525,1322,369,1075,72,179,177,554,249,733
110147,202111,810,2041,518,1486,63,205,213,532,276,737
110148,202111,1010,2696,488,1563,122,447,58,179,180,626
110149,202111,3485,8995,2293,7069,789,2560,461,1544,1250,4104
110150,202111,2952,7152,1876,5537,571,1900,388,1341,959,3241
110155,202111,829,2337,586,1762,122,408,204,548,326,956
110160,202111,1547,4576,1120,3641,322,1074,248,830,570,1904
110170,202111,2267,5649,1435,4119,238,733,771,2115,1009,2848
110175,202111,1940,5320,1336,4143,240,746,488,1605,728,2351
110180,202111,1561,4069,1095,3155,132,411,575,1621,707,2032
120001,202111,3562,9987,2887,8977,485,1602,1764,5597,2249,7199
120005,202111,2035,7514,1853,7258,152,620,1459,5874,1611,6494
120010,202111,5658,16001,4810,14776,437,1249,3569,11304,4006,12553
120013,202111,2441,7902,2144,7535,499,1677,1228,4699,1727,6376
120017,202111,2752,8176,2377,7611,405,1258,1432,4913,1837,6171
120020,202111,16198,58877,14891,56435,954,3889,12004,45787,12958,49676
120025,202111,3370,8985,2719,8215,338,1005,1949,6041,2287,7046
120030,202111,6713,25765,6225,24882,391,1752,4825,19597,5216,21349
120032,202111,1865,7932,1778,7776,88,548,1531,6574,1619,7122
120033,202111,4445,15588,4145,15043,85,482,3634,13041,3719,13523
120034,202111,2899,9965,2488,9280,97,531,2077,7649,2174,8180
120035,202111,4059,14946,3823,14539,242,1063,3197,12106,3439,13169
120038,202111,2890,8805,2444,8091,459,1545,1427,4801,1886,6346
120039,202111,2128,8870,1986,8597,110,660,1612,6967,1722,7627
120040,202111,49527,145926,42279,134535,5435,17900,27001,86734,32436,104634
120042,202111,3662,12751,3387,12270,142,640,2866,10296,3008,10936
120043,202111,1601,6118,1421,5865,34,214,1304,5382,1338,5596
120045,202111,6406,16113,5495,15070,347,1046,4632,12637,4979,13683
120050,202111,9929,34339,9083,33089,361,1659,7626,27928,7987,29587
120060,202111,9939,37885,9093,36668,338,2025,7949,31843,8287,33868
120070,202111,3513,10609,3045,9974,288,866,2188,7498,2476,8364
120080,202111,4734,14124,4204,13359,482,1489,3078,10078,3560,11567
130002,202111,3446,12471,3075,11927,215,647,2627,10542,2842,11189
130006,202111,2665,9327,2211,8568,307,1059,1469,6068,1776,7127
130008,202111,2859,9655,2514,9165,81,321,2146,7855,2227,8176
130010,202111,4108,11788,3449,11034,115,290,3086,10057,3201,10347
130014,202111,3749,10395,2890,9050,457,1451,1800,5766,2257,7217
130020,202111,3154,11928,2811,11419,96,548,2383,9662,2479,10210
130030,202111,11640,34642,10586,33393,366,829,9538,30694,9904,31523
130040,202111,4479,12590,3701,11576,436,1117,2773,9060,3209,10177
130050,202111,8023,28143,6714,26442,224,868,6023,24158,6247,25026
130060,202111,8217,31285,7025,29745,359,1858,5918,25017,6277,26875
130063,202111,6851,21872,6104,21044,192,809,5565,19253,5757,20062
130068,202111,4112,13429,3456,12534,159,805,2724,9786,2883,10591
130070,202111,8035,21552,6576,19968,392,944,5294,16841,5686,17785
130080,202111,7919,26790,6942,25685,241,1112,5986,22630,6227,23742
130083,202111,2970,9288,2640,8882,177,601,2142,7456,2319,8057
130090,202111,3879,11557,3443,11031,39,164,3135,10218,3174,10382
130100,202111,8297,24585,6997,23223,123,259,6492,22187,6615,22446
130110,202111,8859,24361,7191,22299,1124,2826,5001,16922,6125,19748
130115,202111,5343,16528,4582,15657,113,295,4041,14144,4154,14439
130120,202111,14369,49884,12613,47538,1119,4433,10076,38544,11195,42977
130130,202111,6031,17829,4613,15975,497,1662,3311,11773,3808,13435
130140,202111,7607,25793,6613,24659,272,1185,5644,21248,5916,22433
130150,202111,3928,14062,3696,13802,63,380,3427,12824,3490,13204
130160,202111,5778,19087,4948,18038,387,1057,4123,15747,4510,16804
130165,202111,3371,12428,3161,12181,106,455,2863,11159,2969,11614
130170,202111,12478,34740,10020,31934,709,2169,8186,26811,8895,28980
130180,202111,4587,14726,4355,14464,40,198,4202,13939,4242,14137
130185,202111,20185,47585,16537,43663,1403,2207,13341,38276,14744,40483
130190,202111,20300,64239,16320,58454,1702,5496,11780,44208,13482,49704
130195,202111,2629,9188,2138,8533,87,355,1792,7232,1879,7587
130200,202111,2963,7759,2425,7067,90,280,2099,6116,2189,6396
130210,202111,1396,5152,1251,4978,99,546,1017,3956,1116,4502
130220,202111,2590,8208,2174,7703,83,292,1905,6888,1988,7180
130230,202111,5250,20155,4574,19208,181,1080,4008,16818,4189,17898
130240,202111,13489,38337,10973,35126,138,727,10021,32129,10159,32856
130250,202111,27639,80051,23639,75525,1607,4006,19291,64380,20898,68386
130255,202111,5075,15912,4371,14692,159,551,3559,12050,3718,12601
130260,202111,278934,739303,226396,666450,61309,187483,102216,319052,163525,506535
130270,202111,10524,35297,8681,32460,1698,5825,5116,20613,6814,26438
130280,202111,3770,14591,3465,14249,88,415,3222,13412,3310,13827
130290,202111,14860,46309,12998,43994,796,2352,11081,38564,11877,40916
130300,202111,5212,17004,4684,16310,151,767,4063,14179,4214,14946
130310,202111,7051,21866,6104,20680,316,1184,5165,17610,5481,18794
130320,202111,3685,11732,3075,10929,445,1504,2188,8139,2633,9643
130330,202111,4987,15159,4013,14008,217,844,3381,11881,3598,12725
130340,202111,26004,75015,22371,70921,1756,3877,18683,62006,20439,65883
130350,202111,4227,14796,3808,14274,133,634,3363,12590,3496,13224
130353,202111,8312,21364,6697,19331,951,2480,4625,14142,5576,16622
130356,202111,5624,17054,4665,15583,873,2741,2711,9762,3584,12503
130360,202111,3245,10218,2707,9525,73,265,2442,8624,2515,8889
130370,202111,5927,23373,5076,22194,331,1777,3949,17388,4280,19165
130380,202111,7634,31538,7084,30731,409,2239,6001,25899,6410,28138
130390,202111,6541,26092,5835,24973,542,2448,4653,20186,5195,22634
130395,202111,2628,8029,2250,7434,201,660,1748,5846,1949,6506
130400,202111,3009,8925,2571,8349,121,288,2279,7605,2400,7893
130406,202111,11321,38096,9484,35870,1863,6624,6163,24833,8026,31457
130410,202111,4665,15737,3990,14638,1139,4312,1852,7068,2991,11380
130420,202111,15054,50030,12551,46921,976,3973,9716,36893,10692,40866
130423,202111,4715,14251,4131,13582,196,671,3627,11934,3823,12605
130426,202111,2942,11272,2713,10998,47,235,2525,10327,2572,10562
130430,202111,4621,12449,3969,11600,177,529,3458,10082,3635,10611
130440,202111,5429,16171,4559,15133,81,313,4257,14223,4338,14536
140002,202111,2429,6937,2113,6559,103,351,1767,5602,1870,5953
140005,202111,3404,9306,2957,8786,157,405,2482,7643,2639,8048
140010,202111,57234,149562,45771,132616,11173,34258,18610,55525,29783,89783
140015,202111,4057,11545,3450,10815,252,690,2959,9560,3211,10250
140017,202111,5462,13918,4815,13112,369,784,3952,11157,4321,11941
140020,202111,5358,15106,4616,14157,248,942,3797,11598,4045,12540
140023,202111,2646,7595,2163,6913,202,637,1647,5399,1849,6036
140028,202111,2013,5129,1695,4734,81,249,1364,3830,1445,4079
140030,202111,5623,13900,4998,13184,312,557,4428,12054,4740,12611
140040,202111,2719,10287,2509,10011,85,514,2307,9063,2392,9577
140045,202111,2686,9694,2224,9063,390,1335,1380,6337,1770,7672
140047,202111,6650,18279,5532,16665,617,1888,3916,12026,4533,13914
140050,202111,1544,4415,1310,4085,141,394,952,3116,1093,3510
140060,202111,1800,4578,1553,4236,118,293,1270,3547,1388,3840
140070,202111,1975,10028,1906,9897,108,771,1633,8358,1741,9129
150010,202111,48505,118303,43745,112203,1133,2419,39177,100616,40310,103035
150013,202111,2109,5094,1780,4737,154,277,1408,4014,1562,4291
150020,202111,14804,43442,13631,41900,1895,4705,10462,33927,12357,38632
150030,202111,8924,33268,8089,32265,488,1790,7004,28489,7492,30279
150034,202111,4620,10704,3771,9672,285,650,3102,8155,3387,8805
150040,202111,17457,43214,15292,40831,1277,1779,12845,37270,14122,39049
150050,202111,7587,24892,6927,24023,128,510,6405,22430,6533,22940
150060,202111,23580,61931,18996,55146,2670,7817,12468,36928,15138,44745
150070,202111,7819,27086,6856,25956,193,807,6260,23904,6453,24711
150080,202111,98372,216105,80430,191623,21126,55622,18914,56126,40040,111748
150085,202111,8690,23722,7863,22763,150,391,7333,21468,7483,21859
150090,202111,10856,36749,10212,35541,779,2480,8333,29366,9112,31846
150095,202111,6407,17162,5632,16224,313,541,4906,14659,5219,15200
150100,202111,3029,10226,2678,9654,255,737,2041,7673,2296,8410
150110,202111,4476,17921,4163,17570,170,739,3841,16369,4011,17108
150120,202111,8510,25699,8039,25148,276,615,7141,23068,7417,23683
150125,202111,815,2007,597,1718,100,345,365,1027,465,1372
150130,202111,24175,66754,20678,61426,4133,10898,12290,39782,16423,50680
150140,202111,287883,633566,242660,572708,38164,83560,138302,341531,176466,425091
150145,202111,4530,13734,3791,12565,1138,3580,1574,6090,2712,9670
150150,202111,18240,43788,15801,40763,965,2395,12847,33329,13812,35724
150157,202111,3880,10125,3074,9073,345,933,2091,6518,2436,7451
150160,202111,3530,9316,3266,8937,455,1085,2275,6404,2730,7489
150170,202111,26866,81707,23537,76188,4440,13080,14076,49137,18516,62217
150172,202111,5530,14276,4441,12781,329,735,3307,9962,3636,10697
150175,202111,1772,5285,1456,4721,243,804,857,2823,1100,3627
150178,202111,11359,28722,9250,26324,463,762,7957,23529,8420,24291
150180,202111,24330,79848,22022,77251,1501,3362,19021,69579,20522,72941
150190,202111,7247,22666,6726,22037,189,691,6111,20044,6300,20735
150195,202111,5642,16929,5284,16397,205,641,4737,14720,4942,15361
150200,202111,6176,17622,5636,17026,50,111,5336,16239,5386,16350
150210,202111,29304,94807,27426,92448,1488,4181,23127,80724,24615,84905
150215,202111,9478,25768,8185,23795,1415,4046,4758,14257,6173,18303
150220,202111,13677,36700,11944,34263,1160,2912,8247,24431,9407,27343
150230,202111,13778,37271,12173,35117,1449,3506,8178,25008,9627,28514
150240,202111,35780,94561,29645,84309,7109,20822,11280,31877,18389,52699
150250,202111,4445,16308,4136,15965,570,2153,3272,12928,3842,15081
150260,202111,2813,8696,2521,8264,133,372,2048,6828,2181,7200
150270,202111,9770,26683,6850,21442,2087,6928,1498,5045,3585,11973
150275,202111,7182,21933,6521,21021,218,705,5659,18262,5877,18967
150276,202111,2555,6514,2190,6066,289,659,1408,4464,1697,5123
150277,202111,5504,13719,4357,12398,466,1226,3139,9525,3605,10751
150280,202111,7364,28298,7099,27880,386,1429,6204,24693,6590,26122
150285,202111,3424,11752,2989,11065,223,814,2207,8378,2430,9192
150290,202111,11390,29379,10300,28216,445,724,9176,26039,9621,26763
150293,202111,10050,23754,7784,20832,1219,3090,4647,13172,5866,16262
150295,202111,8069,20735,5734,17519,1834,5999,1739,6307,3573,12306
150300,202111,2543,7218,2300,6921,32,98,2133,6454,2165,6552
150304,202111,4562,12804,3749,11542,606,1666,2400,7904,3006,9570
150307,202111,6322,19415,5762,18497,273,774,4599,14950,4872,15724
150309,202111,7007,19531,5617,17233,876,2560,3275,10566,4151,13126
150310,202111,7813,29797,7427,29340,190,922,6630,26476,6820,27398
150320,202111,9629,25570,8754,24308,403,1117,6811,18882,7214,19999
150330,202111,14703,44785,13566,43087,1637,4556,9745,32653,11382,37209
150340,202111,2663,7554,2344,7091,342,933,1603,5045,1945,5978
150345,202111,9206,24893,8216,23606,426,1196,7068,20434,7494,21630
150350,202111,9696,23555,8842,22467,750,1304,7279,19130,8029,20434
150360,202111,25357,66982,20173,60510,2279,4883,14015,45909,16294,50792
150370,202111,12031,34309,9783,31274,1238,3201,6845,23948,8083,27149
150375,202111,3973,15558,3608,15052,223,981,3131,13213,3354,14194
150380,202111,11731,28685,9604,25900,127,395,8495,22883,8622,23278
150390,202111,7950,31010,7088,29676,1127,3876,4987,22480,6114,26356
150400,202111,6913,23945,6621,23422,216,683,5885,20965,6101,21648
150405,202111,9732,24612,8465,23111,547,1007,6819,19364,7366,20371
150410,202111,2066,6157,1755,5636,269,692,1104,3771,1373,4463
150420,202111,43085,114271,32995,99561,8555,26660,11758,41382,20313,68042
150430,202111,8814,24673,7991,23628,942,1860,6202,19421,7144,21281
150440,202111,6173,18235,5579,17435,919,2446,3725,12453,4644,14899
150442,202111,30088,66971,24921,60723,2521,5668,17740,44011,20261,49679
150445,202111,7039,20297,6157,19010,231,646,5357,16641,5588,17287
150450,202111,5505,22267,5090,21726,395,1900,4294,18340,4689,20240
150460,202111,8926,28180,8127,27176,227,761,6994,24262,7221,25023
150470,202111,22223,56472,19870,53804,318,857,18764,50771,19082,51628
150475,202111,5546,16430,4713,15179,775,2184,3152,10741,3927,12925
150480,202111,14597,44350,13056,42115,2432,6459,8662,30416,11094,36875
150490,202111,8877,29863,8080,28847,430,1322,6840,24919,7270,26241
150495,202111,5825,18443,5530,18052,113,447,5058,16491,5171,16938
150497,202111,2946,9010,2349,7977,497,1706,1229,4496,1726,6202
150500,202111,3484,8595,3065,7985,311,725,2299,5994,2610,6719
150503,202111,5351,13263,3704,11116,1036,3284,1177,4059,2213,7343
150506,202111,11730,32888,9789,30240,2014,5560,5998,20574,8012,26134
150510,202111,10652,36106,9172,33461,1382,4435,5970,23208,7352,27643
150520,202111,8158,29455,7829,29054,144,748,7200,26647,7344,27395
150530,202111,13034,42730,11212,40089,1361,3705,8129,31070,9490,34775
150540,202111,5396,13815,4610,12657,314,728,3798,10523,4112,11251
150543,202111,7481,19659,6119,17966,448,1258,4740,14597,5188,15855
150548,202111,10707,32397,9594,30863,232,781,8552,27671,8784,28452
150549,202111,2097,5872,1774,5418,56,175,1468,4529,1524,4704
150550,202111,22301,62847,18350,56464,4873,15003,7082,23565,11955,38568
150553,202111,37276,99203,28760,84464,7814,23106,11151,34093,18965,57199
150555,202111,2115,5377,1658,4664,195,427,1082,3253,1277,3680
150560,202111,2039,5796,1799,5340,305,820,1041,3264,1346,4084
150563,202111,2794,8038,2286,7159,461,1466,1237,3953,1698,5419
150565,202111,4785,14737,4261,13922,90,365,3584,11800,3674,12165
150570,202111,6988,20557,6507,19920,480,1169,5436,17082,5916,18251
150580,202111,11095,41836,9412,39969,558,2693,7379,33324,7937,36017
150590,202111,8575,28740,7324,27251,136,788,6724,24964,6860,25752
150600,202111,10380,32521,9616,31605,217,743,8921,29502,9138,30245
150610,202111,3192,8560,2837,8015,133,376,2385,6718,2518,7094
150611,202111,3542,9318,3145,8779,104,298,2791,7782,2895,8080
150613,202111,14985,39239,11338,33253,2021,6243,5672,16520,7693,22763
150616,202111,3972,10627,2871,8743,629,1952,1201,3692,1830,5644
150618,202111,7489,20589,6084,18437,642,1899,3770,11990,4412,13889
150619,202111,7288,19162,5990,17398,338,714,4950,14739,5288,15453
150620,202111,7075,22918,6080,21254,701,2211,4050,14721,4751,16932
150630,202111,6960,17643,6339,16901,312,663,5536,14930,5848,15593
150635,202111,5468,14311,4550,12814,639,1663,2866,8283,3505,9946
150640,202111,2328,6770,2116,6500,38,107,1973,6117,2011,6224
150650,202111,12314,32433,10606,29751,2967,7951,4516,14007,7483,21958
150655,202111,5845,16452,5281,15628,222,594,4566,13593,4788,14187
150658,202111,4932,13570,3672,11472,765,2441,1742,5735,2507,8176
150660,202111,6169,16797,5436,15768,750,2006,3556,10622,4306,12628
150670,202111,9908,21374,7816,18989,759,1372,6240,16025,6999,17397
150680,202111,75045,209424,58004,182897,13982,42474,24794,89652,38776,132126
150690,202111,2945,6958,2523,6481,144,269,2152,5719,2296,5988
150700,202111,6601,18749,5900,17855,434,911,4635,14647,5069,15558
150710,202111,3893,12656,3520,12072,307,938,2623,9274,2930,10212
150715,202111,5484,14685,4492,13214,317,806,3588,10741,3905,11547
150720,202111,7329,24358,6797,23572,470,1464,5569,19856,6039,21320
150730,202111,13825,39636,11730,36561,1389,4367,8483,27193,9872,31560
150740,202111,4280,11413,3731,10562,337,773,2784,8124,3121,8897
150745,202111,5506,14929,4442,13405,619,1903,3112,9550,3731,11453
150746,202111,1854,5187,1675,4934,82,177,1397,4186,1479,4363
150747,202111,5403,15697,4763,14731,731,1845,3248,10704,3979,12549
150750,202111,4003,11782,3270,10660,245,806,2430,8237,2675,9043
150760,202111,12346,35137,11123,33431,1727,4560,7548,23812,9275,28372
150770,202111,6989,23695,6489,23137,259,552,5834,21713,6093,22265
150775,202111,1151,2941,890,2604,124,380,573,1705,697,2085
150780,202111,4658,14011,4114,13365,150,386,3701,12379,3851,12765
150790,202111,6411,16966,5473,15960,359,864,3851,13237,4210,14101
150795,202111,15524,45048,13375,41812,3088,9090,7545,25126,10633,34216
150796,202111,4154,9566,3600,8934,263,497,2982,7640,3245,8137
150797,202111,4445,12904,3818,12032,217,473,3120,10220,3337,10693
150800,202111,14039,42400,12556,40463,1616,4720,9154,30834,10770,35554
150803,202111,7972,23281,7383,22420,484,1150,6250,19387,6734,20537
150805,202111,3739,10972,3160,10144,279,803,2380,7893,2659,8696
150808,202111,6697,18593,4905,15631,1727,6092,689,2542,2416,8634
150810,202111,22415,55752,16860,49078,3403,10070,8288,27357,11691,37427
150812,202111,5974,15881,5263,14753,449,1325,3996,11001,4445,12326
150815,202111,10380,28984,8660,26962,759,2229,6995,22315,7754,24544
150820,202111,13171,33304,11247,30943,1621,3300,8036,24132,9657,27432
150830,202111,12846,43791,11879,42627,487,1669,10045,37818,10532,39487
150835,202111,3032,8971,2617,8326,362,1136,1725,5508,2087,6644
150840,202111,8499,22486,6826,19882,1148,3582,3770,10865,4918,14447
160005,202111,1286,3334,1128,3144,65,207,959,2689,1024,2896
160010,202111,2493,6561,2323,6377,19,83,2249,6121,2268,6204
160015,202111,3215,8579,2874,8173,69,188,2672,7626,2741,7814
160020,202111,2340,6948,2027,6556,192,483,1548,5314,1740,5797
160021,202111,1304,4643,1198,4510,51,257,952,3644,1003,3901
160023,202111,1409,4690,1246,4412,219,746,765,2900,984,3646
160025,202111,1889,5595,1774,5466,22,54,1705,5289,1727,5343
160027,202111,9136,24822,8142,23569,720,1886,6459,19136,7179,21022
160030,202111,82585,221890,67002,201081,14452,39874,34518,115842,48970,155716
160040,202111,6139,19990,5588,19296,107,350,5204,18159,5311,18509
160050,202111,5312,15119,4159,13622,1474,4503,1519,6377,2993,10880
160053,202111,4263,12338,3804,11767,314,801,3016,9845,3330,10646
160055,202111,1053,2767,1019,2730,27,47,945,2567,972,2614
160060,202111,28291,69450,23287,63816,1723,4170,17860,51885,19583,56055
160070,202111,2920,10413,2564,9876,246,827,1949,7964,2195,8791
160080,202111,3470,10576,3039,10092,22,118,2870,9583,2892,9701
170025,202111,695,1741,491,1424,96,260,231,722,327,982
170030,202111,1323,3839,1037,3351,185,557,443,1506,628,2063
170035,202111,1559,3906,1150,3284,83,253,741,2089,824,2342
170040,202111,1996,5362,1594,4796,105,332,1013,3135,1118,3467
170070,202111,2026,4582,1439,3843,94,257,847,2388,941,2645
170100,202111,2547,7083,2100,6351,283,718,1243,3974,1526,4692
170105,202111,756,2104,522,1618,150,423,143,457,293,880
170110,202111,1059,3023,822,2600,94,321,459,1388,553,1709
170130,202111,1405,3924,1037,3254,179,570,524,1662,703,2232
170190,202111,1605,4175,1213,3571,288,975,465,1349,753,2324
170200,202111,2217,5094,1471,3903,229,603,589,1586,818,2189
170210,202111,27811,72718,21080,61643,6042,19340,3270,10192,9312,29532
170215,202111,1399,3627,1117,3238,42,159,893,2581,935,2740
170220,202111,6265,18586,5184,16648,1497,4660,1684,6287,3181,10947
170230,202111,1312,3700,973,3046,274,880,164,563,438,1443
170240,202111,2757,7393,2201,6510,164,506,1573,4561,1737,5067
170255,202111,4166,11555,3017,9569,661,2034,1218,4059,1879,6093
170270,202111,979,2330,663,1870,66,173,368,1048,434,1221
170290,202111,3118,8767,2712,8238,173,428,2119,6701,2292,7129
170300,202111,2163,5539,1749,4928,216,524,1165,3384,1381,3908
170305,202111,707,1856,596,1678,85,235,302,890,387,1125
170307,202111,1056,3325,869,2981,104,347,513,1780,617,2127
170310,202111,1684,4077,1200,3321,173,489,577,1630,750,2119
170320,202111,1112,2816,835,2371,82,240,518,1503,600,1743
170330,202111,940,2789,847,2655,42,173,703,2150,745,2323
170360,202111,595,1519,425,1242,23,89,292,796,315,885
170370,202111,1355,3444,979,2817,217,607,345,1035,562,1642
170380,202111,1970,5403,1500,4686,103,301,867,2851,970,3152
170382,202111,578,1644,480,1482,25,106,361,1076,386,1182
170384,202111,1752,5825,1433,5233,315,1077,690,2693,1005,3770
170386,202111,1047,2783,657,2043,70,248,245,723,315,971
170388,202111,683,1802,482,1473,69,227,230,701,299,928
170389,202111,1076,3222,878,2882,60,210,619,2081,679,2291
170390,202111,1900,4138,1434,3587,35,84,1212,3095,1247,3179
170410,202111,643,1720,460,1405,22,81,307,909,329,990
170460,202111,421,1091,348,980,45,132,229,649,274,781
170510,202111,981,2652,712,2193,42,146,442,1262,484,1408
170550,202111,7038,18038,5182,15114,1433,4420,1063,3345,2496,7765
170555,202111,1475,3833,1167,3359,109,272,547,1695,656,1967
170560,202111,1100,2960,842,2598,86,234,500,1661,586,1895
170600,202111,1411,3627,1118,3216,318,780,477,1551,795,2331
170610,202111,1717,4333,1264,3656,87,263,781,2224,868,2487
170625,202111,469,1205,315,908,40,106,122,337,162,443
170650,202111,1330,3769,1053,3317,130,402,633,2043,763,2445
170700,202111,3661,10473,2766,8755,556,1766,1144,3667,1700,5433
170710,202111,1598,3984,1238,3426,192,500,738,2105,930,2605
170720,202111,1851,4474,1418,3792,298,770,718,1987,1016,2757
170730,202111,1153,2976,856,2507,135,315,460,1437,595,1752
170740,202111,2200,6952,1891,6399,171,626,1348,4542,1519,5168
170755,202111,928,2449,655,2000,98,314,260,790,358,1104
170765,202111,1184,2981,836,2437,153,432,360,1098,513,1530
170770,202111,1977,5415,1598,4841,152,468,1096,3342,1248,3810
170820,202111,3776,10749,2922,9249,602,1881,1287,4286,1889,6167
170825,202111,1070,2401,880,2159,97,210,641,1588,738,1798
170830,202111,1447,3718,1172,3293,336,915,549,1600,885,2515
170900,202111,2915,8777,2459,8129,227,620,1913,6534,2140,7154
170930,202111,4001,10643,3038,8861,694,2127,871,2565,1565,4692
170950,202111,11958,32098,8322,25580,2118,7482,871,2942,2989,10424
170980,202111,513,1305,388,1111,70,205,198,548,268,753
171050,202111,1732,5282,1511,4912,50,202,1252,4068,1302,4270
171070,202111,1422,3887,1216,3584,317,858,533,1898,850,2756
171090,202111,1116,2751,875,2408,121,335,505,1384,626,1719
171110,202111,610,1571,417,1226,86,235,170,465,256,700
171150,202111,1159,2726,722,2000,75,221,439,1195,514,1416
171180,202111,823,2154,545,1638,97,265,233,720,330,985
171190,202111,2040,6392,1760,5909,282,982,1069,3688,1351,4670
171195,202111,845,2584,665,2245,75,296,420,1382,495,1678
171200,202111,640,1738,476,1469,114,383,165,497,279,880
171215,202111,408,1081,330,956,28,84,212,593,240,677
171240,202111,836,2625,664,2319,28,149,455,1550,483,1699
171245,202111,812,2221,639,1892,58,181,403,1149,461,1330
171250,202111,1064,2774,767,2322,139,447,351,1077,490,1524
171270,202111,521,1755,408,1509,89,332,168,676,257,1008
171280,202111,934,2699,749,2372,71,216,455,1493,526,1709
171320,202111,4267,11544,3330,9938,670,1854,1260,4039,1930,5893
171330,202111,2937,7859,2261,6663,549,1574,936,2906,1485,4480
171360,202111,1564,4245,1230,3764,105,298,836,2730,941,3028
171370,202111,754,1809,581,1569,51,134,407,1106,458,1240
171380,202111,1586,4167,1331,3823,160,407,888,2745,1048,3152
171395,202111,1084,2777,747,2182,65,189,488,1382,553,1571
171420,202111,2109,5850,1565,4810,281,829,687,2169,968,2998
171430,202111,1137,3197,957,2873,51,156,659,1903,710,2059
171488,202111,2552,7053,2039,6241,358,1109,1086,3367,1444,4476
171500,202111,1005,2470,747,2078,71,183,487,1358,558,1541
171510,202111,861,2669,745,2455,45,169,544,1781,589,1950
171515,202111,516,1266,391,1084,43,129,235,608,278,737
171525,202111,764,2024,575,1729,37,128,366,1058,403,1186
171550,202111,361,1014,278,883,40,148,149,448,189,596
171570,202111,1181,3421,996,3095,143,423,569,1853,712,2276
171575,202111,1827,4794,1183,3667,131,413,525,1630,656,2043
171610,202111,6136,16573,4516,13809,904,3152,1061,3562,1965,6714
171620,202111,2788,7518,2362,6911,102,381,1952,5683,2054,6064
171630,202111,1104,2720,849,2381,90,246,587,1701,677,1947
171650,202111,2236,6118,1730,5282,390,1284,483,1656,873,2940
171660,202111,2491,6083,1727,4838,215,532,1003,2858,1218,3390
171665,202111,1304,3556,1031,3120,196,632,470,1460,666,2092
171670,202111,2027,5254,1520,4413,240,727,715,2100,955,2827
171700,202111,1261,3444,919,2828,111,319,503,1568,614,1887
171720,202111,828,2059,648,1787,57,157,467,1285,524,1442
171750,202111,1391,3797,939,2936,206,679,135,524,341,1203
171780,202111,1334,3249,997,2762,70,206,720,1978,790,2184
171790,202111,1479,4597,1198,4009,183,584,575,1950,758,2534
171800,202111,780,2004,595,1736,73,231,330,936,403,1167
171820,202111,12259,33295,9064,27857,2150,6875,2249,7600,4399,14475
171830,202111,1654,5014,1412,4605,156,550,859,2854,1015,3404
171840,202111,790,2033,609,1757,21,63,391,1131,412,1194
171845,202111,679,1590,516,1352,45,159,344,854,389,1013
171850,202111,989,3114,827,2766,70,262,570,1876,640,2138
171855,202111,1110,3248,944,2949,73,196,602,1859,675,2055
171865,202111,478,1363,408,1255,70,208,215,648,285,856
171870,202111,879,2318,615,1853,79,224,314,962,393,1186
171875,202111,1391,3833,1124,3422,36,150,872,2626,908,2776
171880,202111,1330,3759,1160,3533,41,99,910,2868,951,2967
171884,202111,995,2734,743,2288,144,443,268,882,412,1325
171886,202111,1568,4074,1120,3380,289,1003,229,705,518,1708
171888,202111,712,1964,498,1567,24,93,308,926,332,1019
171889,202111,427,1240,306,1011,67,232,108,349,175,581
171890,202111,1244,3431,902,2880,153,456,507,1638,660,2094
171900,202111,580,1927,443,1613,71,218,184,723,255,941
172000,202111,614,1755,509,1580,72,213,260,809,332,1022
172010,202111,1112,3582,960,3306,86,290,617,2147,703,2437
172015,202111,396,1309,291,1096,51,180,123,480,174,660
172020,202111,2985,8001,2614,7533,178,507,1904,5758,2082,6265
172025,202111,745,1988,545,1667,45,147,379,1159,424,1306
172030,202111,1315,3795,1096,3434,80,241,798,2519,878,2760
172049,202111,1391,3232,920,2596,177,433,440,1391,617,1824
172065,202111,1511,3728,1199,3332,106,218,937,2792,1043,3010
172080,202111,2460,7065,2004,6270,128,377,1322,4155,1450,4532
172085,202111,494,1313,320,959,56,162,110,307,166,469
172090,202111,4344,10340,3403,9111,155,348,2612,7129,2767,7477
172093,202111,483,1405,343,1159,20,92,201,654,221,746
172097,202111,750,1905,519,1506,70,210,220,624,290,834
172100,202111,53039,126988,38325,104257,6591,19232,14376,39887,20967,59119
172110,202111,1709,5910,1465,5542,108,410,1110,4323,1218,4733
172120,202111,5366,15216,4220,13361,509,1648,2357,7652,2866,9300
172125,202111,418,1088,314,926,24,81,190,529,214,610
172130,202111,657,1574,508,1331,19,73,362,875,381,948
172208,202111,2749,6433,2211,5745,269,508,1531,4195,1800,4703
172210,202111,2823,6889,2168,6065,301,866,1255,3748,1556,4614
210005,202111,19981,55031,14983,46932,4157,13497,5563,18286,9720,31783
210010,202111,1993,5966,1799,5729,61,198,1583,5069,1644,5267
210015,202111,3495,10103,3030,9478,159,455,2493,7916,2652,8371
210020,202111,7497,17528,6381,16234,108,284,5847,14951,5955,15235
210030,202111,4835,15523,4428,14912,503,1566,3400,11782,3903,13348
210040,202111,2080,4616,1808,4293,91,211,1494,3497,1585,3708
210043,202111,6208,17261,5232,15887,389,1119,4076,12562,4465,13681
210047,202111,6890,20711,5605,18997,145,632,4811,16388,4956,17020
210050,202111,2286,7437,1809,6558,207,746,1213,4493,1420,5239
210055,202111,2052,6231,1861,5948,47,156,1635,5251,1682,5407
210060,202111,7740,27582,6880,26070,785,2852,4599,18115,5384,20967
210070,202111,7345,20051,6809,19347,35,116,6444,18278,6479,18394
210080,202111,4415,14505,4177,14240,26,153,3882,13311,3908,13464
210083,202111,5855,16185,4846,15092,169,442,4432,14038,4601,14480
210087,202111,3057,8287,2600,7669,182,503,2026,6037,2208,6540
210090,202111,9560,28848,8919,27757,986,2123,7014,22772,8000,24895
210095,202111,6847,21522,6234,20742,400,1268,5096,17591,5496,18859
210100,202111,7037,21201,6146,19703,671,2049,4333,14150,5004,16199
210110,202111,2963,9192,2721,8897,52,236,2428,7928,2480,8164
210120,202111,24841,64588,20586,59186,2124,4523,13923,43254,16047,47777
210125,202111,4578,12107,3974,11398,831,1903,2627,8251,3458,10154
210130,202111,4454,11228,3662,10244,173,343,3098,8794,3271,9137
210135,202111,1708,4531,1409,4089,104,209,1138,3420,1242,3629
210140,202111,20934,52995,16179,46881,3441,9071,8544,26754,11985,35825
210150,202111,4786,10872,4228,10122,254,420,3507,8449,3761,8869
210160,202111,18513,50147,15672,46624,1383,3844,11118,34803,12501,38647
210170,202111,16518,48352,15322,46823,986,2171,13227,41358,14213,43529
210173,202111,2335,8841,2174,8572,89,485,1885,7363,1974,7848
210177,202111,3549,9577,3069,8971,418,1055,2302,7092,2720,8147
210180,202111,1459,3835,1269,3602,25,63,1147,3270,1172,3333
210190,202111,5624,14444,4735,13250,86,265,4093,11348,4179,11613
210193,202111,1415,3967,1242,3695,54,139,906,2770,960,2909
210197,202111,2190,6567,2005,6317,166,465,1633,5289,1799,5754
210200,202111,8128,25267,7189,23764,425,1463,5700,18895,6125,20358
210203,202111,7491,21395,6312,19828,401,1186,4993,16143,5394,17329
210207,202111,4019,9588,3107,8584,164,348,2543,7197,2707,7545
210210,202111,8075,25525,7341,24499,124,669,6278,20816,6402,21485
210215,202111,2571,7986,2205,7449,115,546,1653,5516,1768,6062
210220,202111,6518,21609,6132,21049,138,865,5459,18379,5597,19244
210230,202111,5603,16063,5067,15269,421,966,4235,13101,4656,14067
210232,202111,11873,35479,9692,32185,1871,5885,5601,20232,7472,26117
210235,202111,3464,10373,3045,9759,162,569,2533,8162,2695,8731
210237,202111,3209,9631,2715,9042,19,87,2539,8439,2558,8526
210240,202111,2703,8146,2469,7761,64,191,2022,6255,2086,6446
210250,202111,6074,17777,5495,17039,62,301,5010,15495,5072,15796
210255,202111,2710,8046,2308,7351,285,937,1472,4636,1757,5573
210260,202111,5649,16551,4953,15549,366,1049,4025,12829,4391,13878
210270,202111,5276,13967,4692,13229,84,311,4218,11808,4302,12119
210275,202111,3539,8892,3060,8300,112,279,2517,6853,2629,7132
210280,202111,5964,16204,4779,14433,255,850,3614,10842,3869,11692
210290,202111,7976,19955,7148,18941,127,331,6675,17740,6802,18071
210300,202111,33638,90247,27282,81081,3337,10168,16654,52533,19991,62701
210310,202111,3214,7963,2823,7412,103,205,2491,6609,2594,6814
210312,202111,2909,6957,2598,6625,12,44,2483,6303,2495,6347
210315,202111,3152,8493,2712,8000,107,263,2368,7212,2475,7475
210317,202111,4327,13368,3903,12869,81,376,3530,11611,3611,11987
210320,202111,20779,59424,19038,57174,294,1165,17157,51349,17451,52514
210325,202111,3744,10401,3179,9662,158,428,2669,8378,2827,8806
210330,202111,25678,68464,20554,62033,4783,12573,11302,38725,16085,51298
210340,202111,10760,29929,9572,28368,613,1700,7616,23020,8229,24720
210350,202111,9275,26169,8135,24780,124,405,7271,22240,7395,22645
210355,202111,4304,14011,3800,13220,92,415,3218,11267,3310,11682
210360,202111,14271,43026,12563,40377,513,1918,9417,29726,9930,31644
210370,202111,11504,24848,8762,21962,290,444,7948,20461,8238,20905
210375,202111,3429,8997,2582,7781,830,2685,718,2421,1548,5106
210380,202111,5620,14006,4812,13038,322,743,3984,10946,4306,11689
210390,202111,2919,9225,2698,8857,116,386,2315,7624,2431,8010
210400,202111,4598,13625,4042,12965,118,333,3602,11771,3720,12104
210405,202111,7335,18824,5924,16865,1296,3300,3120,9724,4416,13024
210407,202111,2115,6651,1779,6070,83,294,1411,4792,1494,5086
210408,202111,2729,9710,2533,9434,143,609,1999,7510,2142,8119
210409,202111,4054,13295,3674,12779,98,463,3059,10819,3157,11282
210410,202111,3670,10596,3108,9654,120,407,2484,7646,2604,8053
210420,202111,3975,12345,3544,11569,242,624,2909,9729,3151,10353
210430,202111,2324,6667,2052,6314,139,357,1689,5334,1828,5691
210440,202111,4566,11874,3956,11111,84,224,3602,10091,3686,10315
210450,202111,2410,6949,2072,6465,133,353,1661,5246,1794,5599
210455,202111,4684,11838,3557,10405,942,2764,1646,5136,2588,7900
210460,202111,3852,10790,3251,10007,63,201,2836,8724,2899,8925
210462,202111,1788,5198,1505,4747,48,157,1201,3815,1249,3972
210465,202111,2807,7957,2434,7437,82,329,1969,5887,2051,6216
210467,202111,6252,18921,5439,17873,309,993,4510,15109,4819,16102
210470,202111,2036,5361,1516,4625,121,279,1127,3611,1248,3890
210480,202111,17538,49673,14551,46028,1420,3530,10333,36149,11753,39679
210490,202111,3727,9117,3006,8144,77,182,2550,6901,2627,7083
210500,202111,6540,24357,6009,23462,387,1646,4939,19290,5326,20936
210510,202111,6015,19517,5239,18679,87,401,4728,17074,4815,17475
210515,202111,3890,11152,3313,10462,211,645,2659,8660,2870,9305
210520,202111,2625,7456,2339,7061,71,228,1997,5977,2068,6205
210530,202111,54541,131898,42058,113645,7002,21963,12674,41507,19676,63470
210535,202111,3606,11257,3283,10792,129,419,2805,9306,2934,9725
210540,202111,15688,43553,12976,39731,1773,4612,8641,28231,10414,32843
210542,202111,6972,15829,5483,14155,596,1230,4116,11350,4712,12580
210545,202111,2313,6976,2147,6710,31,107,1900,5893,1931,6000
210547,202111,3766,13009,3339,12227,239,827,2570,9628,2809,10455
210550,202111,6171,18309,4796,16080,366,1354,3273,11317,3639,12671
210560,202111,3901,11468,3439,10732,150,404,2859,8931,3009,9335
210565,202111,1530,4728,1273,4364,56,291,992,3403,1048,3694
210570,202111,11014,29320,9764,27797,271,664,8564,24877,8835,25541
210580,202111,3192,8177,2510,7323,152,355,1743,5394,1895,5749
210590,202111,4415,12808,3835,12077,57,290,3439,10790,3496,11080
210592,202111,2738,7862,2502,7491,21,88,2163,6415,2184,6503
210594,202111,2633,6939,2034,6013,119,321,1495,4586,1614,4907
210596,202111,2864,9590,2557,9034,258,758,1923,7077,2181,7835
210598,202111,1923,5350,1773,5129,63,172,1557,4504,1620,4676
210600,202111,3138,8303,2559,7482,206,532,1780,5304,1986,5836
210610,202111,2930,7757,2493,7235,52,204,2162,6278,2214,6482
210620,202111,2964,7436,2423,6782,80,183,2137,6020,2217,6203
210630,202111,3243,10328,2918,9774,117,436,2395,7973,2512,8409
210632,202111,4862,14457,4286,13672,219,788,3467,11036,3686,11824
210635,202111,1792,6212,1681,6004,128,420,1323,4857,1451,5277
210637,202111,2656,8475,2264,7916,128,549,1689,6032,1817,6581
210640,202111,4791,16441,4471,16063,57,249,4141,14911,4198,15160
210650,202111,7541,21115,6816,20178,146,395,6083,18126,6229,18521
210660,202111,8428,24019,7495,22506,228,871,6375,18765,6603,19636
210663,202111,2861,7709,2593,7401,201,366,2103,6358,2304,6724
210667,202111,2052,6484,1839,6177,63,190,1603,5502,1666,5692
210670,202111,5143,16083,4638,15299,100,410,4094,13470,4194,13880
210675,202111,5337,13944,4559,12968,433,961,3519,10532,3952,11493
210680,202111,4881,11329,4107,10425,108,151,3714,9561,3822,9712
210690,202111,7871,23603,6503,22059,243,884,5633,19508,5876,20392
210700,202111,2866,7821,2258,6941,170,428,1613,5190,1783,5618
210710,202111,5252,15590,4637,14743,88,402,4130,13023,4218,13425
210720,202111,3215,9984,2812,9487,57,310,2506,8372,2563,8682
210725,202111,1364,4345,1173,4047,50,157,801,2925,851,3082
210730,202111,1305,3186,1094,2898,49,113,940,2488,989,2601
210735,202111,4910,13691,4172,12755,245,572,3493,11108,3738,11680
210740,202111,5408,13853,4643,12967,110,242,3957,11140,4067,11382
210745,202111,4591,12143,4221,11677,110,261,3808,10528,3918,10789
210750,202111,24659,62448,21315,58174,3132,7329,13485,39751,16617,47080
210760,202111,6113,15535,5093,14445,99,192,4764,13736,4863,13928
210770,202111,6436,15938,5551,14926,56,199,5223,13984,5279,14183
210780,202111,7861,23736,6826,22024,665,1774,5151,17054,5816,18828
210790,202111,4536,13683,4058,13066,217,436,3317,11227,3534,11663
210800,202111,4998,13204,4258,12213,66,243,3807,10814,3873,11057
210805,202111,4138,14447,3924,14119,142,580,3403,12275,3545,12855
210810,202111,5037,14320,4597,13751,418,962,3640,11369,4058,12331
210820,202111,7299,20280,6078,18349,753,2231,3573,11221,4326,13452
210825,202111,7348,21836,6597,20847,368,890,5555,18088,5923,18978
210830,202111,8298,22308,7498,21354,532,1206,6283,18498,6815,19704
210840,202111,3319,8517,2980,8066,33,102,2693,7193,2726,7295
210845,202111,6663,17496,5896,16653,52,156,5610,15965,5662,16121
210850,202111,6184,19894,5042,18194,265,1069,3922,14301,4187,15370
210860,202111,22160,54076,18349,49418,1294,2952,14264,40658,15558,43610
210870,202111,7638,19058,6081,17293,207,452,5362,15415,5569,15867
210880,202111,4283,12854,3824,12281,211,691,2997,9681,3208,10372
210890,202111,4148,11541,3739,11067,461,1079,2821,8774,3282,9853
210900,202111,4916,13696,3786,11660,1466,4824,517,1891,1983,6715
210905,202111,2116,5518,1771,5086,64,110,1594,4712,1658,4822
210910,202111,7436,22007,6125,19916,748,2377,4007,13204,4755,15581
210920,202111,3225,10387,2795,9818,57,322,2503,8707,2560,9029
210923,202111,1671,4692,1413,4293,91,242,1048,3211,1139,3453
210927,202111,5214,16446,4542,15630,580,1832,3172,11528,3752,13360
210930,202111,2620,8408,2280,7754,152,461,1751,5968,1903,6429
210940,202111,4097,11404,3808,11069,119,419,3452,9914,3571,10333
210945,202111,7159,19589,6379,18678,256,645,5354,16136,5610,16781
210950,202111,5486,14714,4204,12940,653,1504,2683,9161,3336,10665
210955,202111,1620,4825,1383,4441,368,1112,679,2343,1047,3455
210960,202111,9547,27146,8262,25224,1850,5239,4721,15433,6571,20672
210970,202111,1472,4238,1190,3764,100,271,902,2844,1002,3115
210975,202111,1875,5533,1688,5244,141,440,1281,3995,1422,4435
210980,202111,10268,23351,8984,22019,119,246,8455,20852,8574,21098
210990,202111,17750,47373,13624,42088,870,2538,9809,31962,10679,34500
211000,202111,15270,42515,12619,39236,1401,3656,9040,30032,10441,33688
211003,202111,5980,16931,4981,15731,114,428,4298,13903,4412,14331
211010,202111,6635,22689,5910,21767,102,454,5290,19764,5392,20218
211020,202111,8464,23801,7324,22512,240,731,6203,19750,6443,20481
211023,202111,2081,6524,1922,6313,94,267,1612,5311,1706,5578
211027,202111,3294,9892,3118,9621,231,574,2639,8303,2870,8877
211030,202111,3913,10561,3492,10036,300,728,2676,7979,2976,8707
211040,202111,4932,16850,4548,16211,122,604,4060,14405,4182,15009
211050,202111,9208,23437,8341,22320,108,349,7579,20267,7687,20616
211060,202111,7113,21065,6427,20132,168,628,5672,17729,5840,18357
211065,202111,2411,6309,2006,5806,97,233,1666,4942,1763,5175
211070,202111,8498,25061,7254,23229,482,1416,5842,18910,6324,20326
211080,202111,1362,3656,1094,3240,29,140,878,2488,907,2628
211085,202111,2222,5946,1869,5476,101,203,1545,4769,1646,4972
211090,202111,3225,8791,2897,8421,30,130,2682,7768,2712,7898
211100,202111,6935,17206,6399,16563,36,119,5983,15568,6019,15687
211102,202111,3324,10671,3022,10224,253,939,2430,8187,2683,9126
211105,202111,2477,7492,2064,6762,144,470,1503,4883,1647,5353
211107,202111,5030,15347,4258,14207,163,606,3325,11635,3488,12241
211110,202111,6359,16556,4986,14487,394,1035,3678,10895,4072,11930
211120,202111,47172,112101,38648,102061,6837,16410,22997,65414,29834,81824
211125,202111,2122,6269,1780,5736,48,148,1493,4840,1541,4988
211130,202111,184892,430374,157726,395173,25769,57883,80949,226336,106718,284219
211140,202111,5207,14843,4539,13995,254,602,3763,11807,4017,12409
211150,202111,9851,25661,8267,23646,412,938,6833,19884,7245,20822
211153,202111,2554,7228,2036,6591,367,1115,1228,4288,1595,5403
211157,202111,1221,3718,1022,3351,34,137,741,2422,775,2559
211160,202111,4575,12175,3609,10819,139,448,2773,8203,2912,8651
211163,202111,1616,5125,1463,4901,39,154,1284,4332,1323,4486
211167,202111,1669,4984,1549,4810,26,75,1429,4446,1455,4521
211170,202111,6749,16107,6244,15520,75,141,5911,14673,5986,14814
211172,202111,2710,7214,2326,6631,106,302,1863,5211,1969,5513
211174,202111,2923,8288,2644,7975,27,133,2487,7472,2514,7605
211176,202111,4425,12143,3453,10723,157,581,2788,8660,2945,9241
211178,202111,5259,11392,4500,10588,17,70,4357,10176,4374,10246
211180,202111,4254,13596,3895,13090,185,609,3195,10803,3380,11412
211190,202111,3174,9103,2689,8395,30,157,2413,7478,2443,7635
211195,202111,1482,4006,1262,3677,147,298,964,2967,1111,3265
211200,202111,2251,6301,1795,5646,214,617,1208,3859,1422,4476
211210,202111,6366,19167,5723,18311,366,1234,4651,14921,5017,16155
211220,202111,40009,97195,32867,88504,3882,9276,23419,65212,27301,74488
211223,202111,5459,14093,4482,12784,499,1355,3082,8902,3581,10257
211227,202111,1801,5711,1591,5415,56,229,1247,4299,1303,4528
211230,202111,8484,22901,7275,21144,387,774,5938,17748,6325,18522
211240,202111,8088,25097,7596,24457,255,842,6876,22128,7131,22970
211245,202111,7403,18158,6503,17212,116,237,6179,16369,6295,16606
211250,202111,13881,42282,12532,40364,1016,3211,9736,31662,10752,34873
211260,202111,8348,26211,7373,24942,229,834,6541,22355,6770,23189
211270,202111,10380,32441,8815,30351,330,1404,7108,24813,7438,26217
211280,202111,13641,35356,12228,33564,868,1901,10256,29029,11124,30930
211285,202111,2003,6183,1794,5904,137,462,1355,4574,1492,5036
211290,202111,7648,22426,6884,21404,272,863,5794,18114,6066,18977
211300,202111,7855,22292,6862,20668,343,1041,5441,16225,5784,17266
211400,202111,12263,33102,9981,29985,1188,3293,6445,20679,7633,23972
220005,202111,1985,4890,1793,4620,40,105,1528,3869,1568,3974
220010,202111,1530,4271,1247,3768,21,80,966,2903,987,2983
220020,202111,4026,10376,3435,9570,137,402,2859,7931,2996,8333
220025,202111,2321,5128,1989,4653,27,60,1675,3819,1702,3879
220027,202111,1383,3310,1180,3037,20,63,1030,2607,1050,2670
220030,202111,3600,8676,3364,8364,120,258,2909,7194,3029,7452
220040,202111,7753,22713,6742,20817,1663,4734,3235,10712,4898,15446
220045,202111,1624,4623,1340,4153,20,95,1140,3466,1160,3561
220050,202111,4839,12826,4090,11865,57,255,3772,10830,3829,11085
220060,202111,2617,5226,2238,4791,36,71,2115,4524,2151,4595
220070,202111,2539,6206,2139,5628,93,171,1772,4689,1865,4860
220080,202111,775,2147,670,1998,19,58,573,1702,592,1760
220090,202111,1822,4264,1528,3845,12,28,1251,3285,1263,3313
220095,202111,734,1689,692,1646,46,76,597,1461,643,1537
220100,202111,1509,3923,1217,3475,37,112,994,2750,1031,2862
220105,202111,2183,6420,1916,5928,139,399,1421,4419,1560,4818
220110,202111,3539,9597,3174,8982,31,153,2843,7945,2874,8098
220115,202111,2864,8009,2643,7726,96,257,2378,6966,2474,7223
220117,202111,1492,3438,1177,3007,4,13,990,2476,994,2489
220120,202111,13859,35450,12634,33927,78,236,11875,31813,11953,32049
220130,202111,1208,3060,1017,2799,6,32,922,2491,928,2523
220140,202111,2255,4553,1906,4148,110,235,1657,3598,1767,3833
220150,202111,6777,19133,6165,18088,130,461,5233,15130,5363,15591
220155,202111,1251,3472,1004,3033,40,108,718,2142,758,2250
220157,202111,1107,2617,932,2350,28,76,749,1849,777,1925
220160,202111,2992,8034,2570,7272,49,163,2084,5795,2133,5958
220170,202111,1687,4293,1430,3914,16,59,1265,3428,1281,3487
220173,202111,2316,6155,1786,5200,51,142,1446,4099,1497,4241
220177,202111,2133,5818,2028,5702,8,29,2004,5626,2012,5655
220180,202111,1188,2749,964,2383,3,15,776,1801,779,1816
220190,202111,7588,17987,6442,16451,373,891,4986,13032,5359,13923
220191,202111,1678,4791,1517,4521,102,293,1052,3117,1154,3410
220192,202111,2148,5508,1577,4525,29,83,1274,3606,1303,3689
220194,202111,1811,4976,1604,4648,49,172,1327,3802,1376,3974
220196,202111,2137,5368,1942,5082,33,124,1694,4354,1727,4478
220198,202111,1352,3524,1150,3266,6,15,1065,3059,1071,3074
220200,202111,5411,15289,4712,14375,76,276,4065,12423,4141,12699
220202,202111,2256,6172,1925,5643,24,119,1656,4766,1680,4885
220205,202111,2595,7282,2310,6766,52,175,1942,5622,1994,5797
220207,202111,804,2368,673,2146,58,193,441,1424,499,1617
220208,202111,1825,5356,1513,4788,193,605,907,2866,1100,3471
220209,202111,1670,4646,1441,4244,25,91,1189,3462,1214,3553
220210,202111,1877,4339,1633,3971,14,48,1436,3393,1450,3441
220211,202111,1734,4177,1591,3987,17,69,1392,3471,1409,3540
220213,202111,1906,4844,1637,4387,17,49,1356,3525,1373,3574
220217,202111,2390,6621,2238,6450,58,96,2057,6076,2115,6172
220220,202111,11381,28198,9527,25454,809,1688,6375,18157,7184,19845
220225,202111,1022,2656,838,2419,2,13,788,2252,790,2265
220230,202111,5818,14283,4967,13112,157,343,4273,11386,4430,11729
220240,202111,3243,9060,2869,8425,98,326,2367,6894,2465,7220
220245,202111,1887,4149,1422,3594,12,44,1294,3294,1306,3338
220250,202111,3124,8402,2731,7911,14,64,2563,7390,2577,7454
220253,202111,1696,4382,1494,4054,53,139,1264,3372,1317,3511
220255,202111,2068,4638,1779,4243,31,113,1558,3592,1589,3705
220260,202111,4777,13736,4142,12589,205,609,3241,9876,3446,10485
220265,202111,1484,4391,1344,4214,47,191,1130,3490,1177,3681
220270,202111,6115,19524,5744,18866,174,806,4801,15310,4975,16116
220271,202111,1540,3877,1350,3609,20,64,1178,3123,1198,3187
220272,202111,1841,5167,1627,4768,60,174,1218,3473,1278,3647
220273,202111,1334,3666,1115,3271,56,185,840,2438,896,2623
220275,202111,2492,5517,1982,4827,36,54,1764,4312,1800,4366
220277,202111,2365,5598,2009,5098,65,127,1673,4203,1738,4330
220280,202111,1806,3979,1503,3590,17,50,1308,3088,1325,3138
220285,202111,1500,3650,1275,3385,7,23,1189,3135,1196,3158
220290,202111,7195,19044,5710,16991,387,1106,4116,12712,4503,13818
220300,202111,2118,5848,1705,5308,28,127,1419,4383,1447,4510
220310,202111,3233,8334,2535,7525,47,151,2167,6408,2214,6559
220320,202111,3226,9030,2491,7705,51,230,1958,5901,2009,6131
220323,202111,1729,4824,1347,4222,52,155,1107,3424,1159,3579
220325,202111,1293,3747,1111,3443,20,84,923,2816,943,2900
220327,202111,1673,4469,1458,4137,37,135,1202,3312,1239,3447
220330,202111,4908,11122,4180,10257,49,153,3808,9289,3857,9442
220335,202111,1743,5131,1574,4904,31,87,1406,4399,1437,4486
220340,202111,1990,5082,1521,4294,65,171,1004,2782,1069,2953
220342,202111,1235,3492,1105,3296,54,139,869,2605,923,2744
220345,202111,3231,7080,2472,6028,18,51,2235,5426,2253,5477
220350,202111,3518,8649,2815,7620,162,392,1979,5435,2141,5827
220360,202111,1295,3264,1025,2820,15,41,818,2244,833,2285
220370,202111,8982,25264,8157,23958,209,627,6996,20474,7205,21101
220375,202111,1700,4647,1506,4413,2,7,1440,4240,1442,4247
220380,202111,1566,3565,1293,3192,16,29,1141,2807,1157,2836
220385,202111,885,2028,732,1769,5,14,643,1536,648,1550
220390,202111,11385,27940,8794,24037,2175,5712,3201,9772,5376,15484
220400,202111,1605,3684,1230,3112,22,68,958,2336,980,2404
220410,202111,1228,3281,999,2886,44,117,821,2353,865,2470
220415,202111,859,2151,724,1933,26,59,574,1523,600,1582
220420,202111,2091,5679,1680,4904,55,158,1279,3673,1334,3831
220430,202111,2763,6838,2515,6490,57,161,2218,5639,2275,5800
220435,202111,1882,4679,1609,4274,34,99,1352,3518,1386,3617
220440,202111,2647,7654,2242,7057,78,341,1922,5876,2000,6217
220450,202111,2658,6699,2161,6084,49,148,1866,5263,1915,5411
220455,202111,1343,4064,1281,3976,6,35,1163,3603,1169,3638
220460,202111,1060,2505,984,2409,26,46,852,2074,878,2120
220465,202111,2518,7399,2214,6933,205,557,1641,5308,1846,5865
220470,202111,3871,10170,3454,9497,190,414,2713,7455,2903,7869
220480,202111,2990,7353,2420,6460,282,517,1536,4274,1818,4791
220490,202111,2567,6245,2219,5808,22,94,1933,4993,1955,5087
220500,202111,3303,7785,2797,7023,120,234,2147,5374,2267,5608
220510,202111,2747,7314,2209,6365,98,220,1745,5094,1843,5314
220515,202111,1756,4077,1627,3899,46,71,1410,3379,1456,3450
220520,202111,5317,13271,4782,12527,99,256,4116,10825,4215,11081
220525,202111,1531,3600,1306,3324,6,30,1207,3060,1213,3090
220527,202111,1407,3704,1222,3439,21,61,1062,3023,1083,3084
220530,202111,1553,3678,1343,3413,49,118,1210,3084,1259,3202
220535,202111,840,2229,786,2157,37,82,623,1715,660,1797
220540,202111,3391,10384,3147,9915,173,518,2579,8156,2752,8674
220545,202111,1529,4356,1401,4156,54,203,1187,3474,1241,3677
220550,202111,9046,27108,8048,25350,460,1463,6070,18952,6530,20415
220551,202111,1485,4009,1315,3739,28,94,1077,3004,1105,3098
220552,202111,1763,4869,1421,4262,23,119,1148,3316,1171,3435
220553,202111,1916,4622,1579,4183,52,71,1330,3621,1382,3692
220554,202111,975,2400,727,2009,54,128,508,1392,562,1520
220555,202111,2654,7135,2310,6708,28,91,1942,5795,1970,5886
220556,202111,1283,3569,1124,3270,33,124,854,2397,887,2521
220557,202111,1817,5272,1500,4585,119,373,1044,3110,1163,3483
220558,202111,1481,3755,1164,3309,17,67,998,2798,1015,2865
220559,202111,1889,4508,1605,4077,21,42,1307,3358,1328,3400
220560,202111,1847,4020,1520,3618,51,83,1359,3288,1410,3371
220570,202111,7868,22274,7180,21311,540,1314,5676,17177,6216,18491
220580,202111,7212,18935,6540,17887,112,276,5861,16048,5973,16324
220585,202111,2192,6594,1802,5898,35,90,1501,4940,1536,5030
220590,202111,1470,3813,1207,3433,82,200,871,2530,953,2730
220595,202111,2824,7292,2561,6941,22,74,2300,6192,2322,6266
220600,202111,1574,3268,1341,2997,68,85,1160,2642,1228,2727
220605,202111,1657,4708,1427,4301,20,99,1166,3407,1186,3506
220610,202111,2870,8153,2686,7880,23,110,2520,7349,2543,7459
220620,202111,8424,24633,7705,23661,120,598,7053,21445,7173,22043
220630,202111,400,1146,309,985,29,90,198,623,227,713
220635,202111,1896,5484,1691,5063,36,155,1352,3924,1388,4079
220640,202111,2496,6785,2123,6257,64,239,1742,5088,1806,5327
220650,202111,2299,5960,1983,5489,33,91,1620,4479,1653,4570
220660,202111,2662,8081,2249,7411,60,256,1880,6114,1940,6370
220665,202111,1311,3830,1104,3489,26,123,930,2874,956,2997
220667,202111,1716,5063,1548,4756,61,213,1255,3829,1316,4042
220669,202111,1727,4953,1652,4842,54,178,1472,4248,1526,4426
220670,202111,2304,5738,1835,5094,14,47,1586,4396,1600,4443
220672,202111,3405,8115,2759,7336,84,262,2468,6486,2552,6748
220675,202111,1386,3624,1234,3353,41,91,993,2707,1034,2798
220680,202111,2904,7478,2766,7293,138,210,2472,6695,2610,6905
220690,202111,1658,4217,1456,3911,66,187,1130,3036,1196,3223
220695,202111,974,2583,905,2457,22,58,784,2120,806,2178
220700,202111,11145,25614,9070,22843,407,874,6929,17366,7336,18240
220710,202111,956,2497,704,2038,31,83,535,1506,566,1589
220720,202111,2246,5131,2022,4838,13,52,1792,4220,1805,4272
220730,202111,1377,3711,1169,3375,13,57,998,2821,1011,2878
220735,202111,1062,2334,827,1979,37,77,661,1558,698,1635
220740,202111,1434,3574,1141,3189,32,77,954,2713,986,2790
220750,202111,4107,9895,3607,9191,142,318,3230,8213,3372,8531
220755,202111,1485,3387,1237,3024,19,56,1036,2475,1055,2531
220760,202111,3335,8580,2923,8038,52,148,2700,7445,2752,7593
220770,202111,25426,72323,21549,65854,6293,20155,7484,24038,13777,44193
220775,202111,1254,3007,1113,2833,8,26,1075,2717,1083,2743
220777,202111,1664,4112,1289,3549,48,103,976,2727,1024,2830
220779,202111,1310,3327,1134,3069,24,68,981,2622,1005,2690
220780,202111,6236,14755,5354,13461,266,644,4208,10473,4474,11117
220785,202111,1540,3334,1356,3099,8,16,1296,2943,1304,2959
220790,202111,10761,29292,9699,27781,159,630,8210,23300,8369,23930
220793,202111,998,2498,800,2164,8,12,668,1825,676,1837
220795,202111,1484,3655,1305,3412,26,71,1146,2997,1172,3068
220800,202111,19891,42158,16934,38300,798,1621,12975,29465,13773,31086
220810,202111,3200,8559,2687,7681,45,118,2232,6334,2277,6452
220820,202111,5464,13484,4762,12456,311,591,3636,9695,3947,10286
220830,202111,7557,19263,6748,18125,267,707,5542,14712,5809,15419
220840,202111,13004,37531,10880,33342,2561,7226,4975,16125,7536,23351
220850,202111,3289,9799,2945,9370,39,201,2640,8422,2679,8623
220855,202111,763,1810,673,1692,19,57,606,1510,625,1567
220860,202111,1105,2634,962,2404,13,48,887,2195,900,2243
220865,202111,2529,6513,1954,5495,56,211,1461,3970,1517,4181
220870,202111,3288,8525,2721,7792,24,117,2504,7151,2528,7268
220880,202111,5635,12854,4851,11891,63,213,4477,10856,4540,11069
220885,202111,1501,4252,1241,3832,82,207,937,2984,1019,3191
220887,202111,1637,3417,1371,3079,18,29,1266,2838,1284,2867
220890,202111,1461,4252,1266,3974,47,149,1053,3355,1100,3504
220900,202111,2102,4855,1750,4401,31,71,1536,3843,1567,3914
220910,202111,1641,4254,1382,3875,76,174,1114,3184,1190,3358
220915,202111,1021,2636,808,2255,15,49,614,1639,629,1688
220920,202111,1542,4565,1334,4296,75,223,1085,3558,1160,3781
220930,202111,1899,4836,1585,4401,18,55,1484,4107,1502,4162
220935,202111,1146,3220,921,2737,21,87,600,1682,621,1769
220937,202111,1592,4012,1359,3638,24,82,1101,2893,1125,2975
220940,202111,1688,4442,1357,3872,31,98,1079,3028,1110,3126
220945,202111,525,1672,418,1469,16,84,305,1055,321,1139
220950,202111,1477,3314,980,2561,19,55,784,1977,803,2032
220955,202111,1683,4170,1400,3694,25,63,1200,3134,1225,3197
220960,202111,841,2079,624,1718,36,95,425,1110,461,1205
220965,202111,1881,4927,1636,4575,14,80,1414,3879,1428,3959
220970,202111,2101,4769,1555,3972,16,33,1328,3353,1344,3386
220975,202111,716,1930,611,1800,9,50,550,1577,559,1627
220980,202111,1203,3275,1066,3090,30,101,896,2577,926,2678
220985,202111,1391,3383,1207,3116,67,137,979,2505,1046,2642
220987,202111,1549,4413,1366,4093,69,208,1095,3271,1164,3479
220990,202111,1749,4740,1529,4408,11,62,1299,3699,1310,3761
220995,202111,1224,3429,1015,3045,30,88,766,2311,796,2399
220997,202111,2465,7247,2275,6942,44,169,2019,6089,2063,6258
221000,202111,4682,12408,4102,11568,93,335,3523,9857,3616,10192
221005,202111,1566,3932,1419,3685,15,75,1233,3100,1248,3175
221010,202111,1326,2838,1042,2487,15,27,902,2129,917,2156
221020,202111,1641,4815,1484,4550,18,62,1150,3505,1168,3567
221030,202111,1734,4069,1471,3750,19,49,1283,3330,1302,3379
221035,202111,1632,4016,1417,3726,25,30,1262,3394,1287,3424
221037,202111,748,1954,620,1736,7,20,460,1222,467,1242
221038,202111,555,1494,423,1262,16,53,291,859,307,912
221039,202111,909,2415,760,2170,25,101,607,1681,632,1782
221040,202111,4545,12655,3949,11618,240,592,3142,9348,3382,9940
221050,202111,4162,10356,3694,9769,74,201,3340,8821,3414,9022
221060,202111,9242,24955,7625,22331,391,873,6014,17933,6405,18806
221062,202111,1195,3701,1028,3428,31,125,831,2740,862,2865
221063,202111,1174,3065,1009,2826,59,169,795,2187,854,2356
221065,202111,2773,6887,2424,6289,15,49,2139,5479,2154,5528
221070,202111,3595,10669,2896,9219,359,1070,1725,5631,2084,6701
221080,202111,3699,8778,3038,7795,67,185,2510,6340,2577,6525
221090,202111,1466,3620,1203,3213,9,27,1033,2712,1042,2739
221093,202111,1532,4029,1398,3773,142,344,982,2615,1124,2959
221095,202111,925,2354,780,2132,10,24,664,1788,674,1812
221097,202111,901,2235,679,1841,22,55,511,1320,533,1375
221100,202111,126551,324743,105381,289384,10252,29645,68959,183731,79211,213376
221110,202111,10327,29705,9455,28565,115,537,8534,25585,8649,26122
221120,202111,5005,13549,4453,12705,158,435,3854,11071,4012,11506
221130,202111,5921,14420,4518,11828,820,1993,2349,6169,3169,8162
221135,202111,1906,4612,1698,4338,51,99,1508,3893,1559,3992
221140,202111,1420,3203,1192,2919,13,42,1078,2595,1091,2637
221150,202111,1131,2761,880,2335,22,94,686,1702,708,1796
221160,202111,760,1835,672,1723,28,37,536,1399,564,1436
221170,202111,1046,2894,959,2742,8,28,842,2366,850,2394
230010,202111,3202,8128,2633,7178,32,95,2173,5791,2205,5886
230015,202111,3270,10115,2879,9339,158,534,2030,6594,2188,7128
230020,202111,13546,41718,12676,40431,384,1401,10867,34589,11251,35990
230030,202111,13481,32637,11280,29782,280,668,9733,25796,10013,26464
230040,202111,4719,11721,3906,10416,35,158,3304,8681,3339,8839
230050,202111,2828,8550,2158,7031,327,1007,954,3030,1281,4037
230060,202111,2498,6589,1995,5706,29,93,1590,4465,1619,4558
230070,202111,4470,11023,3543,9366,242,658,2468,6454,2710,7112
230075,202111,9432,29180,8608,27755,748,2246,6453,21004,7201,23250
230080,202111,3214,6585,2449,5657,4,9,2258,5222,2262,5231
230090,202111,4684,10999,3939,9826,187,429,3180,7891,3367,8320
230100,202111,20139,48904,17579,45581,1609,3771,12339,32387,13948,36158
230110,202111,13268,38208,11058,33921,1783,5329,5662,17575,7445,22904
230120,202111,8285,21176,7236,19520,571,1315,5306,14505,5877,15820
230125,202111,3349,8549,2713,7566,118,300,2074,5728,2192,6028
230130,202111,6046,17715,4915,15308,448,1336,3181,9875,3629,11211
230140,202111,3601,10485,3044,9354,79,317,2333,6982,2412,7299
230150,202111,1718,4938,1411,4282,226,603,800,2529,1026,3132
230160,202111,6880,16917,5934,15518,111,303,5047,13020,5158,13323
230170,202111,6854,18603,5583,16047,457,1190,3831,10950,4288,12140
230180,202111,1742,4665,1467,4135,14,61,1205,3287,1219,3348
230185,202111,4716,12766,3994,11581,352,950,2853,8383,3205,9333
230190,202111,14864,41846,12437,37389,1403,4102,7315,21913,8718,26015
230195,202111,5759,16131,5215,15153,402,1113,3905,11342,4307,12455
230200,202111,5248,14023,4377,12428,164,431,3355,9371,3519,9802
230205,202111,4655,12564,4070,11715,271,702,3092,8870,3363,9572
230210,202111,11075,25119,9336,22832,426,1045,7306,17620,7732,18665
230220,202111,14944,36421,13093,33803,703,1722,10680,27364,11383,29086
230230,202111,7396,20722,6614,19172,508,1314,4821,14008,5329,15322
230240,202111,13600,35195,11662,31916,281,1067,9613,25635,9894,26702
230250,202111,9327,25076,8615,23997,218,670,6988,18884,7206,19554
230260,202111,15660,44023,13509,40330,2466,6705,6963,21674,9429,28379
230270,202111,8081,20783,6221,17387,634,1657,3829,10963,4463,12620
230280,202111,21186,54675,17315,48241,417,1540,13739,36773,14156,38313
230290,202111,5202,13872,4290,12182,239,538,3273,9284,3512,9822
230300,202111,5189,13175,4690,12501,83,203,4156,11070,4239,11273
230310,202111,4983,13732,4187,12308,122,435,2990,8612,3112,9047
230320,202111,8264,23093,6915,20695,191,734,5349,15660,5540,16394
230330,202111,4990,13086,3956,11168,112,328,3007,8288,3119,8616
230340,202111,4045,12016,3466,10842,201,661,2473,7592,2674,8253
230350,202111,19190,50220,16728,46657,841,2472,11471,32044,12312,34516
230360,202111,3163,8020,2501,6870,120,311,1767,4804,1887,5115
230365,202111,3222,7707,2652,6874,58,221,2266,5791,2324,6012
230370,202111,65110,170081,55656,156437,6833,19315,35757,100352,42590,119667
230380,202111,6715,17838,5305,15287,122,392,3951,11090,4073,11482
230390,202111,3653,10265,3143,9459,78,288,2453,7283,2531,7571
230393,202111,3597,10028,2843,8511,63,315,2225,6377,2288,6692
230395,202111,6058,16081,5209,14676,513,1316,3445,9829,3958,11145
230400,202111,5792,15241,5105,14149,62,280,4164,11201,4226,11481
230410,202111,14083,40807,11613,36361,949,3100,7835,24662,8784,27762
230420,202111,31114,81880,25351,72103,2880,8205,14510,40875,17390,49080
230423,202111,5065,14468,4418,13210,250,759,3295,9737,3545,10496
230425,202111,6088,17910,5559,16861,550,1612,3846,11641,4396,13253
230426,202111,2987,7530,2204,6060,29,93,1674,4499,1703,4592
230427,202111,1989,5349,1407,4166,108,327,862,2426,970,2753
230428,202111,10578,27103,9069,24847,1628,4116,4816,13352,6444,17468
230430,202111,5144,13928,4047,12029,153,463,3029,8875,3182,9338
230435,202111,6602,16191,5479,14251,814,1926,3158,8309,3972,10235
230440,202111,459269,1084494,384412,976995,33375,88052,260425,649013,293800,737065
230445,202111,4446,11548,3555,9990,230,590,2392,6583,2622,7173
230450,202111,3810,10498,3307,9770,222,762,2431,6981,2653,7743
230460,202111,2242,6020,1940,5546,44,175,1635,4610,1679,4785
230465,202111,4483,11930,3785,10615,122,362,2880,7799,3002,8161
230470,202111,11667,37389,10454,35190,857,3072,7279,24279,8136,27351
230480,202111,1556,4361,1297,3899,60,236,955,2753,1015,2989
230490,202111,2780,7479,2345,6670,179,541,1476,3959,1655,4500
230495,202111,6188,17255,5434,15927,734,2053,3172,9496,3906,11549
230500,202111,9711,30140,8570,28074,269,1014,6940,22770,7209,23784
230510,202111,1782,4907,1395,4115,152,454,775,2235,927,2689
230520,202111,5067,13315,4371,12124,451,1007,2928,8296,3379,9303
230523,202111,16441,46820,13020,39729,2913,8725,3071,10086,5984,18811
230526,202111,4047,10847,3430,9838,219,504,2469,7250,2688,7754
230530,202111,5870,17690,4929,15907,828,2655,2918,9479,3746,12134
230533,202111,4951,10945,4014,9526,139,280,3327,7806,3466,8086
230535,202111,5472,14851,4617,13416,362,1019,3001,8814,3363,9833
230540,202111,16565,43981,14139,40368,291,921,11704,33226,11995,34147
230550,202111,22828,57548,18350,50122,1517,4089,11963,32341,13480,36430
230560,202111,8220,19747,6637,17299,60,206,5733,14813,5793,15019
230565,202111,3261,8757,2714,7759,123,421,2081,5830,2204,6251
230570,202111,3600,8931,3041,8144,81,185,2487,6653,2568,6838
230580,202111,12122,29599,10377,27140,472,1073,8431,22164,8903,23237
230590,202111,9821,26715,8183,23777,591,1667,5885,16770,6476,18437
230600,202111,4042,9763,3178,8301,105,250,2132,5651,2237,5901
230610,202111,7041,18693,6239,17375,515,1294,4844,13524,5359,14818
230620,202111,2226,5796,1733,4869,105,315,1090,2946,1195,3261
230625,202111,9121,24247,7691,21727,1926,5694,2629,7538,4555,13232
230630,202111,12036,32934,10536,30157,1405,3643,6550,19130,7955,22773
230640,202111,28907,84653,26130,80234,1130,4034,20953,63411,22083,67445
230650,202111,5721,14614,4834,13135,109,370,3982,10518,4091,10888
230655,202111,9624,31505,9031,30502,638,2051,7248,24765,7886,26816
230660,202111,6299,18180,5108,16113,124,628,4120,12718,4244,13346
230670,202111,6516,14909,4706,12076,185,432,3692,9296,3877,9728
230680,202111,2861,7494,2395,6682,112,251,1712,4818,1824,5069
230690,202111,7567,21559,6456,19412,424,1399,4126,12236,4550,13635
230700,202111,11123,26901,8965,23046,464,967,6588,16739,7052,17706
230710,202111,7182,21955,6275,20055,739,2123,4057,13096,4796,15219
230720,202111,2029,5737,1658,5035,99,273,1169,3472,1268,3745
230725,202111,4600,12844,4113,12013,396,1217,2604,7509,3000,8726
230730,202111,62824,160356,49338,140542,11120,33115,14631,45333,25751,78448
230740,202111,6462,17388,5464,15801,144,396,4347,12595,4491,12991
230750,202111,8887,22910,7364,20403,167,473,5871,15878,6038,16351
230760,202111,11867,29997,10264,27570,480,1433,7755,20289,8235,21722
230763,202111,5315,13753,4419,12192,94,386,3587,9555,3681,9941
230765,202111,43564,113177,36127,101377,5141,14783,19273,53059,24414,67842
230770,202111,27815,64183,23355,58470,2232,5301,16057,40182,18289,45483
230780,202111,6812,22969,6126,21348,935,3003,3399,12345,4334,15348
230790,202111,3226,8808,2885,8262,103,385,2230,6182,2333,6567
230800,202111,8905,26753,7806,24590,1190,3582,4298,13547,5488,17129
230810,202111,11604,33948,10402,32011,409,1271,8112,24687,8521,25958
230820,202111,3801,11678,3144,10287,259,951,1971,6117,2230,7068
230830,202111,7987,21024,6782,19073,127,463,5611,15353,5738,15816
230835,202111,4425,10213,3429,8684,116,281,2740,6863,2856,7144
230837,202111,3377,9673,3006,9047,126,395,2415,7158,2541,7553
230840,202111,10072,28060,8638,25617,979,2601,6022,18017,7001,20618
230850,202111,10390,28577,8740,25438,392,1109,6407,18452,6799,19561
230860,202111,5820,13925,4802,12471,58,163,4244,10926,4302,11089
230870,202111,17135,40387,14738,36476,539,1287,11954,29132,12493,30419
230880,202111,2226,6454,2035,6146,39,189,1626,4776,1665,4965
230890,202111,4744,14617,4317,13811,314,996,3157,10045,3471,11041
230900,202111,3280,8958,2835,8146,150,496,1980,5500,2130,5996
230910,202111,3400,8709,2699,7646,54,211,2182,6186,2236,6397
230920,202111,5111,13594,4239,12208,90,284,3375,9531,3465,9815
230930,202111,7229,19310,5966,17077,289,773,4082,11648,4371,12421
230940,202111,8690,21035,7551,19344,209,428,6365,16279,6574,16707
230945,202111,6995,19120,5955,17193,323,967,4226,11939,4549,12906
230950,202111,6548,15903,5784,14872,136,267,4954,12839,5090,13106
230960,202111,14408,39608,12602,36281,2295,6384,5901,17015,8196,23399
230970,202111,15355,38872,12894,35104,1654,4199,7893,21540,9547,25739
230980,202111,2975,8090,2598,7447,358,934,1658,4933,2016,5867
230990,202111,1768,4786,1458,4193,61,207,1030,2842,1091,3049
231000,202111,2746,7048,2199,6000,96,213,1620,4316,1716,4529
231010,202111,3923,8685,3088,7303,25,87,2726,6278,2751,6365
231020,202111,8924,25834,7942,24013,1362,3667,4631,14559,5993,18226
231025,202111,8201,21193,7151,19496,771,1926,5061,13988,5832,15914
231030,202111,7800,22336,6110,18862,1088,3048,3046,9641,4134,12689
231040,202111,3138,8479,2711,7717,117,297,2140,6001,2257,6298
231050,202111,12650,30718,10312,26673,662,1525,7797,19791,8459,21316
231060,202111,3058,8329,2703,7775,57,152,2249,6482,2306,6634
231070,202111,8558,23659,7361,21584,637,1842,4962,14359,5599,16201
231080,202111,4161,11327,3503,10256,136,482,2642,7584,2778,8066
231085,202111,7314,16903,5829,15177,243,514,4567,12011,4810,12525
231090,202111,4730,11970,3487,9627,112,397,2391,6344,2503,6741
231095,202111,2362,6820,1867,5783,187,545,1209,3760,1396,4305
231100,202111,3386,9425,2749,8218,132,402,2063,6111,2195,6513
231110,202111,3943,11002,3618,10416,148,459,2726,7703,2874,8162
231120,202111,2513,6961,2093,6239,93,279,1518,4500,1611,4779
231123,202111,2026,5088,1685,4512,102,222,1186,3194,1288,3416
231126,202111,5893,15491,4784,13429,317,749,3432,9588,3749,10337
231130,202111,23152,56117,19194,51230,1230,3297,14177,37555,15407,40852
231135,202111,4369,11928,3605,10477,191,555,2522,7267,2713,7822
231140,202111,17628,47971,14245,42255,615,2073,10248,29751,10863,31824
231150,202111,6355,16513,4666,13288,638,1864,1914,5612,2552,7476
231160,202111,6621,19776,5860,18392,812,2295,3297,10746,4109,13041
231170,202111,4897,13387,4059,11823,277,799,2832,7972,3109,8771
231180,202111,15672,42378,12715,36383,2698,7470,5283,15273,7981,22743
231190,202111,4238,11416,3456,10036,70,224,2681,7648,2751,7872
231195,202111,5453,15498,4508,13621,274,838,3264,9829,3538,10667
231200,202111,8268,24284,7170,22134,163,720,5795,17346,5958,18066
231210,202111,5191,14467,4399,13142,144,455,3412,9972,3556,10427
231220,202111,13592,32942,10653,27596,549,1311,7861,19760,8410,21071
231230,202111,9539,29576,8403,27490,637,2166,5991,19746,6628,21912
231240,202111,12354,34698,10850,31931,1860,5155,6277,18822,8137,23977
231250,202111,2234,5478,1464,3832,119,310,868,2210,987,2520
231260,202111,3455,9232,3005,8519,313,758,1976,5818,2289,6576
231270,202111,6684,16887,5345,14686,136,491,4082,10872,4218,11363
231280,202111,1837,5489,1667,5192,92,253,1241,3853,1333,4106
231290,202111,39654,114219,33011,101206,5441,16309,15275,46404,20716,62713
231300,202111,4399,11620,3440,9746,145,452,2378,6540,2523,6992
231310,202111,8047,19730,6366,16699,594,1537,4293,10974,4887,12511
231320,202111,7992,21413,6137,18121,102,362,4925,14334,5027,14696
231325,202111,2672,6576,2190,5866,198,349,1521,4233,1719,4582
231330,202111,10543,29640,8767,26192,1772,4803,4591,14501,6363,19304
231335,202111,5877,15186,4959,13739,84,306,4330,11896,4414,12202
231340,202111,19572,56855,17593,53417,1271,3616,13199,40574,14470,44190
231350,202111,16550,44003,15102,41947,257,787,13574,37448,13831,38235
231355,202111,4713,13367,4236,12495,257,725,3304,9657,3561,10382
231360,202111,8228,23680,7105,21766,365,1099,5524,16896,5889,17995
231370,202111,2273,6094,1815,5279,35,98,1389,4014,1424,4112
231375,202111,4419,13367,4037,12742,99,398,3407,10638,3506,11036
231380,202111,6314,16521,5695,15673,229,479,4622,12909,4851,13388
231390,202111,3643,10148,3262,9505,110,367,2438,6913,2548,7280
231395,202111,4428,12280,3673,11081,275,814,2435,7320,2710,8134
231400,202111,10172,28453,8510,25441,235,980,6461,18883,6696,19863
231410,202111,15820,46745,14399,44457,819,2199,11473,35715,12292,37914
240010,202111,2732,6883,2128,5815,273,705,1148,3140,1421,3845
240020,202111,13545,36252,11321,32357,714,2233,7407,20917,8121,23150
240030,202111,3264,7416,2917,6906,133,337,2516,5884,2649,6221
240040,202111,878,2436,728,2161,26,107,502,1409,528,1516
240050,202111,3589,9280,2870,7993,42,117,2200,5993,2242,6110
240060,202111,1523,3874,1236,3354,26,71,993,2638,1019,2709
240070,202111,2551,6876,2242,6231,260,685,1522,4154,1782,4839
240080,202111,3098,8060,2471,6972,85,267,1819,5074,1904,5341
240090,202111,2362,5696,1925,4970,18,38,1605,4094,1623,4132
240100,202111,11116,26063,8845,22131,184,510,7052,17014,7236,17524
240110,202111,4770,13140,3960,11642,202,686,2904,8346,3106,9032
240120,202111,3587,9687,2941,8875,215,618,2076,6400,2291,7018
240130,202111,4018,7939,3278,6971,29,56,2974,6261,3003,6317
240140,202111,1916,5580,1625,5028,190,603,1050,3244,1240,3847
240145,202111,7014,18775,5696,16533,915,2629,3209,9433,4124,12062
240150,202111,1013,2803,891,2564,51,140,682,1925,733,2065
240160,202111,1547,4466,1289,3981,35,136,981,3029,1016,3165
240165,202111,1022,2698,850,2374,26,94,704,1922,730,2016
240170,202111,2875,7288,2415,6493,280,719,1528,4111,1808,4830
240180,202111,3186,9180,2531,7855,605,1809,1043,3434,1648,5243
240185,202111,1325,3987,1222,3811,54,178,1021,3170,1075,3348
240190,202111,1157,3167,991,2901,22,85,815,2392,837,2477
240200,202111,11993,29008,9580,24954,1043,2693,5426,13891,6469,16584
240210,202111,3485,8254,2829,7207,23,106,2403,5905,2426,6011
240220,202111,7711,22642,6917,21406,377,1416,5432,16695,5809,18111
240230,202111,6148,15115,4892,13057,260,601,3749,10126,4009,10727
240240,202111,1875,5258,1225,3798,120,372,419,1165,539,1537
240250,202111,3172,7941,2736,7335,65,191,2367,6279,2432,6470
240260,202111,14285,41655,12285,38314,1872,5387,7183,23915,9055,29302
240270,202111,2555,7200,2194,6600,119,347,1610,4965,1729,5312
240280,202111,1806,4453,1493,3942,77,172,1153,3040,1230,3212
240290,202111,1231,3500,1002,3013,26,108,714,2031,740,2139
240300,202111,2411,5987,1732,4768,74,190,1062,2870,1136,3060
240310,202111,8882,22996,6979,19595,902,2663,3518,9711,4420,12374
240320,202111,2164,5666,1554,4494,43,168,1154,3178,1197,3346
240325,202111,34324,87813,27425,76156,4504,12715,12854,35292,17358,48007
240330,202111,1902,5005,1460,4186,53,178,1014,2768,1067,2946
240340,202111,2124,4660,1722,4073,50,110,1420,3280,1470,3390
240350,202111,2402,5793,2134,5493,37,97,1938,5008,1975,5105
240360,202111,10520,27809,9306,25936,1206,3137,5993,17118,7199,20255
240370,202111,2182,5323,1668,4329,86,202,1159,2920,1245,3122
240375,202111,983,2400,812,2106,29,94,636,1585,665,1679
240380,202111,2353,6467,1767,5203,218,542,913,2732,1131,3274
240390,202111,1096,2559,785,1990,27,43,504,1196,531,1239
240400,202111,1604,3760,1227,3134,32,117,871,2072,903,2189
240410,202111,609,1739,495,1519,50,166,307,889,357,1055
240420,202111,4952,16402,4375,15197,441,1713,2690,9136,3131,10849
240430,202111,3655,8998,3018,7915,162,491,2273,5776,2435,6267
240440,202111,2713,5867,2307,5294,228,415,1747,4082,1975,4497
240450,202111,4754,12520,3706,10598,387,1091,2115,5834,2502,6925
240460,202111,3363,8799,3003,8235,263,701,2370,6522,2633,7223
240470,202111,3719,10996,2807,9113,689,2064,1135,3975,1824,6039
240480,202111,623,1641,414,1192,28,59,198,560,226,619
240485,202111,2316,6218,1857,5408,138,368,1241,3657,1379,4025
240490,202111,1701,4195,1329,3535,90,165,931,2525,1021,2690
240500,202111,2228,5915,1908,5356,108,287,1503,4236,1611,4523
240510,202111,1763,4578,1516,4199,88,268,1194,3268,1282,3536
240520,202111,1649,3729,1252,3195,97,188,888,2383,985,2571
240530,202111,2451,6426,2193,6022,83,230,1818,4913,1901,5143
240540,202111,2453,5877,2163,5442,67,123,1862,4713,1929,4836
240550,202111,772,2028,691,1880,15,59,592,1563,607,1622
240560,202111,3419,8512,2888,7804,292,660,2087,5812,2379,6472
240570,202111,2949,7490,1968,5402,315,845,659,1711,974,2556
240580,202111,8522,24388,7466,22485,774,2074,5657,17364,6431,19438
240590,202111,841,1971,738,1811,9,25,597,1427,606,1452
240600,202111,1918,5001,1416,3996,47,128,952,2584,999,2712
240610,202111,4585,11670,3929,10521,137,366,3004,7878,3141,8244
240615,202111,1341,3330,1079,2880,108,256,735,1947,843,2203
240620,202111,1927,5175,1645,4710,126,295,1282,3729,1408,4024
240630,202111,2228,5854,1988,5465,158,314,1365,3969,1523,4283
240640,202111,1008,2600,795,2249,24,79,592,1642,616,1721
240650,202111,4306,11761,3651,10444,321,787,2562,7363,2883,8150
240660,202111,3264,7984,2905,7529,69,172,2635,6833,2704,7005
240670,202111,2670,7079,2119,5993,145,405,1396,3840,1541,4245
240680,202111,1698,4302,1358,3722,79,201,1009,2696,1088,2897
240690,202111,1137,2681,883,2260,13,51,724,1769,737,1820
240700,202111,2592,7270,2108,6384,93,283,1581,4737,1674,5020
240710,202111,17557,43183,14775,38556,1687,4294,9600,24757,11287,29051
240720,202111,5643,13381,4819,12214,614,1481,3229,8259,3843,9740
240725,202111,1200,3312,913,2772,38,114,617,1815,655,1929
240730,202111,2417,6450,1922,5505,56,155,1459,4117,1515,4272
240740,202111,2013,5280,1610,4483,63,197,1130,2977,1193,3174
240750,202111,2347,7333,1977,6542,255,886,1080,3594,1335,4480
240760,202111,1803,3939,1293,3183,94,115,987,2512,1081,2627
240770,202111,3423,9142,2867,8360,148,459,2308,6698,2456,7157
240780,202111,4925,13430,4075,12029,604,1688,2434,7414,3038,9102
240790,202111,937,2535,767,2232,16,67,581,1630,597,1697
240800,202111,53629,123064,41930,105674,5598,13674,22121,55636,27719,69310
240810,202111,98489,243566,83720,219822,8762,23569,55845,143566,64607,167135
240820,202111,6196,17709,5376,16244,758,2195,3263,10066,4021,12261
240830,202111,9119,25305,8040,23682,305,1026,6511,19069,6816,20095
240840,202111,1134,2750,902,2387,27,67,646,1651,673,1718
240850,202111,1519,3989,1067,3038,71,200,594,1633,665,1833
240860,202111,1427,3665,1076,3052,13,54,840,2281,853,2335
240870,202111,1143,2798,857,2315,162,444,438,1217,600,1661
240880,202111,1354,4166,1182,3837,78,304,865,2747,943,3051
240890,202111,4787,12540,3666,10470,489,1470,1886,5143,2375,6613
240895,202111,3044,8960,2764,8505,288,815,2112,6681,2400,7496
240910,202111,3710,9592,3130,8581,56,178,2554,6835,2610,7013
240920,202111,1070,2648,858,2325,107,210,463,1362,570,1572
240930,202111,3841,8452,3157,7610,252,361,2253,5865,2505,6226
240933,202111,1725,4144,1449,3752,34,114,1260,3198,1294,3312
240940,202111,6713,15886,5234,13397,700,1663,2949,7461,3649,9124
240950,202111,1153,3287,999,3009,34,131,806,2356,840,2487
240960,202111,710,2120,635,1973,20,62,499,1522,519,1584
240970,202111,1991,4940,1594,4269,67,224,1302,3397,1369,3621
240980,202111,3531,10042,3126,9341,98,405,2559,7481,2657,7886
240990,202111,2793,7421,2458,6809,255,769,1731,4617,1986,5386
241000,202111,990,2508,775,2125,25,60,582,1558,607,1618
241010,202111,2998,9122,2701,8504,181,590,1995,6244,2176,6834
241020,202111,2260,5805,1708,4729,93,259,1171,3121,1264,3380
241025,202111,1870,5166,1497,4508,32,127,1099,3229,1131,3356
241030,202111,2577,7928,2068,6856,264,818,1275,4287,1539,5105
241040,202111,2338,7142,2025,6600,75,343,1578,5114,1653,5457
241050,202111,1472,3994,1182,3469,32,111,857,2461,889,2572
241060,202111,840,2243,727,2016,41,102,497,1353,538,1455
241070,202111,732,1883,608,1688,15,38,472,1271,487,1309
241080,202111,1176,3251,897,2682,31,111,637,1865,668,1976
241090,202111,2136,5914,1736,5244,61,249,1320,3886,1381,4135
241100,202111,1282,3387,958,2740,62,152,632,1767,694,1919
241105,202111,990,2899,800,2545,238,755,271,897,509,1652
241110,202111,1037,2794,775,2251,43,120,499,1390,542,1510
241120,202111,7927,21862,6651,19660,849,2393,3992,12174,4841,14567
241140,202111,3566,9122,2745,7501,158,409,1963,5259,2121,5668
241142,202111,821,2176,608,1773,30,90,364,1021,394,1111
241150,202111,6313,15627,5563,14457,211,464,4414,11404,4625,11868
241160,202111,1299,3400,1012,2873,158,474,558,1513,716,1987
241170,202111,1443,3550,1214,3159,41,120,990,2489,1031,2609
241180,202111,1125,2757,828,2209,114,326,372,961,486,1287
241190,202111,1238,3104,1029,2702,11,41,756,1906,767,1947
241200,202111,21905,54263,18981,49561,2825,7318,11277,29161,14102,36479
241210,202111,1590,4045,1140,3186,107,321,656,1792,763,2113
241220,202111,9713,26902,8525,24957,1811,5223,4033,12268,5844,17491
241230,202111,2999,7810,2633,7237,113,306,2175,5942,2288,6248
241240,202111,1336,3613,845,2560,91,275,303,923,394,1198
241250,202111,5978,16340,4805,14228,164,623,3594,10250,3758,10873
241255,202111,2548,7430,2243,6845,160,502,1633,4899,1793,5401
241260,202111,5275,13167,4197,11429,119,371,3360,8978,3479,9349
241270,202111,1732,4895,1434,4331,130,376,984,3005,1114,3381
241280,202111,2307,5548,1976,4964,76,170,1656,4101,1732,4271
241290,202111,3475,8258,2546,6785,78,203,1982,5172,2060,5375
241300,202111,1591,4111,1285,3582,28,81,863,2339,891,2420
241310,202111,2327,5486,2004,5029,29,70,1748,4434,1777,4504
241320,202111,1004,3142,861,2874,88,331,542,1802,630,2133
241330,202111,1851,4600,1457,4079,16,71,1282,3570,1298,3641
241335,202111,3675,9801,3206,8965,129,381,2608,7196,2737,7577
241340,202111,1666,4489,1309,3784,217,683,611,1670,828,2353
241350,202111,2309,6073,2013,5546,135,321,1508,4164,1643,4485
241355,202111,1429,3729,1153,3201,15,36,871,2386,886,2422
241360,202111,2169,5428,1603,4316,56,127,1170,3088,1226,3215
241370,202111,1452,3809,1128,3152,86,234,758,2057,844,2291
241380,202111,754,1944,580,1630,95,240,274,788,369,1028
241390,202111,2874,8105,2546,7617,222,535,1901,5859,2123,6394
241400,202111,3862,10303,3401,9604,218,617,2633,7424,2851,8041
241410,202111,2603,7473,2109,6476,296,915,1172,3604,1468,4519
241415,202111,1840,5038,1535,4459,42,131,1170,3308,1212,3439
241420,202111,2665,7790,2327,7220,448,1476,1323,4088,1771,5564
241430,202111,648,1677,452,1263,19,47,295,798,314,845
241440,202111,8323,24454,7424,22883,318,1026,5890,18163,6208,19189
241445,202111,1338,3144,1158,2908,60,94,976,2571,1036,2665
241450,202111,3024,7010,2528,6235,359,742,1717,4356,2076,5098
241460,202111,4142,10800,3329,9149,247,591,2206,5972,2453,6563
241470,202111,1463,3800,1203,3411,24,72,990,2805,1014,2877
241475,202111,1317,3503,1028,2961,14,57,780,2135,794,2192
241480,202111,3186,9524,2598,8266,786,2492,777,2772,1563,5264
241490,202111,751,1682,553,1400,19,38,416,1042,435,1080
241500,202111,824,2243,745,2145,3,10,707,2049,710,2059
250010,202111,2785,7985,2326,7049,51,176,1725,5111,1776,5287
250020,202111,1752,4463,1283,3589,57,100,913,2565,970,2665
250030,202111,7225,19239,6355,17910,675,1844,4568,12829,5243,14673
250040,202111,4479,12690,3888,11635,420,1145,2699,8014,3119,9159
250050,202111,3855,9881,3483,9403,122,363,2918,7895,3040,8258
250053,202111,1298,3491,1181,3312,86,213,877,2468,963,2681
250057,202111,722,2367,664,2281,9,43,610,2112,619,2155
250060,202111,5959,14816,5360,14065,344,815,4380,11621,4724,12436
250070,202111,4282,11475,3584,10300,19,73,2904,8147,2923,8220
250073,202111,821,2091,664,1850,13,27,538,1478,551,1505
250077,202111,2509,6211,1911,5260,47,145,1514,4100,1561,4245
250080,202111,5485,12876,4616,11791,62,195,4102,10345,4164,10540
250090,202111,3650,8391,3179,7778,57,140,2754,6628,2811,6768
250100,202111,3746,10972,3356,10273,169,509,2617,7885,2786,8394
250110,202111,5087,13800,4582,13083,301,939,3500,9908,3801,10847
250115,202111,796,1882,593,1569,9,39,468,1212,477,1251
250120,202111,1973,5535,1655,5026,24,117,1327,3989,1351,4106
250130,202111,5874,15301,4947,13993,56,281,4257,11868,4313,12149
250135,202111,1315,3465,1148,3180,18,56,1000,2765,1018,2821
250140,202111,2392,6698,2219,6485,112,376,1910,5590,2022,5966
250150,202111,4925,14832,4410,13974,131,484,3553,11077,3684,11561
250153,202111,1425,3701,1173,3329,38,91,924,2618,962,2709
250157,202111,2055,5568,1822,5185,58,184,1462,4092,1520,4276
250160,202111,4133,9841,3299,8721,52,134,2856,7567,2908,7701
250170,202111,1999,5002,1795,4718,20,66,1565,4051,1585,4117
250180,202111,22207,50944,18970,46853,801,2134,15092,36379,15893,38513
250190,202111,4407,11196,3703,10179,339,918,2619,7117,2958,8035
250200,202111,2187,5387,1854,4956,81,177,1539,4156,1620,4333
250205,202111,919,2762,788,2553,13,45,635,2044,648,2089
250210,202111,1592,4668,1432,4428,38,148,1142,3477,1180,3625
250215,202111,1732,4507,1449,4117,72,208,841,2422,913,2630
250220,202111,695,1880,550,1656,24,84,371,1098,395,1182
250230,202111,1779,3895,1249,3119,26,65,996,2445,1022,2510
250240,202111,2558,7283,2248,6744,32,130,1930,5726,1962,5856
250250,202111,4813,12897,4208,12036,112,295,3568,10316,3680,10611
250260,202111,1752,4782,1476,4301,47,117,1147,3368,1194,3485
250270,202111,1251,3692,1141,3556,64,201,858,2760,922,2961
250280,202111,3767,9611,3358,9030,189,404,2615,7125,2804,7529
250290,202111,1644,4202,1404,3843,16,41,1123,3047,1139,3088
250300,202111,5753,14775,5167,14083,149,602,4401,11631,4550,12233
250310,202111,1260,3393,1046,3035,44,137,778,2253,822,2390
250320,202111,13259,28470,11471,26443,260,658,10362,23586,10622,24244
250330,202111,2557,6738,2142,6175,237,496,1616,4814,1853,5310
250340,202111,1242,2984,1092,2792,14,36,997,2535,1011,2571
250350,202111,4321,11729,3785,10809,231,460,2965,8750,3196,9210
250355,202111,2158,6163,1932,5865,23,117,1752,5316,1775,5433
250360,202111,1917,4998,1717,4738,37,118,1456,3961,1493,4079
250370,202111,14698,35960,12219,32275,227,723,10417,27068,10644,27791
250375,202111,1290,3171,1043,2879,4,17,984,2731,988,2748
250380,202111,1707,4193,1567,4020,33,103,1391,3482,1424,3585
250390,202111,1939,4803,1629,4325,73,191,1321,3482,1394,3673
250400,202111,73702,176690,54698,147674,15112,44542,13877,39988,28989,84530
250403,202111,1934,5097,1727,4860,50,250,1388,3726,1438,3976
250407,202111,1444,3325,1102,2818,113,214,671,1903,784,2117
250410,202111,727,1865,619,1683,5,13,507,1341,512,1354
250415,202111,1981,5291,1733,4909,30,104,1487,4187,1517,4291
250420,202111,1256,3343,1123,3163,23,78,1024,2874,1047,2952
250430,202111,6539,15741,5537,14428,165,427,4515,11575,4680,12002
250435,202111,1668,4561,1320,3973,10,40,1001,2961,1011,3001
250440,202111,4838,12484,4187,11665,83,165,3684,10283,3767,10448
250450,202111,1859,4805,1527,4355,33,99,1251,3594,1284,3693
250460,202111,7718,20159,6849,18913,476,1273,5353,14809,5829,16082
250470,202111,1673,4161,1364,3681,66,177,1064,2822,1130,2999
250480,202111,4119,11002,3483,10227,34,107,3091,9166,3125,9273
250485,202111,761,1663,565,1390,48,82,395,957,443,1039
250490,202111,5324,12333,4728,11654,143,380,4204,10198,4347,10578
250500,202111,2111,5647,1884,5262,61,134,1528,4275,1589,4409
250510,202111,5686,13840,4877,12755,80,159,4242,11203,4322,11362
250520,202111,2046,5227,1747,4825,118,315,1285,3525,1403,3840
250523,202111,2227,5437,1957,5089,76,265,1627,4101,1703,4366
250527,202111,1780,4344,1604,4148,22,56,1434,3710,1456,3766
250530,202111,695,1723,593,1572,14,32,512,1353,526,1385
250535,202111,1447,4053,1293,3774,26,93,1037,2940,1063,3033
250540,202111,3245,7050,2708,6456,81,145,2388,5810,2469,5955
250550,202111,811,2527,714,2337,22,74,515,1666,537,1740
250560,202111,1851,4952,1615,4611,38,113,1358,3812,1396,3925
250570,202111,2890,8205,2465,7440,93,282,1911,5714,2004,5996
250580,202111,1098,2806,967,2626,46,151,811,2143,857,2294
250590,202111,942,2394,835,2240,19,55,714,1885,733,1940
250600,202111,8362,21484,6933,19584,254,748,5490,15440,5744,16188
250610,202111,3091,8520,2766,8051,109,359,2287,6626,2396,6985
250620,202111,897,2232,770,2023,23,51,548,1431,571,1482
250625,202111,2498,7041,2228,6600,35,163,1916,5553,1951,5716
250630,202111,11228,29410,9222,26019,1017,2859,5933,16394,6950,19253
250640,202111,3783,9804,3386,9289,73,281,2986,8084,3059,8365
250650,202111,1074,2459,892,2222,15,49,782,1905,797,1954
250660,202111,1706,4084,1350,3594,46,99,1100,2844,1146,2943
250670,202111,2469,7419,2244,7028,33,133,1963,6040,1996,6173
250680,202111,6207,14003,5566,13281,47,183,5215,12264,5262,12447
250690,202111,7181,15764,6034,14350,100,194,5337,12612,5437,12806
250700,202111,4647,12659,4038,11741,686,1910,2414,7151,3100,9061
250710,202111,4540,12819,3956,11984,291,834,2859,8757,3150,9591
250720,202111,2974,7694,2655,7246,26,132,2398,6485,2424,6617
250730,202111,4493,11451,3928,10685,148,458,3254,8651,3402,9109
250740,202111,2096,5013,1724,4523,107,231,1326,3531,1433,3762
250750,202111,115888,274538,98521,250238,8435,21749,71047,177673,79482,199422
250760,202111,2575,6203,2255,5696,61,151,1893,4671,1954,4822
250770,202111,4284,12406,3826,11789,518,1394,2605,8358,3123,9752
250780,202111,1897,4876,1601,4353,67,197,1254,3332,1321,3529
250790,202111,2671,7552,2315,7028,73,284,1749,5182,1822,5466
250800,202111,2588,6608,2273,6114,120,216,1808,4963,1928,5179
250810,202111,1394,3478,1164,3162,49,86,960,2673,1009,2759
250820,202111,2048,5578,1880,5391,30,120,1700,4837,1730,4957
250830,202111,6298,18241,5134,15890,252,834,3429,10287,3681,11121
250840,202111,800,2482,695,2280,18,60,520,1726,538,1786
250850,202111,1890,5382,1688,5029,30,117,1407,4100,1437,4217
250855,202111,1102,3001,954,2765,54,173,752,2156,806,2329
250860,202111,3547,9972,2894,8864,538,1525,1447,4605,1985,6130
250870,202111,1086,2882,916,2605,38,115,732,2061,770,2176
250880,202111,1715,4261,1425,3820,102,281,1061,2841,1163,3122
250890,202111,11049,26776,9735,25071,404,1271,7932,19591,8336,20862
250900,202111,3134,8115,2718,7395,100,221,2281,6161,2381,6382
250905,202111,2673,7093,2470,6819,52,137,2246,6224,2298,6361
250910,202111,6636,15612,5504,14344,66,176,4853,12703,4919,12879
250915,202111,2243,5078,1579,4365,25,47,1381,3907,1406,3954
250920,202111,3683,9080,3237,8410,280,619,2488,6470,2768,7089
250930,202111,2448,6388,2205,6073,41,174,1926,5168,1967,5342
250933,202111,1257,3589,1107,3317,38,142,871,2567,909,2709
250937,202111,766,2022,638,1817,23,75,501,1450,524,1525
250939,202111,2027,5012,1778,4701,67,147,1405,3724,1472,3871
250940,202111,4256,10925,3738,10256,24,66,3365,9236,3389,9302
250950,202111,1833,4594,1479,4131,30,104,1202,3302,1232,3406
250960,202111,1170,3352,1030,3131,22,96,832,2462,854,2558
250970,202111,8691,21761,7612,20029,207,568,6270,16189,6477,16757
250980,202111,2529,6450,2292,6113,18,84,2024,5265,2042,5349
250990,202111,2159,6337,1807,5732,58,215,1352,4242,1410,4457
251000,202111,2108,5817,1701,5121,25,89,1376,4126,1401,4215
251010,202111,2787,7539,2523,7127,24,82,2255,6384,2279,6466
251020,202111,1704,4559,1525,4274,30,121,1320,3636,1350,3757
251030,202111,1100,2835,899,2482,56,135,594,1649,650,1784
251040,202111,1983,5272,1680,4775,28,123,1406,3953,1434,4076
251050,202111,1091,2923,910,2577,46,147,657,1787,703,1934
251060,202111,1132,2366,857,2018,14,33,650,1523,664,1556
251065,202111,509,1346,384,1114,9,24,271,753,280,777
251070,202111,788,1949,653,1755,8,29,564,1477,572,1506
251080,202111,20266,49373,16374,43530,2505,6735,9403,25530,11908,32265
251090,202111,2990,8354,2532,7556,60,163,1999,5940,2059,6103
251100,202111,861,2662,755,2453,25,81,590,1845,615,1926
251110,202111,1879,4763,1581,4243,100,195,1164,3161,1264,3356
251120,202111,8211,21568,6906,19978,378,1132,5238,15237,5616,16369
251130,202111,4160,8859,3664,8298,51,119,3343,7536,3394,7655
251140,202111,4525,12213,4016,11501,65,235,3314,9394,3379,9629
251150,202111,2796,7862,2554,7473,62,265,2197,6268,2259,6533
251160,202111,2310,6502,1992,6034,28,136,1717,5106,1745,5242
251170,202111,1755,4469,1539,4192,19,57,1396,3768,1415,3825
251180,202111,2748,7110,2251,6418,144,381,1598,4579,1742,4960
251190,202111,4639,11791,4179,11270,33,173,3804,10067,3837,10240
251200,202111,4615,12983,4059,12282,62,230,3553,10801,3615,11031
251203,202111,1051,3249,961,3043,31,95,715,2212,746,2307
251207,202111,1195,3122,908,2661,18,71,635,1818,653,1889
251210,202111,8395,20160,6852,18077,396,765,5057,13786,5453,14551
251220,202111,1348,3078,1013,2638,91,174,733,1996,824,2170
251230,202111,4980,13432,4290,12200,112,325,3401,9468,3513,9793
251240,202111,3839,10345,3216,9279,212,494,2312,6685,2524,7179
251250,202111,11636,29810,10188,27359,722,1885,7581,19818,8303,21703
251260,202111,534,1424,480,1337,13,52,383,1032,396,1084
251270,202111,4497,13574,4021,12918,129,461,3250,10676,3379,11137
251272,202111,1357,3646,1240,3491,66,204,1024,2835,1090,3039
251274,202111,952,2564,766,2230,59,178,499,1394,558,1572
251275,202111,1306,3516,1096,3173,39,135,843,2392,882,2527
251276,202111,1372,3665,1192,3419,21,105,966,2682,987,2787
251278,202111,645,1682,580,1586,39,105,443,1219,482,1324
251280,202111,2392,6239,2178,5932,58,149,1832,4950,1890,5099
251290,202111,6737,14719,6147,14010,192,497,5457,12143,5649,12640
251300,202111,918,2628,826,2485,8,39,707,2110,715,2149
251310,202111,2972,8024,2586,7445,32,148,2148,6046,2180,6194
251315,202111,1879,5633,1695,5273,123,328,1261,3944,1384,4272
251320,202111,1709,4429,1257,3643,31,97,943,2686,974,2783
251330,202111,2232,5065,1821,4583,28,73,1611,4085,1639,4158
251335,202111,1177,3187,1051,2998,23,92,931,2605,954,2697
251340,202111,3999,9145,3188,8085,126,303,2465,6270,2591,6573
251350,202111,1123,3095,1024,2931,37,99,836,2379,873,2478
251360,202111,1970,5282,1586,4735,11,52,1303,3874,1314,3926
251365,202111,813,2081,639,1759,6,20,511,1383,517,1403
251370,202111,26351,67209,22514,61796,3608,9609,12461,35547,16069,45156
251380,202111,1373,3617,1164,3275,14,79,997,2737,1011,2816
251385,202111,817,2029,634,1703,28,66,464,1210,492,1276
251390,202111,6727,18935,5927,17699,564,1615,3894,11798,4458,13413
251392,202111,1067,2817,900,2561,24,90,715,2006,739,2096
251394,202111,674,1857,541,1629,48,126,371,1121,419,1247
251396,202111,698,1845,587,1653,21,48,390,1081,411,1129
251398,202111,1076,2650,766,2113,17,50,568,1527,585,1577
251400,202111,1391,3146,1098,2757,20,68,894,2164,914,2232
251410,202111,1657,3722,1328,3263,20,75,1130,2663,1150,2738
251420,202111,2128,5288,1739,4827,33,120,1391,3786,1424,3906
251430,202111,1618,4768,1455,4484,33,146,1254,3838,1287,3984
251440,202111,1136,3099,916,2698,48,101,696,2108,744,2209
251445,202111,1653,4461,1518,4268,26,68,1309,3644,1335,3712
251450,202111,4452,12968,3979,12242,77,284,3325,10162,3402,10446
251455,202111,923,2698,845,2557,17,61,685,2029,702,2090
251460,202111,1011,2760,849,2510,30,91,673,1997,703,2088
251465,202111,492,1373,418,1228,5,20,319,905,324,925
251470,202111,1256,3357,944,2736,79,224,539,1505,618,1729
251480,202111,1082,2719,877,2366,15,51,682,1765,697,1816
251490,202111,2055,5216,1643,4647,86,213,1212,3471,1298,3684
251500,202111,2072,5639,1900,5422,39,131,1708,4870,1747,5001
251510,202111,2838,8165,2356,7220,111,351,1614,4820,1725,5171
251520,202111,1121,2771,860,2317,75,188,556,1463,631,1651
251530,202111,15322,35600,12348,31920,101,487,10950,27803,11051,28290
251540,202111,3270,8893,2935,8305,61,212,2497,6950,2558,7162
251550,202111,4186,9247,3333,8221,175,252,2726,6877,2901,7129
251560,202111,599,1769,534,1669,40,130,379,1137,419,1267
251570,202111,991,2720,814,2372,23,101,649,1839,672,1940
251580,202111,2075,4871,1855,4554,36,120,1590,3766,1626,3886
251590,202111,1714,4038,1445,3719,74,164,1200,3064,1274,3228
251593,202111,1002,2850,898,2674,92,246,569,1686,661,1932
251597,202111,2208,5996,1977,5688,13,70,1785,5077,1798,5147
251600,202111,6608,17376,5753,16064,259,669,4637,12864,4896,13533
251610,202111,3285,9112,2843,8305,291,713,1896,5708,2187,6421
251615,202111,1390,3315,1115,2908,22,63,909,2302,931,2365
251620,202111,20302,44614,15591,38888,70,228,13556,34021,13626,34249
251630,202111,5250,11737,4188,10275,237,527,3107,7565,3344,8092
251640,202111,2361,6111,2109,5729,20,86,1897,5060,1917,5146
251650,202111,4259,10902,3697,10180,126,322,3141,8649,3267,8971
251660,202111,3797,10914,3348,10143,53,216,2789,8342,2842,8558
251670,202111,4324,11797,3812,11088,33,160,3440,9921,3473,10081
251675,202111,798,1974,726,1890,88,196,523,1383,611,1579
251680,202111,2758,6884,2307,6302,43,121,1919,5267,1962,5388
251690,202111,3385,9137,2889,8295,95,222,2177,6258,2272,6480
251700,202111,2350,6285,1954,5778,39,149,1653,4783,1692,4932
251710,202111,858,2125,603,1618,43,122,343,855,386,977
251720,202111,1389,3819,1117,3354,10,41,869,2535,879,2576
251740,202111,628,1715,500,1476,37,130,343,973,380,1103
260005,202111,31513,65061,26018,58033,2242,4651,19360,42593,21602,47244
260010,202111,10936,27689,9031,24643,516,1360,5303,14626,5819,15986
260020,202111,7253,16339,6032,14612,64,251,5174,12288,5238,12539
260030,202111,7226,17835,6059,16156,113,335,4971,13125,5084,13460
260040,202111,8172,19826,6896,18059,491,1214,4958,13254,5449,14468
260050,202111,14810,37085,12327,34341,254,648,11315,31740,11569,32388
260060,202111,4461,10432,3824,9442,326,623,2831,7228,3157,7851
260070,202111,11374,27401,9769,25102,336,1051,7938,19882,8274,20933
260080,202111,6844,15220,5940,14044,112,285,4993,11644,5105,11929
260090,202111,5048,12415,4424,11573,390,998,3326,8747,3716,9745
260100,202111,3138,8204,2631,7461,28,145,2220,6193,2248,6338
260105,202111,5237,13970,4701,13252,136,425,3999,11130,4135,11555
260110,202111,23386,63114,20794,59377,867,2691,17241,48572,18108,51263
260120,202111,15419,39050,12996,35562,1538,3923,8388,23375,9926,27298
260130,202111,3388,8133,2980,7556,193,436,2283,5716,2476,6152
260140,202111,13673,29543,11792,27327,596,1373,9932,22780,10528,24153
260150,202111,3738,8448,3240,7841,115,247,2827,6841,2942,7088
260160,202111,6856,17214,5800,15936,91,275,5293,14647,5384,14922
260170,202111,22101,49977,18797,45519,1044,2428,14932,35809,15976,38237
260180,202111,3728,9483,3217,8794,72,228,2782,7496,2854,7724
260190,202111,19531,37844,16489,34306,242,492,14669,30014,14911,30506
260200,202111,11724,27140,10095,25069,535,1008,8491,21466,9026,22474
260210,202111,12098,32941,10250,29973,304,938,8169,23841,8473,24779
260220,202111,11592,25939,10705,24829,208,464,9555,21928,9763,22392
260230,202111,11493,26880,9948,24857,251,576,8358,20724,8609,21300
260240,202111,2931,8475,2546,7740,87,308,1969,5894,2056,6202
260250,202111,2437,5942,2114,5459,120,227,1676,4335,1796,4562
260260,202111,13592,33626,12060,31354,397,1098,9691,24853,10088,25951
260270,202111,4615,10689,4046,10029,94,331,3476,8488,3570,8819
260280,202111,13107,38319,11805,36463,396,1540,10099,30758,10495,32298
260290,202111,43788,106645,37625,97872,4078,10621,25550,66248,29628,76869
260300,202111,10211,26559,8803,24616,196,651,7501,20908,7697,21559
260310,202111,5875,14126,5181,13274,417,830,3932,10407,4349,11237
260320,202111,8192,22817,6958,20749,200,553,5701,17044,5901,17597
260330,202111,2714,8015,2362,7301,63,199,1891,5719,1954,5918
260340,202111,2187,5623,1899,5206,21,80,1677,4501,1698,4581
260345,202111,27923,68634,23355,62092,3541,9830,12561,32559,16102,42389
260350,202111,5955,13329,5130,12396,43,116,4642,11151,4685,11267
260360,202111,2710,6731,2439,6248,41,119,1791,4498,1832,4617
260370,202111,5852,16116,5037,14768,201,560,3913,11387,4114,11947
260380,202111,5302,14969,4536,13732,160,436,3466,10415,3626,10851
260390,202111,4978,14306,4085,12512,213,591,2744,8285,2957,8876
260392,202111,3650,11065,3292,10607,79,448,2762,8889,2841,9337
260400,202111,20319,44707,17553,41119,493,1183,14095,31783,14588,32966
260410,202111,80233,187066,62990,163280,11538,30976,27493,73750,39031,104726
260415,202111,4680,11904,4024,10881,44,165,3394,9007,3438,9172
260420,202111,13080,26657,11089,24473,78,219,10370,22699,10448,22918
260430,202111,2959,8828,2505,7945,157,465,1690,5344,1847,5809
260440,202111,3994,9735,3544,9103,63,189,3063,7742,3126,7931
260450,202111,5960,14506,5317,13668,276,502,4453,11653,4729,12155
260460,202111,5581,15784,4755,14368,486,1578,2894,8588,3380,10166
260470,202111,5087,12966,4298,12058,84,183,3927,11160,4011,11343
260480,202111,4332,10789,3658,9861,338,851,2468,6827,2806,7678
260490,202111,5575,12526,4909,11594,24,104,4503,10465,4527,10569
260500,202111,6414,15336,5490,14053,410,876,3895,10097,4305,10973
260510,202111,10599,25058,8891,22691,83,291,7870,19845,7953,20136
260515,202111,4704,12013,3687,10158,142,326,2586,6896,2728,7222
260520,202111,17527,39362,15272,36530,726,1660,12626,29880,13352,31540
260530,202111,10351,28736,8788,26354,99,444,7640,22627,7739,23071
260540,202111,7524,16033,6642,14937,130,259,6005,13436,6135,13695
260545,202111,87,258,54,176,4,14,22,67,26,81
260550,202111,3376,8804,2727,7752,149,438,1887,5246,2036,5684
260560,202111,6266,15630,5243,14137,104,351,4429,11752,4533,12103
260570,202111,8381,21340,7395,20023,321,878,6088,16458,6409,17336
260580,202111,4705,10895,4233,10279,23,66,3883,9381,3906,9447
260590,202111,7479,15910,6331,14653,201,393,5488,12787,5689,13180
260600,202111,33672,83470,27549,74329,1148,3114,21065,55728,22213,58842
260610,202111,7972,19830,7077,18652,460,1153,5273,13956,5733,15109
260620,202111,18596,45175,16339,41995,1399,3829,12064,30352,13463,34181
260630,202111,2517,6579,2047,5844,38,115,1674,4698,1712,4813
260640,202111,23958,51342,20200,47063,833,1893,16684,38555,17517,40448
260650,202111,6573,16382,5276,14798,520,865,4190,12309,4710,13174
260660,202111,7520,18667,6551,17416,272,784,5606,14698,5878,15482
260670,202111,2399,6092,1952,5375,82,215,1385,3719,1467,3934
260680,202111,31050,71477,26164,64666,2207,5313,18106,44169,20313,49482
260690,202111,3698,9349,3070,8374,63,221,2425,6571,2488,6792
260700,202111,6691,17800,6163,17204,19,67,5982,16766,6001,16833
260710,202111,1465,3645,1239,3311,33,116,982,2605,1015,2721
260720,202111,27833,63844,23596,58555,2424,5630,16881,42648,19305,48278
260730,202111,8442,23062,7349,21553,230,694,6214,18029,6444,18723
260740,202111,1399,3894,1170,3517,16,70,925,2838,941,2908
260750,202111,7918,20440,6351,18472,254,489,5510,16573,5764,17062
260760,202111,6403,14107,5543,13107,144,314,4779,11301,4923,11615
260765,202111,8854,24100,7730,22560,430,1451,5535,15823,5965,17274
260770,202111,4147,10129,3417,8943,113,328,2722,7011,2835,7339
260775,202111,5688,14407,4977,13357,172,538,3976,10341,4148,10879
260780,202111,3929,11177,3503,10491,436,1292,2154,6379,2590,7671
260790,202111,132543,286042,110059,257329,16910,37886,68208,159986,85118,197872
260795,202111,3239,7838,2781,7256,117,289,2208,5829,2325,6118
260800,202111,5799,12766,5232,12003,202,482,4567,10201,4769,10683
260805,202111,3878,10493,3280,9479,198,604,2405,6875,2603,7479
260810,202111,7051,18076,6187,16491,443,1049,4651,12195,5094,13244
260820,202111,4766,10647,4228,10032,91,235,3539,8308,3630,8543
260825,202111,3141,8925,2764,8280,122,349,2083,6207,2205,6556
260830,202111,4506,12553,3728,11191,532,1340,2295,7216,2827,8556
260840,202111,4465,11038,3990,10404,256,545,3329,8767,3585,9312
260845,202111,4844,12140,4269,11177,270,734,3188,8173,3458,8907
260850,202111,5457,14189,4558,12536,351,999,2934,7789,3285,8788
260860,202111,3587,9843,3073,8964,95,286,2490,7090,2585,7376
260870,202111,4713,10846,4031,10022,55,182,3631,8915,3686,9097
260875,202111,7986,18386,6450,16175,570,1299,4475,11399,5045,12698
260880,202111,10183,27665,8864,25455,391,1121,7054,20173,7445,21294
260890,202111,13963,34071,12013,31167,856,2108,8496,21670,9352,23778
260900,202111,5872,15587,4853,14159,302,850,3307,9637,3609,10487
260910,202111,3448,9022,3006,8372,117,303,2355,6535,2472,6838
260915,202111,5207,14901,4538,14117,42,178,4187,13048,4229,13226
260920,202111,3701,8362,3155,7777,118,216,2714,6786,2832,7002
260930,202111,4379,12408,3746,11304,180,580,2905,8538,3085,9118
260940,202111,15966,36366,13870,33483,1368,3189,10097,24086,11465,27275
260950,202111,7679,19579,6193,17093,360,1169,4112,10734,4472,11903
260960,202111,78528,166875,63851,148417,6948,15746,41714,95950,48662,111696
260970,202111,6164,15264,5468,14334,311,604,4033,10904,4344,11508
260980,202111,4848,13593,4247,12847,46,141,3889,11876,3935,12017
260990,202111,19357,50106,16349,46015,897,2281,12751,35714,13648,37995
261000,202111,17718,39514,14934,36055,443,1134,12169,28793,12612,29927
261010,202111,2447,6178,2119,5748,104,235,1806,4944,1910,5179
261020,202111,7081,17538,6153,16037,357,830,4972,12748,5329,13578
261030,202111,4248,11983,3726,11066,122,436,2949,8531,3071,8967
261040,202111,5804,15884,4744,13936,148,416,3650,10470,3798,10886
261050,202111,8668,20875,7873,19742,367,608,6344,15966,6711,16574
261060,202111,15211,36611,13239,34261,272,777,11165,28555,11437,29332
261070,202111,71394,150430,59258,134603,4061,8582,44277,98954,48338,107536
261080,202111,7180,16481,6498,15658,164,299,5997,14483,6161,14782
261090,202111,20767,47115,18452,44103,395,1077,16148,38003,16543,39080
261100,202111,9119,23573,7930,21846,559,1470,5903,16262,6462,17732
261110,202111,73224,195945,61296,174521,8234,24262,36476,102473,44710,126735
261120,202111,3856,9316,3340,8598,70,133,2896,7443,2966,7576
261130,202111,7734,18160,6759,16855,130,351,5969,14746,6099,15097
261140,202111,3914,8749,3488,8187,233,541,2687,6255,2920,6796
261150,202111,5662,14131,4997,13163,128,313,4291,11242,4419,11555
261153,202111,2059,5967,1723,5322,55,157,1160,3620,1215,3777
261160,202111,235950,523209,192819,464970,47322,116681,79597,196703,126919,313384
261170,202111,7106,16174,6200,14972,242,507,5219,12467,5461,12974
261180,202111,9987,24021,8719,22383,553,1216,6355,16587,6908,17803
261190,202111,4889,13603,4394,12815,130,550,3570,10118,3700,10668
261200,202111,3632,7949,3202,7387,191,430,2644,6016,2835,6446
261210,202111,2024,4773,1740,4377,80,179,1436,3574,1516,3753
261220,202111,15145,39993,12797,35881,1452,4105,7793,21517,9245,25622
261230,202111,4272,11706,3548,10754,35,115,2996,9175,3031,9290
261240,202111,6004,13978,5265,12852,383,749,4185,10260,4568,11009
261245,202111,4007,10702,3336,9541,65,285,2693,7421,2758,7706
261247,202111,3238,9127,2662,8109,158,455,1874,5687,2032,6142
261250,202111,25247,54911,21969,51117,3245,6742,14770,36026,18015,42768
261255,202111,4390,12319,3588,10781,134,481,2776,8167,2910,8648
261260,202111,13812,35106,12014,32795,279,935,10580,28548,10859,29483
261270,202111,4829,11202,4222,10462,220,466,3490,8659,3710,9125
261280,202111,2637,7157,2309,6615,73,236,1833,5114,1906,5350
261290,202111,3100,7702,2584,7122,65,219,2111,5863,2176,6082
261300,202111,13719,35985,11767,32812,404,1361,9082,24601,9486,25962
261310,202111,9914,23720,8502,21821,673,1751,6288,15847,6961,17598
261320,202111,6476,17367,5591,15942,66,254,4789,13470,4855,13724
261330,202111,6004,14182,5414,13425,120,375,4729,11492,4849,11867
261340,202111,4591,12122,4003,11381,126,425,3406,9580,3532,10005
261350,202111,9132,26171,8034,24301,129,454,6528,19595,6657,20049
261360,202111,8732,19984,7357,18045,299,711,5880,14075,6179,14786
261370,202111,25974,62132,21831,56526,2675,6344,13873,36550,16548,42894
261380,202111,4419,12485,3894,11603,434,1339,2618,7741,3052,9080
261390,202111,17901,48874,15062,44366,1191,3661,10069,29372,11260,33033
261400,202111,4954,14855,4333,13565,271,856,3170,9802,3441,10658
261410,202111,10343,24654,8493,21877,331,955,6921,17359,7252,18314
261420,202111,7853,22314,7092,21398,645,2157,5244,15764,5889,17921
261430,202111,3794,10028,3225,9159,44,170,2749,7646,2793,7816
261440,202111,1524,4400,1266,3916,48,195,917,2723,965,2918
261450,202111,15305,40182,13496,37475,176,572,11077,30893,11253,31465
261460,202111,8265,21482,7208,19865,290,787,5806,15982,6096,16769
261470,202111,4324,10428,3725,9607,35,114,3199,8214,3234,8328
261480,202111,5583,16208,4783,14870,239,765,3687,11312,3926,12077
261485,202111,5391,14576,4692,13504,392,1167,3447,9832,3839,10999
261500,202111,6574,15953,5717,14797,504,1035,3845,10514,4349,11549
261510,202111,1967,5686,1708,5269,60,212,1300,4023,1360,4235
261520,202111,2444,7233,2198,6749,59,189,1643,5011,1702,5200
261530,202111,12998,35963,10596,31766,857,2858,5794,16563,6651,19421
261540,202111,9274,24906,8408,23701,1413,3676,4514,13745,5927,17421
261550,202111,3924,10042,3400,9238,289,738,2407,6467,2696,7205
261560,202111,8611,23925,7477,22264,326,1014,5869,17466,6195,18480
261570,202111,3666,9596,2900,8343,197,598,1967,5580,2164,6178
261580,202111,7131,18179,6162,16859,91,404,5570,15046,5661,15450
261590,202111,2897,7061,2362,6311,84,241,1788,4730,1872,4971
261600,202111,5815,13521,4937,12279,303,602,3615,9065,3918,9667
261610,202111,2226,6287,1780,5463,127,429,1145,3509,1272,3938
261618,202111,2666,6376,2332,5906,102,237,1870,4696,1972,4933
261620,202111,4401,12094,4005,11513,833,2091,2519,7643,3352,9734
261630,202111,6380,17556,5398,15720,416,1291,3506,9861,3922,11152
261640,202111,40291,86057,34421,78943,2328,3944,25815,61499,28143,65443
261650,202111,4492,10459,3811,9608,255,535,2828,7219,3083,7754
270010,202111,4654,14990,4004,13879,115,626,3235,10920,3350,11546
270020,202111,4120,9872,3615,9244,126,394,3087,7654,3213,8048
270030,202111,35980,95127,30082,85719,3252,9155,20834,59078,24086,68233
270040,202111,11388,28924,9784,27011,398,1135,8239,22672,8637,23807
270050,202111,5757,12981,4883,11993,432,777,4054,10288,4486,11065
270060,202111,2356,5849,1973,5395,179,432,1505,4178,1684,4610
270070,202111,4910,13325,4261,12435,99,349,3609,10319,3708,10668
270080,202111,1553,4089,1315,3693,63,155,1003,2755,1066,2910
270090,202111,1857,5505,1674,5157,45,170,1408,4252,1453,4422
270100,202111,6102,14693,5288,13529,221,582,4447,11177,4668,11759
270110,202111,3473,7704,2827,6969,164,298,2237,5830,2401,6128
270120,202111,2707,7280,2345,6790,69,267,1956,5562,2025,5829
270130,202111,5373,13433,4649,12556,189,526,3947,10680,4136,11206
270135,202111,2114,4956,1785,4592,30,99,1650,4209,1680,4308
270140,202111,10072,23098,8100,20385,404,1086,6264,15103,6668,16189
270150,202111,2717,8119,2470,7772,6,31,2324,7298,2330,7329
270160,202111,6185,16456,5278,15401,137,455,4796,14024,4933,14479
270170,202111,3518,9973,2963,9208,181,715,2209,6596,2390,7311
270180,202111,2403,7191,2204,6941,37,188,2004,6231,2041,6419
270190,202111,1876,5150,1663,4894,19,87,1523,4453,1542,4540
270200,202111,2665,7726,2303,7203,116,332,1694,5344,1810,5676
270210,202111,6003,13733,5103,12712,57,189,4714,11605,4771,11794
270220,202111,1749,4366,1395,3855,184,507,897,2432,1081,2939
270230,202111,10380,26882,8679,24296,997,2660,6021,16965,7018,19625
270235,202111,6288,18594,5449,17262,177,532,4545,14323,4722,14855
270240,202111,12154,31351,10035,28483,981,2756,7194,20641,8175,23397
270250,202111,3014,7160,2656,6658,185,359,2153,5435,2338,5794
270255,202111,4744,13030,3760,11308,121,396,2903,8586,3024,8982
270260,202111,5706,16605,5165,15713,85,383,4519,13493,4604,13876
270270,202111,1105,2763,918,2532,112,267,673,1895,785,2162
270280,202111,4076,9480,3263,8479,546,755,2258,6407,2804,7162
270290,202111,8199,24868,7393,23594,109,510,6577,20765,6686,21275
270300,202111,4490,11279,3491,10185,217,484,2695,8133,2912,8617
270310,202111,7410,19915,6353,18319,67,330,5552,15665,5619,15995
270320,202111,5786,16575,5005,15097,290,870,3709,10869,3999,11739
270330,202111,4303,13293,3799,12530,237,892,3017,9925,3254,10817
270340,202111,1733,4385,1465,4027,52,101,1248,3426,1300,3527
270350,202111,1994,4467,1616,4030,131,322,1167,2941,1298,3263
270360,202111,2814,6789,2521,6463,83,169,2336,6020,2419,6189
270370,202111,1489,4387,1358,4149,30,119,1165,3514,1195,3633
270375,202111,3238,7409,2714,6837,25,69,2549,6430,2574,6499
270380,202111,5854,15584,4956,14460,554,1402,3472,10591,4026,11993
270390,202111,1295,3167,1036,2867,10,41,879,2446,889,2487
270400,202111,6966,17300,5872,15709,264,563,4707,12601,4971,13164
270410,202111,4988,13821,4330,12834,128,426,3654,10796,3782,11222
270420,202111,6153,17320,5545,16445,116,467,4856,14128,4972,14595
270430,202111,150321,341977,117635,300178,21507,56038,57169,148336,78676,204374
270440,202111,4957,12902,4311,12110,78,293,3832,10681,3910,10974
270450,202111,7601,19517,6663,18380,303,774,5522,15588,5825,16362
270460,202111,3890,8479,3314,7795,161,305,2978,7040,3139,7345
270470,202111,11845,31528,10322,29408,635,1836,8091,23124,8726,24960
270480,202111,3111,7947,2621,7260,93,296,2146,5841,2239,6137
270490,202111,988,2621,862,2468,52,149,691,1967,743,2116
270500,202111,5167,15102,4599,14163,248,745,3669,11193,3917,11938
270510,202111,5999,15176,5045,13973,399,1236,3769,10137,4168,11373
270520,202111,4374,11836,3477,10368,747,2251,1394,4364,2141,6615
270530,202111,1394,3871,1178,3533,65,169,823,2511,888,2680
270540,202111,2409,6404,2048,5940,76,185,1752,5092,1828,5277
270550,202111,7195,17761,5733,16147,764,1752,4041,11949,4805,13701
270560,202111,3165,7842,2663,7160,177,486,2105,5622,2282,6108
270570,202111,4707,12203,4041,11236,365,843,3143,8849,3508,9692
270580,202111,2446,6604,2211,6277,128,335,1882,5340,2010,5675
270590,202111,1631,4848,1502,4671,16,83,1424,4411,1440,4494
270600,202111,2892,8653,2615,8232,43,186,2330,7253,2373,7439
270610,202111,3826,9771,3319,9096,78,178,2947,8030,3025,8208
270620,202111,1337,3841,1229,3638,24,80,1068,3081,1092,3161
270630,202111,18643,44018,16067,40515,763,1988,13386,33205,14149,35193
270640,202111,5773,15793,5043,14645,176,600,4197,12013,4373,12613
270642,202111,2648,8298,2334,7810,158,598,1770,5854,1928,6452
270644,202111,3929,9456,3254,8585,490,1082,2237,6190,2727,7272
270650,202111,3449,9596,3004,8997,309,942,2288,6865,2597,7807
270660,202111,2055,5146,1757,4731,79,243,1342,3568,1421,3811
270670,202111,17998,39505,15107,35991,460,1078,13004,30342,13464,31420
270680,202111,5918,13529,5295,12850,134,194,4954,12192,5088,12386
270690,202111,9979,23802,8369,21767,371,940,6785,17511,7156,18451
270700,202111,568,1665,495,1541,45,134,346,1072,391,1206
270710,202111,5995,17078,5286,15981,342,1012,4147,12524,4489,13536
270720,202111,3847,10740,3421,10041,58,239,3041,8777,3099,9016
270730,202111,8623,18327,7543,17180,416,630,5855,14879,6271,15509
270740,202111,2473,6342,2181,6002,94,284,1816,4967,1910,5251
270750,202111,5979,15127,5223,14191,66,244,4658,12589,4724,12833
270760,202111,3533,9534,2975,8771,58,235,2487,7273,2545,7508
270770,202111,22462,53983,18126,48540,3393,8021,10373,29691,13766,37712
270780,202111,1939,5027,1794,4826,56,178,1609,4285,1665,4463
270790,202111,1792,4625,1508,4235,132,355,1121,3151,1253,3506
270800,202111,11656,30518,10504,28885,393,1193,8947,24409,9340,25602
270810,202111,3575,9646,2838,8476,196,593,1990,5897,2186,6490
270820,202111,1689,4852,1431,4443,38,156,1151,3504,1189,3660
270830,202111,5456,12577,4406,11298,159,446,3634,9165,3793,9611
270840,202111,8863,25598,7844,24120,165,723,6821,20611,6986,21334
270850,202111,9281,21336,8189,20060,808,1954,6622,16177,7430,18131
270860,202111,15395,32993,12249,29460,639,1284,9897,23896,10536,25180
270870,202111,2380,6450,1945,5746,280,737,1220,3809,1500,4546
270880,202111,8294,24135,7403,22783,169,631,6176,18707,6345,19338
270890,202111,3414,8897,2892,8152,256,692,1910,5402,2166,6094
270895,202111,3383,9860,3054,9439,63,347,2734,8281,2797,8628
270900,202111,1812,4549,1379,3870,26,62,1098,3067,1124,3129
270910,202111,4320,11909,3728,11012,103,275,3110,9102,3213,9377
270915,202111,10233,27826,8284,24717,681,2183,5699,16610,6380,18793
270920,202111,6118,17100,5547,16221,68,310,4852,13819,4920,14129
270930,202111,18464,41095,14335,36324,1876,4056,9536,25793,11412,29849
270940,202111,6847,17373,5784,16101,176,629,4628,12539,4804,13168
280010,202111,701,1934,562,1648,18,61,400,1087,418,1148
280020,202111,5247,12837,4420,11568,400,992,3101,8116,3501,9108
280030,202111,84855,190700,68018,167251,13300,32209,32856,83117,46156,115326
280040,202111,3134,8206,2731,7604,293,740,1883,5277,2176,6017
280050,202111,4348,11923,3696,10908,740,2093,1891,5671,2631,7764
280060,202111,7094,17208,5612,15014,1000,2760,2730,7584,3730,10344
280067,202111,7467,17514,6335,15789,303,673,4686,11586,4989,12259
280070,202111,1922,5623,1779,5394,116,338,1460,4416,1576,4754
280100,202111,4285,10833,3594,9770,358,965,2402,6565,2760,7530
280110,202111,1568,3919,1363,3622,15,53,1228,3201,1243,3254
280120,202111,8006,21932,7085,20463,962,2441,4836,14455,5798,16896
280130,202111,9414,21435,8205,19775,444,1089,6596,15815,7040,16904
280140,202111,5886,13437,5171,12465,327,737,4178,10136,4505,10873
280150,202111,4419,10732,3846,9961,532,1176,2737,7299,3269,8475
280160,202111,1274,3507,1081,3194,97,325,748,2149,845,2474
280170,202111,5473,13788,4905,13077,282,630,3928,10572,4210,11202
280190,202111,1406,2938,1254,2739,51,109,1071,2297,1122,2406
280200,202111,1354,3418,1121,3093,61,193,861,2332,922,2525
280210,202111,18420,43076,15978,39654,1883,4365,10188,25496,12071,29861
280220,202111,1791,4646,1508,4279,45,167,1245,3505,1290,3672
280230,202111,4578,11102,3773,9911,330,656,2592,6956,2922,7612
280240,202111,3467,8972,3075,8386,34,164,2674,7107,2708,7271
280250,202111,968,2223,804,1979,79,194,568,1361,647,1555
280260,202111,2355,5486,2055,5112,39,82,1870,4695,1909,4777
280270,202111,2570,6717,2269,6268,167,404,1817,5060,1984,5464
280280,202111,4259,12247,3780,11538,581,1510,2507,8089,3088,9599
280290,202111,19999,49726,17190,45805,1523,3965,11472,30859,12995,34824
280300,202111,13279,29590,11631,27827,468,827,8395,22373,8863,23200
280310,202111,1463,3667,1218,3270,41,113,921,2425,962,2538
280320,202111,9208,23810,7947,21925,1049,2656,5240,14484,6289,17140
280330,202111,4959,11833,4175,10743,266,698,3062,7895,3328,8593
280340,202111,5753,11795,4772,10714,277,414,4068,9379,4345,9793
280350,202111,28016,62862,24582,58336,1210,2743,19554,45750,20764,48493
280360,202111,5944,15985,5203,14789,673,1889,3142,9112,3815,11001
280370,202111,2341,5411,1912,4713,60,112,1525,3683,1585,3795
280380,202111,1091,2759,921,2541,75,175,636,1801,711,1976
280390,202111,3912,9148,3313,8239,221,426,2567,6450,2788,6876
280400,202111,4120,9836,3582,9118,558,1194,2262,6077,2820,7271
280410,202111,2697,6925,2228,6204,188,504,1389,3810,1577,4314
280420,202111,4552,11657,4168,11172,71,247,3844,10240,3915,10487
280430,202111,2257,5264,1984,4902,79,202,1630,3935,1709,4137
280440,202111,4519,11458,3978,10649,132,419,3383,8828,3515,9247
280445,202111,2459,6094,2200,5667,52,130,1703,4233,1755,4363
280450,202111,10541,24301,9050,22279,1645,3943,4796,12373,6441,16316
280460,202111,7286,16488,6593,15556,457,924,5470,12906,5927,13830
280470,202111,1787,4863,1514,4362,111,321,1086,3077,1197,3398
280480,202111,47707,110446,41223,101387,3785,9303,28828,69623,32613,78926
280490,202111,3932,10897,3324,9846,109,387,2515,7206,2624,7593
280500,202111,1055,2417,905,2219,28,64,771,1864,799,1928
280510,202111,2888,6718,2487,6166,66,201,2003,4826,2069,5027
280520,202111,1844,4370,1613,4054,100,203,1264,3180,1364,3383
280530,202111,2500,6122,2172,5661,199,425,1613,4276,1812,4701
280540,202111,9129,23826,8272,22603,281,819,7189,19509,7470,20328
280550,202111,6930,15606,5743,13946,147,485,4814,11297,4961,11782
280560,202111,7759,20472,7265,19735,109,377,6487,17391,6596,17768
280570,202111,6795,15973,5491,14362,285,729,3987,10613,4272,11342
280580,202111,6042,15180,5270,14068,521,1169,3844,10432,4365,11601
280590,202111,3006,6721,2580,6220,130,400,2017,4641,2147,5041
280600,202111,4035,9952,3594,9347,319,713,2551,6704,2870,7417
280610,202111,2709,6315,2411,5914,141,331,1977,4779,2118,5110
280620,202111,5908,13685,5079,12611,421,837,3650,9410,4071,10247
280630,202111,4254,11013,3917,10568,222,551,3170,8617,3392,9168
280640,202111,2485,6382,2188,6049,57,139,1963,5466,2020,5605
280650,202111,1267,3273,1036,2929,94,278,737,2011,831,2289
280660,202111,3917,8219,3364,7584,312,473,2719,6354,3031,6827
280670,202111,20863,46522,17953,42747,1612,3701,13355,31772,14967,35473
280680,202111,2959,6823,2541,6223,270,475,1761,4468,2031,4943
280690,202111,1008,2371,858,2185,57,130,680,1708,737,1838
280700,202111,1250,2990,1080,2746,27,61,860,2158,887,2219
280710,202111,16224,35174,13755,32369,807,1248,11436,27857,12243,29105
280720,202111,2818,6223,2330,5640,41,125,1771,4435,1812,4560
280730,202111,1127,2830,988,2609,70,198,729,1852,799,2050
280740,202111,15540,35619,13363,32367,1065,2487,9653,22959,10718,25446
280750,202111,3803,10200,3280,9302,198,527,2380,6677,2578,7204
280760,202111,7058,17617,6105,16221,726,1655,3878,10784,4604,12439
290010,202111,3319,6773,2169,5025,7,22,1811,4028,1818,4050
290020,202111,5599,14366,5091,13735,361,625,4269,11965,4630,12590
290030,202111,4977,10831,4028,9800,247,448,3316,8295,3563,8743
290035,202111,5509,11499,4511,10213,339,482,3510,8188,3849,8670
290040,202111,4763,10766,4034,9897,195,372,2978,8003,3173,8375
290050,202111,2167,6742,1823,6020,111,401,1272,4111,1383,4512
290060,202111,1466,3270,1076,2686,160,354,649,1651,809,2005
290070,202111,39855,84113,34339,77313,2015,4494,26765,59538,28780,64032
290080,202111,5739,16057,4972,14932,568,1650,3352,10283,3920,11933
290090,202111,2269,4243,1607,3534,20,50,1458,3192,1478,3242
290100,202111,10479,26124,8483,23231,1514,3764,4318,12571,5832,16335
290110,202111,5674,14168,4983,13097,625,1508,3179,8483,3804,9991
290115,202111,4265,12101,3612,10960,301,828,2725,8342,3026,9170
290120,202111,6897,16433,5746,14820,161,446,4881,12394,5042,12840
290130,202111,5003,11689,3887,10220,183,400,2936,7871,3119,8271
290135,202111,4611,10436,3755,9050,179,416,2981,6950,3160,7366
290140,202111,4715,11930,3662,10560,84,299,3128,8984,3212,9283
290150,202111,2748,6640,2342,6156,136,308,1800,4829,1936,5137
290160,202111,3742,7994,3327,7430,209,377,2747,6139,2956,6516
290170,202111,3521,8635,3111,8189,104,225,2783,7440,2887,7665
290180,202111,3194,8352,2638,7460,73,240,2190,6128,2263,6368
290190,202111,4625,12062,4086,11350,90,307,3452,9436,3542,9743
290195,202111,2504,5972,2009,5325,33,116,1722,4525,1755,4641
290200,202111,4442,11819,3552,10312,136,376,2687,7722,2823,8098
290205,202111,3719,9133,3305,8532,196,505,2583,6570,2779,7075
290210,202111,13753,36137,12148,33699,1020,2411,9315,26309,10335,28720
290220,202111,3122,7229,2735,6741,117,263,2251,5560,2368,5823
290225,202111,3365,6953,2558,6107,121,202,2211,5349,2332,5551
290230,202111,2854,6934,2621,6654,56,128,2365,6028,2421,6156
290240,202111,3905,9479,3077,8465,68,214,2610,7166,2678,7380
290250,202111,4131,11625,3428,10586,109,297,2810,8869,2919,9166
290260,202111,5628,13369,4738,12092,221,612,3918,9832,4139,10444
290265,202111,3727,10473,3023,9175,243,658,2076,6333,2319,6991
290270,202111,11153,37222,10333,35849,625,2369,8168,28351,8793,30720
290280,202111,6465,18749,5561,16942,295,996,4024,12083,4319,13079
290290,202111,10474,29530,8540,26051,758,2420,5758,17331,6516,19751
290300,202111,4390,11663,3245,9512,195,567,2279,6691,2474,7258
290310,202111,1802,4054,1447,3636,30,129,1238,3027,1268,3156
290320,202111,26891,67190,21556,59273,4666,12184,10409,30425,15075,42609
290323,202111,4036,10474,3452,9550,116,278,2684,7475,2800,7753
290327,202111,4444,12272,3784,11017,338,883,2653,7749,2991,8632
290330,202111,2509,4926,1981,4365,54,69,1746,3949,1800,4018
290340,202111,6179,14647,4712,12892,501,1262,3353,9426,3854,10688
290350,202111,5052,13653,4198,12192,273,720,2930,8583,3203,9303
290360,202111,5129,13057,4474,12211,133,302,3851,10611,3984,10913
290370,202111,5462,12816,4001,10891,209,467,2814,7782,3023,8249
290380,202111,6007,15260,4968,13853,108,226,4248,12021,4356,12247
290390,202111,15519,42648,12761,38221,1433,3993,8155,24917,9588,28910
290395,202111,3179,8594,2538,7504,63,243,1942,5665,2005,5908
290400,202111,4019,10425,3252,9178,130,380,2488,6915,2618,7295
290405,202111,4928,13704,4180,12425,376,1058,2773,8472,3149,9530
290410,202111,5982,15652,4580,13435,106,413,3476,10009,3582,10422
290420,202111,3340,8697,2764,7803,88,258,2220,6196,2308,6454
290430,202111,3590,9056,2956,8077,218,622,2119,5636,2337,6258
290440,202111,3050,7227,2208,5930,105,219,1544,4284,1649,4503
290450,202111,3830,9073,3041,7916,116,255,2370,6144,2486,6399
290460,202111,13070,35524,10904,31535,2455,7101,4157,12189,6612,19290
290470,202111,4955,11356,3651,9577,531,1333,1939,5275,2470,6608
290475,202111,6944,19491,5856,17625,59,301,4899,14487,4958,14788
290480,202111,1932,4668,1577,4164,73,224,1142,2883,1215,3107
290485,202111,4895,13631,4293,12795,104,429,3671,10795,3775,11224
290490,202111,9701,21895,8728,20574,467,963,7010,16676,7477,17639
290500,202111,4426,12629,3469,10641,573,1805,1460,4383,2033,6188
290510,202111,3747,8908,3127,8115,55,176,2785,7164,2840,7340
290515,202111,3784,10344,3280,9636,38,130,2976,8863,3014,8993
290520,202111,12610,34294,9801,28998,790,2149,5745,16991,6535,19140
290530,202111,5199,14493,4369,13157,108,429,3698,11044,3806,11473
290540,202111,3581,9077,3230,8695,41,130,3018,8111,3059,8241
290550,202111,4420,11365,3856,10702,15,65,3562,10000,3577,10065
290560,202111,6528,16460,4935,14157,389,1324,3247,8994,3636,10318
290570,202111,46713,111855,41369,105108,2326,5807,33491,84508,35817,90315
290580,202111,8735,23708,7520,21982,773,1961,5324,16287,6097,18248
290590,202111,7254,21815,6109,19795,155,502,4907,16058,5062,16560
290600,202111,20173,54297,17466,49936,943,2407,13732,39509,14675,41916
290610,202111,2713,8115,2131,6917,88,293,1494,4839,1582,5132
290620,202111,6384,17753,5502,16299,274,714,4565,13569,4839,14283
290630,202111,9968,22902,7944,20325,761,1801,5853,15304,6614,17105
290640,202111,2946,7195,2263,6218,131,311,1575,4554,1706,4865
290650,202111,13757,32952,12189,31187,2102,4933,8384,22369,10486,27302
290660,202111,3930,9803,3216,8696,67,174,2441,6717,2508,6891
290670,202111,7395,18987,6303,17290,365,956,4936,13672,5301,14628
290680,202111,11570,30887,9670,28119,189,889,8016,22966,8205,23855
290682,202111,5023,12492,4363,11609,159,300,3667,9909,3826,10209
290685,202111,3720,8112,2700,6656,446,972,1372,3728,1818,4700
290687,202111,7094,18117,5772,15953,747,1922,3639,10338,4386,12260
290689,202111,3018,8049,2283,6720,200,610,1506,4474,1706,5084
290690,202111,5637,14235,4553,12736,271,764,3343,9235,3614,9999
290700,202111,2897,7257,2571,6851,41,151,2286,6059,2327,6210
290710,202111,8895,23786,7601,22011,283,736,6347,18506,6630,19242
290720,202111,19545,51762,17682,48898,956,2680,14189,38843,15145,41523
290730,202111,7284,16920,6228,15691,314,592,4845,12434,5159,13026
290740,202111,1127,2857,893,2495,24,67,772,2143,796,2210
290750,202111,12530,29302,10856,26662,711,1712,8232,19662,8943,21374
290755,202111,2152,5862,1722,5106,116,292,1161,3513,1277,3805
290760,202111,3951,11157,3244,9857,162,395,2198,6884,2360,7279
290770,202111,2786,8422,2540,8121,44,179,2145,6996,2189,7175
290780,202111,8404,20448,7228,18908,268,525,5580,15017,5848,15542
290790,202111,5181,13511,4481,12485,204,487,3667,10369,3871,10856
290800,202111,7361,14574,5168,12046,327,606,3872,9165,4199,9771
290810,202111,5424,13854,4400,12383,115,303,3349,9662,3464,9965
290820,202111,5336,13591,4817,12864,267,647,3570,9696,3837,10343
290830,202111,4700,10709,4146,9950,43,141,3546,8234,3589,8375
290840,202111,18503,47070,15770,42885,2068,4616,10170,29359,12238,33975
290850,202111,8036,17561,7106,16561,439,713,5985,14264,6424,14977
290860,202111,6404,17541,5545,16553,283,723,4581,14097,4864,14820
290870,202111,5035,13361,3804,11038,290,712,2502,7335,2792,8047
290880,202111,1511,3568,1216,3192,159,364,717,2049,876,2413
290890,202111,9873,19332,8836,18186,167,329,8239,16879,8406,17208
290900,202111,2592,6526,2010,5526,142,313,1212,3351,1354,3664
290910,202111,5453,12539,4138,10583,40,99,3548,8993,3588,9092
290920,202111,5456,13236,4843,12508,126,166,4481,11855,4607,12021
290930,202111,7865,21317,6363,18727,213,733,4888,14065,5101,14798
290940,202111,3777,10354,3189,9503,179,535,2521,7541,2700,8076
290950,202111,1519,3751,1239,3328,79,183,852,2316,931,2499
290960,202111,6047,14800,5376,13970,242,519,4480,11687,4722,12206
290970,202111,3321,9686,2711,8565,97,351,2101,6648,2198,6999
290980,202111,13539,31010,11410,27859,770,1988,7412,17554,8182,19542
290990,202111,9973,26057,8842,24271,295,1043,7402,19727,7697,20770
291000,202111,3578,8868,2746,7814,130,343,2208,6376,2338,6719
291005,202111,16349,39151,14430,36683,1533,3422,11032,28394,12565,31816
291010,202111,3206,9496,2599,8191,166,530,1636,5028,1802,5558
291020,202111,1345,3180,1087,2748,29,88,797,1887,826,1975
291030,202111,2676,6260,1901,4968,125,280,1183,3040,1308,3320
291040,202111,5723,15084,4698,13628,163,506,3700,10742,3863,11248
291050,202111,8956,21511,7730,19859,947,2321,5441,13925,6388,16246
291060,202111,7221,19636,6188,18268,345,1168,4790,14029,5135,15197
291070,202111,17009,44048,14177,39575,380,1194,11580,32058,11960,33252
291072,202111,27746,66256,20373,54229,3228,8784,9769,25614,12997,34398
291075,202111,5798,13757,5241,12917,113,246,4407,10642,4520,10888
291077,202111,1781,4558,1383,3859,82,148,945,2688,1027,2836
291080,202111,125670,294173,99788,258644,26999,69747,30771,87182,57770,156929
291085,202111,5963,14490,4869,12862,175,473,4053,10671,4228,11144
291090,202111,2211,4023,1645,3393,45,76,1399,2849,1444,2925
291100,202111,3400,7146,2335,5893,97,253,1808,4529,1905,4782
291110,202111,6391,18298,5403,16649,269,914,4219,12636,4488,13550
291120,202111,8346,19325,7058,17704,355,804,5451,13661,5806,14465
291125,202111,2378,4070,1794,3415,90,145,1465,2818,1555,2963
291130,202111,3434,9504,2537,7761,59,270,1929,5674,1988,5944
291140,202111,5115,13218,3682,10667,576,1449,2123,6192,2699,7641
291150,202111,2683,5604,2063,4919,6,18,1962,4678,1968,4696
291160,202111,5321,14145,4417,12855,432,1225,2912,8473,3344,9698
291165,202111,2281,6076,1683,4898,26,106,1214,3404,1240,3510
291170,202111,22505,55109,18712,48817,1079,2894,12393,31505,13472,34399
291180,202111,6901,15069,5112,12726,228,509,4101,10198,4329,10707
291185,202111,3292,8342,2904,7745,164,361,2245,6085,2409,6446
291190,202111,8252,19328,6847,17556,264,671,5552,14273,5816,14944
291200,202111,2957,7861,2180,6382,61,191,1422,3978,1483,4169
291210,202111,7729,15773,5696,13466,196,464,4178,10001,4374,10465
291220,202111,4669,12370,4214,11715,310,831,3193,8902,3503,9733
291230,202111,4839,9873,3683,8615,52,106,3353,7899,3405,8005
291240,202111,4306,10819,3628,9694,59,199,3099,8176,3158,8375
291250,202111,3550,10086,2761,8646,159,448,1750,5533,1909,5981
291260,202111,1543,3490,1276,3146,23,65,1053,2611,1076,2676
291270,202111,6002,14484,4713,12661,336,827,3487,9504,3823,10331
291280,202111,2877,6663,2130,5611,205,479,1343,3523,1548,4002
291290,202111,5934,15226,4527,13069,422,1196,2999,8650,3421,9846
291300,202111,4040,10531,3182,9118,106,320,2422,6812,2528,7132
291310,202111,5394,13930,4635,12586,214,539,3840,10377,4054,10916
291320,202111,6582,17345,5127,14740,1158,3105,2468,7551,3626,10656
291330,202111,1995,4848,1668,4316,68,167,1282,3238,1350,3405
291340,202111,4567,11371,3662,9852,127,301,2687,7218,2814,7519
291345,202111,3056,8701,2748,8240,108,338,2274,6847,2382,7185
291350,202111,7295,17145,5673,15221,62,186,4958,13444,5020,13630
291360,202111,39792,87233,31440,77363,3815,8330,19979,51386,23794,59716
291370,202111,8614,22640,7587,21033,666,1812,5535,15112,6201,16924
291380,202111,3809,9750,3354,9140,106,340,2847,7697,2953,8037
291390,202111,13669,28484,10478,24977,526,1091,8567,20512,9093,21603
291400,202111,15524,36529,12888,32689,1402,3161,8307,22028,9709,25189
291410,202111,3181,8104,2484,6904,35,125,1852,5071,1887,5196
291420,202111,2056,4844,1594,4275,18,70,1421,3795,1439,3865
291430,202111,2850,7702,2441,7022,105,338,1898,5324,2003,5662
291440,202111,6814,18799,5890,17308,319,895,4529,13457,4848,14352
291450,202111,10676,23749,8790,21613,91,161,7867,19731,7958,19892
291460,202111,16798,42693,14705,39632,736,2039,11116,29659,11852,31698
291465,202111,9415,22506,7349,20144,133,550,6344,17244,6477,17794
291470,202111,18965,40224,15832,36636,873,1715,11869,28129,12742,29844
291480,202111,47452,100005,35764,84467,3836,9095,20349,47466,24185,56561
291490,202111,5939,14321,5134,13417,145,409,4633,12070,4778,12479
291500,202111,5404,12532,4530,11393,55,181,4174,10503,4229,10684
291510,202111,4687,10973,3473,9428,44,196,2947,7891,2991,8087
291520,202111,4809,10507,3642,8988,213,510,2801,6907,3014,7417
291530,202111,2478,5370,1773,4476,283,643,1065,2884,1348,3527
291535,202111,3671,10394,3155,9457,180,479,2377,7397,2557,7876
291540,202111,2332,5029,1608,4170,91,223,1304,3404,1395,3627
291550,202111,6149,13336,4785,11644,520,1011,3206,8048,3726,9059
291560,202111,19359,44618,14149,37791,1766,4329,7856,22267,9622,26596
291570,202111,2477,5652,1919,4987,76,161,1581,4271,1657,4432
291580,202111,6841,16868,5378,14934,339,805,3854,10756,4193,11561
291590,202111,2396,5486,2110,5162,84,249,1887,4534,1971,4783
291600,202111,5736,12784,4429,10830,429,1051,2998,7135,3427,8186
291610,202111,5845,14745,5234,14071,57,204,4811,12904,4868,13108
291620,202111,3284,7124,2458,6215,147,313,1870,4873,2017,5186
291630,202111,3709,7659,2802,6513,213,478,2161,5032,2374,5510
291640,202111,17913,41457,13634,35397,2041,4699,6503,17402,8544,22101
291650,202111,9510,22964,8371,21624,566,948,6993,18611,7559,19559
291660,202111,2141,5091,1564,4221,120,356,1023,2597,1143,2953
291670,202111,2139,5471,1790,4964,128,309,1280,3631,1408,3940
291680,202111,4327,10091,3495,8912,468,1127,2172,5680,2640,6807
291685,202111,5096,11927,4080,10554,217,411,3126,8316,3343,8727
291690,202111,4347,9215,3054,7365,522,975,2050,5152,2572,6127
291700,202111,9244,25531,8146,23677,324,999,6692,19107,7016,20106
291710,202111,5704,12757,4290,10816,456,970,2926,7466,3382,8436
291720,202111,4672,13547,3888,12000,787,2434,2024,6256,2811,8690
291730,202111,6714,16175,5782,14950,288,770,4809,12393,5097,13163
291733,202111,2859,7162,2411,6565,67,165,1747,5050,1814,5215
291735,202111,3074,7955,2437,6853,65,128,1869,5270,1934,5398
291740,202111,4204,10551,3077,8447,106,203,2121,5846,2227,6049
291750,202111,21693,49368,17679,43492,2286,5102,11087,28180,13373,33282
291760,202111,11365,31002,8903,27133,2630,9034,2196,6689,4826,15723
291770,202111,7803,19991,6499,17752,296,874,4977,13176,5273,14050
291780,202111,5392,13882,4849,13132,93,295,4240,11375,4333,11670
291790,202111,2917,7620,2651,7286,244,512,1996,5690,2240,6202
291800,202111,33303,79142,25307,67606,4622,11545,11646,32647,16268,44192
291810,202111,11031,25126,9271,22984,403,851,7650,19331,8053,20182
291820,202111,4096,10325,3557,9624,97,266,2859,7751,2956,8017
291830,202111,4850,10819,3960,9626,267,452,3057,7589,3324,8041
291835,202111,6975,20074,5557,17428,506,1549,3691,11757,4197,13306
291840,202111,49937,132903,43405,122816,4025,12004,31115,87425,35140,99429
291845,202111,2870,6920,2296,6225,106,274,1938,5323,2044,5597
291850,202111,4446,11829,3723,10672,136,360,3018,8730,3154,9090
291855,202111,2352,4405,1834,3837,28,66,1681,3506,1709,3572
291860,202111,2379,6062,1657,4692,33,73,1105,3031,1138,3104
291870,202111,1364,3320,925,2558,34,86,643,1751,677,1837
291875,202111,3138,9147,2691,8229,43,157,2003,5926,2046,6083
291880,202111,5933,16079,5067,14666,279,698,3730,10990,4009,11688
291890,202111,1744,3469,1143,2769,214,446,646,1605,860,2051
291900,202111,1435,3229,1086,2719,20,70,874,2118,894,2188
291905,202111,2527,6322,2062,5608,86,273,1601,4195,1687,4468
291910,202111,3278,7734,2767,7115,49,158,2399,6324,2448,6482
291915,202111,7689,21042,6237,18605,180,539,4694,14200,4874,14739
291920,202111,30415,74430,26061,68552,2001,5761,19232,49286,21233,55047
291930,202111,2647,6695,2272,6190,224,595,1578,4368,1802,4963
291940,202111,4166,10132,2805,7877,251,645,1620,4589,1871,5234
291950,202111,9561,28266,8038,25413,305,996,5539,17433,5844,18429
291955,202111,16880,40947,14986,38523,1302,3347,11735,30189,13037,33536
291960,202111,3625,8494,3045,7735,205,360,2387,6307,2592,6667
291970,202111,4898,11739,4092,10744,164,463,3090,8157,3254,8620
291980,202111,10599,28638,8545,25197,1103,2724,5329,16409,6432,19133
291990,202111,2443,6116,2000,5572,19,73,1847,5134,1866,5207
291992,202111,4236,9790,3478,8822,338,684,2708,7103,3046,7787
291995,202111,2325,5974,1896,5292,57,203,1482,4032,1539,4235
292000,202111,2804,6298,2281,5676,91,253,1834,4558,1925,4811
292010,202111,6036,13605,4907,12001,135,341,4155,9966,4290,10307
292020,202111,5023,13528,4215,12139,164,516,3304,9247,3468,9763
292030,202111,2099,5981,1871,5576,119,369,1217,3544,1336,3913
292040,202111,4807,11555,3752,10025,229,509,2870,7839,3099,8348
292045,202111,4349,10698,3262,9124,33,91,2937,8333,2970,8424
292050,202111,6925,18436,5606,16204,264,794,3672,10488,3936,11282
292060,202111,12002,26591,11091,25460,441,880,9789,22218,10230,23098
292070,202111,6002,14963,5223,14048,336,830,4398,11819,4734,12649
292080,202111,3503,8112,2883,7328,55,174,2627,6617,2682,6791
292090,202111,4714,9954,3345,8290,240,527,2505,6266,2745,6793
292100,202111,13522,30679,11534,28239,1993,4468,6468,16785,8461,21253
292105,202111,3822,9080,3325,8418,69,154,2815,7131,2884,7285
292110,202111,6557,14906,4646,12041,870,2310,2422,6236,3292,8546
292120,202111,7511,18430,6201,16242,406,1065,4553,11759,4959,12824
292130,202111,3645,8430,3018,7661,167,419,2282,5770,2449,6189
292140,202111,5764,12536,4883,11307,163,351,4250,9772,4413,10123
292145,202111,2739,7131,2291,6384,112,259,1817,5075,1929,5334
292150,202111,15884,40430,13753,37054,255,899,11465,30271,11720,31170
292160,202111,3135,7343,2357,6348,32,81,1930,5463,1962,5544
292170,202111,9438,23545,7928,21173,413,1142,6091,15916,6504,17058
292180,202111,3101,8105,2295,6634,150,423,1443,4105,1593,4528
292190,202111,3076,7834,2618,7173,157,441,1943,5365,2100,5806
292200,202111,9629,22569,7196,19173,1400,3699,3240,9142,4640,12841
292205,202111,3878,10554,3350,9768,68,268,2899,8411,2967,8679
292210,202111,6951,15364,5626,13711,85,285,5101,12337,5186,12622
292220,202111,2330,5200,2004,4717,79,161,1549,3542,1628,3703
292225,202111,3443,9600,3040,9006,54,216,2673,7794,2727,8010
292230,202111,9369,21363,8391,20139,187,538,7293,17225,7480,17763
292240,202111,5074,14073,4428,12926,305,846,3121,9086,3426,9932
292250,202111,6268,15331,5629,14422,322,785,4393,11151,4715,11936
292260,202111,3480,8883,3096,8389,78,198,2704,7338,2782,7536
292265,202111,3693,9537,3082,8624,49,216,2533,6925,2582,7141
292270,202111,4496,9980,3563,8876,146,297,2878,7220,3024,7517
292273,202111,2977,6145,2375,5414,69,118,1716,4190,1785,4308
292275,202111,1697,4337,1335,3853,54,153,1015,2969,1069,3122
292280,202111,2788,6312,2248,5692,114,197,1851,4875,1965,5072
292285,202111,2780,6356,2204,5589,85,168,1804,4613,1889,4781
292290,202111,7961,19928,6262,17586,178,502,5168,14521,5346,15023
292300,202111,10825,26088,8543,23093,920,2564,5785,15674,6705,18238
292303,202111,3108,8527,2687,7874,92,188,2238,6656,2330,6844
292305,202111,2349,6169,2156,5907,49,157,1928,5209,1977,5366
292310,202111,7388,17374,6406,16190,101,289,5694,14205,5795,14494
292320,202111,6444,16819,5130,14478,205,628,3867,10649,4072,11277
292330,202111,2938,6096,2400,5500,129,205,1845,4459,1974,4664
292335,202111,5139,12860,4509,11936,255,570,3745,10088,4000,10658
292340,202111,5599,15485,4611,13616,234,653,3350,9854,3584,10507
292350,202111,2661,6987,2221,6390,92,273,1788,5195,1880,5468
292360,202111,5299,13544,4414,12071,218,640,3184,8608,3402,9248
292370,202111,10706,24715,9178,22729,116,324,8510,20897,8626,21221
292380,202111,7175,19470,6389,18084,473,1283,4785,13459,5258,14742
292390,202111,4963,9038,3676,7572,134,205,3243,6695,3377,6900
292400,202111,23565,64428,20264,59301,2026,5637,13789,40864,15815,46501
292405,202111,4800,11211,4041,10050,91,214,3396,8310,3487,8524
292410,202111,2312,5381,1931,4902,66,133,1711,4376,1777,4509
292420,202111,3972,10740,3564,10152,84,285,3120,8728,3204,9013
292430,202111,5237,14986,3981,12691,307,945,2619,8400,2926,9345
292440,202111,9073,27784,8348,26719,108,488,7479,23837,7587,24325
292450,202111,4355,11816,3386,9980,107,331,2635,7715,2742,8046
292460,202111,5681,14215,4709,12680,231,568,3727,9944,3958,10512
292465,202111,2868,6976,2446,6445,91,179,1629,4740,1720,4919
292467,202111,2072,5498,1818,5156,321,751,1183,3571,1504,4322
292470,202111,3142,7712,2419,6599,85,143,1822,5028,1907,5171
292480,202111,6609,15010,5370,13516,64,216,4891,12209,4955,12425
292490,202111,2602,5936,2182,5352,101,161,1755,4337,1856,4498
292500,202111,7428,18657,5924,16186,400,1076,4078,11065,4478,12141
292510,202111,14572,36724,11359,31764,588,1626,8025,22462,8613,24088
292520,202111,7726,18541,6788,17153,444,1178,5368,13348,5812,14526
292525,202111,6500,14767,5344,13477,129,250,4735,12106,4864,12356
292530,202111,32628,82168,25526,70587,5309,14964,11777,32717,17086,47681
292540,202111,4716,8350,3726,7302,144,226,3360,6619,3504,6845
292550,202111,8578,21532,6537,19108,475,1220,4559,14281,5034,15501
292560,202111,4634,11359,3903,10337,146,369,2912,7648,3058,8017
292570,202111,3918,9866,3270,8730,52,181,2773,7202,2825,7383
292575,202111,7046,19681,6453,18903,825,2231,4666,14021,5491,16252
292580,202111,8089,19538,6675,17477,118,305,5709,14765,5827,15070
292590,202111,7747,20048,6482,17817,358,993,5123,13860,5481,14853
292593,202111,2994,7281,2477,6423,79,190,2071,5336,2150,5526
292595,202111,5840,14783,5018,13778,134,409,4291,11712,4425,12121
292600,202111,11540,30046,9977,27722,530,1263,7867,22056,8397,23319
292610,202111,4594,11298,3934,10191,157,354,3079,8018,3236,8372
292620,202111,6830,17857,5589,16357,143,282,5035,15064,5178,15346
292630,202111,9460,21979,7576,19017,984,2300,4522,11627,5506,13927
292640,202111,8642,24253,7462,22328,258,811,5341,16156,5599,16967
292650,202111,4581,11120,4076,10459,106,239,3707,9446,3813,9685
292660,202111,11892,31221,10027,28466,528,1461,7396,21307,7924,22768
292665,202111,2262,6454,1936,6024,74,196,1590,5063,1664,5259
292670,202111,3723,9886,2890,8351,144,428,1942,5492,2086,5920
292680,202111,4266,10695,3370,9160,150,352,2544,6766,2694,7118
292690,202111,2793,6976,1930,5580,200,517,1150,3493,1350,4010
292700,202111,10668,27803,9290,25692,758,1666,6458,18540,7216,20206
292710,202111,2860,8106,2660,7847,57,136,2435,7233,2492,7369
292720,202111,9520,21709,8037,20001,238,555,6422,16333,6660,16888
292730,202111,5278,11570,4800,10849,383,631,3898,9086,4281,9717
292740,202111,346834,802292,300256,737265,40561,97961,192697,470419,233258,568380
292750,202111,6803,16848,6002,15736,222,516,4866,12928,5088,13444
292760,202111,4203,11432,3671,10523,175,467,2765,7847,2940,8314
292770,202111,6999,17200,5656,15359,783,2118,3708,10349,4491,12467
292780,202111,2250,4245,1677,3568,80,164,1344,2757,1424,2921
292790,202111,4148,8547,3131,7447,167,343,2576,6184,2743,6527
292800,202111,11976,29133,10220,26479,473,1132,8324,21481,8797,22613
292805,202111,3907,8941,3072,7874,128,313,2437,6236,2565,6549
292810,202111,11898,28766,9524,25138,691,1513,7024,18344,7715,19857
292820,202111,7562,20516,5538,17115,365,1168,3898,11855,4263,13023
292830,202111,3075,7044,2614,6488,92,199,2229,5590,2321,5789
292840,202111,9460,23656,7980,21678,156,450,7044,18915,7200,19365
292850,202111,2698,6731,2263,6105,175,420,1553,4197,1728,4617
292860,202111,17518,37357,15759,35304,553,1188,13580,30230,14133,31418
292870,202111,20692,48355,17939,44574,1003,2322,12801,31242,13804,33564
292880,202111,11986,31541,10216,28870,300,986,8044,21991,8344,22977
292890,202111,7717,20241,6810,18968,160,583,5995,16585,6155,17168
292895,202111,3338,6777,2503,5572,108,216,2029,4487,2137,4703
292900,202111,2828,7292,2566,6899,44,160,2145,5613,2189,5773
292905,202111,4611,11380,3669,9977,105,314,2823,7561,2928,7875
292910,202111,5014,13201,4581,12599,173,440,3614,9840,3787,10280
292920,202111,10306,27473,9566,26474,287,958,8295,22659,8582,23617
292925,202111,5574,15387,4627,13660,266,691,3274,9695,3540,10386
292930,202111,6867,19222,5942,17575,563,1687,3758,10976,4321,12663
292935,202111,2623,6198,2055,5566,14,63,1852,5044,1866,5107
292937,202111,2860,7051,2410,6431,76,194,1903,5093,1979,5287
292940,202111,3170,7612,2519,6635,295,633,1663,4599,1958,5232
292950,202111,10081,24814,8786,22940,549,1175,6595,17227,7144,18402
292960,202111,5517,12916,4606,11629,147,329,3700,9287,3847,9616
292970,202111,4070,11099,3608,10430,71,256,3020,8791,3091,9047
292975,202111,4517,9556,4010,8989,160,263,3599,8166,3759,8429
292980,202111,3752,8400,3069,7422,69,185,2614,6224,2683,6409
292990,202111,12151,32219,10121,28731,553,1628,7596,21123,8149,22751
293000,202111,2883,6622,2474,6005,50,155,2007,4832,2057,4987
293010,202111,19582,47913,15757,42106,1981,5363,9749,26064,11730,31427
293015,202111,9295,26889,7366,23248,512,1525,5020,16182,5532,17707
293020,202111,10315,28998,9280,27534,121,406,8368,24894,8489,25300
293030,202111,5472,13927,4186,11955,128,332,2868,8478,2996,8810
293040,202111,4753,11686,3963,10585,82,206,3462,9230,3544,9436
293050,202111,24558,56771,21614,52460,1474,3330,16071,38718,17545,42048
293060,202111,3903,9919,3134,8475,196,539,2215,5831,2411,6370
293070,202111,27357,63120,24136,59083,2034,5042,18157,44206,20191,49248
293075,202111,3896,11484,3388,10661,87,406,2851,8910,2938,9316
293076,202111,3735,8762,3393,8363,70,130,3024,7558,3094,7688
293077,202111,6847,18073,5479,15948,516,1524,3336,10297,3852,11821
293080,202111,4996,14255,4252,12960,77,350,3484,10420,3561,10770
293090,202111,3376,9579,2600,8264,203,577,1739,5605,1942,6182
293100,202111,6157,15651,5103,13798,289,699,3941,10693,4230,11392
293105,202111,4076,12365,3534,11266,272,829,2441,7781,2713,8610
293110,202111,2560,6077,2137,5477,66,188,1745,4406,1811,4594
293120,202111,4941,12449,4453,11720,373,644,3563,9705,3936,10349
293130,202111,3929,10425,3410,9766,49,184,3027,8590,3076,8774
293135,202111,32981,74581,24350,63160,4013,11067,10500,27646,14513,38713
293140,202111,2713,5513,2371,5107,71,108,2054,4423,2125,4531
293150,202111,5584,16240,4587,14389,308,953,3169,9966,3477,10919
293160,202111,3882,9373,3317,8756,265,425,2774,7714,3039,8139
293170,202111,5315,10503,4653,9703,96,183,4146,8599,4242,8782
293180,202111,4676,12600,3888,11182,68,237,3138,8809,3206,9046
293190,202111,15325,39441,13402,36743,112,465,11993,32611,12105,33076
293200,202111,9377,21800,7619,19059,242,583,6255,15523,6497,16106
293210,202111,5459,13769,4671,12562,365,903,3524,9534,3889,10437
293220,202111,5605,13481,4155,11116,781,2057,2070,5628,2851,7685
293230,202111,4356,10356,3242,8862,256,656,2267,6353,2523,7009
293240,202111,4809,12057,3878,10572,88,153,2893,8325,2981,8478
293245,202111,4116,10672,3730,10111,160,391,3145,8472,3305,8863
293250,202111,6287,14192,5075,12601,251,607,4071,10061,4322,10668
293260,202111,5045,12674,4162,11304,158,337,2921,8085,3079,8422
293270,202111,7685,16279,6076,14555,471,623,4714,12300,5185,12923
293280,202111,4757,12001,4135,11112,274,601,3158,8685,3432,9286
293290,202111,16691,44781,14777,41808,1690,4769,10084,28632,11774,33401
293300,202111,6260,14527,5385,13262,357,787,3941,9764,4298,10551
293305,202111,4444,10271,3842,9509,79,176,3471,8607,3550,8783
293310,202111,2304,5597,1946,5055,42,118,1575,4015,1617,4133
293315,202111,4449,9986,3657,8834,218,441,2993,7228,3211,7669
293317,202111,2928,6470,2590,5995,197,315,1994,4670,2191,4985
293320,202111,12864,29652,11417,28049,208,532,10387,25374,10595,25906
293325,202111,1911,4524,1484,3972,224,567,915,2500,1139,3067
293330,202111,69322,182511,56648,160898,9110,26598,28321,78799,37431,105397
293340,202111,2306,6269,1888,5541,135,375,1242,3645,1377,4020
293345,202111,3933,10024,3146,8833,467,1035,1905,5989,2372,7024
293350,202111,6753,18496,5777,17311,59,267,5242,15858,5301,16125
293360,202111,15900,38621,13611,35603,229,872,12137,31191,12366,32063
310010,202111,1043,2275,687,1794,48,153,263,659,311,812
310020,202111,3106,7929,2366,6634,432,1273,734,1957,1166,3230
310030,202111,2019,5503,1561,4698,229,740,1002,2926,1231,3666
310040,202111,913,2293,718,1955,68,225,384,926,452,1151
310050,202111,1545,4441,1297,4054,105,414,878,2650,983,3064
310060,202111,3368,9081,2903,8468,120,371,2363,6869,2483,7240
310070,202111,349,785,253,650,11,24,186,475,197,499
310080,202111,757,1979,548,1605,75,236,271,761,346,997
310090,202111,5189,12778,4281,11332,212,597,3325,8622,3537,9219
310100,202111,3853,9917,3267,8988,75,299,2762,7396,2837,7695
310110,202111,5044,12693,3896,10778,659,1994,1953,5148,2612,7142
310120,202111,669,1557,427,1176,49,158,241,600,290,758
310130,202111,399,1002,342,917,26,94,264,675,290,769
310140,202111,318,848,228,704,38,140,102,284,140,424
310150,202111,6341,15577,4753,12752,503,1535,2457,6136,2960,7671
310160,202111,9779,23258,7237,19187,1185,3312,2978,7807,4163,11119
310163,202111,1193,3401,951,2925,177,583,296,825,473,1408
310170,202111,10228,24603,8204,21523,717,1819,5734,15117,6451,16936
310180,202111,2060,4784,1488,3890,148,427,926,2336,1074,2763
310190,202111,2942,8149,2407,7213,541,1794,433,1218,974,3012
310200,202111,2193,6057,1631,5018,190,659,826,2452,1016,3111
310205,202111,1174,3103,931,2717,121,394,547,1606,668,2000
310210,202111,2670,6984,2180,6109,130,343,1526,4165,1656,4508
310220,202111,1321,3468,1015,2861,87,235,655,1789,742,2024
310230,202111,2370,6281,1902,5432,230,699,1181,3161,1411,3860
310240,202111,1089,3082,927,2806,56,187,635,1854,691,2041
310250,202111,1144,2881,933,2551,18,63,700,1873,718,1936
310260,202111,3491,8727,2327,6642,626,2083,742,1715,1368,3798
310270,202111,2942,6779,2357,6005,79,212,1973,5027,2052,5239
310280,202111,2689,5994,2146,5234,198,525,1424,3315,1622,3840
310285,202111,1979,6043,1651,5452,154,534,1023,3354,1177,3888
310290,202111,1385,3514,1169,3150,165,531,700,1697,865,2228
310300,202111,1751,4758,1463,4262,144,493,848,2295,992,2788
310310,202111,343,803,225,601,42,106,110,283,152,389
310320,202111,557,1352,393,1095,17,64,240,631,257,695
310330,202111,524,1209,317,837,47,138,119,278,166,416
310340,202111,8808,21957,7035,18964,954,2512,3552,9683,4506,12195
310350,202111,13914,32614,9716,25930,1514,4304,4722,12048,6236,16352
310360,202111,609,1319,490,1170,20,53,323,751,343,804
310370,202111,1331,3978,1140,3629,206,730,342,1181,548,1911
310375,202111,909,2190,645,1802,102,299,352,976,454,1275
310380,202111,415,929,236,652,29,85,118,305,147,390
310390,202111,542,1546,433,1341,78,261,157,441,235,702
310400,202111,12317,29122,9094,24209,732,2257,5886,15025,6618,17282
310410,202111,1136,3202,615,2042,60,217,226,681,286,898
310420,202111,5137,12836,3710,10283,483,1469,1680,4273,2163,5742
310430,202111,1788,4655,1221,3618,220,710,489,1251,709,1961
310440,202111,711,1802,496,1411,48,158,261,692,309,850
310445,202111,1477,4031,1087,3269,77,225,758,2233,835,2458
310450,202111,4769,11637,3639,9870,141,464,2816,7432,2957,7896
310460,202111,1894,4869,1458,4079,204,627,575,1444,779,2071
310470,202111,3863,8384,2999,7248,325,686,2073,5169,2398,5855
310480,202111,1070,2660,830,2274,95,268,492,1283,587,1551
310490,202111,3025,7949,2380,6908,257,882,1346,3606,1603,4488
310500,202111,1491,3926,1131,3341,180,590,610,1729,790,2319
310510,202111,2321,5860,1602,4530,272,835,679,1903,951,2738
310520,202111,1231,3099,905,2516,147,394,449,1263,596,1657
310530,202111,809,1997,549,1548,76,242,194,444,270,686
310540,202111,3205,8815,2632,7771,490,1580,1231,3357,1721,4937
310550,202111,1357,3273,975,2640,73,241,574,1426,647,1667
310560,202111,16929,42657,12130,34089,1628,4959,5379,13576,7007,18535
310570,202111,1126,2846,896,2523,47,161,689,1903,736,2064
310590,202111,4498,11333,3599,9684,219,660,2195,5547,2414,6207
310600,202111,1461,4119,1191,3559,143,487,634,1775,777,2262
310610,202111,507,1350,331,1053,120,405,44,132,164,537
310620,202111,207544,507311,154212,411730,17770,54706,82940,200342,100710,255048
310630,202111,4991,13089,3861,10887,475,1339,2247,6209,2722,7548
310640,202111,1320,3617,1084,3178,154,527,561,1509,715,2036
310650,202111,2625,6960,1944,5682,141,426,1222,3419,1363,3845
310660,202111,1470,3764,1210,3400,29,79,1043,2915,1072,2994
310665,202111,1496,3640,1220,3265,17,60,998,2717,1015,2777
310670,202111,64907,159961,54779,142985,4753,13863,38126,94528,42879,108391
310680,202111,832,1874,689,1673,20,71,590,1377,610,1448
310690,202111,2314,5582,1700,4615,115,353,1064,2719,1179,3072
310700,202111,525,1118,411,977,18,56,323,748,341,804
310710,202111,6454,17387,4689,14736,878,3196,776,2164,1654,5360
310720,202111,1146,2543,895,2229,31,100,684,1633,715,1733
310730,202111,10965,27554,9356,25078,369,1170,7061,18428,7430,19598
310740,202111,7079,18621,5184,14885,673,2128,2179,5646,2852,7774
310750,202111,1387,3175,1063,2713,102,314,617,1420,719,1734
310760,202111,738,1790,517,1453,41,119,294,823,335,942
310770,202111,1145,3003,802,2478,78,279,412,1167,490,1446
310780,202111,4518,10298,3736,9282,144,357,2922,7271,3066,7628
310790,202111,1933,5925,1649,5304,305,1032,267,720,572,1752
310800,202111,2534,7251,1846,5873,328,1273,110,275,438,1548
310810,202111,1418,3356,1177,2970,54,140,847,2058,901,2198
310820,202111,1276,3161,783,2346,166,504,176,554,342,1058
310825,202111,2811,7881,2263,6998,45,243,1874,5623,1919,5866
310830,202111,2085,5601,1546,4594,269,943,647,1782,916,2725
310840,202111,2319,6096,1763,5168,358,1203,491,1236,849,2439
310850,202111,1479,3988,1228,3621,35,153,950,2699,985,2852
310855,202111,3313,8450,2574,7258,178,533,1847,5132,2025,5665
310860,202111,7261,20178,5899,17644,621,1760,3579,10903,4200,12663
310870,202111,1012,2355,800,2052,52,132,599,1521,651,1653
310880,202111,1033,3014,826,2598,109,325,460,1445,569,1770
310890,202111,2365,6606,1518,4893,254,886,226,616,480,1502
310900,202111,4184,11311,2942,8651,465,1461,1270,3433,1735,4894
310910,202111,2338,5502,1649,4415,141,444,388,940,529,1384
310920,202111,2009,5033,1533,4339,162,483,947,2630,1109,3113
310925,202111,1070,2729,870,2419,40,140,650,1717,690,1857
310930,202111,6060,15094,4291,12288,882,2450,1859,5670,2741,8120
310940,202111,7275,16216,5907,14274,185,486,4676,11032,4861,11518
310945,202111,1406,3479,1103,2986,168,472,588,1530,756,2002
310950,202111,2024,5832,1346,4320,215,747,384,1044,599,1791
310960,202111,772,1988,438,1294,74,255,98,264,172,519
310970,202111,1232,3560,867,2806,219,759,137,409,356,1168
310980,202111,365,831,203,557,19,56,112,303,131,359
310990,202111,1421,3717,1128,3228,144,422,624,1736,768,2158
311000,202111,4128,11090,3063,9369,746,2320,1242,3755,1988,6075
311010,202111,1026,2692,827,2345,194,602,403,1125,597,1727
311020,202111,1240,3065,801,2278,46,137,439,1200,485,1337
311030,202111,1908,4595,1370,3710,296,906,577,1455,873,2361
311040,202111,305,922,247,795,78,265,73,211,151,476
311050,202111,3228,7764,2424,6581,385,1187,1205,3088,1590,4275
311060,202111,3543,8777,2641,7155,348,1071,1083,2689,1431,3760
311070,202111,2555,6083,1876,5048,157,549,1112,2782,1269,3331
311080,202111,1241,2712,997,2339,50,147,791,1756,841,1903
311090,202111,2477,7399,2012,6528,436,1505,628,2011,1064,3516
311100,202111,2600,7114,1563,5025,273,972,325,887,598,1859
311110,202111,3907,7838,2205,5460,466,1168,673,1711,1139,2879
311115,202111,1501,3176,1270,2878,82,148,1014,2298,1096,2446
311120,202111,7484,18997,5779,15996,856,2613,2184,5313,3040,7926
311130,202111,2014,5143,1529,4475,104,364,918,2618,1022,2982
311140,202111,1601,3835,1263,3367,83,250,895,2347,978,2597
311150,202111,1530,4702,1184,4025,169,623,613,2022,782,2645
311160,202111,4245,11687,3060,9525,636,2154,1043,3088,1679,5242
311170,202111,959,2377,770,2122,51,144,479,1398,530,1542
311180,202111,1478,3233,968,2500,188,491,427,1105,615,1596
311190,202111,929,2530,696,2069,112,393,271,675,383,1068
311200,202111,2279,5915,1641,4695,307,963,589,1492,896,2455
311205,202111,955,2659,794,2369,31,114,523,1458,554,1572
311210,202111,1102,3083,959,2882,117,303,676,2120,793,2423
311220,202111,814,2129,686,1899,32,103,483,1248,515,1351
311230,202111,8578,24518,6496,20363,1159,3741,2346,7468,3505,11209
311240,202111,1159,2875,900,2510,181,496,406,1144,587,1640
311250,202111,1312,3574,1023,3042,181,536,407,1119,588,1655
311260,202111,2975,7005,1925,5203,259,781,885,2105,1144,2886
311265,202111,1384,3441,1020,2846,38,138,725,1970,763,2108
311270,202111,3183,9099,2761,8423,148,585,2010,5880,2158,6465
311280,202111,1185,3043,620,1901,98,336,107,276,205,612
311290,202111,1946,5696,1763,5334,118,347,1193,3616,1311,3963
311300,202111,5020,13245,4142,11797,163,536,3338,9309,3501,9845
311310,202111,606,1618,511,1449,31,94,342,931,373,1025
311320,202111,3488,10209,3013,9199,285,1004,1585,4402,1870,5406
311330,202111,6221,15041,4923,13005,523,1376,2723,7329,3246,8705
311340,202111,11378,30437,8969,26244,2051,6436,2718,7453,4769,13889
311350,202111,2603,6116,1882,4854,193,500,1026,2410,1219,2910
311360,202111,1174,2791,789,2238,194,634,270,771,464,1405
311370,202111,5141,11979,3821,9940,287,892,2394,5784,2681,6676
311380,202111,389,1150,283,930,64,207,130,442,194,649
311390,202111,1864,5469,1494,4968,657,2424,349,1053,1006,3477
311400,202111,1706,4491,1253,3640,236,711,358,876,594,1587
311410,202111,1980,5552,1583,4920,217,748,887,2656,1104,3404
311420,202111,1667,4720,1203,3778,218,770,347,912,565,1682
311430,202111,4686,11888,3153,8943,463,1334,1203,3286,1666,4620
311440,202111,3246,8636,2476,7368,674,2310,500,1381,1174,3691
311450,202111,1960,5686,1430,4682,361,1326,329,897,690,2223
311455,202111,1108,2413,766,1914,133,349,371,922,504,1271
311460,202111,579,1701,385,1288,71,278,84,221,155,499
311470,202111,562,1652,370,1219,91,344,49,146,140,490
311480,202111,1172,2799,958,2474,77,184,725,1864,802,2048
311490,202111,265,767,200,648,27,108,89,251,116,359
311500,202111,513,1222,402,1056,24,77,263,668,287,745
311510,202111,3541,8768,2499,7030,296,915,1120,2909,1416,3824
311520,202111,676,1808,594,1658,79,259,338,927,417,1186
311530,202111,9173,20790,6012,15825,1373,3987,1684,4231,3057,8218
311535,202111,891,2344,617,1777,92,278,239,636,331,914
311540,202111,530,1604,472,1497,61,202,337,1047,398,1249
311545,202111,2101,5809,1808,5357,105,311,1383,4077,1488,4388
311547,202111,1605,3836,1396,3523,53,119,1066,2673,1119,2792
311550,202111,3137,8232,2537,7184,357,1102,1100,2934,1457,4036
311560,202111,329,687,211,509,79,181,51,113,130,294
311570,202111,1643,3713,1160,3046,38,108,888,2366,926,2474
311580,202111,2344,4353,1611,3476,206,357,1031,2259,1237,2616
311590,202111,575,1462,467,1302,97,287,245,674,342,961
311600,202111,1752,3979,1455,3584,127,343,1117,2682,1244,3025
311610,202111,2442,7265,2025,6470,135,499,1290,4012,1425,4511
311615,202111,3548,9448,2854,8325,100,334,2310,6614,2410,6948
311620,202111,507,1257,410,1126,114,354,223,572,337,926
311630,202111,1416,3772,1177,3305,141,405,705,1938,846,2343
311640,202111,781,2044,621,1784,66,225,323,844,389,1069
311650,202111,2065,4981,1658,4354,202,552,1007,2566,1209,3118
311660,202111,3154,8783,2350,7186,315,1072,645,1594,960,2666
311670,202111,1703,4198,1266,3419,147,436,587,1557,734,1993
311680,202111,2380,6349,1810,5349,127,362,1300,3832,1427,4194
311690,202111,657,1363,511,1179,36,71,382,920,418,991
311700,202111,2295,5308,1788,4591,11,57,1518,3802,1529,3859
311710,202111,1644,4578,1206,3810,299,1036,388,1212,687,2248
311720,202111,458,1294,369,1136,40,139,192,596,232,735
311730,202111,4024,10041,2688,7421,703,2098,739,1942,1442,4040
311740,202111,1025,2553,849,2311,83,204,680,1910,763,2114
311750,202111,4243,12019,3417,10549,335,1120,2185,6467,2520,7587
311760,202111,719,1959,585,1727,76,264,271,680,347,944
311770,202111,2338,6367,1841,5499,304,909,835,2391,1139,3300
311780,202111,1489,4109,1100,3367,166,560,394,1061,560,1621
311783,202111,2445,6242,1988,5490,30,134,1628,4334,1658,4468
311787,202111,901,2502,703,2055,106,340,312,792,418,1132
311790,202111,1607,4280,1065,3264,224,750,313,883,537,1633
311800,202111,5487,15827,4370,13432,868,2774,630,1532,1498,4306
311810,202111,998,2849,782,2475,50,166,525,1645,575,1811
311820,202111,876,2041,666,1729,57,182,431,1043,488,1225
311830,202111,9048,24881,6335,19103,1706,5442,832,2431,2538,7873
311840,202111,4008,9630,3254,8568,241,648,2429,6370,2670,7018
311850,202111,383,978,310,848,13,36,208,539,221,575
311860,202111,69847,168938,54226,142434,6522,18595,32413,80357,38935,98952
311870,202111,2000,5146,1430,4177,255,862,588,1557,843,2419
311880,202111,6914,17024,5772,15438,353,760,4275,11757,4628,12517
311890,202111,1850,4233,1440,3678,69,201,1055,2541,1124,2742
311900,202111,801,1979,603,1710,66,190,362,1037,428,1227
311910,202111,4412,10859,3349,9452,619,1701,1618,4751,2237,6452
311920,202111,2257,5689,1818,5060,116,263,1174,3364,1290,3627
311930,202111,4375,9794,3195,8167,867,2370,1128,2728,1995,5098
311940,202111,17009,42678,12358,34012,1699,5068,5563,14172,7262,19240
311950,202111,2523,6400,1915,5370,144,421,1189,3340,1333,3761
311960,202111,509,1228,399,1061,40,134,216,512,256,646
311970,202111,456,1420,330,1111,52,218,81,227,133,445
311980,202111,496,1294,267,852,23,79,105,320,128,399
311990,202111,559,1298,357,988,72,237,139,340,211,577
311995,202111,1002,2732,536,1656,18,64,75,147,93,211
312000,202111,844,1965,640,1668,52,127,432,1130,484,1257
312010,202111,1085,2794,858,2438,34,110,616,1676,650,1786
312015,202111,1485,4075,1320,3814,47,162,1072,3020,1119,3182
312020,202111,1821,5420,1305,4267,205,694,279,813,484,1507
312030,202111,2175,5079,1889,4763,13,51,1784,4487,1797,4538
312040,202111,886,2549,638,2062,90,284,274,867,364,1151
312050,202111,1274,3779,1030,3318,213,842,364,1038,577,1880
312060,202111,1002,2346,651,1866,163,470,279,796,442,1266
312070,202111,980,2673,706,2134,27,95,433,1217,460,1312
312080,202111,2921,6967,2237,5965,127,339,1523,3888,1650,4227
312083,202111,999,2465,770,2119,56,187,564,1492,620,1679
312087,202111,2691,6683,2189,5914,55,141,1770,4807,1825,4948
312090,202111,11504,28969,9107,25210,1168,3535,4908,12878,6076,16413
312100,202111,1675,4633,1344,4022,85,317,859,2431,944,2748
312110,202111,1069,3206,879,2821,164,608,338,973,502,1581
312120,202111,1082,2865,747,2287,185,642,221,554,406,1196
312125,202111,1930,4703,1641,4309,104,283,1291,3299,1395,3582
312130,202111,1162,2729,869,2250,75,216,392,919,467,1135
312140,202111,745,2099,618,1845,106,347,275,761,381,1108
312150,202111,501,1329,426,1187,23,72,284,736,307,808
312160,202111,9925,25670,7656,21736,857,2614,3829,10351,4686,12965
312170,202111,963,2434,734,2021,38,114,480,1278,518,1392
312180,202111,1479,3797,1196,3292,143,402,651,1741,794,2143
312190,202111,756,2003,568,1664,66,228,261,703,327,931
312200,202111,4776,12515,3740,10843,703,1924,1810,5317,2513,7241
312210,202111,1452,3141,1075,2616,43,118,828,1964,871,2082
312220,202111,1705,5038,1474,4620,90,289,992,3115,1082,3404
312230,202111,17189,42456,12057,33381,2474,7777,3302,7607,5776,15384
312235,202111,2148,5121,1699,4494,135,367,1214,3116,1349,3483
312240,202111,806,2476,621,2090,131,454,175,573,306,1027
312245,202111,2912,6994,2418,6259,45,96,2074,5338,2119,5434
312247,202111,1097,2461,807,2055,106,296,489,1213,595,1509
312250,202111,994,2593,626,1860,81,254,219,630,300,884
312260,202111,1020,2609,818,2308,36,131,639,1715,675,1846
312270,202111,759,2048,583,1693,31,114,319,853,350,967
312280,202111,437,1241,340,1072,91,305,59,168,150,473
312290,202111,900,2510,736,2226,130,438,243,676,373,1114
312300,202111,1108,3264,750,2383,180,624,138,358,318,982
312310,202111,1028,2931,822,2522,117,385,418,1229,535,1614
312320,202111,2186,5407,1598,4407,352,986,336,921,688,1907
312330,202111,941,2592,772,2247,84,266,467,1309,551,1575
312340,202111,276,690,200,570,29,116,110,266,139,382
312350,202111,274,549,202,471,19,49,142,321,161,370
312352,202111,1618,4744,1425,4384,121,377,809,2688,930,3065
312360,202111,3323,9249,2481,7694,422,1454,942,2669,1364,4123
312370,202111,2055,5093,1694,4496,163,487,1076,2717,1239,3204
312380,202111,2338,5111,1943,4610,10,36,1733,4037,1743,4073
312385,202111,1361,3514,1047,2959,247,765,271,784,518,1549
312390,202111,2029,5575,1487,4551,219,776,412,1056,631,1832
312400,202111,3114,8527,2615,7703,731,2360,807,2389,1538,4749
312410,202111,13489,35250,11011,31198,1757,5065,6364,17613,8121,22678
312420,202111,4232,10734,3459,9474,692,2063,1737,4557,2429,6620
312430,202111,8613,21740,7048,19045,293,913,5207,13668,5500,14581
312440,202111,1016,3156,830,2761,366,1298,139,429,505,1727
312450,202111,1346,3813,1025,3241,278,923,339,1101,617,2024
312460,202111,490,1194,354,990,51,143,202,570,253,713
312470,202111,502,1191,313,853,30,95,103,234,133,329
312480,202111,1102,2675,788,2214,84,271,416,1097,500,1368
312490,202111,2446,5511,1961,4837,164,449,1176,2841,1340,3290
312500,202111,1116,2604,925,2349,40,141,698,1744,738,1885
312510,202111,4431,11537,3205,9219,746,2041,824,2362,1570,4403
312520,202111,300,738,232,635,43,133,117,312,160,445
312530,202111,728,1637,618,1512,33,73,475,1214,508,1287
312540,202111,1714,4510,1181,3501,138,417,653,1869,791,2286
312550,202111,835,2133,644,1763,43,137,422,1071,465,1208
312560,202111,2029,5171,1632,4549,85,224,1179,3291,1264,3515
312570,202111,2664,6008,2016,5206,468,1163,903,2482,1371,3645
312580,202111,644,1704,447,1309,54,186,197,520,251,706
312590,202111,1645,4574,1265,3803,89,326,765,2108,854,2434
312595,202111,2193,6053,1812,5443,268,728,1060,3403,1328,4131
312600,202111,1290,3033,775,2033,113,360,159,460,272,820
312610,202111,7632,18757,5143,14225,710,2161,1849,4562,2559,6723
312620,202111,2663,6614,1991,5677,55,174,1573,4558,1628,4732
312630,202111,331,896,236,724,33,127,90,264,123,391
312640,202111,558,1491,401,1226,36,135,199,587,235,722
312650,202111,2235,5350,1573,4149,69,190,1141,2829,1210,3019
312660,202111,1398,3261,1067,2717,97,235,710,1746,807,1981
312670,202111,5595,13738,4665,12298,146,515,3597,9016,3743,9531
312675,202111,1366,3355,1117,3002,54,151,914,2421,968,2572
312680,202111,1553,4083,1352,3767,45,162,1144,3096,1189,3258
312690,202111,3102,6369,2383,5503,41,110,1994,4597,2035,4707
312695,202111,1078,2709,903,2429,44,84,718,1924,762,2008
312700,202111,2180,5570,1603,4534,138,463,934,2501,1072,2964
312705,202111,1565,3505,1353,3201,11,34,1259,2950,1270,2984
312707,202111,1512,4136,1134,3490,70,266,732,2157,802,2423
312710,202111,7089,15926,4371,11739,1047,2986,1243,3490,2290,6476
312720,202111,1155,2918,862,2459,89,271,546,1479,635,1750
312730,202111,1728,3940,1221,3247,99,283,742,1920,841,2203
312733,202111,1438,3690,1079,3024,27,100,744,1943,771,2043
312735,202111,805,2042,633,1699,74,195,378,955,452,1150
312737,202111,830,1791,596,1465,59,156,408,980,467,1136
312738,202111,807,1952,579,1566,57,171,349,885,406,1056
312740,202111,451,1114,266,798,49,172,62,129,111,301
312750,202111,1637,4543,1216,3740,194,625,531,1531,725,2156
312760,202111,1922,5429,1376,4299,242,752,520,1567,762,2319
312770,202111,47652,111255,30155,81448,5569,16232,10535,27090,16104,43322
312780,202111,2588,7303,2180,6628,268,819,1371,4145,1639,4964
312790,202111,260,600,137,394,2,7,39,78,41,85
312800,202111,5474,14643,4212,12278,746,2325,1899,5245,2645,7570
312810,202111,1652,4312,1114,3420,271,912,389,1088,660,2000
312820,202111,1872,4787,1517,4179,80,237,1104,2996,1184,3233
312825,202111,1503,3296,1301,3038,25,52,1129,2587,1154,2639
312830,202111,2972,8100,1861,5872,355,1200,492,1463,847,2663
312840,202111,1560,3917,1228,3379,81,258,736,1907,817,2165
312850,202111,1062,2423,750,1969,20,73,489,1186,509,1259
312860,202111,1162,2903,796,2350,189,562,182,505,371,1067
312870,202111,6494,16866,4103,12300,627,1949,1100,3008,1727,4957
312880,202111,1562,3796,1214,3219,55,143,709,1906,764,2049
312890,202111,2408,5740,1796,4760,135,320,956,2532,1091,2852
312900,202111,1374,3376,1123,3041,117,367,619,1754,736,2121
312910,202111,1613,2919,899,1988,196,367,356,818,552,1185
312920,202111,1033,2699,725,2211,115,415,268,713,383,1128
312930,202111,2585,6094,1958,5161,407,1075,876,2389,1283,3464
312940,202111,1077,2812,861,2513,60,226,530,1469,590,1695
312950,202111,3288,7812,2215,6115,425,1321,909,2367,1334,3688
312960,202111,1946,4911,1635,4443,97,231,1202,3379,1299,3610
312965,202111,1750,4555,1453,4110,145,368,952,2724,1097,3092
312970,202111,1572,4244,1263,3750,153,519,778,2184,931,2703
312980,202111,26671,70465,21494,61242,4086,12340,9823,26189,13909,38529
312990,202111,558,1327,377,1022,53,161,197,486,250,647
313000,202111,501,1387,370,1152,22,96,228,660,250,756
313005,202111,2682,7422,2260,6726,132,350,1630,4763,1762,5113
313010,202111,5766,15024,4586,13120,731,2273,2705,7587,3436,9860
313020,202111,1167,3422,859,2743,136,463,184,518,320,981
313030,202111,1229,2684,844,2144,60,197,581,1406,641,1603
313040,202111,894,2654,739,2352,35,145,465,1426,500,1571
313050,202111,1920,5094,1348,4223,201,752,410,1134,611,1886
313055,202111,2066,5291,1824,4938,274,737,1281,3478,1555,4215
313060,202111,1051,2502,756,2004,143,462,172,412,315,874
313065,202111,1721,4905,1516,4570,37,129,1204,3539,1241,3668
313070,202111,996,2540,772,2175,78,224,454,1244,532,1468
313080,202111,415,1137,310,937,48,162,109,272,157,434
313090,202111,5655,14140,4799,12803,355,996,3287,8698,3642,9694
313100,202111,1401,3513,1088,3061,29,105,822,2254,851,2359
313110,202111,1583,4037,1172,3337,101,344,643,1665,744,2009
313115,202111,3011,8179,2406,7037,263,910,1336,3568,1599,4478
313120,202111,4037,9299,2978,7914,195,582,2008,5352,2203,5934
313130,202111,34326,84893,25973,69804,2526,7731,14891,37401,17417,45132
313140,202111,727,1522,466,1165,30,78,342,850,372,928
313150,202111,1474,4029,1099,3367,321,1064,187,521,508,1585
313160,202111,1331,3228,1045,2805,24,80,800,2068,824,2148
313170,202111,11983,32681,8831,26789,1412,4594,3299,9068,4711,13662
313180,202111,2420,6142,1775,4855,289,719,992,2731,1281,3450
313190,202111,4720,13113,3410,10456,571,1852,1197,3369,1768,5221
313200,202111,1218,3162,1048,2863,11,37,904,2401,915,2438
313210,202111,4209,11335,3462,10041,392,1136,2111,5967,2503,7103
313220,202111,1891,4789,1260,3556,175,536,551,1362,726,1898
313230,202111,3014,8205,2447,7485,43,142,2023,6330,2066,6472
313240,202111,11141,26461,7428,20659,930,2957,3732,9607,4662,12564
313250,202111,6613,18745,5027,15328,932,2798,2198,6425,3130,9223
313260,202111,790,1947,570,1576,67,239,294,715,361,954
313270,202111,6321,14806,5157,13236,575,1232,3640,9725,4215,10957
313280,202111,492,1319,323,982,39,140,137,389,176,529
313290,202111,1058,3183,802,2721,180,689,307,1019,487,1708
313300,202111,1825,4734,1384,3986,312,962,399,1018,711,1980
313310,202111,1367,3927,1082,3332,164,574,333,860,497,1434
313320,202111,2197,5636,1579,4656,272,892,566,1722,838,2614
313330,202111,4415,11120,3358,9533,142,450,2244,6335,2386,6785
313340,202111,1546,3381,1127,2803,77,214,824,2001,901,2215
313350,202111,3202,8567,2129,6200,228,742,861,2169,1089,2911
313360,202111,1652,3927,1135,3094,163,561,609,1497,772,2058
313370,202111,1674,4439,1357,3833,193,579,568,1458,761,2037
313375,202111,1960,5015,1255,3697,235,739,268,722,503,1461
313380,202111,6947,16831,5090,13485,745,2234,2547,5960,3292,8194
313390,202111,839,2584,727,2389,51,220,489,1546,540,1766
313400,202111,3994,9371,3077,8084,109,291,2350,6085,2459,6376
313410,202111,1496,3678,1125,3044,99,292,759,1961,858,2253
313420,202111,16654,36286,8912,23447,2030,5985,1193,3058,3223,9043
313430,202111,1069,2915,847,2468,98,363,467,1195,565,1558
313440,202111,6673,14015,4598,11357,262,665,3241,7929,3503,8594
313450,202111,794,2038,563,1595,98,290,201,489,299,779
313460,202111,2333,6380,1846,5601,354,1218,842,2450,1196,3668
313470,202111,2997,7381,2374,6467,169,457,1690,4634,1859,5091
313480,202111,1124,3126,686,2170,52,183,248,718,300,901
313490,202111,3199,7755,1707,5001,361,1147,464,1286,825,2433
313500,202111,596,1561,433,1216,29,82,196,502,225,584
313505,202111,10785,27387,9192,25210,344,1042,7395,20278,7739,21320
313507,202111,1532,3799,1243,3359,37,138,991,2592,1028,2730
313510,202111,15331,40588,11959,34027,1338,3687,5863,16257,7201,19944
313520,202111,15974,42128,12746,36654,603,1833,9624,27133,10227,28966
313530,202111,619,1764,465,1439,55,191,160,415,215,606
313535,202111,2497,6707,2043,5846,261,675,1255,3601,1516,4276
313540,202111,885,2492,710,2090,120,373,314,831,434,1204
313545,202111,1218,3852,1030,3491,118,428,563,1827,681,2255
313550,202111,1989,5700,1664,4959,228,747,1009,2903,1237,3650
313560,202111,2965,5498,2226,4613,61,97,1905,3963,1966,4060
313570,202111,1074,2950,882,2610,199,593,366,1082,565,1675
313580,202111,6398,15343,5025,13096,453,1208,3161,8115,3614,9323
313590,202111,1191,3114,962,2781,179,539,500,1528,679,2067
313600,202111,4431,11059,3702,9959,86,266,3197,8456,3283,8722
313610,202111,1125,2696,909,2332,89,250,594,1441,683,1691
313620,202111,5766,14751,4561,12607,462,1487,2796,7362,3258,8849
313630,202111,9484,22111,6791,18104,671,2045,4100,10576,4771,12621
313640,202111,1329,2745,842,2135,120,306,485,1237,605,1543
313650,202111,1762,5117,1380,4482,90,339,887,2919,977,3258
313652,202111,880,2524,787,2352,76,231,558,1606,634,1837
313655,202111,1223,2917,948,2571,61,165,667,1824,728,1989
313657,202111,1224,3126,960,2704,25,82,730,1944,755,2026
313660,202111,1072,2873,875,2533,65,226,593,1638,658,1864
313665,202111,5627,14257,4489,12283,404,1216,2923,7574,3327,8790
313670,202111,55328,131640,36547,100092,4742,14169,17428,44711,22170,58880
313680,202111,1129,2867,935,2549,47,122,651,1739,698,1861
313690,202111,957,2779,687,2240,133,482,210,634,343,1116
313695,202111,1966,5000,1468,4179,104,289,947,2787,1051,3076
313700,202111,3020,9124,2623,8593,221,658,2010,6685,2231,7343
313710,202111,1582,3442,1134,2850,81,210,760,1919,841,2129
313720,202111,6448,17064,4609,13301,618,1874,1926,5053,2544,6927
313730,202111,1516,3188,1112,2667,92,171,719,1765,811,1936
313740,202111,1773,6173,1481,5418,294,1219,303,966,597,2185
313750,202111,2239,5717,1764,4906,291,907,911,2333,1202,3240
313753,202111,2326,5486,1550,4204,164,500,819,2135,983,2635
313760,202111,6073,16172,4722,13587,806,2581,2240,5934,3046,8515
313770,202111,4376,11764,3474,10347,200,532,2596,7896,2796,8428
313780,202111,4349,11011,3251,9252,294,887,1003,2976,1297,3863
313790,202111,589,1651,520,1527,67,204,310,883,377,1087
313800,202111,1485,3198,1084,2649,88,233,608,1419,696,1652
313810,202111,1787,4281,1449,3808,46,149,1154,2948,1200,3097
313820,202111,19001,47255,12025,32603,1983,5480,3084,8013,5067,13493
313830,202111,415,1179,296,913,53,189,107,297,160,486
313835,202111,949,2673,787,2390,63,227,438,1247,501,1474
313840,202111,8234,20835,6426,17884,1347,4025,1474,4179,2821,8204
313850,202111,1039,2468,823,2177,139,422,392,939,531,1361
313860,202111,2841,7219,2146,5964,277,894,1024,2563,1301,3457
313862,202111,1334,2762,660,1794,37,106,309,841,346,947
313865,202111,2756,6994,2267,6222,89,260,1719,4586,1808,4846
313867,202111,1482,4338,1236,3893,239,735,618,2023,857,2758
313868,202111,1823,5284,1495,4666,49,177,1144,3454,1193,3631
313870,202111,1094,2739,738,2099,99,291,295,756,394,1047
313880,202111,2036,5110,1502,4198,165,520,791,2022,956,2542
313890,202111,2341,4686,1757,3942,33,83,1363,2976,1396,3059
313900,202111,5144,14037,3676,11026,831,2686,936,2459,1767,5145
313910,202111,762,2154,576,1791,96,314,118,354,214,668
313920,202111,3083,8899,2562,7839,466,1419,1298,3991,1764,5410
313925,202111,1745,4200,1417,3649,142,355,970,2477,1112,2832
313930,202111,5128,14319,4162,12632,259,858,2814,8379,3073,9237
313940,202111,9823,27292,7353,23086,775,2866,1852,6517,2627,9383
313950,202111,5781,12195,4430,10552,274,779,3035,7239,3309,8018
313960,202111,6133,14224,4104,10852,755,2233,1302,3060,2057,5293
313970,202111,1635,4215,1386,3804,22,63,923,2478,945,2541
313980,202111,1324,3370,883,2700,142,476,368,1058,510,1534
313990,202111,2094,6334,1561,5164,298,1141,668,1966,966,3107
314000,202111,10888,26421,8907,23128,638,2003,5959,15132,6597,17135
314010,202111,1521,3510,1199,3075,37,112,915,2261,952,2373
314015,202111,2183,5766,1708,4958,177,602,989,2735,1166,3337
314020,202111,558,1456,384,1161,88,321,69,230,157,551
314030,202111,851,2348,669,2009,89,258,323,964,412,1222
314040,202111,617,1649,508,1451,73,241,266,727,339,968
314050,202111,2049,5238,1518,4266,130,434,884,2293,1014,2727
314053,202111,2066,5869,1649,5050,306,886,901,2886,1207,3772
314055,202111,2348,5965,1983,5422,39,147,1656,4502,1695,4649
314060,202111,1407,3599,1066,3058,32,99,754,2132,786,2231
314070,202111,5202,13538,4107,11599,723,2030,1964,5426,2687,7456
314080,202111,2268,5666,1578,4509,160,508,722,1877,882,2385
314085,202111,2502,6533,2030,5838,183,505,1235,3599,1418,4104
314090,202111,5300,13316,4568,12257,287,774,3061,8526,3348,9300
314100,202111,3209,7532,2479,6521,43,124,1855,4910,1898,5034
314110,202111,5428,14573,4388,12619,542,1697,2372,6274,2914,7971
314120,202111,755,1717,337,966,59,193,103,268,162,461
314130,202111,701,1818,461,1376,24,81,276,804,300,885
314140,202111,4854,12905,3872,11125,461,1342,2061,5797,2522,7139
314150,202111,1593,3860,1164,3132,75,197,779,2061,854,2258
314160,202111,2487,6120,1830,4959,222,657,843,2253,1065,2910
314170,202111,990,2668,800,2297,38,144,537,1422,575,1566
314180,202111,5902,15520,4735,13681,355,1037,2856,8274,3211,9311
314190,202111,678,1642,507,1396,79,251,271,693,350,944
314200,202111,3173,8556,2625,7649,173,507,1813,5197,1986,5704
314210,202111,2228,5560,1766,4748,251,708,762,1972,1013,2680
314220,202111,1620,4252,1248,3633,212,696,536,1439,748,2135
314225,202111,1166,3271,953,2885,85,233,655,1970,740,2203
314230,202111,910,2273,743,2049,68,201,485,1357,553,1558
314240,202111,1154,3018,893,2619,185,563,361,1063,546,1626
314250,202111,505,1411,318,1002,49,138,120,351,169,489
314260,202111,1156,2895,899,2542,149,470,471,1281,620,1751
314270,202111,3515,9519,2898,8555,73,250,2158,6312,2231,6562
314280,202111,3747,8416,2564,6620,274,784,1502,3638,1776,4422
314290,202111,4788,11873,3997,10487,349,913,2733,7029,3082,7942
314300,202111,2160,5887,1397,4290,263,890,462,1249,725,2139
314310,202111,4130,10559,2773,8223,791,2611,396,992,1187,3603
314315,202111,1036,3169,876,2842,44,161,617,1959,661,2120
314320,202111,3387,8846,2261,6748,380,1243,866,2403,1246,3646
314330,202111,55009,148910,41959,125977,10477,32496,9190,28701,19667,61197
314340,202111,2687,6553,1722,4854,306,1008,456,1105,762,2113
314345,202111,1516,4266,1225,3750,115,333,791,2398,906,2731
314350,202111,874,2329,568,1765,121,393,130,326,251,719
314360,202111,584,1646,380,1221,58,181,115,329,173,510
314370,202111,794,2035,640,1809,58,176,419,1143,477,1319
314380,202111,1207,3186,802,2482,187,657,191,568,378,1225
314390,202111,15565,37823,10584,29041,1535,4615,3895,9393,5430,14008
314400,202111,4220,12199,3262,10320,806,2656,1227,4049,2033,6705
314410,202111,3078,8399,2139,6577,292,1058,615,1916,907,2974
314420,202111,874,2082,644,1716,26,91,445,1125,471,1216
314430,202111,8521,19675,5996,15593,889,2394,2839,7032,3728,9426
314435,202111,2002,5209,1549,4467,182,546,909,2576,1091,3122
314437,202111,958,2352,691,1923,67,195,378,1039,445,1234
314440,202111,658,1835,470,1469,150,525,85,204,235,729
314450,202111,1546,3924,1282,3490,151,421,703,1853,854,2274
314460,202111,3412,9985,2532,8199,594,2040,685,2076,1279,4116
314465,202111,2386,6569,2034,5911,44,140,1596,4517,1640,4657
314467,202111,943,2401,799,2173,19,54,633,1659,652,1713
314470,202111,2460,6759,2029,5906,344,1072,940,2535,1284,3607
314480,202111,8276,22104,6252,17922,947,3019,2578,6505,3525,9524
314490,202111,1149,2889,844,2286,61,173,557,1452,618,1625
314500,202111,1830,4235,1323,3569,357,899,435,1243,792,2142
314505,202111,2259,5217,1845,4646,88,233,1399,3404,1487,3637
314510,202111,2162,5427,1536,4476,327,1056,673,1885,1000,2941
314520,202111,5719,16714,4373,14048,867,3024,739,2105,1606,5129
314530,202111,5745,17403,5141,16299,281,1039,3846,11900,4127,12939
314535,202111,2783,6811,2250,6048,88,285,1771,4738,1859,5023
314537,202111,1235,3368,943,2905,50,153,681,2073,731,2226
314540,202111,445,1070,314,860,20,59,192,499,212,558
314545,202111,2076,4735,1862,4490,30,69,1633,4020,1663,4089
314550,202111,799,1865,570,1514,34,113,340,823,374,936
314560,202111,4968,14110,3642,11235,464,1645,1436,3871,1900,5516
314570,202111,334,909,237,726,32,107,110,340,142,447
314580,202111,487,1422,386,1219,98,300,136,432,234,732
314585,202111,693,2056,532,1705,59,219,246,751,305,970
314587,202111,2342,6008,1811,5171,382,1015,970,2814,1352,3829
314590,202111,4511,11687,3380,9638,404,1286,1611,4185,2015,5471
314600,202111,2037,5345,1242,3855,245,789,138,396,383,1185
314610,202111,9785,23492,7177,19669,972,3137,3414,9481,4386,12618
314620,202111,2434,5460,1952,4852,48,142,1646,4072,1694,4214
314625,202111,1628,4257,1397,3936,20,108,1206,3334,1226,3442
314630,202111,5716,13760,4654,12320,114,425,3844,10093,3958,10518
314640,202111,768,1725,570,1415,55,155,362,826,417,981
314650,202111,880,1990,564,1494,51,161,331,774,382,935
314655,202111,1649,4394,1184,3585,179,512,578,1790,757,2302
314660,202111,352,782,242,593,12,27,160,377,172,404
314670,202111,1768,3841,1227,3081,26,76,849,2069,875,2145
314675,202111,1801,4508,1525,4061,70,200,1197,3121,1267,3321
314690,202111,2165,5762,1631,4963,385,1268,582,1770,967,3038
314700,202111,12014,31742,8124,24468,1359,4409,3173,9107,4532,13516
314710,202111,8715,23652,6387,18780,922,2986,2452,6265,3374,9251
314720,202111,2366,6841,1657,5366,296,1023,364,1075,660,2098
314730,202111,2588,6514,1838,5179,297,891,662,1705,959,2596
314740,202111,3272,8889,2568,7644,352,1046,1300,3792,1652,4838
314750,202111,300,798,230,656,27,82,134,336,161,418
314760,202111,2052,5857,1322,4239,227,817,322,799,549,1616
314770,202111,1127,3170,644,1999,66,207,201,574,267,781
314780,202111,382,925,263,736,36,119,148,367,184,486
314790,202111,12809,32867,9114,26117,1550,5019,3730,9878,5280,14897
314795,202111,1630,4129,1382,3711,27,112,1119,2882,1146,2994
314800,202111,11844,29353,7606,21661,1278,3923,2179,5465,3457,9388
314810,202111,10038,25626,7359,21038,1872,5623,2377,6670,4249,12293
314820,202111,1382,3191,1077,2733,64,205,696,1671,760,1876
314830,202111,1803,5047,1502,4512,175,545,807,2368,982,2913
314840,202111,917,2756,716,2398,44,197,506,1611,550,1808
314850,202111,2404,5116,1948,4553,42,122,1702,3948,1744,4070
314860,202111,3484,9642,2922,8645,147,567,2106,6026,2253,6593
314870,202111,6946,15899,5282,13826,206,523,4004,10652,4210,11175
314875,202111,1981,5668,1751,5358,239,598,1297,4153,1536,4751
314880,202111,886,2093,685,1784,41,119,427,1090,468,1209
314890,202111,474,1367,365,1143,56,191,165,476,221,667
314900,202111,886,2203,677,1845,85,252,314,819,399,1071
314910,202111,1802,4900,1331,4133,203,739,655,1878,858,2617
314915,202111,2258,6440,1884,5768,129,384,1230,3716,1359,4100
314920,202111,538,1349,366,1098,21,53,241,742,262,795
314930,202111,6140,16712,4696,13995,731,2440,1970,5339,2701,7779
314940,202111,441,1025,369,911,38,90,239,567,277,657
314950,202111,604,1474,419,1187,30,103,228,589,258,692
314960,202111,925,2080,717,1751,24,70,534,1235,558,1305
314970,202111,1104,3181,849,2670,133,446,381,1103,514,1549
314980,202111,1759,4346,1348,3741,201,629,728,1947,929,2576
314990,202111,2792,7869,2002,6090,385,1200,448,1238,833,2438
314995,202111,1768,4735,1409,4100,24,90,966,2640,990,2730
315000,202111,1190,2946,858,2436,74,210,537,1493,611,1703
315010,202111,414,1085,323,937,48,167,167,456,215,623
315015,202111,2509,6708,2170,6136,213,710,1435,3939,1648,4649
315020,202111,823,2351,585,1828,57,217,276,800,333,1017
315030,202111,669,1712,460,1339,106,326,98,243,204,569
315040,202111,1002,2556,829,2264,96,297,548,1415,644,1712
315050,202111,1302,3201,968,2679,55,199,538,1405,593,1604
315053,202111,1260,3131,940,2591,59,165,560,1475,619,1640
315057,202111,1914,5413,1538,4793,137,371,1011,3321,1148,3692
315060,202111,638,1853,468,1514,97,316,115,357,212,673
315070,202111,626,1560,459,1277,108,314,154,399,262,713
315080,202111,3418,8925,2643,7542,130,403,1872,5075,2002,5478
315090,202111,853,2500,639,2100,81,288,268,836,349,1124
315100,202111,1456,4138,971,3040,129,472,441,1206,570,1678
315110,202111,2239,5117,1631,4218,137,338,877,2288,1014,2626
315120,202111,13635,30434,10117,25257,1212,2695,5743,14834,6955,17529
315130,202111,1784,4748,1500,4264,148,486,655,1726,803,2212
315140,202111,3164,8499,2491,7312,462,1515,1229,3357,1691,4872
315150,202111,4661,11045,3336,8952,451,1420,1601,4195,2052,5615
315160,202111,1983,4730,1335,3701,260,753,617,1676,877,2429
315170,202111,1449,4453,1026,3444,201,735,278,877,479,1612
315180,202111,18761,44430,10786,29982,1324,4097,3816,9253,5140,13350
315190,202111,2344,5012,1839,4360,263,609,1255,3041,1518,3650
315200,202111,4416,11931,3288,10000,853,2804,833,2482,1686,5286
315210,202111,9577,23819,6714,18037,689,2015,3442,8304,4131,10319
315213,202111,1159,2996,1004,2777,21,74,831,2247,852,2321
315217,202111,2976,8216,2258,7019,75,294,1541,4598,1616,4892
315220,202111,9048,23806,7157,20591,818,2341,3644,10576,4462,12917
315230,202111,3197,7095,2654,6363,188,311,1877,4816,2065,5127
315240,202111,2569,7194,2133,6446,454,1424,985,2989,1439,4413
315250,202111,15021,39237,10979,31694,1655,5087,4664,12733,6319,17820
315260,202111,967,2570,551,1721,86,261,41,112,127,373
315270,202111,936,2619,690,2150,90,301,248,674,338,975
315280,202111,3120,7620,1980,5624,484,1460,376,1047,860,2507
315290,202111,1247,2978,739,2176,176,577,223,637,399,1214
315300,202111,705,1715,513,1436,46,141,325,904,371,1045
315310,202111,1333,3493,1014,2919,63,205,627,1665,690,1870
315320,202111,680,1939,481,1551,60,215,195,584,255,799
315330,202111,832,2616,480,1717,66,259,166,528,232,787
315340,202111,3185,7506,2212,6036,389,1081,1013,2728,1402,3809
315350,202111,1764,4541,1442,4046,136,452,947,2577,1083,3029
315360,202111,1876,5286,1447,4416,198,643,635,1786,833,2429
315370,202111,590,1577,478,1369,75,205,230,645,305,850
315380,202111,278,758,196,588,32,107,25,59,57,166
315390,202111,1271,3451,1023,3006,119,415,562,1510,681,1925
315400,202111,4395,11354,3487,9762,367,1102,2093,5531,2460,6633
315410,202111,2638,5795,1952,4803,369,1006,411,1044,780,2050
315415,202111,1512,3976,1219,3520,254,856,426,1213,680,2069
315420,202111,1600,4305,1109,3399,193,622,247,708,440,1330
315430,202111,3887,9186,2742,7485,445,1392,1256,3242,1701,4634
315440,202111,1111,2838,874,2455,74,232,514,1353,588,1585
315445,202111,2097,4790,1545,4007,78,240,1189,3025,1267,3265
315450,202111,2474,6466,2014,5716,257,630,1242,3568,1499,4198
315460,202111,43573,114711,36106,101657,4317,13929,21524,56458,25841,70387
315470,202111,723,1938,504,1425,45,132,274,737,319,869
315480,202111,1238,3429,881,2690,148,473,319,919,467,1392
315490,202111,3096,7528,2185,6084,267,757,891,2309,1158,3066
315500,202111,564,1461,358,1023,42,146,189,470,231,616
315510,202111,1369,3403,1153,3106,9,34,1024,2702,1033,2736
315520,202111,1105,2819,916,2525,47,131,723,1941,770,2072
315530,202111,684,1801,555,1579,96,300,329,888,425,1188
315540,202111,1759,4512,1192,3438,94,311,519,1408,613,1719
315550,202111,1963,5101,1298,3869,235,802,365,1075,600,1877
315560,202111,6798,19483,5810,17737,321,910,4039,12423,4360,13333
315570,202111,2274,5794,1810,5019,212,653,927,2392,1139,3045
315580,202111,3367,7630,2623,6468,404,1061,989,2287,1393,3348
315590,202111,1012,2428,799,2110,48,149,536,1326,584,1475
315600,202111,2690,7908,1887,6336,351,1064,861,3138,1212,4202
315610,202111,1062,2586,796,2121,109,354,375,867,484,1221
315620,202111,556,1431,425,1231,45,137,222,651,267,788
315630,202111,1132,2907,854,2393,124,382,410,1043,534,1425
315640,202111,379,917,284,798,27,98,179,477,206,575
315645,202111,1041,2595,726,2096,150,472,192,519,342,991
315650,202111,1813,4145,1466,3661,40,109,1182,2873,1222,2982
315660,202111,2420,5939,1845,4927,113,313,1280,3306,1393,3619
315670,202111,15359,40215,11764,33738,2096,6351,5476,14802,7572,21153
315680,202111,3398,9295,2543,7722,295,1025,1380,3968,1675,4993
315690,202111,3908,9290,2413,6777,496,1381,607,1848,1103,3229
315700,202111,9031,23726,6819,19452,954,2860,3184,8566,4138,11426
315710,202111,1997,4712,1436,3877,59,174,1004,2637,1063,2811
315720,202111,4687,12540,3864,11083,169,633,2758,7568,2927,8201
315725,202111,2382,5925,1833,5048,219,562,1121,3230,1340,3792
315727,202111,611,1514,465,1275,62,201,209,537,271,738
315730,202111,651,1901,562,1731,92,315,203,553,295,868
315733,202111,1438,3520,1070,2912,167,502,413,1039,580,1541
315737,202111,1241,3336,970,2808,30,98,691,1923,721,2021
315740,202111,848,2320,682,1988,66,213,449,1229,515,1442
315750,202111,1341,3378,1071,2960,92,255,681,1902,773,2157
315760,202111,1234,2823,1070,2603,46,139,889,2103,935,2242
315765,202111,2075,5168,1697,4678,30,104,1516,4175,1546,4279
315770,202111,1073,2869,837,2542,323,1084,166,451,489,1535
315780,202111,33096,86863,27620,77068,1500,4941,18989,50230,20489,55171
315790,202111,3764,11233,3200,10193,435,1411,1829,6018,2264,7429
315800,202111,1400,4525,1051,3699,138,532,393,1193,531,1725
315810,202111,1421,3378,1179,2973,61,156,922,2265,983,2421
315820,202111,2873,7169,2294,6372,242,629,1567,4423,1809,5052
315830,202111,1291,3708,866,2762,87,289,277,746,364,1035
315840,202111,948,2207,675,1737,50,160,372,856,422,1016
315850,202111,1280,3549,1006,3082,172,528,513,1501,685,2029
315860,202111,537,1458,378,1182,62,207,133,358,195,565
315870,202111,498,1315,390,1132,22,68,281,790,303,858
315880,202111,1187,2906,839,2297,104,299,281,712,385,1011
315890,202111,1842,5005,1498,4535,392,1279,711,2163,1103,3442
315895,202111,6815,17777,5094,14443,485,1514,2645,6950,3130,8464
315900,202111,838,2128,718,1957,71,204,516,1365,587,1569
315910,202111,560,1484,472,1353,72,199,314,900,386,1099
315920,202111,1507,3738,869,2542,130,457,289,752,419,1209
315930,202111,1202,2573,811,2010,140,325,348,866,488,1191
315935,202111,1007,2924,800,2523,157,486,284,896,441,1382
315940,202111,657,1701,518,1501,69,208,270,756,339,964
315950,202111,1234,3298,1024,2963,107,308,762,2198,869,2506
315960,202111,5996,16219,4135,12513,1028,3436,704,1526,1732,4962
315970,202111,605,1570,485,1409,59,177,315,934,374,1111
315980,202111,4527,9475,2539,6302,454,1165,1009,2278,1463,3443
315990,202111,3737,9371,2923,7970,354,988,1584,4171,1938,5159
316000,202111,723,1678,559,1443,52,163,320,774,372,937
316010,202111,826,2227,612,1841,59,184,290,773,349,957
316020,202111,993,2821,793,2432,110,359,441,1271,551,1630
316030,202111,2923,7837,2247,6624,278,789,1399,4250,1677,5039
316040,202111,2821,7786,2067,6356,335,1175,569,1514,904,2689
316045,202111,2251,5464,2074,5248,91,152,1819,4721,1910,4873
316050,202111,419,1131,323,969,48,125,171,483,219,608
316060,202111,743,1749,549,1492,17,69,402,1039,419,1108
316070,202111,5839,15547,4759,13525,828,2333,2225,6158,3053,8491
316080,202111,816,2468,643,2115,164,577,101,281,265,858
316090,202111,458,1234,361,1050,46,141,187,477,233,618
316095,202111,1374,4105,1068,3350,263,884,393,1151,656,2035
316100,202111,2599,7273,1894,5820,317,1071,713,1960,1030,3031
316105,202111,884,2232,716,1967,39,132,488,1378,527,1510
316110,202111,14719,40127,12282,36092,792,2543,8600,24844,9392,27387
316120,202111,1314,3534,866,2532,133,402,298,694,431,1096
316130,202111,1331,2930,887,2202,75,215,541,1282,616,1497
316140,202111,1306,3370,827,2467,104,327,354,1049,458,1376
316150,202111,2257,4879,1810,4258,195,558,866,1916,1061,2474
316160,202111,1078,2783,867,2404,37,122,625,1682,662,1804
316165,202111,937,2188,742,1895,112,330,439,1051,551,1381
316170,202111,1344,3160,1029,2697,48,155,736,1820,784,1975
316180,202111,1585,4338,1104,3393,170,575,278,764,448,1339
316190,202111,2873,7908,1703,5134,245,785,684,1818,929,2603
316200,202111,3617,9978,2817,8608,537,1708,992,2971,1529,4679
316210,202111,5178,14798,3629,11176,1130,3884,225,519,1355,4403
316220,202111,705,2073,481,1608,83,315,64,251,147,566
316225,202111,1668,3700,1260,3067,44,159,965,2175,1009,2334
316230,202111,489,1275,377,1086,53,163,187,524,240,687
316240,202111,5918,16509,5159,15154,390,1192,3830,11097,4220,12289
316245,202111,3395,10277,3071,9736,103,534,2472,7499,2575,8033
316250,202111,11622,27017,8615,22233,1683,4655,3198,8149,4881,12804
316255,202111,3145,8422,2721,7757,164,417,1995,5817,2159,6234
316257,202111,1510,3473,1099,2785,86,237,728,1747,814,1984
316260,202111,2446,5721,1945,4939,223,529,1084,2789,1307,3318
316265,202111,1183,3111,928,2672,13,47,708,1981,721,2028
316270,202111,3952,11645,3388,10457,494,1600,1754,5150,2248,6750
316280,202111,3183,8476,2694,7579,330,1007,1503,4070,1833,5077
316290,202111,3872,10319,3124,8914,395,1207,1166,3197,1561,4404
316292,202111,6001,15127,4779,13168,628,1758,3000,8025,3628,9783
316294,202111,934,2655,709,2279,105,408,197,566,302,974
316295,202111,3603,9784,2934,8638,153,536,2052,5755,2205,6291
316300,202111,1081,2938,856,2585,32,97,602,1804,634,1901
316310,202111,843,2200,571,1719,134,448,125,317,259,765
316320,202111,729,1970,568,1717,67,222,237,705,304,927
316330,202111,1142,2857,873,2409,53,157,670,1810,723,1967
316340,202111,1048,2748,784,2275,87,307,437,1196,524,1503
316350,202111,1418,3795,1175,3382,164,469,732,2079,896,2548
316360,202111,681,1736,570,1555,49,133,438,1205,487,1338
316370,202111,6056,14909,4663,12515,585,1780,2328,5588,2913,7368
316380,202111,1819,4255,1439,3711,63,124,998,2586,1061,2710
316390,202111,806,2141,582,1751,245,834,80,205,325,1039
316400,202111,1279,3509,841,2635,105,348,295,818,400,1166
316410,202111,1212,3183,1012,2885,49,157,836,2316,885,2473
316420,202111,2081,5496,1812,5148,34,113,1496,4157,1530,4270
316430,202111,931,2334,645,1862,101,340,274,699,375,1039
316440,202111,915,2720,728,2377,122,457,190,547,312,1004
316443,202111,600,1618,443,1324,92,303,107,306,199,609
316447,202111,2199,5595,1906,5142,25,76,1664,4442,1689,4518
316450,202111,2271,6512,1734,5397,252,831,1002,3006,1254,3837
316460,202111,1336,3327,1086,2937,115,345,715,1827,830,2172
316470,202111,7642,21154,5589,16906,805,2742,2313,6266,3118,9008
316480,202111,211,555,183,520,44,129,89,244,133,373
316490,202111,347,918,246,733,39,123,81,199,120,322
316500,202111,1310,3916,886,2923,183,666,196,576,379,1242
316510,202111,838,2633,665,2289,111,389,338,1165,449,1554
316520,202111,1447,3408,1126,2882,143,434,573,1314,716,1748
316530,202111,1213,3085,886,2500,94,327,445,1131,539,1458
316540,202111,1034,2536,842,2254,93,264,476,1170,569,1434
316550,202111,1467,4061,1244,3661,32,120,988,2875,1020,2995
316553,202111,4825,13635,3502,10555,438,1436,1486,3916,1924,5352
316555,202111,2805,8191,2504,7782,77,248,2116,6579,2193,6827
316556,202111,558,1328,428,1096,27,72,267,611,294,683
316557,202111,1175,3440,1010,3184,333,1152,358,1065,691,2217
316560,202111,367,998,269,852,44,152,115,345,159,497
316570,202111,1478,4035,1230,3605,295,849,401,1254,696,2103
316580,202111,420,865,267,622,39,95,137,300,176,395
316590,202111,1422,3503,988,2681,186,429,500,1331,686,1760
316600,202111,995,2917,851,2637,130,418,462,1423,592,1841
316610,202111,633,1886,523,1716,50,183,312,999,362,1182
316620,202111,2327,5746,2032,5322,98,262,1631,4255,1729,4517
316630,202111,1649,4770,1368,4249,373,1172,501,1740,874,2912
316640,202111,165,442,134,395,24,86,53,123,77,209
316650,202111,1137,3340,919,3002,82,281,595,1926,677,2207
316660,202111,203,471,90,244,12,37,23,41,35,78
316670,202111,1852,4540,1405,3839,362,1027,427,1137,789,2164
316680,202111,2445,6114,1820,4943,121,361,1305,3417,1426,3778
316690,202111,1502,4093,1134,3429,187,616,486,1411,673,2027
316695,202111,1066,3009,885,2686,31,106,603,1808,634,1914
316700,202111,431,930,354,843,13,36,292,678,305,714
316710,202111,3469,10662,2728,9152,418,1535,1310,4232,1728,5767
316720,202111,22451,59144,16804,48503,2687,8265,7566,20401,10253,28666
316730,202111,528,1305,426,1128,51,139,218,540,269,679
316740,202111,831,2300,719,2123,91,299,454,1344,545,1643
316750,202111,433,1206,331,1022,68,218,135,396,203,614
316760,202111,3771,11490,3191,10383,1133,4045,946,2963,2079,7008
316770,202111,1712,3689,1301,3148,34,77,1051,2603,1085,2680
316780,202111,589,1671,464,1433,169,555,93,266,262,821
316790,202111,804,2116,595,1701,90,288,168,444,258,732
316800,202111,6888,18647,5495,16132,688,2126,2585,7409,3273,9535
316805,202111,1165,2412,940,2162,52,139,757,1721,809,1860
316810,202111,674,1799,495,1467,66,213,303,866,369,1079
316820,202111,346,803,192,532,17,63,91,237,108,300
316830,202111,885,2203,694,1901,73,194,426,1167,499,1361
316840,202111,3017,7407,2409,6415,173,557,1758,4465,1931,5022
316850,202111,2159,5341,1606,4402,202,633,838,2115,1040,2748
316860,202111,21906,53839,16155,45143,2315,7500,7661,20500,9976,28000
316870,202111,8844,22917,6668,18828,855,2659,3264,8515,4119,11174
316880,202111,1055,2718,871,2450,136,432,472,1262,608,1694
316890,202111,1228,2705,747,2072,86,307,481,1255,567,1562
316900,202111,2543,6555,2019,5559,407,1159,686,1792,1093,2951
316905,202111,522,1519,419,1315,104,356,176,558,280,914
316910,202111,973,2439,613,1817,131,424,85,224,216,648
316920,202111,1928,4526,1384,3729,188,558,768,1976,956,2534
316930,202111,8960,24511,6852,20800,1507,4808,2144,6045,3651,10853
316935,202111,4518,11722,3340,9563,558,1777,1392,3630,1950,5407
316940,202111,6842,19409,5338,16378,750,2482,2361,6714,3111,9196
316950,202111,2052,4616,1595,3994,44,123,1342,3319,1386,3442
316960,202111,5483,11924,3968,9897,360,973,2737,6674,3097,7647
316970,202111,4207,11173,3610,10121,526,1474,1603,4241,2129,5715
316980,202111,756,2196,583,1871,163,592,102,320,265,912
316990,202111,13429,34846,9999,28012,2227,6720,1739,4432,3966,11152
317000,202111,2559,7306,2244,6865,191,442,1654,5176,1845,5618
317005,202111,2759,7390,2181,6237,336,1002,1164,3234,1500,4236
317010,202111,26301,60515,16774,45912,2975,9046,6901,18816,9876,27862
317020,202111,68869,161077,41845,114318,7428,21991,14082,35223,21510,57214
317030,202111,722,1845,571,1637,13,46,440,1238,453,1284
317040,202111,11916,29114,8374,23112,1815,5313,2833,8101,4648,13414
317043,202111,962,2058,695,1693,50,128,513,1218,563,1346
317047,202111,1231,2896,852,2290,58,165,559,1448,617,1613
317050,202111,1294,3862,930,3023,122,439,373,1028,495,1467
317052,202111,2578,6791,2074,6009,246,699,1339,3871,1585,4570
317057,202111,2130,4656,1577,3822,22,74,1165,2736,1187,2810
317060,202111,563,1455,349,1019,43,134,151,394,194,528
317065,202111,1206,3449,990,3034,65,178,621,1813,686,1991
317070,202111,7867,21413,5767,17362,914,3056,2052,5701,2966,8757
317075,202111,1042,2603,789,2176,92,288,419,1068,511,1356
317080,202111,6777,15284,5047,12556,1236,3313,1854,4476,3090,7789
317090,202111,5123,14085,4524,13138,343,860,3323,9757,3666,10617
317100,202111,2759,6402,1813,4871,404,1110,662,1760,1066,2870
317103,202111,2411,5969,2057,5476,62,264,1668,4274,1730,4538
317107,202111,1586,4017,1207,3331,63,189,760,1895,823,2084
317110,202111,698,1607,370,1088,70,243,117,341,187,584
317115,202111,1158,3208,976,2876,86,254,624,1833,710,2087
317120,202111,18396,47262,15097,41919,1065,3509,9956,26147,11021,29656
317130,202111,12395,28021,8216,21203,1208,3422,3008,7635,4216,11057
317140,202111,1002,2306,788,1979,50,137,544,1386,594,1523
317150,202111,1039,2427,801,2128,31,89,643,1674,674,1763
317160,202111,3831,8846,2553,6842,129,352,1390,3857,1519,4209
317170,202111,2019,4924,1508,4019,161,492,831,1969,992,2461
317180,202111,2101,6261,1539,4942,297,962,395,1138,692,2100
317190,202111,1245,3290,922,2760,202,604,413,1222,615,1826
317200,202111,6601,16912,4908,13582,964,2836,1317,3293,2281,6129
317210,202111,1283,3003,990,2602,33,119,723,1918,756,2037
317220,202111,306,884,262,800,50,160,130,390,180,550
320010,202111,5028,14205,3904,11917,432,1449,2342,6891,2774,8340
320013,202111,2253,5898,1567,4568,236,696,695,2137,931,2833
320016,202111,3147,7822,2471,6786,206,531,1753,4851,1959,5382
320020,202111,4476,11287,3321,9294,594,1850,1355,3826,1949,5676
320030,202111,1862,5026,1199,3708,205,684,415,1207,620,1891
320035,202111,2086,5433,1710,4805,378,1197,831,2212,1209,3409
320040,202111,4714,12927,3920,11493,544,1657,2169,6089,2713,7746
320050,202111,1839,4133,1579,3750,197,543,928,2129,1125,2672
320060,202111,15027,39617,11133,31738,1743,5309,5067,13280,6810,18589
320070,202111,1834,4857,1313,3832,191,629,541,1412,732,2041
320080,202111,6108,15271,4282,11637,839,2380,1586,4032,2425,6412
320090,202111,9229,23790,6106,17446,1353,4113,2169,5693,3522,9806
320100,202111,3433,8946,2797,7847,424,1264,1483,4139,1907,5403
320110,202111,2315,5250,1623,4166,206,556,878,2136,1084,2692
320115,202111,2286,6875,1960,6334,812,2752,585,1994,1397,4746
320120,202111,27107,67001,19134,52769,2576,7600,9203,23737,11779,31337
320130,202111,55785,147205,45727,129037,5380,16461,27371,74146,32751,90607
320140,202111,4035,10741,2755,8218,385,1322,1182,3379,1567,4701
320150,202111,15564,39019,11111,30730,2606,7937,1501,3624,4107,11561
320160,202111,6935,18541,5119,15109,778,2471,2245,6453,3023,8924
320170,202111,1924,5353,1370,4247,372,1137,471,1579,843,2716
320180,202111,757,2325,602,2023,193,707,146,433,339,1140
320190,202111,3180,9821,2453,8225,587,2137,555,1668,1142,3805
320200,202111,1431,3789,976,2971,216,727,285,842,501,1569
320210,202111,4814,11956,3689,10041,592,1734,1867,4776,2459,6510
320220,202111,3610,9029,2791,7690,396,1161,1506,3907,1902,5068
320225,202111,1506,4519,1041,3440,354,1253,209,670,563,1923
320230,202111,5747,15154,4343,12786,943,2960,1483,4294,2426,7254
320240,202111,18522,45423,13794,37871,3401,10133,3869,10464,7270,20597
320245,202111,3413,9710,2581,7981,824,2715,388,1145,1212,3860
320250,202111,2892,7555,1953,5437,425,1350,680,1596,1105,2946
320255,202111,2125,6338,1830,5797,485,1632,809,2580,1294,4212
320260,202111,1568,4283,968,2977,191,645,244,617,435,1262
320265,202111,2582,7748,2050,6665,829,2926,265,816,1094,3742
320270,202111,2426,6746,1868,5622,463,1512,597,1787,1060,3299
320280,202111,8318,21205,6754,18569,1439,4083,3346,8927,4785,13010
320290,202111,1476,4259,943,3008,226,787,220,643,446,1430
320300,202111,4432,12634,3524,10805,904,3067,1123,3216,2027,6283
320305,202111,5681,15425,4329,12764,798,2521,1990,5669,2788,8190
320310,202111,2453,6467,1704,4922,302,951,735,1986,1037,2937
320313,202111,2707,6485,1840,4909,354,1035,516,1185,870,2220
320316,202111,1753,4706,1334,3996,226,685,685,2050,911,2735
320320,202111,24536,62150,17374,49675,4069,12036,5914,16926,9983,28962
320330,202111,3114,8184,2406,6923,408,1229,1255,3621,1663,4850
320332,202111,9037,23484,7149,19967,1491,4533,3109,8321,4600,12854
320334,202111,1971,5392,1347,4094,261,944,314,709,575,1653
320335,202111,1714,4854,1193,3653,226,809,332,922,558,1731
320340,202111,5474,13057,4528,11679,543,1476,2620,6806,3163,8282
320350,202111,5869,13943,4142,10901,432,1268,2274,5549,2706,6817
320360,202111,1533,3829,1135,3091,139,370,541,1425,680,1795
320370,202111,2838,8372,2077,6742,611,2128,599,1881,1210,4009
320380,202111,2971,7535,2453,6698,292,881,1488,3910,1780,4791
320390,202111,8242,21263,6008,16838,1219,3666,2316,6044,3535,9710
320400,202111,3591,9815,2645,7799,724,2290,794,2184,1518,4474
320405,202111,5727,14344,4329,11882,602,1775,2276,6006,2878,7781
320410,202111,5220,13072,3922,10965,735,1995,1835,5364,2570,7359
320420,202111,3855,9496,2935,7965,595,1793,965,2459,1560,4252
320425,202111,2358,5511,1799,4566,159,402,1094,2719,1253,3121
320430,202111,3516,8614,2779,7318,415,1156,1620,4079,2035,5235
320435,202111,2406,7278,1862,6129,621,2206,569,1857,1190,4063
320440,202111,1685,4535,1251,3705,214,666,529,1475,743,2141
320450,202111,2030,5566,1577,4718,291,1007,729,2004,1020,3011
320455,202111,4873,14328,3248,10513,736,2610,792,2235,1528,4845
320460,202111,2312,6579,1663,5225,407,1400,428,1223,835,2623
320465,202111,1539,4145,1135,3378,218,648,542,1631,760,2279
320470,202111,4076,10775,2971,8499,570,1763,847,2190,1417,3953
320480,202111,2187,5431,1777,4743,193,570,1158,2970,1351,3540
320490,202111,26240,64399,19683,53083,3265,9122,8586,22914,11851,32036
320495,202111,1514,4029,1095,3202,267,901,282,738,549,1639
320500,202111,58657,151304,46965,131334,6099,18540,27691,73659,33790,92199
320501,202111,5162,14539,3865,12160,1056,3709,1072,3293,2128,7002
320503,202111,2518,7046,1607,5144,474,1620,359,1111,833,2731
320506,202111,2952,8638,2164,6893,635,2167,177,566,812,2733
320510,202111,12202,31552,9907,27680,1015,3188,6178,16413,7193,19601
320515,202111,1936,5218,1502,4330,389,1246,480,1296,869,2542
320517,202111,2359,6839,1886,5835,557,1865,588,1764,1145,3629
320520,202111,43100,107644,32231,89197,4977,15179,14201,37243,19178,52422
320530,202111,37424,94842,29525,80962,2391,7606,18775,48181,21166,55787
330010,202111,26527,66159,22077,59000,2281,6748,15472,39841,17753,46589
330015,202111,1539,3636,1218,3178,204,594,694,1724,898,2318
330020,202111,21389,51860,17987,46981,2492,7032,12336,31643,14828,38675
330022,202111,2098,5460,1649,4730,268,766,843,2430,1111,3196
330023,202111,6179,13944,4742,11981,631,1760,2978,7268,3609,9028
330025,202111,7788,17308,4823,12502,953,2738,1358,3217,2311,5955
330030,202111,11271,28960,8694,24876,751,2529,5620,15232,6371,17761
330040,202111,16934,42351,13687,36995,923,2879,9687,24969,10610,27848
330045,202111,95367,214790,79156,194413,5845,13911,63577,155229,69422,169140
330050,202111,3051,7673,2327,6480,410,1251,1240,3236,1650,4487
330060,202111,6012,14967,4709,12689,860,2567,1985,4839,2845,7406
330070,202111,26795,63978,21885,57055,2974,8355,13683,35095,16657,43450
330080,202111,9909,23616,8443,21574,1014,2744,5750,14447,6764,17191
330090,202111,3635,7405,2585,5980,147,359,1853,4263,2000,4622
330093,202111,2996,6929,2258,5931,133,365,1723,4464,1856,4829
330095,202111,1542,4084,1195,3456,130,382,677,1839,807,2221
330100,202111,78694,197967,67532,181775,3367,10636,53009,140031,56376,150667
330110,202111,2259,6052,1813,5329,249,781,1091,3099,1340,3880
330115,202111,2915,6730,2070,5414,310,882,1099,2760,1409,3642
330120,202111,3899,8163,2975,7006,200,542,2220,4992,2420,5534
330130,202111,4714,12231,3864,10977,478,1396,2485,6982,2963,8378
330140,202111,4220,10280,3395,9137,353,1098,2379,6170,2732,7268
330150,202111,2611,6586,2056,5715,353,994,1049,2823,1402,3817
330160,202111,1512,3956,1133,3283,234,695,570,1581,804,2276
330170,202111,129134,302272,105231,270236,14377,36007,71454,185121,85831,221128
330180,202111,2176,4970,1690,4310,88,258,1221,3014,1309,3272
330185,202111,11360,26788,9529,24292,479,1470,7820,19410,8299,20880
330187,202111,5342,12658,4237,10880,649,1692,2494,6317,3143,8009
330190,202111,41184,93120,35072,84785,2061,5371,28388,67446,30449,72817
330200,202111,18148,43752,14851,39673,2786,6936,9370,25861,12156,32797
330205,202111,2436,5786,1844,4829,133,372,1254,3149,1387,3521
330210,202111,3643,8617,2697,7020,345,927,1403,3466,1748,4393
330220,202111,14057,33269,10141,26796,1807,5349,4146,10045,5953,15394
330225,202111,4291,10361,3282,8849,197,631,2378,6253,2575,6884
330227,202111,19122,43932,16066,40220,706,1712,13733,34101,14439,35813
330230,202111,2291,4922,1516,3930,147,410,821,2104,968,2514
330240,202111,26762,65949,22402,59355,2031,6128,16122,41350,18153,47478
330245,202111,1882,4490,1151,3230,240,648,413,1161,653,1809
330250,202111,44162,106676,36555,95513,5372,14536,23516,60581,28888,75117
330260,202111,5569,12690,4258,10917,293,886,3240,7992,3533,8878
330270,202111,35939,79752,22080,56839,3142,8701,9438,22839,12580,31540
330280,202111,2680,6577,2051,5536,216,632,1273,3263,1489,3895
330285,202111,28576,64670,22757,56386,1264,3674,17707,42353,18971,46027
330290,202111,4553,10416,3671,9251,317,952,2746,6608,3063,7560
330300,202111,6339,14262,4694,11965,345,976,3325,8211,3670,9187
330310,202111,2953,6891,2145,5593,167,362,1446,3761,1613,4123
330320,202111,19077,42562,14828,37252,1789,4001,10562,27039,12351,31040
330330,202111,48435,101239,37926,87022,2998,7491,27702,61761,30700,69252
330340,202111,20068,45692,14513,37168,2021,5929,7674,18152,9695,24081
330350,202111,164117,360525,136410,326971,7488,18597,114782,272390,122270,290987
330360,202111,7967,18624,6814,17227,263,596,5746,14530,6009,15126
330370,202111,5543,15073,4285,12971,990,2963,1799,5634,2789,8597
330380,202111,6371,15906,4882,13338,599,1989,2880,7368,3479,9357
330385,202111,4426,11988,3622,10837,725,2401,1872,5405,2597,7806
330390,202111,30455,77511,23577,66119,2859,9207,14503,38070,17362,47277
330395,202111,3542,8294,2879,7462,148,450,2179,5488,2327,5938
330400,202111,3778,9470,3222,8605,148,515,2473,6217,2621,6732
330410,202111,3751,9321,2709,7560,491,1494,1304,3388,1795,4882
330411,202111,3102,8113,2421,6888,157,518,1693,4586,1850,5104
330412,202111,1798,4809,1473,4273,130,417,979,2689,1109,3106
330414,202111,26224,63280,21433,56744,1430,4042,16448,42697,17878,46739
330415,202111,5301,13599,3939,11209,416,1218,2238,6162,2654,7380
330420,202111,13898,33185,10055,27009,1034,3148,5676,14102,6710,17250
330430,202111,10757,24434,9086,22194,279,850,7459,17678,7738,18528
330440,202111,3111,7766,2376,6543,280,894,1491,3916,1771,4810
330450,202111,1568,4222,1248,3681,145,447,714,2048,859,2495
330452,202111,19871,48197,15879,42051,1756,5218,10535,26829,12291,32047
330455,202111,637669,1439899,503822,1250873,62399,164282,339343,822432,401742,986714
330460,202111,1265,3287,958,2852,169,529,504,1463,673,1992
330470,202111,5973,14055,4300,11496,1176,3254,1304,3514,2480,6768
330475,202111,10659,25984,8618,23365,1206,3798,5627,14703,6833,18501
330480,202111,6418,15949,5384,14440,444,1259,3736,9705,4180,10964
330490,202111,123990,274353,100770,243180,11009,27215,71979,171570,82988,198785
330500,202111,8598,20024,7157,18096,636,1779,5250,12975,5886,14754
330510,202111,46062,108583,34695,92690,4971,14332,22054,57689,27025,72021
330513,202111,1413,3430,1155,3096,217,596,641,1766,858,2362
330515,202111,2775,7137,2245,6390,361,1157,1310,3551,1671,4708
330520,202111,13113,32772,10807,29263,1103,3345,7200,18823,8303,22168
330530,202111,1844,4303,1351,3579,245,705,644,1694,889,2399
330540,202111,3151,7948,2424,6724,630,1780,878,2417,1508,4197
330550,202111,11400,26542,8768,23117,1951,5696,4309,11130,6260,16826
330555,202111,20835,41655,17345,37587,721,1671,14628,31905,15349,33576
330560,202111,4463,11206,3584,9772,558,1508,2138,5694,2696,7202
330570,202111,2976,7730,2560,7136,422,1265,1644,4534,2066,5799
330575,202111,6226,15248,5360,13811,337,942,4330,10804,4667,11746
330580,202111,21027,53047,16734,45430,2424,7148,9069,23118,11493,30266
330590,202111,1612,4119,1338,3763,249,697,820,2363,1069,3060
330600,202111,13963,34816,11316,30568,872,2722,7526,19555,8398,22277
330610,202111,10466,26610,8441,23445,798,2436,5640,15277,6438,17713
330615,202111,2298,5974,1821,5328,357,1025,1119,3362,1476,4387
330620,202111,4580,12336,3589,10659,719,2282,1544,4326,2263,6608
330630,202111,28660,68802,22527,59245,1277,3973,16345,41190,17622,45163
350010,202111,2326,6046,1335,3946,271,855,270,608,541,1463
350020,202111,764,1899,443,1292,52,160,145,388,197,548
350030,202111,3844,10301,2944,8773,667,2228,1395,3800,2062,6028
350040,202111,816,2269,471,1531,64,239,144,349,208,588
350050,202111,1547,3685,1036,2817,207,631,365,809,572,1440
350055,202111,989,2537,787,2221,101,305,455,1223,556,1528
350060,202111,259,641,146,407,20,67,59,150,79,217
350070,202111,3514,9084,2317,6914,443,1439,809,2127,1252,3566
350075,202111,664,1854,499,1540,170,554,74,244,244,798
350080,202111,714,1826,483,1423,64,216,203,540,267,756
350090,202111,635,1465,390,1052,70,198,161,401,231,599
350100,202111,2626,6722,1837,5366,109,401,1172,3188,1281,3589
350110,202111,525,1269,368,1002,19,56,227,600,246,656
350115,202111,1305,3658,1056,3153,169,567,537,1435,706,2002
350120,202111,701,1613,397,1078,33,106,214,514,247,620
350130,202111,3473,8976,2716,7566,499,1407,1294,3377,1793,4784
350140,202111,812,2189,573,1745,46,175,304,832,350,1007
350150,202111,564,1654,454,1442,100,314,132,387,232,701
350160,202111,12576,31424,8613,24010,1103,3441,5060,13256,6163,16697
350170,202111,2675,7277,2228,6322,327,1043,1176,2995,1503,4038
350180,202111,1087,2551,607,1687,76,234,252,629,328,863
350190,202111,3231,8999,2185,6657,358,1250,962,2467,1320,3717
350200,202111,491,1344,374,1123,18,56,248,698,266,754
350210,202111,6524,14819,4501,11662,466,1341,2843,6985,3309,8326
350220,202111,3158,8485,2157,6530,439,1369,723,1979,1162,3348
350230,202111,1077,2649,892,2393,165,476,506,1295,671,1771
350240,202111,687,1927,440,1354,95,299,105,277,200,576
350250,202111,3510,9376,2574,7811,648,2089,783,2301,1431,4390
350260,202111,916,2047,592,1522,66,191,352,845,418,1036
350270,202111,4968,12735,3946,10835,530,1625,2166,5451,2696,7076
350275,202111,2679,6979,2138,6167,285,906,1366,3760,1651,4666
350280,202111,20072,44978,12468,32638,1906,5206,5301,13137,7207,18343
350290,202111,3364,9106,2315,6974,413,1338,932,2589,1345,3927
350300,202111,700,1823,525,1499,58,170,305,814,363,984
350310,202111,1029,2810,771,2312,114,393,345,941,459,1334
350315,202111,649,1573,439,1232,28,90,238,606,266,696
350320,202111,17101,42829,12669,35018,2362,7205,5290,13407,7652,20612
350330,202111,15182,36280,11014,28541,1071,3087,7089,17275,8160,20362
350335,202111,408,1120,315,942,40,132,146,411,186,543
350340,202111,1303,3247,807,2339,121,405,351,904,472,1309
350350,202111,792,1924,614,1731,66,213,383,1058,449,1271
350360,202111,1143,3312,877,2772,197,637,317,1004,514,1641
350370,202111,736,1787,523,1377,167,419,167,424,334,843
350380,202111,4869,13069,3503,10231,999,2864,941,2772,1940,5636
350390,202111,11898,30058,9383,25881,1547,4529,4971,13013,6518,17542
350395,202111,464,1150,240,726,25,76,89,240,114,316
350400,202111,8986,21391,6293,17055,1568,4527,1698,4537,3266,9064
350410,202111,11163,30221,8276,24752,1590,5229,3304,9088,4894,14317
350420,202111,923,2394,619,1768,87,261,163,394,250,655
350430,202111,747,1909,591,1677,68,223,358,929,426,1152
350440,202111,2236,5412,1819,4791,142,377,1196,3071,1338,3448
350450,202111,6998,18895,5401,16124,1112,3637,2205,6140,3317,9777
350460,202111,2059,5211,1200,3493,168,514,450,1174,618,1688
350470,202111,277,685,217,582,12,37,157,406,169,443
350480,202111,1066,2551,712,1960,135,419,192,445,327,864
350490,202111,2110,5331,1501,4346,325,987,494,1271,819,2258
350500,202111,694,1832,509,1506,56,183,230,645,286,828
350510,202111,1305,3215,990,2667,103,314,599,1523,702,1837
350520,202111,2429,7019,1899,6024,266,944,846,2406,1112,3350
350530,202111,3186,7881,2403,6382,235,712,1429,3503,1664,4215
350535,202111,1610,4226,1365,3871,192,575,824,2281,1016,2856
350540,202111,2130,4806,1598,4045,171,437,1056,2574,1227,3011
350550,202111,9123,22066,6351,17445,645,2117,3680,9223,4325,11340
350560,202111,4068,11009,3261,9645,261,850,2162,6134,2423,6984
350570,202111,28268,76129,23019,66367,3861,12271,12018,32916,15879,45187
350580,202111,2271,5866,1421,4162,363,1135,310,761,673,1896
350590,202111,5334,14033,3908,10906,494,1559,2306,5918,2800,7477
350600,202111,37294,84985,23464,61294,3360,9941,10944,25996,14304,35937
350610,202111,7589,20010,5403,15786,788,2564,2721,7391,3509,9955
350620,202111,463,1157,282,863,27,88,153,431,180,519
350630,202111,1680,4031,1237,3283,75,249,832,2026,907,2275
350635,202111,10712,25276,7967,20960,969,2789,4973,12457,5942,15246
350640,202111,991,2608,528,1602,80,227,153,396,233,623
350650,202111,9365,24249,6489,18671,1135,3524,2611,6932,3746,10456
350660,202111,4903,12351,3791,10528,598,1599,2088,5815,2686,7414
350670,202111,1862,4919,1518,4414,197,576,942,2752,1139,3328
350680,202111,1184,3126,810,2447,140,439,323,930,463,1369
350690,202111,1400,3539,993,2847,147,471,532,1465,679,1936
350700,202111,5227,12873,3869,10759,820,2552,1742,4603,2562,7155
350710,202111,3135,8264,2649,7408,460,1450,1393,3572,1853,5022
350715,202111,828,2284,698,2067,111,376,351,927,462,1303
350720,202111,169,433,124,358,17,46,43,109,60,155
350730,202111,654,1759,547,1570,30,103,396,1070,426,1173
350740,202111,1867,4769,1295,3649,226,694,473,1183,699,1877
350745,202111,647,1591,372,1091,28,108,171,451,199,559
350750,202111,11112,28406,8690,24191,1462,4708,4145,10340,5607,15048
350760,202111,16523,39924,12102,32357,2249,6707,5522,13165,7771,19872
350770,202111,1150,2750,693,1959,49,147,421,1147,470,1294
350775,202111,763,1714,527,1369,65,158,267,699,332,857
350780,202111,2579,6061,1872,5059,361,1126,605,1920,966,3046
350790,202111,2242,5840,1431,4314,264,804,405,1018,669,1822
350800,202111,3846,10637,3279,9662,266,870,2284,6493,2550,7363
350810,202111,3143,7350,2404,6285,460,1117,1078,2862,1538,3979
350820,202111,1009,2310,585,1567,78,242,274,658,352,900
350830,202111,925,2492,531,1641,80,259,157,396,237,655
350840,202111,3639,10412,2788,8838,582,2072,1226,3538,1808,5610
350850,202111,8730,23226,6887,19893,1295,4012,3479,9394,4774,13406
350860,202111,3896,10033,3349,9290,109,384,2616,7179,2725,7563
350870,202111,2865,7673,2143,6515,250,845,1274,3742,1524,4587
350880,202111,1472,4028,1170,3444,290,910,284,794,574,1704
350890,202111,561,1442,360,1026,52,160,133,327,185,487
350900,202111,8993,23364,6056,17314,1070,3286,2588,6733,3658,10019
350910,202111,997,2325,846,2105,94,245,613,1491,707,1736
350920,202111,13141,31538,11126,28320,409,1275,9231,22610,9640,23885
350925,202111,4386,11584,3146,9402,555,1826,1532,4188,2087,6014
350930,202111,1570,4023,1108,3141,69,210,676,1856,745,2066
350940,202111,2397,6120,1849,5235,185,602,1176,3143,1361,3745
350945,202111,949,2596,735,2190,119,371,363,1001,482,1372
350950,202111,98910,246904,76472,205328,9342,27232,47558,121493,56900,148725
350960,202111,6836,18057,5285,15180,672,2171,3082,8383,3754,10554
350970,202111,3747,10195,2687,8258,748,2534,626,1619,1374,4153
350980,202111,702,1835,563,1577,135,399,263,722,398,1121
350990,202111,2000,5320,1509,4531,323,1080,548,1557,871,2637
350995,202111,900,2694,813,2522,60,218,568,1687,628,1905
351000,202111,3119,8064,2110,6145,434,1302,671,1917,1105,3219
351010,202111,407,974,257,719,33,102,115,300,148,402
351015,202111,965,2803,795,2447,119,390,369,1023,488,1413
351020,202111,9238,24409,7021,20654,1651,4742,3048,8810,4699,13552
351030,202111,3064,8812,2444,7593,340,1160,1349,4026,1689,5186
351040,202111,5466,13193,4583,11883,230,685,3756,9467,3986,10152
351050,202111,18213,43252,13387,35913,2420,6927,6383,16713,8803,23640
351060,202111,53165,129859,40922,109232,3867,11452,27968,71690,31835,83142
351070,202111,1453,3530,820,2464,202,653,119,350,321,1003
351080,202111,2915,6866,2112,5906,224,723,1396,3714,1620,4437
351090,202111,343,952,256,797,48,148,74,235,122,383
351100,202111,2882,7566,1884,5596,390,1213,530,1559,920,2772
351110,202111,6596,16473,4421,12536,677,2161,2029,5335,2706,7496
351120,202111,784,2034,554,1632,77,243,200,563,277,806
351130,202111,1207,3075,568,1705,103,324,146,390,249,714
351140,202111,2426,6554,1822,5430,374,1250,799,2083,1173,3333
351150,202111,3035,8448,2063,6370,275,935,771,2122,1046,3057
351160,202111,1205,3600,875,2850,153,560,205,518,358,1078
351170,202111,1432,3846,1226,3488,100,312,856,2335,956,2647
351190,202111,1082,2950,746,2283,141,431,257,740,398,1171
351200,202111,1702,3960,1276,3358,92,277,912,2261,1004,2538
351210,202111,1681,4045,1074,2927,78,252,629,1560,707,1812
351220,202111,3643,9793,3128,8954,296,852,2146,6023,2442,6875
351230,202111,2034,5287,1536,4421,274,887,755,1953,1029,2840
351240,202111,2592,6460,1607,4449,377,1129,516,1267,893,2396
351250,202111,1170,3011,700,2071,64,202,273,795,337,997
351260,202111,971,2360,705,1881,161,440,231,575,392,1015
351270,202111,557,1470,388,1122,44,148,185,455,229,603
351280,202111,4191,10683,3204,8855,620,1730,1310,3531,1930,5261
351290,202111,1358,3294,964,2610,123,367,605,1556,728,1923
351300,202111,20925,54688,14727,43026,2451,7712,6744,18585,9195,26297
351310,202111,3755,8961,2867,7585,141,472,2146,5384,2287,5856
351320,202111,1002,2817,724,2257,122,400,224,609,346,1009
351330,202111,514,1245,414,1055,24,80,284,632,308,712
351340,202111,6901,18718,5585,16382,1362,4013,2483,7287,3845,11300
351350,202111,12901,31336,10671,27793,897,2520,7958,20024,8855,22544
351360,202111,4102,10573,3379,9508,670,2080,1536,3960,2206,6040
351370,202111,2192,5941,1461,4415,318,1038,410,1108,728,2146
351380,202111,50747,119297,35954,93933,4110,11581,21502,53376,25612,64957
351385,202111,437,1096,182,545,27,78,61,155,88,233
351390,202111,1417,3381,884,2600,114,387,519,1435,633,1822
351400,202111,1050,2814,863,2448,106,300,560,1531,666,1831
351410,202111,2847,7653,2039,6077,341,1010,795,2301,1136,3311
351420,202111,527,1256,303,853,37,101,179,468,216,569
351430,202111,1037,2684,837,2357,56,153,608,1666,664,1819
351440,202111,3693,9492,2464,7011,438,1331,691,1668,1129,2999
351450,202111,1855,4789,1239,3666,241,808,247,524,488,1332
351460,202111,965,2421,768,2118,147,408,443,1207,590,1615
351470,202111,1298,3191,1028,2748,77,261,696,1733,773,1994
351480,202111,2654,7502,2066,6527,368,1269,909,2653,1277,3922
351490,202111,2187,5970,1888,5441,62,254,1555,4327,1617,4581
351492,202111,371,985,313,862,7,21,241,644,248,665
351495,202111,212,531,165,445,14,34,102,270,116,304
351500,202111,43093,102120,32973,85556,4594,12426,20392,50626,24986,63052
351510,202111,13659,32666,9994,26563,1098,3375,6390,16101,7488,19476
351512,202111,521,1365,382,1064,70,199,129,332,199,531
351515,202111,3503,7795,2184,5689,388,1149,585,1567,973,2716
351518,202111,2711,6645,1801,5062,226,724,947,2335,1173,3059
351519,202111,680,1819,418,1307,74,239,67,183,141,422
351520,202111,1375,3360,615,1819,55,182,295,788,350,970
351530,202111,372,944,216,618,38,118,97,227,135,345
351535,202111,1917,4620,1375,3685,209,598,688,1742,897,2340
351540,202111,2859,6896,1930,5255,210,675,888,2101,1098,2776
351550,202111,7819,19006,5346,14574,523,1630,3027,7573,3550,9203
351560,202111,499,1389,389,1172,86,282,108,302,194,584
351565,202111,276,758,217,652,40,132,57,141,97,273
351570,202111,23440,60280,17946,49568,1691,5043,11532,30477,13223,35520
351580,202111,242,606,138,419,17,45,62,193,79,238
351590,202111,541,1212,282,754,25,90,165,400,190,490
351600,202111,1427,3772,1095,3132,134,422,588,1562,722,1984
351610,202111,799,1857,501,1334,32,87,286,714,318,801
351620,202111,25342,65133,18499,53575,2777,9152,8714,22773,11491,31925
351630,202111,30858,77668,24853,67654,2956,8714,16343,42520,19299,51234
351640,202111,19105,48189,15039,41046,1336,4269,10337,26745,11673,31014
351650,202111,395,1037,199,619,28,91,57,157,85,248
351660,202111,771,2083,503,1528,75,233,107,267,182,500
351670,202111,6600,17225,4334,12362,939,2638,1719,4587,2658,7225
351680,202111,462,1261,315,947,45,147,81,192,126,339
351685,202111,428,1201,347,1073,97,293,113,333,210,626
351690,202111,1241,3070,691,1995,90,303,315,812,405,1115
351700,202111,1410,3438,1036,2807,215,591,491,1252,706,1843
351710,202111,836,2171,619,1769,56,185,355,914,411,1099
351720,202111,1594,4021,1069,3096,171,533,459,1219,630,1752
351730,202111,1024,2598,843,2320,73,221,510,1332,583,1553
351740,202111,3651,8955,2918,7578,498,1413,1498,3518,1996,4931
351750,202111,1679,4196,989,2961,165,533,414,1164,579,1697
351760,202111,3538,9589,2645,7892,504,1707,1109,2972,1613,4679
351770,202111,2018,5616,1635,4900,263,854,954,2724,1217,3578
351780,202111,1263,3131,752,2197,101,354,302,802,403,1156
351790,202111,1479,3484,1181,3075,186,497,687,1787,873,2284
351800,202111,553,1246,279,736,36,105,114,245,150,350
351810,202111,1164,3000,969,2708,87,213,636,1699,723,1912
351820,202111,2935,7935,2108,6340,500,1657,536,1430,1036,3087
351830,202111,4848,12547,3691,10535,322,1032,2334,6313,2656,7345
351840,202111,9625,25433,7290,21189,879,2891,4148,11134,5027,14025
351850,202111,1629,4388,1068,3261,148,514,378,950,526,1464
351860,202111,2860,7976,2189,6748,330,1131,1206,3671,1536,4802
351870,202111,26097,64526,19532,53778,4520,12912,7984,22036,12504,34948
351880,202111,151013,373755,114521,311890,21310,64598,60403,154676,81713,219274
351885,202111,1006,2593,788,2239,51,178,544,1467,595,1645
351890,202111,923,2361,591,1808,110,358,121,318,231,676
351900,202111,1256,3214,952,2759,123,336,573,1650,696,1986
351905,202111,487,1332,348,1058,29,97,177,474,206,571
351907,202111,23157,59047,18122,50249,1908,5975,11812,31106,13720,37081
351910,202111,1798,4498,1275,3409,101,299,755,1800,856,2099
351920,202111,946,2493,711,2028,112,351,299,761,411,1112
351925,202111,959,2455,735,2058,92,296,394,1007,486,1303
351930,202111,3469,9390,3107,8730,517,1491,2152,5938,2669,7429
351940,202111,1138,2877,827,2329,128,397,401,1107,529,1504
351950,202111,1826,3989,1391,3366,68,197,1013,2347,1081,2544
351960,202111,5471,13478,4013,10909,911,2628,1708,4355,2619,6983
351970,202111,8338,23319,6648,20427,988,3469,3752,10973,4740,14442
351980,202111,1104,2580,723,1950,97,308,408,979,505,1287
351990,202111,1595,3680,1173,3051,48,173,610,1391,658,1564
352000,202111,2876,7917,2478,7103,262,850,1650,4419,1912,5269
352010,202111,2511,6412,2035,5631,517,1597,448,1265,965,2862
352020,202111,1519,4029,1169,3426,166,553,561,1520,727,2073
352030,202111,6335,16146,4960,13893,800,2425,2685,7199,3485,9624
352040,202111,4171,10367,2944,8000,482,1425,1062,2528,1544,3953
352042,202111,3525,8247,2401,6479,371,1135,1264,3233,1635,4368
352044,202111,2254,5839,1330,4081,190,661,281,782,471,1443
352050,202111,14019,36345,9331,27151,2078,6875,1902,4687,3980,11562
352060,202111,801,2097,594,1714,99,310,257,668,356,978
352070,202111,981,1974,637,1523,53,148,355,766,408,914
352080,202111,507,1272,303,870,33,111,100,255,133,366
352090,202111,1650,4709,1371,4178,161,564,662,1808,823,2372
352100,202111,3763,10258,2995,8800,582,1869,1338,3723,1920,5592
352110,202111,703,1984,519,1618,110,357,207,600,317,957
352115,202111,596,1574,493,1412,69,222,283,782,352,1004
352120,202111,940,2655,755,2293,79,212,451,1274,530,1486
352130,202111,2208,5959,1447,4146,223,636,598,1616,821,2252
352140,202111,1227,3297,883,2618,153,468,384,1112,537,1580
352150,202111,962,2473,743,2106,84,259,505,1377,589,1636
352160,202111,1068,2590,779,2120,73,238,445,1159,518,1397
352170,202111,3203,8318,2551,7080,281,845,1614,4191,1895,5036
352180,202111,2583,6770,1945,5626,442,1425,640,1633,1082,3058
352190,202111,1380,3608,1099,3180,185,468,572,1713,757,2181
352200,202111,342,1031,246,841,31,115,85,284,116,399
352210,202111,21905,49767,17151,43347,906,2592,13509,33301,14415,35893
352215,202111,718,1805,591,1602,84,243,329,864,413,1107
352220,202111,25068,59377,18012,47362,2899,8378,9488,22764,12387,31142
352230,202111,16362,45142,12685,38311,2969,9879,4430,12252,7399,22131
352240,202111,10833,27108,8309,22966,1773,5397,3575,9222,5348,14619
352250,202111,25112,67644,20187,59343,2845,9024,12666,36314,15511,45338
352260,202111,5330,13013,3639,9776,539,1660,2091,5018,2630,6678
352265,202111,993,2699,874,2526,124,383,570,1593,694,1976
352270,202111,1630,4718,1215,3838,250,843,424,1222,674,2065
352280,202111,2515,6167,1895,5280,209,677,1116,2898,1325,3575
352290,202111,1420,3908,1132,3378,134,433,610,1628,744,2061
352300,202111,948,2451,644,1835,81,260,352,938,433,1198
352310,202111,44197,114730,33130,95803,7439,22113,15295,44122,22734,66235
352320,202111,7167,17909,5551,14945,731,2200,3123,7553,3854,9753
352330,202111,2484,6257,1914,5459,272,918,1151,3049,1423,3967
352340,202111,6972,18025,5248,14868,809,2567,2644,6877,3453,9444
352350,202111,2470,6717,1939,5576,155,534,1257,3387,1412,3921
352360,202111,1416,3659,1145,3175,89,290,839,2220,928,2510
352370,202111,1142,3133,983,2866,21,86,800,2276,821,2362
352380,202111,913,2396,683,1994,159,469,227,636,386,1105
352390,202111,15979,38547,10927,29650,1728,5095,5936,15109,7664,20204
352400,202111,3823,10427,3104,9073,642,2153,1378,3742,2020,5895
352410,202111,3706,9237,2845,7803,224,726,1800,4714,2024,5440
352420,202111,880,2144,636,1798,128,392,241,632,369,1024
352430,202111,8950,21433,6553,17292,1076,3211,3401,8412,4477,11623
352440,202111,20214,53659,15154,43921,3445,10343,5449,15164,8894,25507
352450,202111,834,1983,440,1314,59,193,166,463,225,656
352460,202111,3298,8695,2327,6970,452,1453,993,2806,1445,4259
352470,202111,3572,8939,2732,7572,270,876,1729,4490,1999,5366
352480,202111,4533,10528,3043,7904,410,1258,1490,3386,1900,4644
352490,202111,863,2391,691,2089,109,369,321,904,430,1273
352500,202111,11421,28725,7802,22027,2939,9190,1024,1674,3963,10864
352510,202111,4206,11229,3177,9392,576,1801,1567,4449,2143,6250
352520,202111,3094,7834,2407,6701,394,1242,1384,3495,1778,4737
352530,202111,12003,30005,8256,23002,1368,4250,3038,7206,4406,11456
352540,202111,615,1763,458,1435,67,219,167,475,234,694
352550,202111,1057,2835,734,2237,119,408,260,703,379,1111
352560,202111,642,1729,504,1474,69,221,291,784,360,1005
352570,202111,2559,7081,1657,5153,345,1179,200,448,545,1627
352580,202111,656,1663,548,1465,46,142,375,954,421,1096
352585,202111,374,999,273,819,16,62,174,478,190,540
352590,202111,14123,36325,9996,28602,2293,7199,4736,12474,7029,19673
352600,202111,2027,5394,1594,4621,145,460,1015,2779,1160,3239
352610,202111,2943,7940,2207,6681,416,1429,942,2627,1358,4056
352620,202111,6097,14868,4637,12781,1285,3521,1861,5195,3146,8716
352630,202111,914,2199,685,1872,111,356,329,836,440,1192
352640,202111,3236,8100,2351,6523,235,662,1373,3630,1608,4292
352650,202111,641,1759,444,1342,65,215,176,495,241,710
352660,202111,1168,3333,972,2931,99,314,603,1756,702,2070
352670,202111,10629,27754,7298,21298,1607,5203,2571,6738,4178,11941
352680,202111,3471,9873,2455,7605,389,1400,1133,3067,1522,4467
352690,202111,29227,71648,23004,61291,1238,3895,16708,42624,17946,46519
352700,202111,717,1757,534,1493,121,376,200,545,321,921
352710,202111,5712,14346,4104,11435,994,2989,1688,4377,2682,7366
352720,202111,9112,23612,7156,20035,2126,6189,2501,6531,4627,12720
352725,202111,606,1409,346,945,21,58,190,486,211,544
352730,202111,5710,16479,5149,15207,604,1933,2363,6017,2967,7950
352740,202111,2469,5822,1876,4948,177,548,1130,2779,1307,3327
352750,202111,469,1164,298,860,44,142,127,311,171,453
352760,202111,1820,4878,1412,4089,123,340,798,2302,921,2642
352770,202111,970,2508,684,1960,117,352,302,815,419,1167
352780,202111,698,1921,501,1518,110,295,124,392,234,687
352790,202111,468,1199,349,973,30,87,153,373,183,460
352800,202111,1441,4171,1001,3172,232,771,168,404,400,1175
352810,202111,1295,2984,837,2197,162,436,442,1112,604,1548
352820,202111,474,1304,348,1080,73,231,72,197,145,428
352830,202111,626,1553,306,899,27,83,93,222,120,305
352840,202111,4278,11764,3482,10326,1017,3307,1276,3574,2293,6881
352850,202111,11955,28355,8350,22580,2085,6192,3011,7241,5096,13433
352860,202111,1142,3097,868,2609,141,459,340,954,481,1413
352870,202111,929,2279,654,1743,65,190,403,1018,468,1208
352880,202111,1820,4281,1268,3309,206,551,554,1392,760,1943
352885,202111,333,872,254,740,26,70,150,429,176,499
352890,202111,743,1763,495,1256,46,137,297,650,343,787
352900,202111,19724,50045,13048,36946,2031,6021,5574,14682,7605,20703
352910,202111,431,1119,250,747,22,71,93,226,115,297
352920,202111,2860,7151,2130,5928,116,371,1490,3979,1606,4350
352930,202111,6239,16460,4712,13485,816,2576,2264,6027,3080,8603
352940,202111,24852,64711,18502,51830,3172,9640,9378,24556,12550,34196
352950,202111,605,1570,381,1146,89,271,86,228,175,499
352960,202111,805,2082,478,1415,66,226,147,332,213,558
352965,202111,259,711,171,544,38,116,45,131,83,247
352970,202111,3205,7477,2493,6315,196,558,1768,4357,1964,4915
352980,202111,1449,3655,1141,3203,271,833,582,1578,853,2411
352990,202111,4637,12240,3496,10358,640,2058,1771,5059,2411,7117
353000,202111,513,1357,300,870,38,124,76,168,114,292
353010,202111,2809,6817,1862,5073,341,1069,814,1995,1155,3064
353020,202111,3756,9525,2244,6444,314,985,796,2147,1110,3132
353030,202111,4943,12165,3415,9558,748,2280,945,2490,1693,4770
353040,202111,712,1611,501,1293,117,296,226,559,343,855
353050,202111,5585,15438,3969,12152,709,2310,1847,5397,2556,7707
353060,202111,51916,129174,42874,114810,2888,8989,32343,83534,35231,92523
353070,202111,10888,30037,7977,23794,1316,4282,3550,9586,4866,13868
353080,202111,4825,12739,3199,9607,549,1891,1255,3246,1804,5137
353090,202111,643,1855,517,1603,31,105,334,992,365,1097
353100,202111,320,829,151,461,24,79,43,108,67,187
353110,202111,7995,20295,6414,18078,1513,4329,2971,8846,4484,13175
353120,202111,432,1055,330,884,39,128,172,399,211,527
353130,202111,2816,6455,1782,4665,414,1207,637,1460,1051,2667
353140,202111,2926,7053,2163,5785,92,308,1576,4022,1668,4330
353150,202111,1697,4106,1217,3324,256,725,504,1301,760,2026
353160,202111,684,1720,490,1392,62,178,222,567,284,745
353170,202111,579,1502,432,1289,78,247,199,600,277,847
353180,202111,10946,26077,8602,22332,1504,3983,5114,12828,6618,16811
353190,202111,3717,9668,2905,8065,382,1134,1687,4356,2069,5490
353200,202111,1926,5049,1101,3399,165,568,355,972,520,1540
353205,202111,458,1331,385,1177,56,182,193,565,249,747
353210,202111,963,2127,634,1602,21,53,456,1118,477,1171
353215,202111,415,1087,324,922,47,148,150,393,197,541
353220,202111,797,2090,525,1545,99,294,106,287,205,581
353230,202111,852,2270,663,1977,180,561,223,619,403,1180
353240,202111,2488,6560,2068,5898,272,908,1252,3405,1524,4313
353250,202111,1299,2886,816,2111,105,301,451,1105,556,1406
353260,202111,1250,2841,702,1936,96,289,333,849,429,1138
353270,202111,752,1897,629,1689,59,174,425,1075,484,1249
353280,202111,745,1966,530,1591,136,399,139,410,275,809
353282,202111,1937,5297,1618,4736,176,551,1010,2800,1186,3351
353284,202111,390,862,221,567,21,75,114,254,135,329
353286,202111,189,463,113,335,19,53,34,89,53,142
353290,202111,1544,4003,936,2801,173,499,278,751,451,1250
353300,202111,2296,5977,1690,4808,265,873,761,1897,1026,2770
353310,202111,429,1025,319,842,21,69,214,529,235,598
353320,202111,730,1768,619,1614,13,47,505,1282,518,1329
353325,202111,731,2077,518,1609,107,319,176,535,283,854
353330,202111,656,1639,441,1248,59,167,220,570,279,737
353340,202111,3300,8769,2485,7182,473,1522,1227,3212,1700,4734
353350,202111,4004,9858,2872,7723,653,1798,911,2223,1564,4021
353360,202111,705,1910,545,1603,57,183,321,903,378,1086
353370,202111,603,1668,502,1508,46,147,350,1019,396,1166
353380,202111,318,909,256,795,28,98,118,339,146,437
353390,202111,6889,16663,5174,13827,432,1305,3264,8249,3696,9554
353400,202111,533,1402,404,1162,69,220,164,394,233,614
353410,202111,555,1451,418,1204,71,197,235,673,306,870
353420,202111,435,1106,266,764,60,167,27,71,87,238
353430,202111,2428,6471,1897,5506,325,1052,953,2585,1278,3637
353440,202111,72928,190086,53990,153743,8122,25079,30080,80574,38202,105653
353450,202111,406,1009,280,796,34,114,141,360,175,474
353460,202111,3543,9334,2650,7696,305,939,931,2536,1236,3475
353470,202111,9304,23795,6739,18994,1089,3456,3057,7886,4146,11342
353475,202111,1783,4365,1215,3279,158,472,621,1528,779,2000
353480,202111,1709,4423,1384,3879,54,183,1020,2757,1074,2940
353490,202111,1171,2992,801,2299,106,331,379,1023,485,1354
353500,202111,1105,2577,800,2103,164,449,446,1126,610,1575
353510,202111,905,2566,644,1986,146,457,189,502,335,959
353520,202111,1078,2735,686,2048,66,222,340,922,406,1144
353530,202111,2615,6702,2068,5719,255,819,1149,2937,1404,3756
353540,202111,2258,5908,1853,5270,279,828,1083,2959,1362,3787
353550,202111,6378,15859,5175,13930,775,2131,3026,7811,3801,9942
353560,202111,2489,6423,1909,5562,499,1564,598,1551,1097,3115
353570,202111,692,1767,486,1406,67,221,221,586,288,807
353580,202111,2347,6044,1783,4945,399,1098,791,2132,1190,3230
353590,202111,760,1909,533,1506,71,204,285,804,356,1008
353600,202111,1802,4399,1364,3645,177,465,741,1940,918,2405
353610,202111,727,2078,519,1651,89,350,188,538,277,888
353620,202111,3002,7621,2165,6207,404,1274,770,1998,1174,3272
353625,202111,589,1439,388,1086,33,101,217,580,250,681
353630,202111,1520,4427,1293,3970,208,685,592,1684,800,2369
353640,202111,1415,3583,1132,3146,148,408,649,1775,797,2183
353650,202111,8180,21396,6248,17828,743,2270,3598,9660,4341,11930
353657,202111,410,1049,300,868,29,96,138,359,167,455
353660,202111,1403,2914,967,2334,291,733,395,899,686,1632
353670,202111,4387,11832,3408,9952,647,2116,1591,4221,2238,6337
353680,202111,743,1902,558,1643,72,243,330,898,402,1141
353690,202111,464,1204,225,673,22,81,57,146,79,227
353700,202111,2213,5586,1817,4942,125,403,1337,3482,1462,3885
353710,202111,5667,12646,3402,8632,416,1080,1759,3935,2175,5015
353715,202111,473,1244,283,865,8,28,106,300,114,328
353720,202111,2155,5471,1653,4696,266,808,898,2456,1164,3264
353730,202111,4638,11895,3569,10014,449,1474,2000,5136,2449,6610
353740,202111,2178,5563,1546,4466,349,1119,532,1364,881,2483
353750,202111,978,2876,714,2366,152,544,184,577,336,1121
353760,202111,14201,31491,10935,27183,2320,5720,5609,13878,7929,19598
353770,202111,706,2049,429,1398,66,241,58,170,124,411
353780,202111,6126,15959,4930,13815,1039,3213,2512,6510,3551,9723
353790,202111,3026,8807,2215,7094,528,1842,441,1215,969,3057
353800,202111,20248,51257,15960,44350,2430,6951,8643,23890,11073,30841
353810,202111,1315,3446,872,2536,125,409,380,1037,505,1446
353820,202111,1876,4903,1276,3739,255,822,408,1092,663,1914
353830,202111,672,1652,489,1358,83,238,213,560,296,798
353850,202111,1713,4573,1326,3855,263,777,500,1397,763,2174
353860,202111,2856,7529,2178,6401,495,1657,996,2599,1491,4256
353870,202111,32459,82855,23353,65503,2984,9183,12239,31354,15223,40537
353880,202111,3332,8951,2629,7642,216,710,1621,4496,1837,5206
353890,202111,3113,6529,2253,5287,175,456,1582,3442,1757,3898
353900,202111,777,2120,575,1727,79,272,240,657,319,929
353910,202111,2763,7347,2331,6671,201,652,1658,4637,1859,5289
353920,202111,2044,5479,1486,4437,343,1127,354,870,697,1997
353930,202111,4884,12679,3349,9784,556,1861,1429,3642,1985,5503
353940,202111,1289,3618,904,2846,144,490,306,850,450,1340
353950,202111,3430,9041,2622,7530,542,1639,1296,3501,1838,5140
353960,202111,886,2229,627,1745,141,385,203,541,344,926
353970,202111,679,1595,508,1337,42,126,361,933,403,1059
353980,202111,17341,42595,13555,36149,804,2513,9919,25224,10723,27737
353990,202111,1002,2391,612,1693,113,337,289,750,402,1087
354000,202111,2757,6482,1546,4188,343,939,265,679,608,1618
354010,202111,359,912,254,743,50,151,130,373,180,524
354020,202111,3977,10419,3148,8754,645,1954,1438,3636,2083,5590
354025,202111,757,2043,502,1548,66,227,139,403,205,630
354030,202111,535,1148,295,766,63,169,140,338,203,507
354040,202111,861,1942,561,1472,32,93,415,1047,447,1140
354050,202111,1007,2798,715,2265,155,548,249,734,404,1282
354060,202111,3761,10329,2669,8015,478,1559,1101,2938,1579,4497
354070,202111,4128,10486,2803,7910,454,1449,1269,3109,1723,4558
354075,202111,2994,8209,2387,7118,329,1012,1393,4060,1722,5072
354080,202111,1476,3985,989,3017,183,591,302,815,485,1406
354085,202111,465,929,372,813,0,0,289,583,289,583
354090,202111,1723,4726,1482,4244,85,258,1149,3206,1234,3464
354100,202111,21168,55369,14719,44280,3122,10051,5728,17003,8850,27054
354105,202111,1504,3712,1051,2907,128,371,516,1305,644,1676
354110,202111,465,1285,334,1029,56,171,115,338,171,509
354120,202111,1458,3823,1005,2871,213,641,331,835,544,1476
354130,202111,5858,15122,3877,11282,927,2820,223,427,1150,3247
354140,202111,21060,50968,14500,38925,2234,6684,6606,16083,8840,22767
354150,202111,3085,7182,2375,6069,493,1309,938,2356,1431,3665
354160,202111,3030,8517,2300,7082,584,1960,723,1999,1307,3959
354165,202111,730,2096,559,1761,87,323,296,856,383,1179
354170,202111,2012,5434,1671,4799,111,365,1009,2744,1120,3109
354180,202111,408,1105,301,890,47,142,143,378,190,520
354190,202111,1673,4596,1173,3561,71,243,598,1714,669,1957
354200,202111,936,2216,713,1873,67,200,472,1159,539,1359
354210,202111,969,2496,791,2209,53,165,550,1434,603,1599
354220,202111,3359,8771,2544,7198,385,1183,1341,3554,1726,4737
354230,202111,846,2048,688,1860,33,109,516,1350,549,1459
354240,202111,1871,5069,1251,3816,204,653,403,1102,607,1755
354250,202111,663,1594,419,1174,92,275,120,307,212,582
354260,202111,8728,22248,6668,18682,1181,3616,3174,8368,4355,11984
354270,202111,1065,3115,872,2737,174,526,339,1034,513,1560
354280,202111,868,2090,745,1910,61,187,514,1218,575,1405
354290,202111,983,3042,825,2724,132,420,422,1440,554,1860
354300,202111,3746,10658,3155,9565,769,2348,1332,3972,2101,6320
354310,202111,772,2220,636,1964,146,468,250,723,396,1191
354320,202111,1048,2487,694,1895,98,300,288,697,386,997
354323,202111,520,1208,325,853,55,130,137,338,192,468
354325,202111,1595,4632,1108,3524,185,587,336,1022,521,1609
354330,202111,10149,24992,7020,18797,838,2521,4223,10464,5061,12985
354340,202111,36735,90018,25621,70784,3338,10466,14612,38251,17950,48717
354350,202111,1270,3184,1009,2760,156,447,574,1493,730,1940
354360,202111,659,1645,398,1220,89,269,92,279,181,548
354370,202111,1058,2922,853,2598,131,419,518,1518,649,1937
354380,202111,705,1819,516,1514,86,329,150,344,236,673
354390,202111,15176,35833,10165,27113,1634,4691,4972,12385,6606,17076
354400,202111,1674,5209,1314,4377,225,773,458,1507,683,2280
354410,202111,6861,17515,5220,14364,918,2777,2659,6807,3577,9584
354420,202111,1614,4072,1199,3327,153,458,723,1873,876,2331
354425,202111,2940,7017,2097,5554,472,1276,835,2205,1307,3481
354430,202111,1627,4230,1265,3670,105,319,790,2183,895,2502
354440,202111,657,1651,434,1219,67,202,196,506,263,708
354450,202111,482,1255,283,883,41,136,93,243,134,379
354460,202111,911,2270,617,1757,96,292,297,821,393,1113
354470,202111,487,1211,338,932,16,55,170,403,186,458
354480,202111,1394,3061,908,2292,91,219,557,1331,648,1550
354490,202111,852,2448,628,1966,115,380,279,801,394,1181
354500,202111,2302,6256,1843,5527,549,1700,443,1345,992,3045
354510,202111,774,2111,633,1851,41,128,373,988,414,1116
354515,202111,383,1041,270,813,43,143,105,304,148,447
354520,202111,7419,19790,5249,15248,660,2226,2948,7896,3608,10122
354530,202111,4830,13241,3759,11181,976,2875,1245,3834,2221,6709
354540,202111,1431,3639,1044,2949,215,637,390,1068,605,1705
354550,202111,641,1662,505,1403,77,236,275,714,352,950
354560,202111,2440,5791,1327,3675,177,503,692,1740,869,2243
354570,202111,1327,3260,544,1506,100,281,75,193,175,474
354580,202111,8941,23160,5926,17375,919,2891,2931,8189,3850,11080
354600,202111,2172,5494,1722,4710,211,610,1085,2810,1296,3420
354610,202111,474,1195,276,802,27,85,138,382,165,467
354620,202111,518,1400,319,1013,36,141,138,402,174,543
354625,202111,326,866,196,618,36,127,40,93,76,220
354630,202111,2332,6688,1901,5854,621,1980,370,1052,991,3032
354640,202111,3633,10090,2739,8319,382,1287,1171,3262,1553,4549
354650,202111,930,2377,747,2080,83,221,443,1217,526,1438
354660,202111,3879,8921,2092,5949,185,636,966,2460,1151,3096
354670,202111,1149,3112,806,2425,158,519,298,821,456,1340
354680,202111,5737,14491,4320,12210,911,2754,2217,6290,3128,9044
354690,202111,538,1620,386,1286,77,273,122,376,199,649
354700,202111,989,2572,696,2008,86,269,369,973,455,1242
354710,202111,536,1405,379,1094,47,141,166,422,213,563
354720,202111,319,751,144,417,67,186,22,72,89,258
354730,202111,10700,29495,8198,24710,1064,3507,4714,13573,5778,17080
354740,202111,326,874,130,419,14,56,28,74,42,130
354750,202111,2989,7508,1931,5531,270,829,828,2080,1098,2909
354760,202111,2312,6022,1647,4804,352,1113,568,1458,920,2571
354765,202111,387,1031,165,522,17,61,46,133,63,194
354770,202111,2667,6469,1941,5147,311,877,908,2258,1219,3135
354780,202111,61403,150804,47129,123163,3880,11609,31721,77357,35601,88966
354790,202111,1072,2855,832,2469,71,228,522,1479,593,1707
354800,202111,2794,7074,2117,5934,535,1530,871,2277,1406,3807
354805,202111,1457,3276,1024,2644,116,286,616,1509,732,1795
354810,202111,677,1935,407,1371,58,230,119,369,177,599
354820,202111,1015,2823,711,2242,100,343,206,518,306,861
354830,202111,519,1239,327,898,67,197,100,256,167,453
354840,202111,960,2366,600,1639,61,171,321,807,382,978
354850,202111,22522,56650,15857,44968,1595,5150,9829,26282,11424,31432
354860,202111,1839,4944,1162,3549,183,606,378,1044,561,1650
354870,202111,64689,160224,50151,133549,4829,14134,32402,81198,37231,95332
354880,202111,6264,15160,3112,8628,337,1075,1240,2819,1577,3894
354890,202111,16887,41854,13081,35422,1791,5422,7394,19380,9185,24802
354900,202111,434,1070,288,813,64,199,93,209,157,408
354910,202111,6394,16525,3964,12093,862,2784,823,2303,1685,5087
354920,202111,553,1445,277,889,37,127,63,168,100,295
354925,202111,315,873,183,584,23,77,44,124,67,201
354930,202111,407,973,272,734,31,95,125,305,156,400
354940,202111,2535,7294,1855,5834,603,2046,454,1284,1057,3330
354950,202111,1632,4028,1301,3589,53,187,970,2544,1023,2731
354960,202111,950,2479,711,2119,76,254,374,1035,450,1289
354970,202111,4509,12163,3547,10543,364,1239,2305,6604,2669,7843
354980,202111,36096,84107,24733,64678,2497,7718,15393,37317,17890,45035
354990,202111,75944,185750,55988,149773,4191,12984,37483,93699,41674,106683
354995,202111,3067,6621,2328,5664,142,402,1766,4141,1908,4543
355000,202111,1679,4058,1255,3429,211,662,614,1512,825,2174
355010,202111,4280,11254,2690,7885,875,2612,390,1158,1265,3770
355020,202111,3901,10531,2870,8719,560,1916,1219,3431,1779,5347
355030,202111,1484606,3583712,1085502,2819898,154815,441252,569489,1359092,724304,1800344
355040,202111,3261,7723,2519,6758,260,721,1861,4960,2121,5681
355050,202111,1098,2401,813,2009,187,524,334,724,521,1248
355060,202111,6727,17506,4917,14193,763,2547,2535,6620,3298,9167
355070,202111,10626,26213,8656,23076,997,3018,5527,13773,6524,16791
355080,202111,1020,2847,646,2154,127,459,106,296,233,755
355090,202111,1294,3534,1022,3080,206,656,445,1242,651,1898
355100,202111,23883,60633,18646,52836,2761,8268,11381,31725,14142,39993
355110,202111,950,2562,689,2151,168,591,92,260,260,851
355120,202111,779,1987,560,1664,61,184,258,748,319,932
355130,202111,870,1918,456,1168,31,103,296,692,327,795
355140,202111,2106,4583,1762,4115,91,239,1463,3325,1554,3564
355150,202111,4630,11843,3688,10187,404,1226,2353,6229,2757,7455
355160,202111,2375,6315,1711,5145,403,1307,419,1150,822,2457
355170,202111,12033,29445,9435,25149,1622,4653,5026,12972,6648,17625
355180,202111,3034,7824,2168,6388,405,1335,915,2462,1320,3797
355190,202111,1986,5122,1556,4430,427,1194,735,2251,1162,3445
355200,202111,875,2615,741,2397,210,727,299,933,509,1660
355210,202111,3221,8570,2478,7047,451,1416,1178,3120,1629,4536
355220,202111,51014,131067,40620,111296,7829,22819,18779,47590,26608,70409
355230,202111,1242,3070,675,1965,135,399,233,631,368,1030
355240,202111,26950,69709,19014,54072,2213,6870,10734,28512,12947,35382
355250,202111,40630,105519,30353,85838,7627,22516,11654,31429,19281,53945
355255,202111,687,1673,366,1095,52,165,131,376,183,541
355260,202111,1638,3824,1164,3069,121,389,704,1701,825,2090
355270,202111,1226,3523,953,2983,210,696,373,1065,583,1761
355280,202111,33597,83094,24234,65901,2955,8746,13031,33095,15986,41841
355290,202111,995,2608,770,2230,151,413,328,911,479,1324
355300,202111,1421,4060,1138,3520,209,689,434,1248,643,1937
355310,202111,995,2681,740,2255,93,287,424,1295,517,1582
355320,202111,559,1435,420,1179,73,228,170,385,243,613
355330,202111,3150,7850,2431,6604,116,394,1860,4820,1976,5214
355340,202111,4395,9658,3349,8271,434,1024,2018,5080,2452,6104
355350,202111,1440,3996,1081,3312,200,641,432,1270,632,1911
355360,202111,1297,3218,1000,2768,116,336,601,1626,717,1962
355365,202111,380,964,201,652,45,144,29,102,74,246
355370,202111,5677,14271,4389,12209,1038,2626,1873,5759,2911,8385
355380,202111,3052,7996,2304,6632,399,1264,848,2104,1247,3368
355385,202111,1548,3952,1281,3570,108,355,817,2078,925,2433
355390,202111,880,2360,631,1823,129,398,244,624,373,1022
355395,202111,2085,5600,1477,4385,243,771,532,1362,775,2133
355400,202111,9887,27433,7821,23355,1779,5966,2917,7733,4696,13699
355410,202111,24795,66835,15455,47436,2968,9969,4386,12993,7354,22962
355420,202111,654,2034,544,1832,133,491,148,460,281,951
355430,202111,3909,9683,2941,7936,605,1662,1376,3623,1981,5285
355440,202111,803,2147,504,1529,81,245,142,399,223,644
355450,202111,3531,8923,2375,6677,349,1065,1061,2656,1410,3721
355460,202111,540,1273,335,931,39,137,172,420,211,557
355465,202111,477,1212,375,1051,46,139,218,594,264,733
355470,202111,1204,3020,694,2011,180,573,190,477,370,1050
355475,202111,374,849,311,768,14,33,240,574,254,607
355480,202111,4293,11542,3472,10304,488,1640,2212,6404,2700,8044
355490,202111,987,2582,547,1680,49,169,268,744,317,913
355495,202111,882,2395,648,1999,72,267,242,654,314,921
355500,202111,7364,18484,4536,13057,661,2074,1708,4487,2369,6561
355510,202111,1492,3561,962,2677,148,441,385,962,533,1403
355520,202111,391,885,194,559,38,111,60,172,98,283
355530,202111,378,879,147,428,8,28,70,184,78,212
355535,202111,546,1449,422,1256,79,285,198,541,277,826
355540,202111,11760,28372,9704,25484,1198,3446,6689,16986,7887,20432
355550,202111,641,1856,528,1636,61,212,288,813,349,1025
355560,202111,1221,3100,701,2092,157,534,30,86,187,620
355570,202111,312,832,162,501,24,82,38,97,62,179
355580,202111,1278,3019,798,2205,146,475,282,674,428,1149
355590,202111,179,455,139,391,17,55,85,227,102,282
355600,202111,1649,3983,1077,3009,166,493,362,998,528,1491
355610,202111,1942,4672,1290,3541,143,427,691,1767,834,2194
355620,202111,5454,14081,4065,11358,408,1361,2290,5820,2698,7181
355630,202111,2622,6936,1867,5558,278,859,995,2837,1273,3696
355635,202111,952,2715,698,2215,108,372,219,626,327,998
355640,202111,3491,9364,2378,7192,505,1507,658,2015,1163,3522
355645,202111,4391,11974,3203,9883,468,1570,1715,5077,2183,6647
355650,202111,6846,18165,5272,15278,1308,3970,1518,3895,2826,7865
355660,202111,1499,3782,1035,2965,165,497,297,840,462,1337
355670,202111,4152,10888,2851,7997,347,1140,1464,3588,1811,4728
355680,202111,3091,8279,1447,4454,326,1106,93,274,419,1380
355690,202111,842,2400,555,1846,124,461,8,14,132,475
355695,202111,279,772,165,511,12,50,36,83,48,133
355700,202111,8063,22405,6645,19319,987,3135,3775,10309,4762,13444
355710,202111,9935,23126,6628,17118,901,2639,3332,7541,4233,10180
355715,202111,510,1349,280,839,60,190,44,112,104,302
355720,202111,1547,4240,1225,3671,181,579,669,1880,850,2459
355730,202111,1004,2679,823,2356,120,385,432,1152,552,1537
410010,202111,1327,3628,1020,2987,192,626,247,666,439,1292
410020,202111,1110,3243,842,2643,274,804,179,546,453,1350
410030,202111,1645,4380,1406,4013,201,589,764,2232,965,2821
410040,202111,13985,37715,10206,30582,2183,6970,3145,8662,5328,15632
410045,202111,851,2257,614,1785,94,304,238,617,332,921
410050,202111,2432,5971,1679,4681,255,815,636,1638,891,2453
410060,202111,2197,6052,1718,5124,369,1166,515,1456,884,2622
410070,202111,2111,5208,1563,4234,250,750,601,1453,851,2203
410080,202111,1408,3695,1001,2962,254,791,182,529,436,1320
410090,202111,1186,2927,1007,2647,114,281,563,1568,677,1849
410100,202111,2067,5782,1352,4112,200,675,125,364,325,1039
410105,202111,527,1313,307,888,35,101,113,308,148,409
410110,202111,3517,8585,2480,6666,335,960,1168,2932,1503,3892
410115,202111,599,1530,431,1235,55,165,165,424,220,589
410120,202111,2842,7534,2459,6986,483,1420,1366,3793,1849,5213
410130,202111,1352,3528,1164,3174,219,682,593,1510,812,2192
410140,202111,17745,42337,11707,31581,2068,6115,3174,7756,5242,13871
410150,202111,17688,40932,9067,24317,1527,4541,2241,5306,3768,9847
410160,202111,3171,8583,2543,7480,585,1842,837,2419,1422,4261
410165,202111,694,1825,557,1548,66,206,307,786,373,992
410170,202111,3082,7806,2031,5607,430,1270,115,322,545,1592
410180,202111,16328,44547,12517,36896,1809,5770,6245,16969,8054,22739
410185,202111,463,1324,339,1014,57,186,108,284,165,470
410190,202111,2328,5682,1687,4544,338,953,425,1052,763,2005
410200,202111,6292,13933,3482,9132,538,1599,464,1178,1002,2777
410210,202111,3433,8383,2199,6208,346,1103,727,1734,1073,2837
410220,202111,578,1468,382,1107,61,188,98,257,159,445
410230,202111,1923,5061,1456,4137,223,687,608,1544,831,2231
410240,202111,5580,14351,3801,10882,703,2239,523,1336,1226,3575
410250,202111,2671,6309,1974,5197,147,446,957,2460,1104,2906
410260,202111,1994,4904,1246,3513,170,493,574,1544,744,2037
410270,202111,513,1337,373,1082,47,158,140,389,187,547
410275,202111,662,1826,469,1411,76,243,187,509,263,752
410280,202111,2531,6512,1681,4861,201,665,705,1855,906,2520
410290,202111,3583,9778,2456,7416,737,2175,557,1680,1294,3855
410300,202111,745,1794,588,1551,61,188,280,658,341,846
410302,202111,358,904,205,615,16,51,103,297,119,348
410304,202111,1349,3396,1126,2979,123,345,704,1787,827,2132
410305,202111,1812,4266,1268,3485,105,334,810,2131,915,2465
410310,202111,2845,7662,2306,6667,295,969,1279,3580,1574,4549
410315,202111,701,1601,444,1193,162,437,94,265,256,702
410320,202111,1099,3003,739,2278,114,396,121,342,235,738
410322,202111,681,1771,354,1023,42,124,148,369,190,493
410330,202111,1625,3891,1116,2949,178,484,311,816,489,1300
410335,202111,906,2376,682,1958,106,318,276,725,382,1043
410337,202111,877,2132,608,1612,88,240,207,498,295,738
410340,202111,537,1503,361,1075,25,75,165,406,190,481
410345,202111,2715,7007,1492,4377,288,875,416,1067,704,1942
410347,202111,799,2033,586,1639,63,214,186,512,249,726
410350,202111,1734,4178,1249,3394,146,437,608,1513,754,1950
410360,202111,4478,10986,3395,9084,517,1448,1340,3494,1857,4942
410370,202111,14825,38947,9558,26780,1101,3338,3994,9729,5095,13067
410380,202111,1794,4363,1299,3500,223,642,396,938,619,1580
410390,202111,2918,7090,1959,5439,368,1147,692,1684,1060,2831
410395,202111,986,2724,791,2330,162,482,290,878,452,1360
410400,202111,7464,18819,5631,15364,763,2220,2914,7442,3677,9662
410405,202111,927,2107,646,1693,103,310,307,749,410,1059
410410,202111,1352,3498,1267,3370,145,457,808,2233,953,2690
410420,202111,12131,32139,9112,26117,1373,4382,3881,9934,5254,14316
410425,202111,3634,9877,2491,7529,402,1294,899,2446,1301,3740
410430,202111,14059,34525,9856,26884,1444,4331,3642,9147,5086,13478
410440,202111,2468,7087,2100,6414,334,1136,1069,3169,1403,4305
410442,202111,2591,7493,2035,6283,519,1655,528,1522,1047,3177
410445,202111,2406,6715,1732,5397,328,1151,258,873,586,2024
410450,202111,1610,3873,1205,3245,235,673,460,1165,695,1838
410460,202111,2372,5767,1733,4663,209,606,802,2022,1011,2628
410465,202111,3001,8432,2361,7230,427,1378,782,2207,1209,3585
410470,202111,2320,6190,1614,4927,397,1401,211,689,608,2090
410480,202111,41096,96900,22561,64127,3260,10287,5392,12913,8652,23200
410490,202111,12293,32974,8792,25864,1521,4762,3535,9572,5056,14334
410500,202111,2004,5094,1340,3865,241,763,345,848,586,1611
410510,202111,1919,4701,1296,3568,251,658,375,1040,626,1698
410520,202111,3177,9679,2779,8885,947,3155,775,2521,1722,5676
410530,202111,1724,4115,791,2184,106,314,202,454,308,768
410540,202111,3012,7938,2062,6027,329,1057,862,2372,1191,3429
410550,202111,8158,21272,5439,15460,893,2768,1472,3530,2365,6298
410560,202111,1630,4188,1184,3280,254,756,372,862,626,1618
410570,202111,2782,7345,2018,6019,563,2023,192,559,755,2582
410580,202111,29025,73231,21219,59123,3495,10572,9763,25236,13258,35808
410590,202111,1662,4637,1154,3462,143,446,344,856,487,1302
410600,202111,1904,4911,1464,4062,340,918,414,1235,754,2153
410610,202111,760,1907,567,1557,61,200,266,669,327,869
410620,202111,2710,7447,1848,5488,403,1286,240,691,643,1977
410630,202111,2719,6860,1777,4995,296,999,409,914,705,1913
410640,202111,5165,11889,3550,9072,753,2206,424,1086,1177,3292
410645,202111,1184,3221,972,2954,267,843,482,1464,749,2307
410650,202111,2569,6801,1772,5212,334,1032,642,1725,976,2757
410655,202111,944,2232,660,1736,30,79,334,835,364,914
410657,202111,649,1738,389,1174,54,171,101,244,155,415
410660,202111,3758,9251,2231,5999,382,1058,698,1685,1080,2743
410670,202111,1084,2652,659,1857,133,361,202,522,335,883
410680,202111,2684,7838,1829,5732,419,1313,263,840,682,2153
410685,202111,556,1387,411,1141,96,294,154,384,250,678
410690,202111,145294,344649,98202,258897,14616,43491,40267,93396,54883,136887
410700,202111,2619,6512,2163,5801,428,1165,924,2388,1352,3553
410710,202111,939,2315,620,1737,110,327,262,661,372,988
410712,202111,695,1890,574,1671,101,329,273,747,374,1076
410715,202111,918,2595,558,1771,63,202,220,660,283,862
410720,202111,3621,9029,2930,7794,450,1421,822,2119,1272,3540
410725,202111,1200,2893,709,1979,149,439,97,222,246,661
410730,202111,782,2045,604,1710,116,381,132,372,248,753
410740,202111,923,2521,678,2053,87,298,274,817,361,1115
410750,202111,1931,4700,1538,3995,250,694,728,1799,978,2493
410752,202111,391,941,216,606,28,83,104,266,132,349
410753,202111,367,1062,260,819,40,141,61,170,101,311
410754,202111,1150,2885,945,2578,68,163,652,1862,720,2025
410755,202111,608,1529,434,1193,55,153,195,487,250,640
410760,202111,3928,9972,2836,7991,634,2073,735,1918,1369,3991
410765,202111,16180,43769,12597,36761,2152,6771,3062,7779,5214,14550
410770,202111,1129,2616,793,2051,78,182,397,1049,475,1231
410773,202111,1361,3518,1190,3260,124,375,765,2028,889,2403
410775,202111,1635,3919,1427,3611,54,161,987,2416,1041,2577
410780,202111,686,1671,462,1251,70,201,134,332,204,533
410785,202111,765,1942,580,1628,89,282,186,518,275,800
410790,202111,974,2700,813,2400,199,596,65,146,264,742
410800,202111,3634,7978,2913,6938,50,147,1900,4378,1950,4525
410810,202111,481,1248,360,1016,31,97,141,336,172,433
410820,202111,1028,2832,540,1585,96,301,100,240,196,541
410830,202111,44323,103902,30591,81206,5980,17477,12008,29645,17988,47122
410832,202111,1096,2826,879,2444,102,326,517,1339,619,1665
410840,202111,9456,23229,5569,15928,1061,3273,1466,3844,2527,7117
410845,202111,1229,2981,950,2551,170,472,406,1052,576,1524
410850,202111,2329,6474,2035,5948,344,1033,927,2659,1271,3692
410855,202111,815,1990,519,1422,59,167,242,600,301,767
410860,202111,4756,11355,3731,9696,251,787,2366,5818,2617,6605
410865,202111,1540,4311,1321,3906,135,421,757,2305,892,2726
410870,202111,1302,3405,1057,2991,102,299,671,1870,773,2169
410880,202111,4963,12853,3418,10033,536,1588,499,1552,1035,3140
410890,202111,1089,2957,839,2483,164,534,278,770,442,1304
410895,202111,1067,3274,894,2907,271,971,223,677,494,1648
410900,202111,916,2392,635,1852,96,290,153,370,249,660
410910,202111,450,1023,276,698,11,43,145,323,156,366
410920,202111,921,2195,670,1788,90,267,327,844,417,1111
410930,202111,1821,4542,1249,3542,285,933,206,548,491,1481
410940,202111,24821,65529,18067,53619,3613,11693,5799,16586,9412,28279
410950,202111,2031,5789,1829,5485,78,228,1497,4470,1575,4698
410960,202111,8457,20192,5908,16028,1327,3988,2277,6130,3604,10118
410965,202111,1264,3086,857,2338,74,225,533,1414,607,1639
410970,202111,4405,11609,3105,9058,668,2302,440,1059,1108,3361
410975,202111,1473,3493,1124,2963,131,375,541,1370,672,1745
410980,202111,8169,19894,5286,14781,568,1747,2404,6049,2972,7796
410990,202111,1522,3553,1033,2779,199,622,407,1063,606,1685
411000,202111,729,1900,515,1507,70,229,163,404,233,633
411005,202111,504,1225,293,785,51,153,96,219,147,372
411007,202111,2649,7032,1985,5799,445,1397,668,1846,1113,3243
411010,202111,4478,13112,3518,11194,846,2917,359,1037,1205,3954
411020,202111,2489,6830,2015,5997,562,1707,519,1521,1081,3228
411030,202111,821,1985,578,1494,50,159,297,670,347,829
411040,202111,1053,2633,563,1586,65,208,171,395,236,603
411050,202111,2114,6393,1711,5523,387,1358,275,750,662,2108
411060,202111,2255,5872,1466,4229,285,914,303,822,588,1736
411065,202111,452,1135,287,808,35,105,117,310,152,415
411070,202111,8086,19934,6381,17102,811,2359,3316,8592,4127,10951
411080,202111,1955,5119,1617,4552,382,1268,367,985,749,2253
411090,202111,853,2241,563,1678,47,165,135,360,182,525
411095,202111,2860,6587,1586,4295,204,573,376,929,580,1502
411100,202111,1304,3327,918,2616,93,309,328,928,421,1237
411110,202111,677,1736,323,978,32,93,23,50,55,143
411120,202111,1455,3834,1197,3380,298,1003,323,803,621,1806
411125,202111,5601,15955,4971,14800,1165,3384,2250,7032,3415,10416
411130,202111,773,1992,546,1570,102,264,184,600,286,864
411140,202111,2412,7114,2003,6283,589,1943,537,1678,1126,3621
411150,202111,4262,10582,2853,7727,496,1555,252,501,748,2056
411155,202111,1068,2702,673,1960,106,319,302,803,408,1122
411160,202111,399,898,271,709,27,66,70,186,97,252
411170,202111,814,2300,625,1892,139,447,229,651,368,1098
411180,202111,6051,15554,4707,13265,738,2218,2255,5922,2993,8140
411190,202111,2001,5021,1475,4048,202,599,597,1461,799,2060
411200,202111,5180,13678,3757,11042,859,2833,867,2174,1726,5007
411210,202111,3535,7789,2413,5981,434,1168,820,1934,1254,3102
411220,202111,943,2345,651,1794,149,458,179,460,328,918
411230,202111,919,2386,671,1923,139,424,213,573,352,997
411240,202111,1721,4005,1178,3058,134,406,582,1381,716,1787
411250,202111,2406,6185,1748,5001,343,1160,522,1380,865,2540
411260,202111,353,875,229,636,23,68,97,241,120,309
411270,202111,2126,5522,1566,4412,221,649,738,1910,959,2559
411275,202111,1590,3580,1106,2801,141,423,545,1269,686,1692
411280,202111,1431,3807,977,2940,247,761,140,381,387,1142
411290,202111,893,2283,566,1654,68,204,283,793,351,997
411295,202111,1342,3322,955,2588,121,347,419,1055,540,1402
411300,202111,1105,2736,720,1991,79,249,320,755,399,1004
411310,202111,957,2145,742,1852,95,246,332,799,427,1045
411320,202111,5841,14643,4244,11796,621,1856,1840,4554,2461,6410
411325,202111,1524,4166,1256,3676,258,719,595,1830,853,2549
411330,202111,3529,9266,2562,7499,583,1845,733,2143,1316,3988
411340,202111,896,2410,530,1600,88,279,144,402,232,681
411342,202111,1121,2676,622,1687,107,299,197,487,304,786
411345,202111,1205,3002,921,2543,60,179,659,1820,719,1999
411350,202111,3101,8105,2004,5890,470,1517,342,870,812,2387
411360,202111,783,1851,569,1519,66,191,246,606,312,797
411370,202111,64359,155805,46807,125784,3470,10914,27655,68630,31125,79544
411373,202111,1516,3753,1226,3323,127,360,637,1765,764,2125
411375,202111,1203,2955,844,2278,135,368,320,844,455,1212
411380,202111,1226,2789,835,2056,47,126,529,1205,576,1331
411390,202111,1602,4310,1250,3551,196,602,477,1167,673,1769
411400,202111,2530,6094,1891,4912,159,494,1015,2461,1174,2955
411410,202111,2913,7919,2149,6325,435,1419,470,1278,905,2697
411420,202111,4679,11144,2504,7039,326,1046,478,974,804,2020
411430,202111,3942,10296,2974,8500,592,1847,973,2535,1565,4382
411435,202111,455,1234,289,891,57,166,84,233,141,399
411440,202111,2720,7374,2173,6347,452,1410,644,1764,1096,3174
411450,202111,2588,6762,1954,5703,232,697,1113,3253,1345,3950
411460,202111,4659,11795,2889,8373,412,1371,562,1399,974,2770
411470,202111,870,2158,641,1739,107,327,243,575,350,902
411480,202111,5656,14596,4084,11644,664,2244,1571,3957,2235,6201
411490,202111,1732,4370,1329,3707,146,477,583,1433,729,1910
411500,202111,1416,3701,964,2745,153,466,189,431,342,897
411510,202111,2477,6066,1984,5260,334,1055,567,1539,901,2594
411520,202111,36244,87295,21409,58370,2423,7584,8556,20491,10979,28075
411530,202111,1022,2600,616,1834,98,317,94,238,192,555
411535,202111,541,1546,354,1104,47,172,107,297,154,469
411540,202111,2767,6646,1910,5113,113,366,1066,2793,1179,3159
411545,202111,958,2701,804,2432,73,233,514,1559,587,1792
411550,202111,760,1872,559,1506,88,242,114,316,202,558
411560,202111,2145,5773,1206,3739,132,452,65,156,197,608
411570,202111,7668,17425,5175,13703,1155,3288,995,2627,2150,5915
411573,202111,817,2156,670,1895,128,373,281,752,409,1125
411575,202111,2153,5691,1600,4595,266,794,430,1176,696,1970
411580,202111,5211,11899,3157,8701,434,1455,567,1357,1001,2812
411585,202111,644,1888,306,979,53,158,54,166,107,324
411590,202111,439,1179,325,957,40,118,171,472,211,590
411600,202111,362,879,224,655,34,99,73,202,107,301
411605,202111,1669,3807,1077,2882,145,470,521,1401,666,1871
411610,202111,2807,6410,1993,4992,63,207,1389,3239,1452,3446
411620,202111,2950,7639,2486,6931,375,1116,1342,3722,1717,4838
411630,202111,869,2165,542,1566,55,194,195,490,250,684
411640,202111,487,1239,336,915,39,111,99,237,138,348
411650,202111,221,631,146,466,26,88,30,71,56,159
411660,202111,974,2461,701,1944,60,175,276,714,336,889
411670,202111,1568,3669,1067,2735,116,306,557,1302,673,1608
411680,202111,1517,3974,1140,3243,200,651,413,1108,613,1759
411690,202111,4231,10453,3171,8635,693,1863,807,2396,1500,4259
411695,202111,675,1968,466,1428,51,167,187,521,238,688
411700,202111,1834,4602,1216,3420,257,752,193,522,450,1274
411705,202111,2444,6978,2052,6298,412,1158,1117,3728,1529,4886
411710,202111,2151,5354,1462,4056,318,878,373,983,691,1861
411720,202111,1160,2670,814,2059,134,347,311,760,445,1107
411721,202111,1081,2600,815,2115,136,333,259,663,395,996
411722,202111,975,2560,547,1616,95,309,184,450,279,759
411725,202111,1311,3608,868,2723,202,683,176,521,378,1204
411727,202111,1592,4328,1036,3141,226,691,95,254,321,945
411729,202111,699,1677,395,1080,52,178,134,308,186,486
411730,202111,5680,14601,4391,12153,828,2499,2009,5382,2837,7881
411740,202111,549,1396,290,838,80,208,53,142,133,350
411745,202111,853,2386,592,1802,66,230,148,351,214,581
411750,202111,6122,15767,4435,12477,575,1726,2116,5573,2691,7299
411760,202111,7376,19083,5687,16214,1721,5124,1021,3330,2742,8454
411770,202111,3360,9431,2422,7389,512,1676,437,1166,949,2842
411780,202111,2832,7788,2447,7092,686,2084,788,2325,1474,4409
411790,202111,3099,7319,1769,4930,348,1093,452,1075,800,2168
411800,202111,1197,3375,839,2503,137,455,162,413,299,868
411810,202111,1688,4273,1257,3431,222,639,522,1311,744,1950
411820,202111,13175,36137,10775,31975,2520,8005,4765,13630,7285,21635
411830,202111,573,1393,426,1131,101,281,60,167,161,448
411840,202111,13225,34415,9069,25801,1451,4449,2577,6513,4028,10962
411845,202111,651,1807,390,1205,60,213,95,246,155,459
411850,202111,8045,19995,5442,15407,1250,3824,1029,2633,2279,6457
411860,202111,749,2036,540,1608,75,226,117,313,192,539
411870,202111,623,1766,440,1363,88,283,95,283,183,566
411880,202111,2478,5940,1766,4796,255,749,678,1724,933,2473
411885,202111,1186,3039,859,2446,127,425,260,654,387,1079
411890,202111,1519,3961,1091,3173,187,607,112,302,299,909
411900,202111,878,2359,552,1667,123,389,102,299,225,688
411910,202111,1160,3309,843,2660,182,679,313,889,495,1568
411915,202111,16605,40178,11438,30750,1650,4859,4817,11627,6467,16486
411920,202111,1273,3531,1036,3067,219,753,388,1046,607,1799
411925,202111,529,1363,380,1092,81,240,158,419,239,659
411930,202111,5297,15421,4416,13797,1799,6130,295,1109,2094,7239
411940,202111,3497,9914,2702,8232,623,1907,904,2501,1527,4408
411950,202111,15658,41274,12932,36756,1580,5081,7732,20914,9312,25995
411960,202111,6485,16701,5103,13992,946,2737,2037,5342,2983,8079
411965,202111,508,1365,363,1076,51,167,164,448,215,615
411970,202111,1268,2798,977,2411,188,430,414,1184,602,1614
411980,202111,1576,3721,1138,3010,289,753,413,1073,702,1826
411990,202111,40985,104499,26423,78247,4739,15441,9427,26108,14166,41549
411995,202111,4434,10603,3401,8981,964,2773,848,2137,1812,4910
412000,202111,1949,4436,1345,3422,36,114,937,2214,973,2328
412010,202111,665,1975,494,1596,77,261,118,323,195,584
412015,202111,571,1568,460,1368,68,202,248,740,316,942
412020,202111,476,1303,300,934,42,149,128,370,170,519
412030,202111,641,1786,480,1492,68,218,172,513,240,731
412033,202111,1008,2600,721,2032,89,261,266,629,355,890
412035,202111,763,2035,489,1536,66,217,245,729,311,946
412040,202111,723,1900,398,1219,55,162,51,141,106,303
412050,202111,1683,4128,1133,3115,251,744,240,660,491,1404
412060,202111,7796,21895,6415,19146,1701,5697,1638,4656,3339,10353
412065,202111,664,1811,486,1451,96,316,117,342,213,658
412070,202111,1304,3326,1016,2773,137,402,388,962,525,1364
412080,202111,2475,6588,1731,5131,245,772,580,1515,825,2287
412085,202111,344,826,119,364,14,42,24,58,38,100
412090,202111,6699,16751,4896,13479,1086,3132,1797,4971,2883,8103
412100,202111,1877,4845,1388,3962,442,1424,304,897,746,2321
412110,202111,990,2541,634,1819,87,269,211,568,298,837
412120,202111,2288,6305,1722,5244,350,1205,440,1112,790,2317
412125,202111,701,1944,471,1452,89,268,92,280,181,548
412130,202111,866,2100,589,1589,93,239,146,401,239,640
412135,202111,653,1703,315,933,48,155,93,234,141,389
412140,202111,1912,4554,1319,3534,193,609,280,716,473,1325
412150,202111,2990,7539,2465,6570,561,1544,1094,2732,1655,4276
412160,202111,954,2903,529,1750,61,231,58,142,119,373
412170,202111,4662,12445,3898,11206,703,2285,1662,4373,2365,6658
412175,202111,1394,3854,1155,3448,260,820,458,1349,718,2169
412180,202111,1794,4841,1311,3958,158,544,570,1583,728,2127
412190,202111,3563,8766,2612,7100,319,943,1073,2853,1392,3796
412200,202111,2014,5668,1323,4107,326,1105,187,532,513,1637
412210,202111,716,1646,441,1195,61,187,176,421,237,608
412215,202111,3437,9082,2530,7295,620,1778,947,2880,1567,4658
412217,202111,1043,2670,867,2354,39,103,616,1606,655,1709
412220,202111,5988,16429,4911,14488,1369,3930,1398,4406,2767,8336
412230,202111,2866,8155,2235,6946,340,1210,512,1348,852,2558
412240,202111,8105,20549,5154,14716,867,2659,1513,3839,2380,6498
412250,202111,2149,5402,1574,4291,367,1043,289,702,656,1745
412260,202111,1379,3555,1035,2865,171,476,303,791,474,1267
412265,202111,996,2603,784,2236,173,508,321,872,494,1380
412270,202111,1080,2906,697,2103,82,277,266,730,348,1007
412280,202111,442,1173,342,1005,87,264,89,243,176,507
412290,202111,1094,2742,769,2169,120,373,260,667,380,1040
412300,202111,1781,4549,1252,3630,243,726,284,834,527,1560
412310,202111,769,2149,580,1764,101,356,168,466,269,822
412320,202111,825,2080,528,1474,43,145,151,414,194,559
412330,202111,1685,4378,1159,3413,246,764,391,1167,637,1931
412340,202111,1322,3519,882,2566,109,362,116,310,225,672
412350,202111,3230,8301,2090,6043,366,1160,383,975,749,2135
412360,202111,279,746,201,580,6,28,133,357,139,385
412370,202111,894,2487,606,1874,118,396,77,226,195,622
412380,202111,1644,4384,1158,3417,289,894,114,372,403,1266
412382,202111,514,1225,340,941,39,134,154,345,193,479
412385,202111,2380,6279,1934,5448,635,1709,573,1788,1208,3497
412390,202111,2658,6205,2130,5394,355,936,724,1815,1079,2751
412395,202111,746,2051,539,1592,78,196,228,685,306,881
412400,202111,977,2516,702,1991,130,420,203,540,333,960
412402,202111,2452,5902,1687,4652,434,1187,245,721,679,1908
412405,202111,3308,8534,2157,6406,525,1769,146,411,671,2180
412410,202111,6685,16998,4888,14042,771,2574,1565,4119,2336,6693
412420,202111,567,1397,373,1001,27,80,185,427,212,507
412430,202111,618,1540,334,958,35,106,134,352,169,458
412440,202111,2995,7763,2024,5971,463,1440,439,1305,902,2745
412450,202111,530,1487,350,1038,41,122,34,71,75,193
412460,202111,1166,2932,906,2492,162,491,403,1046,565,1537
412470,202111,1642,4980,1343,4319,287,974,283,885,570,1859
412480,202111,1165,2969,781,2182,136,411,269,651,405,1062
412490,202111,1416,3378,1104,2826,137,357,565,1346,702,1703
412500,202111,2154,5307,1618,4332,321,901,471,1125,792,2026
412510,202111,2048,6075,1403,4477,313,1048,173,488,486,1536
412520,202111,1396,3459,785,2207,174,480,110,293,284,773
412530,202111,730,1895,523,1480,78,252,111,298,189,550
412535,202111,853,2186,578,1656,114,362,110,250,224,612
412540,202111,1224,3040,884,2446,91,319,289,845,380,1164
412545,202111,725,1846,502,1408,88,266,134,363,222,629
412550,202111,36980,95953,26348,74946,4026,12369,10952,27979,14978,40348
412555,202111,311,805,209,586,25,78,65,148,90,226
412560,202111,5309,14749,3982,11737,704,2280,1175,3422,1879,5702
412570,202111,4727,11696,2757,7915,481,1605,357,1019,838,2624
412575,202111,1105,2730,884,2362,124,356,468,1179,592,1535
412580,202111,1572,3952,1115,3100,89,283,611,1603,700,1886
412590,202111,430,1120,242,737,27,88,29,76,56,164
412600,202111,1750,4532,1345,3761,166,515,657,1693,823,2208
412610,202111,917,2387,656,1835,80,235,292,704,372,939
412620,202111,1349,3430,1037,2959,192,627,330,856,522,1483
412625,202111,9279,24073,5712,16976,782,2581,339,937,1121,3518
412627,202111,1186,3271,773,2420,143,495,215,660,358,1155
412630,202111,3010,8614,2162,6803,382,1256,591,1672,973,2928
412635,202111,454,1206,298,867,35,112,97,220,132,332
412640,202111,1109,2860,656,1907,84,255,170,427,254,682
412650,202111,1793,4734,1407,3964,230,736,541,1319,771,2055
412660,202111,2735,6884,1983,5459,238,686,714,1769,952,2455
412665,202111,423,1026,325,854,75,204,129,332,204,536
412667,202111,1917,4896,1391,3853,194,579,600,1587,794,2166
412670,202111,913,2116,595,1601,111,326,152,385,263,711
412680,202111,2230,5753,1538,4454,184,628,539,1340,723,1968
412690,202111,1221,3165,863,2468,148,461,286,759,434,1220
412700,202111,2018,5199,1689,4687,211,645,922,2491,1133,3136
412710,202111,6234,17608,4582,14090,823,2771,1185,3119,2008,5890
412720,202111,1265,3572,986,2978,145,473,252,619,397,1092
412730,202111,2727,6961,1913,5380,318,1030,753,1928,1071,2958
412740,202111,2052,5611,1412,4321,215,724,188,590,403,1314
412750,202111,4251,10817,3445,9645,312,965,2225,5956,2537,6921
412760,202111,3105,8237,2571,7334,477,1514,1371,3655,1848,5169
412770,202111,11486,29109,6214,18621,807,2599,1295,3175,2102,5774
412780,202111,1262,3273,959,2727,198,620,351,945,549,1565
412785,202111,2306,5313,1633,4203,194,488,1056,2685,1250,3173
412788,202111,1512,4163,1235,3679,338,997,452,1315,790,2312
412790,202111,1440,3717,842,2521,118,398,268,682,386,1080
412795,202111,1330,3394,722,2159,107,338,121,346,228,684
412796,202111,2379,6601,1976,5893,416,1307,600,1628,1016,2935
412800,202111,3922,9340,2749,7196,284,859,1316,3035,1600,3894
412810,202111,13175,33139,8628,24044,1027,3321,3435,8404,4462,11725
412820,202111,6598,17711,4668,13822,1127,3566,1315,3821,2442,7387
412830,202111,355,992,255,781,37,110,64,185,101,295
412840,202111,1995,4811,1426,3732,152,451,703,1655,855,2106
412850,202111,2917,7458,2147,6166,298,926,936,2558,1234,3484
412853,202111,1613,3983,1337,3495,181,527,698,1597,879,2124
412855,202111,1432,3645,838,2398,115,383,209,499,324,882
412860,202111,787,1935,533,1515,82,247,269,706,351,953
412862,202111,707,1717,475,1327,103,290,172,453,275,743
412863,202111,1342,3881,1176,3567,301,956,386,1122,687,2078
412865,202111,748,1995,544,1584,165,501,116,345,281,846
412870,202111,905,2318,652,1903,182,585,159,505,341,1090
412880,202111,941,2495,640,1906,120,393,142,369,262,762
420005,202111,437,1256,258,843,30,96,121,396,151,492
420010,202111,3498,8354,2299,6324,128,369,1693,4696,1821,5065
420020,202111,457,1385,303,991,44,170,76,190,120,360
420030,202111,101,355,63,259,17,78,16,66,33,144
420040,202111,536,1580,328,1120,63,231,29,79,92,310
420050,202111,742,1665,494,1232,103,280,271,605,374,885
420055,202111,167,505,88,312,19,84,24,75,43,159
420060,202111,118,324,77,226,8,24,19,47,27,71
420070,202111,782,2267,578,1842,107,344,236,737,343,1081
420075,202111,82,207,42,128,6,23,11,17,17,40
420080,202111,412,1135,314,910,74,240,119,323,193,563
420090,202111,448,1357,284,971,64,230,55,159,119,389
420100,202111,1350,3352,1131,3023,66,189,906,2385,972,2574
420110,202111,271,848,239,779,40,136,125,400,165,536
420120,202111,630,1673,430,1247,56,179,228,583,284,762
420125,202111,380,1126,261,858,68,244,81,247,149,491
420127,202111,329,839,133,396,18,61,52,140,70,201
420130,202111,3965,10670,3034,9139,458,1616,1359,3705,1817,5321
420140,202111,4091,10700,3024,8884,811,2673,558,1652,1369,4325
420150,202111,694,1729,484,1378,46,158,287,779,333,937
420160,202111,191,451,69,212,8,28,18,54,26,82
420165,202111,170,478,107,340,21,62,35,96,56,158
420170,202111,295,907,197,661,29,108,62,175,91,283
420180,202111,173,546,105,374,16,56,26,87,42,143
420190,202111,215,651,125,423,28,103,48,154,76,257
420195,202111,1700,4257,1288,3615,321,1027,376,977,697,2004
420200,202111,5614,13344,3511,9486,449,1428,1526,3556,1975,4984
420205,202111,2069,5410,1406,4066,208,644,733,2090,941,2734
420207,202111,2103,5320,1326,3842,203,667,548,1451,751,2118
420208,202111,339,941,196,661,60,211,45,124,105,335
420209,202111,161,503,103,320,13,45,52,141,65,186
420210,202111,3590,9000,2522,7253,364,1211,1300,3538,1664,4749
420213,202111,839,2468,703,2199,146,512,275,807,421,1319
420215,202111,219,637,152,484,36,127,39,116,75,243
420220,202111,317,923,199,666,29,123,87,256,116,379
420230,202111,5608,14743,4292,12309,569,1775,2338,6341,2907,8116
420240,202111,15422,41983,9910,29273,1176,3962,4760,12168,5936,16130
420243,202111,405,1102,333,965,52,177,211,581,263,758
420245,202111,1646,4115,1229,3395,96,324,771,1979,867,2303
420250,202111,481,1308,413,1195,53,175,265,730,318,905
420253,202111,480,1139,337,933,35,91,192,537,227,628
420257,202111,165,419,106,317,13,50,60,175,73,225
420260,202111,1190,3007,882,2593,109,378,613,1761,722,2139
420270,202111,580,1497,303,883,39,129,118,315,157,444
420280,202111,1395,4023,1105,3416,180,637,449,1304,629,1941
420285,202111,135,302,69,195,10,44,25,45,35,89
420287,202111,471,1059,336,879,82,225,130,341,212,566
420290,202111,5153,14344,3978,11749,548,1832,2311,6321,2859,8153
420300,202111,7888,21833,4621,14123,818,2761,1476,3893,2294,6654
420310,202111,857,1936,456,1231,42,132,257,643,299,775
420315,202111,824,2239,557,1789,87,302,267,837,354,1139
420320,202111,5651,14750,4044,12120,1068,3559,1050,2912,2118,6471
420325,202111,357,996,252,784,32,105,106,303,138,408
420330,202111,1021,2919,646,2115,102,374,202,606,304,980
420340,202111,973,2631,730,2196,159,481,156,415,315,896
420350,202111,1247,3137,924,2570,76,250,643,1749,719,1999
420360,202111,3083,8250,1659,5189,296,1010,116,344,412,1354
420370,202111,1313,3373,1071,2968,75,260,788,2087,863,2347
420380,202111,4644,11880,3138,9135,604,1863,1258,3429,1862,5292
420390,202111,1103,2651,769,1987,129,388,311,577,440,965
420395,202111,1245,3470,853,2667,130,448,136,300,266,748
420400,202111,1083,2932,762,2290,121,415,344,973,465,1388
420410,202111,602,1548,468,1275,36,105,334,893,370,998
420415,202111,301,865,221,696,52,181,86,281,138,462
420417,202111,600,1739,466,1471,126,418,177,568,303,986
420419,202111,144,508,114,436,39,158,9,36,48,194
420420,202111,12772,32654,8549,24880,2249,7389,2512,6606,4761,13995
420425,202111,664,1748,459,1317,32,107,240,658,272,765
420430,202111,3290,8638,1969,5812,418,1302,671,1787,1089,3089
420435,202111,289,731,149,466,21,78,72,210,93,288
420440,202111,738,1919,465,1362,132,399,148,402,280,801
420445,202111,267,636,176,475,29,79,76,180,105,259
420450,202111,789,2272,562,1774,86,335,207,551,293,886
420455,202111,2154,5055,1577,4201,292,791,722,1889,1014,2680
420460,202111,9786,25550,7389,21137,1000,3243,3870,10496,4870,13739
420470,202111,635,1628,328,1004,61,214,63,157,124,371
420475,202111,70,187,28,92,7,25,3,9,10,34
420480,202111,5488,13255,3413,9857,627,1961,1278,3619,1905,5580
420490,202111,393,1068,275,816,53,168,113,320,166,488
420500,202111,1372,3660,881,2778,137,484,407,1257,544,1741
420510,202111,166,466,86,283,13,53,23,69,36,122
420515,202111,87,240,55,170,8,35,17,53,25,88
420517,202111,778,2103,654,1869,77,229,405,1159,482,1388
420519,202111,326,779,236,646,20,64,147,401,167,465
420520,202111,284,746,148,482,17,60,9,25,26,85
420530,202111,840,2402,571,1814,75,287,228,622,303,909
420535,202111,234,678,97,324,17,58,38,122,55,180
420540,202111,41399,97723,27576,74323,3768,11402,10509,24466,14277,35868
420543,202111,229,661,173,532,25,80,79,218,104,298
420545,202111,1333,3914,998,3179,182,644,347,986,529,1630
420550,202111,3780,9787,2490,7644,365,1324,1141,3505,1506,4829
420555,202111,315,889,226,704,24,79,130,392,154,471
420560,202111,404,992,269,790,49,151,159,470,208,621
420570,202111,2680,6936,2063,5798,321,1013,978,2632,1299,3645
420580,202111,1864,4779,1306,3870,276,871,383,1120,659,1991
420590,202111,2900,7697,1758,5229,276,975,492,1130,768,2105
420600,202111,1121,3133,872,2675,96,366,534,1545,630,1911
420610,202111,402,1147,260,837,66,212,89,300,155,512
420620,202111,808,1939,550,1525,121,346,203,561,324,907
420630,202111,957,2868,706,2265,78,277,417,1268,495,1545
420640,202111,523,1389,266,864,84,275,48,145,132,420
420650,202111,3865,10001,2453,7099,353,1140,994,2484,1347,3624
420660,202111,450,1146,286,798,57,156,61,160,118,316
420665,202111,708,1812,468,1402,81,268,204,546,285,814
420670,202111,1316,3595,826,2556,124,470,286,736,410,1206
420675,202111,196,509,117,362,16,63,62,175,78,238
420680,202111,321,725,170,513,28,92,85,245,113,337
420690,202111,868,2525,541,1774,71,277,143,396,214,673
420700,202111,2838,7326,2172,6220,211,672,1374,3806,1585,4478
420710,202111,1120,3094,884,2600,92,339,528,1364,620,1703
420720,202111,1255,3403,915,2809,145,488,483,1384,628,1872
420730,202111,3305,8459,2472,7089,414,1321,1319,3599,1733,4920
420740,202111,518,1516,284,996,58,224,17,68,75,292
420750,202111,2075,5856,1345,4188,223,821,538,1494,761,2315
420757,202111,86,205,38,111,3,5,18,53,21,58
420760,202111,323,913,178,535,33,112,55,141,88,253
420765,202111,491,1379,244,787,26,84,128,401,154,485
420768,202111,1412,3841,1231,3547,143,398,916,2646,1059,3044
420770,202111,439,1204,198,690,21,83,59,199,80,282
420775,202111,292,841,199,627,36,132,75,194,111,326
420780,202111,1003,2796,587,1826,89,293,84,231,173,524
420785,202111,215,561,157,442,13,50,75,170,88,220
420790,202111,1072,3122,802,2575,128,477,458,1391,586,1868
420800,202111,703,1716,385,1103,82,260,171,466,253,726
420810,202111,1544,4618,1273,4084,324,1211,517,1418,841,2629
420820,202111,13619,33569,9887,27477,1674,5146,4621,11905,6295,17051
420830,202111,4837,12399,3596,10200,618,1856,1512,4098,2130,5954
420840,202111,502,1502,248,916,58,214,17,69,75,283
420845,202111,2734,6863,1761,5132,326,1168,734,1979,1060,3147
420850,202111,1154,3585,719,2451,112,409,165,493,277,902
420860,202111,389,1005,223,707,33,105,57,159,90,264
420870,202111,827,2291,597,1836,143,466,196,546,339,1012
420880,202111,1103,3248,849,2724,169,638,327,944,496,1582
420890,202111,8469,22717,5277,16085,718,2374,1822,4909,2540,7283
420895,202111,184,525,116,350,29,88,37,111,66,199
420900,202111,1608,3902,970,2798,123,432,449,1112,572,1544
420910,202111,34250,88854,22048,65536,3098,10439,9102,23691,12200,34130
420915,202111,529,1864,389,1467,62,230,207,787,269,1017
420917,202111,472,1185,215,590,38,101,99,273,137,374
420920,202111,87,227,39,125,2,5,9,26,11,31
420930,202111,17549,44472,12541,35703,2079,6524,5739,15325,7818,21849
420940,202111,3374,8115,2063,5875,444,1428,426,970,870,2398
420945,202111,153,433,112,341,20,68,44,124,64,192
420950,202111,372,1049,222,709,28,105,62,181,90,286
420960,202111,1110,2684,790,2147,112,352,367,898,479,1250
420970,202111,2531,6681,1720,5203,445,1384,472,1447,917,2831
420980,202111,282,929,243,845,107,380,58,207,165,587
420985,202111,340,956,186,631,40,150,48,145,88,295
420990,202111,341,1040,192,675,28,94,40,142,68,236
421000,202111,582,1706,429,1374,91,307,96,263,187,570
421003,202111,478,1121,163,471,3,8,19,42,22,50
421005,202111,83,239,59,199,15,51,23,78,38,129
421010,202111,3503,9378,2511,7530,459,1541,723,1885,1182,3426
421020,202111,403,1228,319,1071,45,177,156,489,201,666
421030,202111,870,2469,670,2084,166,585,253,720,419,1305
421040,202111,675,1588,415,1187,30,95,262,732,292,827
421050,202111,1103,2929,733,2124,135,417,280,729,415,1146
421055,202111,179,483,102,308,16,53,58,161,74,214
421060,202111,705,1997,492,1543,85,302,241,691,326,993
421070,202111,697,2045,425,1360,63,224,172,504,235,728
421080,202111,524,1487,427,1305,47,178,243,713,290,891
421085,202111,395,1089,164,543,17,52,30,84,47,136
421090,202111,277,707,149,417,13,45,51,124,64,169
421100,202111,824,1826,360,1055,79,259,98,230,177,489
421105,202111,1674,4434,1177,3501,174,559,576,1598,750,2157
421110,202111,1204,3096,970,2751,72,234,627,1842,699,2076
421120,202111,1107,3249,767,2494,114,401,215,595,329,996
421125,202111,301,768,216,617,73,241,74,178,147,419
421130,202111,5284,14971,4330,13078,948,3216,2185,6176,3133,9392
421140,202111,357,950,223,664,40,118,85,233,125,351
421145,202111,448,1197,285,844,61,191,77,199,138,390
421150,202111,703,1915,474,1458,73,257,203,549,276,806
421160,202111,546,1495,414,1238,60,205,250,699,310,904
421165,202111,238,688,147,466,28,93,58,171,86,264
421170,202111,1139,3056,959,2765,140,397,596,1756,736,2153
421175,202111,999,2418,598,1791,110,376,272,779,382,1155
421180,202111,410,1056,229,701,37,138,108,294,145,432
421185,202111,329,827,225,620,27,80,127,336,154,416
421187,202111,278,849,177,592,30,98,59,193,89,291
421189,202111,409,1151,320,976,53,168,120,340,173,508
421190,202111,12404,32780,8576,25506,1456,4638,3314,8963,4770,13601
421200,202111,737,2020,607,1804,93,335,348,970,441,1305
421205,202111,196,514,139,422,23,80,65,186,88,266
421210,202111,1135,2811,649,1975,121,381,223,666,344,1047
421220,202111,1439,4159,1117,3505,258,887,369,1034,627,1921
421223,202111,325,876,202,654,47,148,99,321,146,469
421225,202111,882,2517,752,2302,111,405,464,1390,575,1795
421227,202111,730,2026,466,1470,77,261,215,705,292,966
421230,202111,604,1536,389,1133,80,263,141,404,221,667
421240,202111,305,862,147,494,16,66,30,89,46,155
421250,202111,2212,5474,1571,4443,180,548,937,2548,1117,3096
421260,202111,229,716,51,187,11,51,5,14,16,65
421265,202111,735,1872,642,1741,22,53,556,1500,578,1553
421270,202111,366,963,161,538,32,110,50,154,82,264
421280,202111,2137,5535,1610,4679,217,756,909,2483,1126,3239
421290,202111,1039,2816,515,1559,107,347,101,266,208,613
421300,202111,292,752,138,444,12,47,19,57,31,104
421310,202111,203,583,140,457,29,96,69,220,98,316
421315,202111,250,632,167,465,43,117,48,133,91,250
421320,202111,643,2009,341,1127,31,87,33,58,64,145
421330,202111,640,1868,464,1498,94,332,122,352,216,684
421335,202111,372,1111,299,982,55,203,128,398,183,601
421340,202111,1465,3929,1051,3193,178,614,498,1389,676,2003
421350,202111,1630,4114,1058,3126,202,655,398,1112,600,1767
421360,202111,2358,6133,1403,4217,263,906,514,1344,777,2250
421370,202111,779,2431,482,1646,80,293,147,417,227,710
421380,202111,877,2231,755,2041,97,296,447,1151,544,1447
421390,202111,168,442,64,213,15,41,22,64,37,105
421400,202111,449,1260,296,951,55,205,148,437,203,642
421410,202111,187,491,84,283,21,69,21,71,42,140
421415,202111,192,536,133,386,19,62,45,107,64,169
421420,202111,582,1535,468,1318,43,137,286,786,329,923
421430,202111,101,315,72,242,10,36,16,47,26,83
421440,202111,672,1774,398,1248,72,225,159,476,231,701
421450,202111,496,1424,283,942,29,106,39,131,68,237
421460,202111,370,1117,201,745,13,51,21,60,34,111
421470,202111,323,869,205,630,30,90,71,231,101,321
421480,202111,2885,7596,1929,5667,337,1157,780,2078,1117,3235
421490,202111,117,390,68,249,10,33,13,45,23,78
421500,202111,2250,6424,1516,4873,351,1296,351,974,702,2270
421505,202111,312,837,259,762,32,117,170,473,202,590
421507,202111,444,1211,252,809,49,178,95,274,144,452
421510,202111,381,1037,242,709,40,118,121,327,161,445
421520,202111,511,1340,320,912,37,105,155,395,192,500
421530,202111,302,880,169,582,24,103,33,86,57,189
421535,202111,404,1042,248,750,38,135,128,368,166,503
421540,202111,327,758,179,527,25,84,62,165,87,249
421545,202111,636,1853,474,1563,100,402,226,678,326,1080
421550,202111,2163,5624,1738,4966,335,1010,938,2647,1273,3657
421555,202111,174,531,67,239,7,28,8,14,15,42
421560,202111,88,293,60,223,9,39,21,71,30,110
421565,202111,975,2437,661,1944,170,564,220,605,390,1169
421567,202111,466,1407,322,1036,95,330,98,284,193,614
421568,202111,341,985,233,735,42,152,88,256,130,408
421569,202111,156,441,73,236,9,28,44,146,53,174
421570,202111,1388,3727,978,2878,207,659,324,857,531,1516
421575,202111,303,865,227,666,29,96,115,308,144,404
421580,202111,4593,12190,2936,8796,406,1387,1115,2833,1521,4220
421590,202111,171,508,127,412,30,110,47,145,77,255
421600,202111,598,1559,402,1150,75,248,144,350,219,598
421605,202111,731,1891,528,1567,104,288,251,785,355,1073
421610,202111,1074,2832,719,2162,128,419,210,613,338,1032
421620,202111,4013,10435,2480,7657,465,1652,814,2385,1279,4037
421625,202111,135,368,66,199,8,25,21,54,29,79
421630,202111,2757,7080,1759,5168,301,1040,639,1572,940,2612
421635,202111,275,727,192,557,14,44,119,315,133,359
421640,202111,694,1844,507,1566,115,399,203,611,318,1010
421650,202111,2612,6993,1780,5476,381,1342,573,1556,954,2898
421660,202111,11398,30943,8077,24443,1153,3898,3702,10158,4855,14056
421670,202111,798,2232,574,1710,101,338,264,740,365,1078
421680,202111,1244,3159,964,2696,133,406,639,1658,772,2064
421690,202111,1451,4012,996,3077,174,590,329,990,503,1580
421700,202111,578,1682,412,1314,83,295,127,372,210,667
421710,202111,205,639,102,331,19,64,29,81,48,145
421715,202111,132,336,99,268,22,61,58,150,80,211
421720,202111,2133,5640,1251,3769,293,936,313,817,606,1753
421725,202111,274,657,156,460,17,49,77,201,94,250
421730,202111,424,1165,249,705,35,104,135,346,170,450
421740,202111,814,2256,540,1675,113,369,165,465,278,834
421750,202111,900,2098,440,1259,88,274,177,467,265,741
421755,202111,173,473,95,288,16,54,38,100,54,154
421760,202111,1055,2714,719,2110,130,412,240,592,370,1004
421770,202111,2491,6433,1778,5205,460,1278,616,1932,1076,3210
421775,202111,216,557,132,396,16,49,55,155,71,204
421780,202111,877,2515,573,1868,106,380,237,693,343,1073
421790,202111,897,2397,506,1647,103,351,204,642,307,993
421795,202111,178,493,124,363,23,74,38,99,61,173
421800,202111,2825,7414,2066,6027,261,859,1193,3287,1454,4146
421810,202111,649,1745,440,1354,45,161,252,759,297,920
421820,202111,1040,2978,640,2013,106,375,220,577,326,952
421825,202111,1429,3798,1267,3558,98,302,947,2593,1045,2895
421830,202111,2052,5855,1657,5118,334,1105,614,1868,948,2973
421835,202111,247,598,166,469,36,121,67,175,103,296
421840,202111,214,672,148,524,23,87,36,114,59,201
421850,202111,394,1097,225,759,54,207,54,144,108,351
421860,202111,314,868,184,598,27,93,64,184,91,277
421870,202111,4809,11810,3536,9438,475,1501,1941,4582,2416,6083
421875,202111,325,940,133,407,18,54,33,83,51,137
421880,202111,695,1929,474,1450,93,315,136,390,229,705
421885,202111,237,651,150,455,35,107,51,139,86,246
421890,202111,918,2623,680,2150,106,399,386,1152,492,1551
421895,202111,420,1045,363,970,37,103,247,697,284,800
421900,202111,1093,2859,841,2348,104,324,414,1046,518,1370
421910,202111,338,979,220,697,28,108,50,125,78,233
421915,202111,400,1120,242,758,54,168,46,133,100,301
421917,202111,597,1339,337,1008,121,382,77,240,198,622
421920,202111,385,1148,278,933,110,382,83,278,193,660
421930,202111,2783,6914,1520,4532,315,1053,545,1402,860,2455
421935,202111,418,1269,335,1095,67,219,189,616,256,835
421940,202111,388,1110,177,559,27,90,40,98,67,188
421950,202111,3250,8019,1843,5339,350,1102,460,1128,810,2230
421960,202111,182,441,94,279,14,52,28,62,42,114
421970,202111,2009,5067,1278,3573,233,765,534,1304,767,2069
421985,202111,314,857,201,629,25,83,78,227,103,310
422000,202111,2021,5070,1638,4482,146,474,1136,3055,1282,3529
430003,202111,591,1540,390,1183,73,227,174,526,247,753
430005,202111,268,707,168,528,26,89,80,247,106,336
430010,202111,1849,4253,1459,3658,289,709,834,2107,1123,2816
430020,202111,605,1355,452,1150,47,139,298,721,345,860
430030,202111,1016,2340,569,1551,139,401,198,498,337,899
430040,202111,10896,25043,6669,17835,1731,4885,1088,2970,2819,7855
430045,202111,498,1225,360,972,29,88,248,649,277,737
430047,202111,254,546,95,255,22,50,26,74,48,124
430050,202111,913,2269,547,1538,107,325,159,412,266,737
430055,202111,283,683,142,390,17,55,74,174,91,229
430057,202111,85,176,30,81,9,28,5,10,14,38
430060,202111,18714,48304,14576,41782,2826,8409,6977,19724,9803,28133
430063,202111,822,2246,672,1945,142,405,357,1040,499,1445
430064,202111,1190,3101,882,2501,175,511,406,1128,581,1639
430066,202111,100,210,71,167,9,24,54,120,63,144
430070,202111,748,1899,138,435,22,86,25,57,47,143
430080,202111,950,2291,573,1553,99,316,309,716,408,1032
430085,202111,947,2038,556,1418,93,240,252,626,345,866
430087,202111,876,2065,731,1876,67,172,517,1321,584,1493
430090,202111,492,1267,182,587,18,77,46,131,64,208
430100,202111,936,2202,570,1531,100,304,168,384,268,688
430105,202111,1346,3426,910,2674,125,414,437,1228,562,1642
430107,202111,183,524,98,302,18,55,27,73,45,128
430110,202111,2340,5729,1720,4794,328,939,778,2108,1106,3047
430120,202111,1312,3695,864,2602,148,443,384,1136,532,1579
430130,202111,3706,8153,2738,6815,870,2213,490,1483,1360,3696
430140,202111,1063,2656,749,2093,161,432,376,1028,537,1460
430150,202111,584,1481,318,952,70,216,87,269,157,485
430155,202111,250,632,119,356,19,57,24,59,43,116
430160,202111,21633,48509,17041,42087,1880,4918,10519,25510,12399,30428
430163,202111,3410,7677,2398,6122,69,225,1820,4537,1889,4762
430165,202111,324,795,108,338,14,33,15,44,29,77
430170,202111,991,2574,351,1172,61,206,37,101,98,307
430175,202111,729,1999,619,1770,144,382,291,862,435,1244
430180,202111,703,1677,531,1381,83,196,298,798,381,994
430185,202111,721,1806,369,1059,105,269,49,149,154,418
430187,202111,826,1717,599,1435,64,163,372,879,436,1042
430190,202111,1503,3735,1186,3241,237,696,554,1430,791,2126
430192,202111,129,340,45,130,7,21,9,21,16,42
430195,202111,437,1255,71,242,9,34,7,14,16,48
430200,202111,1095,3112,862,2694,286,924,207,684,493,1608
430205,202111,474,1169,424,1078,13,43,382,952,395,995
430210,202111,6504,16484,4307,11862,683,2000,1253,2732,1936,4732
430215,202111,331,833,211,599,35,98,81,231,116,329
430220,202111,672,1645,213,688,26,85,51,135,77,220
430222,202111,215,562,151,441,23,71,47,135,70,206
430223,202111,265,672,202,566,16,40,116,319,132,359
430225,202111,16,32,10,23,0,0,7,16,7,16
430230,202111,2063,5404,1702,4852,143,451,1264,3531,1407,3982
430235,202111,396,1078,250,764,44,143,62,160,106,303
430237,202111,541,1231,406,1014,16,45,317,775,333,820
430240,202111,1421,3247,804,2185,90,283,410,1000,500,1283
430245,202111,759,2018,594,1710,123,367,314,917,437,1284
430250,202111,973,2274,701,1851,243,677,55,125,298,802
430258,202111,146,402,106,318,8,19,55,161,63,180
430260,202111,732,1845,496,1407,60,193,279,797,339,990
430265,202111,238,672,160,521,29,90,56,194,85,284
430270,202111,3119,7385,2459,6377,363,1031,1565,3908,1928,4939
430280,202111,5369,12130,3752,9428,732,1886,1652,4055,2384,5941
430290,202111,2352,5267,1926,4769,78,222,1603,3871,1681,4093
430300,202111,10926,26263,8257,21756,1271,3660,4413,11162,5684,14822
430310,202111,13256,31922,9092,24329,1156,3403,4577,11363,5733,14766
430320,202111,1085,2646,608,1721,60,165,357,1010,417,1175
430330,202111,728,1716,436,1151,83,226,163,394,246,620
430340,202111,633,1465,411,1104,62,161,251,661,313,822
430350,202111,8591,20497,6600,17134,711,2028,4204,10301,4915,12329
430355,202111,316,831,120,381,16,53,15,42,31,95
430360,202111,912,2129,598,1588,115,353,221,541,336,894
430367,202111,361,777,206,518,38,116,107,241,145,357
430370,202111,561,1464,229,667,36,100,59,137,95,237
430380,202111,723,1734,344,1034,76,253,94,273,170,526
430390,202111,3595,8406,2225,5977,418,1254,294,552,712,1806
430400,202111,1069,2245,811,1902,69,184,487,1100,556,1284
430410,202111,564,1291,394,1022,55,144,256,646,311,790
430420,202111,2789,7117,2151,5826,394,1163,1151,2927,1545,4090
430430,202111,609,1509,269,815,60,168,53,172,113,340
430435,202111,1660,4070,1267,3441,227,641,640,1723,867,2364
430440,202111,4104,10771,3262,9372,302,937,2091,5972,2393,6909
430450,202111,7110,17053,5675,14557,1176,3158,2685,6602,3861,9760
430460,202111,37224,91083,27870,75743,4298,12737,14556,37805,18854,50542
430461,202111,235,612,79,241,13,45,32,78,45,123
430462,202111,332,849,170,525,32,104,45,127,77,231
430463,202111,6736,17153,4949,13868,938,2924,2282,6042,3220,8966
430465,202111,472,1173,373,987,66,189,232,594,298,783
430466,202111,4701,11380,3728,9870,750,2066,1873,4686,2623,6752
430467,202111,519,1224,363,986,52,165,196,483,248,648
430468,202111,1351,3212,1076,2812,80,244,774,1967,854,2211
430469,202111,594,1588,86,256,11,34,19,40,30,74
430470,202111,5973,14998,3966,11411,1092,3409,966,2573,2058,5982
430471,202111,580,1596,476,1407,75,228,275,779,350,1007
430480,202111,678,1856,430,1321,59,195,101,258,160,453
430485,202111,177,454,70,205,20,57,11,30,31,87
430490,202111,442,1103,236,697,26,95,106,264,132,359
430495,202111,413,1092,273,830,45,138,115,330,160,468
430500,202111,1041,2603,727,2073,240,732,200,519,440,1251
430510,202111,29304,73441,20900,57620,3317,10175,9631,24357,12948,34532
430511,202111,383,1039,140,449,14,47,18,54,32,101
430512,202111,1049,2270,818,1929,184,446,298,706,482,1152
430513,202111,830,2009,390,1095,67,196,177,456,244,652
430515,202111,403,1092,292,872,42,123,153,454,195,577
430517,202111,1267,3599,960,2915,161,481,528,1605,689,2086
430520,202111,1428,3488,761,2090,138,394,175,417,313,811
430530,202111,1026,2496,427,1241,73,218,117,324,190,542
430535,202111,3769,9389,2728,7498,381,1070,1380,3647,1761,4717
430537,202111,416,1270,358,1137,23,70,276,880,299,950
430540,202111,631,1485,355,1008,74,208,164,460,238,668
430543,202111,1044,1794,622,1304,65,136,236,573,301,709
430544,202111,778,2131,535,1605,127,396,163,478,290,874
430545,202111,2603,6327,1942,5337,304,842,1102,3020,1406,3862
430550,202111,362,1000,262,787,54,167,95,267,149,434
430558,202111,120,281,57,159,7,14,22,63,29,77
430560,202111,299,683,150,434,27,86,51,134,78,220
430570,202111,896,2160,643,1709,114,348,294,687,408,1035
430580,202111,870,2103,622,1724,172,507,246,710,418,1217
430583,202111,202,494,40,122,4,12,11,23,15,35
430585,202111,233,570,122,343,18,46,42,104,60,150
430587,202111,207,541,153,447,22,70,62,169,84,239
430590,202111,1399,3328,1152,2955,78,241,920,2296,998,2537
430593,202111,22,65,14,40,2,4,6,17,8,21
430595,202111,440,1102,122,385,13,44,19,46,32,90
430597,202111,467,1160,243,712,25,74,72,172,97,246
430600,202111,2069,5255,869,2439,137,402,188,481,325,883
430605,202111,1375,3485,1004,2813,117,354,492,1328,609,1682
430607,202111,653,1432,473,1159,36,89,327,781,363,870
430610,202111,6004,13614,4019,10667,1048,3201,902,2279,1950,5480
430613,202111,300,692,88,256,10,26,23,57,33,83
430620,202111,691,1658,514,1336,75,221,306,706,381,927
430630,202111,444,1186,126,390,23,75,33,82,56,157
430632,202111,468,1194,206,592,36,94,80,219,116,313
430635,202111,593,1329,448,1083,44,111,333,795,377,906
430637,202111,474,1107,361,937,37,112,246,618,283,730
430640,202111,1157,3026,775,2245,118,351,310,830,428,1181
430642,202111,379,1014,276,793,49,138,129,349,178,487
430645,202111,160,378,66,175,14,40,18,35,32,75
430650,202111,1832,4916,1437,4256,432,1247,560,1834,992,3081
430655,202111,319,769,187,520,28,88,93,228,121,316
430660,202111,5483,13492,4194,11397,868,2436,1902,5106,2770,7542
430670,202111,669,1571,503,1295,63,172,263,675,326,847
430673,202111,565,1258,245,674,43,116,91,231,134,347
430675,202111,257,736,61,213,7,22,10,31,17,53
430676,202111,5566,13329,4468,11677,583,1581,2804,7185,3387,8766
430680,202111,1105,2854,648,1927,190,535,154,438,344,973
430690,202111,3021,7870,2386,6733,807,2390,682,1870,1489,4260
430692,202111,222,670,174,589,13,45,131,453,144,498
430693,202111,983,2513,595,1766,113,378,148,415,261,793
430695,202111,422,1041,257,713,34,90,135,360,169,450
430697,202111,454,1094,344,930,72,184,179,514,251,698
430700,202111,8253,19602,5106,13851,1027,2979,1225,2936,2252,5915
430705,202111,410,948,202,570,22,61,82,209,104,270
430710,202111,1795,3691,1247,2971,152,411,741,1702,893,2113
430720,202111,852,1969,417,1201,59,168,203,565,262,733
430730,202111,1054,2796,736,2185,97,279,370,1069,467,1348
430740,202111,705,1872,362,1154,59,191,98,320,157,511
430745,202111,378,981,258,732,65,209,87,200,152,409
430750,202111,1570,3806,1049,2887,311,900,349,919,660,1819
430755,202111,463,1116,296,781,26,79,164,393,190,472
430760,202111,2236,5329,1716,4542,356,1023,798,2007,1154,3030
430770,202111,6950,16858,5410,14534,640,1940,3472,8954,4112,10894
430780,202111,2044,4949,1285,3657,190,607,621,1687,811,2294
430781,202111,491,1329,284,854,70,193,84,228,154,421
430783,202111,358,813,218,595,29,90,126,318,155,408
430786,202111,32,113,23,87,4,17,4,16,8,33
430790,202111,4875,11566,3462,9145,365,1142,2116,5163,2481,6305
430800,202111,801,1773,603,1497,49,118,388,961,437,1079
430805,202111,382,955,250,686,13,44,176,459,189,503
430807,202111,572,1385,324,916,35,107,159,405,194,512
430810,202111,781,1840,345,992,42,142,126,310,168,452
430820,202111,1269,3395,755,2356,123,405,224,647,347,1052
430825,202111,285,684,99,255,14,33,33,83,47,116
430830,202111,1844,4951,1487,4268,183,479,974,2779,1157,3258
430840,202111,1113,2602,751,2021,113,276,475,1303,588,1579
430843,202111,182,429,85,227,8,24,33,75,41,99
430845,202111,500,1153,327,876,39,115,171,429,210,544
430850,202111,2395,6080,1637,4652,269,837,594,1731,863,2568
430860,202111,981,2285,465,1287,55,177,213,503,268,680
430865,202111,560,1397,390,1096,103,304,95,257,198,561
430870,202111,596,1551,254,797,38,127,71,193,109,320
430880,202111,1550,3420,1072,2697,166,417,601,1469,767,1886
430885,202111,177,471,95,303,10,35,53,166,63,201
430890,202111,1087,2591,710,1951,53,204,135,353,188,557
430900,202111,3232,6873,2273,5524,161,502,1577,3584,1738,4086
430905,202111,924,2243,605,1647,103,303,255,661,358,964
430910,202111,2252,5926,1704,4824,258,832,804,1972,1062,2804
430912,202111,533,1464,372,1133,45,133,225,698,270,831
430915,202111,524,1540,381,1243,131,409,104,357,235,766
430920,202111,25150,62234,19585,52968,2502,7388,11925,31263,14427,38651
430925,202111,90,202,38,113,4,12,19,55,23,67
430930,202111,11346,25917,7537,20127,1378,3623,3275,9023,4653,12646
430940,202111,1044,2637,650,1833,119,352,215,547,334,899
430950,202111,871,1885,562,1374,40,133,376,833,416,966
430955,202111,405,1042,112,312,23,59,33,70,56,129
430957,202111,171,566,152,525,27,86,92,326,119,412
430960,202111,1435,3338,820,2224,156,436,329,845,485,1281
430965,202111,1609,3742,1245,3178,70,183,934,2423,1004,2606
430970,202111,392,919,214,582,32,107,109,258,141,365
430975,202111,530,1499,405,1217,80,256,189,542,269,798
430980,202111,410,912,238,626,20,60,118,275,138,335
430990,202111,595,1628,394,1177,58,189,172,495,230,684
430995,202111,578,1438,437,1212,67,191,232,625,299,816
431000,202111,1444,3367,601,1724,108,345,41,98,149,443
431010,202111,2519,6500,1726,5112,322,1013,535,1414,857,2427
431020,202111,8273,17679,4914,12657,929,2746,1802,4044,2731,6790
431030,202111,360,972,180,599,35,134,23,72,58,206
431033,202111,4124,9414,2709,7190,554,1524,994,2617,1548,4141
431036,202111,342,744,73,210,7,24,21,43,28,67
431040,202111,935,2289,601,1713,70,226,304,784,374,1010
431041,202111,453,1032,320,828,29,72,182,470,211,542
431043,202111,336,824,200,576,37,122,101,277,138,399
431046,202111,109,279,42,126,6,16,8,22,14,38
431050,202111,1394,3307,979,2630,191,521,430,1202,621,1723
431053,202111,711,1801,396,1173,71,229,126,325,197,554
431055,202111,623,1454,506,1270,60,133,363,912,423,1045
431057,202111,234,667,134,434,29,95,42,125,71,220
431060,202111,6034,14567,4077,11288,912,2788,1226,3210,2138,5998
431065,202111,417,1006,306,823,41,116,156,410,197,526
431070,202111,434,1137,262,769,58,196,69,182,127,378
431075,202111,225,633,134,426,30,102,39,131,69,233
431080,202111,596,1581,413,1194,66,219,155,418,221,637
431085,202111,816,2063,520,1407,56,157,281,744,337,901
431087,202111,429,1159,345,993,40,118,202,573,242,691
431090,202111,418,965,164,491,23,73,43,138,66,211
431100,202111,3674,7857,2561,6413,303,766,1484,3705,1787,4471
431110,202111,1484,3333,1019,2526,209,552,451,1004,660,1556
431112,202111,658,1705,542,1496,41,149,392,1013,433,1162
431113,202111,426,1103,353,967,61,170,180,484,241,654
431115,202111,995,2761,781,2366,75,288,506,1439,581,1727
431120,202111,2831,7101,1961,5482,505,1513,520,1356,1025,2869
431123,202111,388,1040,255,747,60,158,133,401,193,559
431125,202111,1060,2838,814,2386,275,800,310,949,585,1749
431127,202111,202,544,67,219,7,24,11,34,18,58
431130,202111,3175,7793,2391,6553,348,1018,1331,3565,1679,4583
431140,202111,6170,14317,3726,9752,437,1217,1592,3614,2029,4831
431142,202111,561,1388,422,1160,51,134,265,741,316,875
431150,202111,1084,2794,796,2277,145,454,363,1014,508,1468
431160,202111,704,1916,462,1392,106,343,114,322,220,665
431162,202111,553,1345,336,949,39,127,170,429,209,556
431164,202111,182,420,46,144,5,13,8,21,13,34
431170,202111,468,1250,336,985,97,284,87,247,184,531
431171,202111,725,1634,598,1467,162,334,323,849,485,1183
431173,202111,458,1157,336,975,90,304,121,322,211,626
431175,202111,1358,3080,858,2245,133,338,326,818,459,1156
431177,202111,871,2245,678,1939,114,400,431,1157,545,1557
431179,202111,346,744,103,295,15,44,30,83,45,127
431180,202111,2353,5856,1445,4081,337,981,426,1120,763,2101
431190,202111,620,1535,266,759,34,98,80,189,114,287
431198,202111,418,1165,331,1000,82,262,124,394,206,656
431200,202111,377,938,94,254,19,53,12,32,31,85
431205,202111,223,590,119,369,37,119,32,106,69,225
431210,202111,667,1531,533,1347,148,377,205,554,353,931
431213,202111,273,711,205,577,10,32,116,315,126,347
431215,202111,660,1548,316,907,30,93,151,400,181,493
431217,202111,168,430,116,329,17,52,55,134,72,186
431220,202111,569,1443,358,1037,35,109,199,533,234,642
431225,202111,1568,3597,1217,3034,125,327,835,2067,960,2394
431230,202111,713,1944,566,1628,93,272,320,884,413,1156
431235,202111,180,482,20,71,2,4,4,19,6,23
431237,202111,367,1124,290,946,53,200,138,418,191,618
431238,202111,34,96,28,83,3,9,14,35,17,44
431240,202111,5030,11851,4018,10267,456,1290,2569,6217,3025,7507
431242,202111,283,694,248,638,38,106,158,388,196,494
431244,202111,373,925,184,520,25,86,68,162,93,248
431245,202111,1375,3123,878,2278,66,179,482,1198,548,1377
431247,202111,292,705,176,477,27,82,78,182,105,264
431250,202111,1851,4478,1378,3842,306,859,677,2048,983,2907
431260,202111,283,742,172,531,24,88,59,177,83,265
431261,202111,274,802,216,694,15,52,123,373,138,425
431262,202111,339,939,175,566,12,41,107,342,119,383
431265,202111,1652,3835,687,1958,81,263,222,534,303,797
431267,202111,252,621,164,438,5,16,119,301,124,317
431270,202111,2953,6444,1585,4131,334,879,489,1340,823,2219
431275,202111,125,343,69,215,21,65,16,49,37,114
431280,202111,241,644,75,239,4,15,14,33,18,48
431290,202111,366,1079,245,782,45,158,33,86,78,244
431295,202111,75,181,27,75,6,18,5,11,11,29
431300,202111,311,811,67,204,9,25,23,58,32,83
431301,202111,297,834,68,218,11,34,8,25,19,59
431303,202111,653,1644,401,1130,23,81,183,457,206,538
431306,202111,2400,5577,1476,4024,180,543,649,1580,829,2123
431308,202111,33,91,30,85,10,34,16,43,26,77
431310,202111,576,1517,411,1174,50,134,192,514,242,648
431320,202111,699,1882,394,1246,69,211,110,305,179,516
431330,202111,1855,4288,953,2666,152,478,387,959,539,1437
431333,202111,222,578,120,351,18,55,46,115,64,170
431335,202111,37,110,20,72,4,10,1,3,5,13
431337,202111,2843,7191,2182,6134,315,1034,1351,3617,1666,4651
431339,202111,458,1133,338,930,96,275,121,316,217,591
431340,202111,19543,46636,13725,36890,1965,5885,6757,16811,8722,22696
431342,202111,439,979,323,793,31,62,243,599,274,661
431344,202111,408,1012,243,708,18,53,126,361,144,414
431346,202111,223,541,81,250,14,44,19,47,33,91
431349,202111,792,1911,493,1287,92,236,233,585,325,821
431350,202111,4590,11275,3485,9431,421,1312,1979,5064,2400,6376
431360,202111,597,1390,297,822,92,261,66,178,158,439
431365,202111,2215,4949,1756,4315,122,356,1364,3273,1486,3629
431370,202111,4960,11478,3664,9440,740,1971,1800,4719,2540,6690
431380,202111,884,2289,722,2033,63,173,486,1379,549,1552
431390,202111,2779,6709,1773,4922,169,566,942,2283,1111,2849
431395,202111,1498,3487,1121,2928,208,541,600,1586,808,2127
431400,202111,313,860,175,552,30,96,36,100,66,196
431402,202111,935,2035,702,1687,90,209,473,1123,563,1332
431403,202111,208,567,160,467,33,98,67,187,100,285
431405,202111,5258,13315,4118,11437,674,2058,2063,5377,2737,7435
431406,202111,591,1597,409,1219,82,237,170,524,252,761
431407,202111,533,1379,385,1070,71,212,227,608,298,820
431410,202111,18911,45456,13070,35473,1691,5201,7208,18113,8899,23314
431413,202111,238,647,58,191,5,17,11,35,16,52
431415,202111,745,1770,475,1316,77,261,218,532,295,793
431417,202111,598,1297,395,975,59,167,213,499,272,666
431420,202111,1714,3716,1302,3167,149,363,779,1834,928,2197
431430,202111,613,1540,310,940,46,148,98,261,144,409
431440,202111,32460,73421,22900,58763,3714,10287,9726,23048,13440,33335
431442,202111,143,406,71,243,14,54,11,32,25,86
431445,202111,384,1062,105,334,9,22,14,37,23,59
431446,202111,282,796,210,651,30,110,104,308,134,418
431447,202111,802,2031,444,1281,86,260,124,363,210,623
431449,202111,814,2075,511,1460,99,259,183,546,282,805
431450,202111,2370,4720,1847,3980,75,178,1487,3112,1562,3290
431454,202111,37,122,29,102,5,19,12,39,17,58
431455,202111,619,1428,310,804,29,77,159,378,188,455
431460,202111,3058,7089,2099,5418,544,1438,554,1441,1098,2879
431470,202111,1415,3848,1028,3041,186,549,390,1158,576,1707
431475,202111,255,677,57,193,5,18,8,18,13,36
431477,202111,444,1114,266,765,41,110,101,266,142,376
431478,202111,228,596,53,163,9,25,6,16,15,41
431480,202111,3631,8727,2896,7589,735,1895,1382,3657,2117,5552
431490,202111,114853,262917,87521,221302,5671,16971,64395,155701,70066,172672
431500,202111,512,1280,382,1043,68,194,194,509,262,703
431505,202111,253,603,170,477,12,40,120,331,132,371
431507,202111,343,806,142,414,43,129,28,71,71,200
431510,202111,1717,4245,1166,3180,293,847,380,1040,673,1887
431513,202111,233,505,127,328,26,58,53,134,79,192
431514,202111,122,310,94,261,5,14,62,160,67,174
431515,202111,494,1194,362,967,81,221,205,505,286,726
431517,202111,58,167,46,134,5,15,22,59,27,74
431520,202111,404,987,171,503,16,53,80,210,96,263
431530,202111,5251,11163,3162,7995,630,1554,1129,2870,1759,4424
431531,202111,210,495,128,343,17,39,52,131,69,170
431532,202111,568,1293,346,896,66,197,147,370,213,567
431535,202111,264,696,117,360,23,75,23,62,46,137
431540,202111,1830,5699,1688,5508,61,230,1361,4471,1422,4701
431545,202111,375,943,77,225,6,18,23,62,29,80
431550,202111,2259,5525,1627,4368,270,771,813,2081,1083,2852
431555,202111,702,1564,417,1094,42,124,239,618,281,742
431560,202111,26063,60371,17407,46780,3408,9271,6078,17105,9486,26376
431570,202111,4575,10700,3872,9679,440,1165,2791,6768,3231,7933
431575,202111,341,803,279,709,82,178,125,330,207,508
431580,202111,608,1561,391,1137,44,143,208,569,252,712
431590,202111,652,1763,486,1426,106,309,165,480,271,789
431595,202111,381,1013,243,723,38,111,86,232,124,343
431600,202111,1596,3695,1147,3021,218,622,503,1266,721,1888
431610,202111,1479,3616,1006,2770,170,440,490,1387,660,1827
431620,202111,504,1271,244,687,46,133,104,269,150,402
431630,202111,1366,3283,656,1855,97,279,255,686,352,965
431640,202111,6695,15214,5687,13944,571,1454,4144,10196,4715,11650
431642,202111,650,1478,393,1006,46,102,180,439,226,541
431643,202111,391,940,180,509,17,45,54,151,71,196
431645,202111,1956,4186,1544,3647,46,141,1292,3009,1338,3150
431647,202111,316,753,107,314,9,20,28,72,37,92
431650,202111,131,341,91,274,7,22,40,106,47,128
431660,202111,912,2339,432,1326,58,208,107,277,165,485
431670,202111,1262,2930,748,1992,131,374,340,817,471,1191
431673,202111,245,633,93,311,7,27,16,35,23,62
431675,202111,408,1045,108,364,11,38,19,57,30,95
431680,202111,8788,21484,6441,17232,1425,3922,2814,7272,4239,11194
431690,202111,26168,62296,18035,47876,3276,9314,8203,21210,11479,30524
431695,202111,215,510,115,328,21,66,58,146,79,212
431697,202111,486,1111,374,943,49,111,220,568,269,679
431700,202111,1438,3545,1165,3069,205,495,628,1685,833,2180
431710,202111,14333,32696,10247,26949,1476,4181,5661,14764,7137,18945
431720,202111,7085,16865,4264,11641,1021,2906,846,2080,1867,4986
431725,202111,27,72,21,62,4,14,9,22,13,36
431730,202111,4307,9915,2734,7492,582,1680,963,2749,1545,4429
431740,202111,5598,12769,3740,9743,918,2788,998,2247,1916,5035
431750,202111,8132,20420,6136,17252,1510,4409,2231,6208,3741,10617
431755,202111,342,918,84,272,14,33,13,44,27,77
431760,202111,5621,12396,3865,9620,447,1240,2365,5562,2812,6802
431770,202111,2062,4584,1567,3937,148,352,1126,2795,1274,3147
431775,202111,207,517,104,315,22,70,18,42,40,112
431780,202111,2283,5409,1485,3977,228,647,608,1585,836,2232
431790,202111,809,2081,527,1522,94,255,218,638,312,893
431795,202111,292,713,142,418,30,85,35,95,65,180
431800,202111,8687,20013,5455,14985,1262,4143,470,1331,1732,5474
431805,202111,290,708,72,251,4,17,5,12,9,29
431810,202111,3473,7833,2203,5582,397,1043,991,2365,1388,3408
431820,202111,2254,5786,1729,4951,464,1439,656,1884,1120,3323
431830,202111,9355,19983,6945,16747,1833,5228,1348,3175,3181,8403
431840,202111,2822,6990,2264,6108,318,881,1451,3905,1769,4786
431842,202111,514,1268,184,554,29,95,69,188,98,283
431843,202111,340,891,247,701,32,95,114,306,146,401
431844,202111,203,538,72,235,17,62,18,62,35,124
431845,202111,525,1346,364,1029,43,110,208,589,251,699
431846,202111,292,718,251,659,13,33,219,575,232,608
431848,202111,166,419,90,262,10,29,19,39,29,68
431849,202111,415,1006,82,241,8,21,15,30,23,51
431850,202111,4421,11438,3405,9530,764,2346,1135,3040,1899,5386
431860,202111,660,1531,362,969,58,169,209,542,267,711
431861,202111,95,261,60,182,10,33,20,59,30,92
431862,202111,493,1522,408,1374,77,287,199,633,276,920
431870,202111,22807,55431,18247,48426,1985,5907,11414,28985,13399,34892
431880,202111,4100,10259,2921,8187,396,1297,1466,3881,1862,5178
431890,202111,4923,12021,3105,8594,854,2497,547,1676,1401,4173
431900,202111,1023,2504,665,1867,108,327,327,847,435,1174
431910,202111,798,1826,295,785,37,104,86,184,123,288
431912,202111,517,1326,404,1132,79,236,234,653,313,889
431915,202111,1151,2630,903,2246,46,115,681,1663,727,1778
431920,202111,1292,2885,1063,2592,37,83,907,2199,944,2282
431930,202111,718,1814,489,1390,176,494,158,468,334,962
431935,202111,87,226,61,171,15,39,14,35,29,74
431936,202111,319,878,184,548,37,109,85,239,122,348
431937,202111,149,366,94,260,11,28,41,98,52,126
431940,202111,3183,7240,1928,5011,158,439,1093,2695,1251,3134
431950,202111,2109,5265,1659,4546,359,1026,680,1822,1039,2848
431960,202111,3124,7383,2367,6062,623,1691,654,1648,1277,3339
431970,202111,408,1014,178,514,38,119,39,91,77,210
431971,202111,84,203,36,108,4,16,8,15,12,31
431973,202111,499,1573,405,1390,48,149,275,962,323,1111
431975,202111,118,243,29,85,4,14,7,16,11,30
431980,202111,1073,2655,832,2274,131,406,467,1184,598,1590
431990,202111,6103,14271,4387,11831,438,1427,2494,6464,2932,7891
432000,202111,13136,30087,9580,24635,1895,5071,4693,11804,6588,16875
432010,202111,2871,6528,1929,4985,367,989,757,1808,1124,2797
432020,202111,1835,4695,1130,3200,250,752,321,872,571,1624
432023,202111,567,1329,281,768,42,119,117,275,159,394
432026,202111,1017,2740,758,2235,194,567,237,715,431,1282
432030,202111,423,968,237,634,18,51,140,346,158,397
432032,202111,347,860,237,643,23,67,136,334,159,401
432035,202111,690,1883,605,1742,177,476,255,794,432,1270
432040,202111,1159,2702,434,1310,58,196,179,473,237,669
432045,202111,169,465,108,337,18,60,43,133,61,193
432050,202111,587,1400,435,1142,77,220,202,526,279,746
432055,202111,597,1562,400,1206,135,417,80,230,215,647
432057,202111,177,471,141,380,7,17,77,194,84,211
432060,202111,441,1058,133,415,31,104,29,80,60,184
432065,202111,221,601,162,478,44,135,55,161,99,296
432067,202111,791,2189,672,1924,64,206,494,1364,558,1570
432070,202111,1766,4355,1231,3367,212,647,546,1379,758,2026
432080,202111,5188,11671,3920,9772,608,1742,1869,4402,2477,6144
432085,202111,393,1049,290,883,62,200,133,399,195,599
432090,202111,2486,5995,1450,4020,266,744,634,1660,900,2404
432100,202111,1014,2470,497,1468,101,313,87,213,188,526
432110,202111,2183,5531,1534,4387,356,1129,206,530,562,1659
432120,202111,3480,8953,2781,7826,444,1365,1323,3518,1767,4883
432130,202111,2749,6628,2289,5946,633,1684,1016,2658,1649,4342
432132,202111,227,629,116,374,19,66,57,166,76,232
432135,202111,1038,2360,693,1778,77,204,474,1208,551,1412
432140,202111,1811,5122,1395,4303,178,584,871,2621,1049,3205
432143,202111,1519,3877,1155,3314,78,234,737,2086,815,2320
432145,202111,1863,4821,1192,3460,175,537,386,937,561,1474
432146,202111,110,301,83,263,26,95,26,76,52,171
432147,202111,507,1342,297,918,102,313,54,169,156,482
432149,202111,469,1117,238,655,26,71,99,240,125,311
432150,202111,3608,8726,2695,7175,536,1501,1188,3086,1724,4587
432160,202111,5773,14339,4237,11920,953,2976,1367,3773,2320,6749
432162,202111,235,513,38,110,5,18,12,22,17,40
432163,202111,160,375,30,80,0,0,6,8,6,8
432166,202111,676,1815,534,1534,104,350,192,473,296,823
432170,202111,1635,4304,1129,3383,194,621,469,1319,663,1940
432180,202111,3216,7457,1756,4761,297,854,686,1620,983,2474
432183,202111,396,1108,282,860,59,204,99,274,158,478
432185,202111,866,2185,505,1495,53,164,239,677,292,841
432190,202111,2064,4881,1452,3914,133,417,905,2304,1038,2721
432195,202111,959,2379,634,1780,132,346,250,714,382,1060
432200,202111,3727,8952,2725,7407,339,970,1680,4503,2019,5473
432210,202111,412,1065,262,773,53,178,114,288,167,466
432215,202111,656,1839,594,1747,50,115,439,1320,489,1435
432218,202111,263,634,117,322,15,45,48,110,63,155
432220,202111,3818,8720,2702,6901,525,1330,1257,3205,1782,4535
432225,202111,117,312,79,237,12,34,48,142,60,176
432230,202111,799,1851,422,1165,53,152,175,442,228,594
432232,202111,513,1229,329,921,59,164,133,338,192,502
432234,202111,284,706,133,381,26,60,20,54,46,114
432235,202111,45,128,19,60,6,21,4,12,10,33
432237,202111,316,793,279,733,15,28,227,589,242,617
432240,202111,17430,40879,12807,34717,1097,2785,8130,23061,9227,25846
432250,202111,5977,16384,4438,13340,1076,3355,1866,5580,2942,8935
432252,202111,483,1137,310,811,36,93,166,403,202,496
432253,202111,919,2650,615,1894,146,490,54,147,200,637
432254,202111,709,1638,210,609,29,72,32,88,61,160
432255,202111,107,273,61,179,4,11,29,79,33,90
432260,202111,5459,13532,4050,10938,1053,2924,1486,3864,2539,6788
432270,202111,2143,5608,1744,4876,497,1486,514,1370,1011,2856
432280,202111,1480,3585,771,2225,104,338,270,648,374,986
432285,202111,147,437,25,75,2,6,5,14,7,20
432290,202111,373,994,221,650,66,209,53,120,119,329
432300,202111,28313,68715,21407,57715,2588,8004,13254,34046,15842,42050
432310,202111,913,2326,657,1863,69,192,444,1271,513,1463
432320,202111,201,461,80,241,7,26,27,70,34,96
432330,202111,222,491,69,212,11,27,7,24,18,51
432335,202111,170,484,61,212,10,36,14,43,24,79
432340,202111,342,845,151,487,18,57,43,142,61,199
432345,202111,785,1675,675,1545,15,35,574,1290,589,1325
432350,202111,359,888,188,562,31,94,65,195,96,289
432360,202111,232,682,40,136,3,8,12,38,15,46
432370,202111,349,830,223,619,22,67,146,391,168,458
432375,202111,490,1185,368,952,97,250,152,392,249,642
432377,202111,164,505,33,113,2,7,7,14,9,21
432380,202111,1994,5244,1374,4108,212,663,680,1991,892,2654
500020,202111,3302,7896,2253,6185,226,710,1370,3611,1596,4321
500025,202111,1226,2964,762,2089,86,223,385,1029,471,1252
500060,202111,8510,23387,5836,17826,702,2237,3404,10580,4106,12817
500070,202111,4868,11907,3447,9535,641,1836,1484,4140,2125,5976
500080,202111,1725,4112,1046,2880,190,602,401,967,591,1569
500085,202111,2102,5162,1473,4068,396,1154,631,1626,1027,2780
500090,202111,2241,5713,1514,4471,216,693,482,1537,698,2230
500100,202111,3887,9589,2937,8037,424,1288,1449,3680,1873,4968
500110,202111,9341,22972,6244,18119,1242,3847,2044,6788,3286,10635
500124,202111,2246,6272,1797,5550,315,862,943,3083,1258,3945
500150,202111,1476,3214,975,2513,148,424,468,1143,616,1567
500190,202111,5353,13518,3444,9835,698,1981,950,2574,1648,4555
500200,202111,2831,6404,1922,4881,167,435,1199,2933,1366,3368
500210,202111,5065,11576,3577,9605,1096,2825,1440,4058,2536,6883
500215,202111,1497,3994,1097,3264,101,327,627,1852,728,2179
500220,202111,3138,8296,2172,6557,396,1241,829,2418,1225,3659
500230,202111,2122,4778,1612,4075,206,497,1066,2665,1272,3162
500240,202111,4313,12267,3079,9708,427,1441,1300,4173,1727,5614
500260,202111,3486,7261,2262,5638,283,736,1287,3055,1570,3791
500270,202111,149382,343869,92178,248794,13468,39749,36629,90632,50097,130381
500280,202111,1488,3648,998,2880,181,542,458,1311,639,1853
500290,202111,3935,9351,2358,6572,340,1070,777,1847,1117,2917
500295,202111,3925,9262,2549,6843,433,1295,1046,2440,1479,3735
500310,202111,1058,2093,726,1681,108,236,382,899,490,1135
500315,202111,4163,10906,3351,9727,264,782,2433,7156,2697,7938
500320,202111,21454,55313,14699,44180,3686,11356,4744,15455,8430,26811
500325,202111,5624,12170,3893,9777,477,1192,2378,5981,2855,7173
500330,202111,7121,15685,4645,12137,471,1282,2367,6427,2838,7709
500345,202111,2167,5192,1459,4076,292,848,560,1543,852,2391
500348,202111,2508,6280,1852,5160,236,691,1095,3067,1331,3758
500350,202111,1364,3646,763,2343,96,280,304,916,400,1196
500370,202111,29319,73116,21121,59854,2486,8069,11352,31367,13838,39436
500375,202111,2687,6871,1808,5086,260,820,666,1678,926,2498
500380,202111,3631,8841,2537,7013,737,2174,439,1257,1176,3431
500390,202111,679,1399,414,1065,60,175,241,602,301,777
500400,202111,1661,4139,1091,3035,200,615,366,910,566,1525
500410,202111,2558,6007,1789,4886,184,471,1003,2884,1187,3355
500430,202111,2931,6954,1996,5584,291,907,822,2453,1113,3360
500440,202111,1678,3889,905,2601,137,413,308,947,445,1360
500450,202111,1728,4153,1049,2963,163,478,292,767,455,1245
500460,202111,3915,10086,2322,6965,404,1340,635,1787,1039,3127
500470,202111,2692,7041,1689,5020,437,1433,371,976,808,2409
500480,202111,2184,6560,1817,5975,170,512,1344,4512,1514,5024
500490,202111,1196,2692,699,1941,117,393,174,480,291,873
500500,202111,4460,11403,2865,8830,743,2724,280,902,1023,3626
500510,202111,734,1799,477,1330,41,112,289,780,330,892
500515,202111,1751,4461,1346,3815,175,535,777,2090,952,2625
500520,202111,3563,10080,2724,8625,674,2094,1128,3885,1802,5979
500525,202111,1012,2825,799,2515,78,268,506,1570,584,1838
500540,202111,5026,12753,2912,8911,662,2541,272,740,934,3281
500560,202111,5679,15011,4537,13571,287,829,3673,11219,3960,12048
500568,202111,4750,10116,2904,7363,773,1888,867,2316,1640,4204
500570,202111,8569,19436,5584,14515,857,2484,2539,6046,3396,8530
500580,202111,3345,8504,2426,6898,600,1713,1003,2902,1603,4615
500600,202111,3645,8903,2623,7287,589,1689,1022,2935,1611,4624
500620,202111,8578,21841,5795,16604,1022,3071,2476,6730,3498,9801
500625,202111,567,1489,376,1119,62,187,106,297,168,484
500627,202111,847,2176,519,1596,99,305,144,428,243,733
500630,202111,7847,17260,4368,11585,874,2512,1224,3196,2098,5708
500635,202111,3081,9505,2371,8554,173,587,1606,6409,1779,6996
500640,202111,1909,4031,1242,3144,48,138,818,2009,866,2147
500660,202111,20443,49795,13997,40453,4003,13116,3514,10489,7517,23605
500690,202111,2745,7103,1785,5499,461,1606,462,1422,923,3028
500710,202111,3280,8443,2441,6998,611,1872,727,1953,1338,3825
500720,202111,5387,13287,3556,10195,789,2404,1130,3250,1919,5654
500730,202111,1178,2822,636,1832,120,337,147,441,267,778
500740,202111,4967,11497,3266,8881,495,1405,1534,4016,2029,5421
500750,202111,1096,2719,754,2134,99,258,315,834,414,1092
500755,202111,1081,2751,639,1918,96,313,158,429,254,742
500769,202111,5587,13404,3141,8864,571,1732,429,1103,1000,2835
500770,202111,1470,3886,996,3085,174,603,314,945,488,1548
500780,202111,1275,3019,814,2257,157,485,219,549,376,1034
500790,202111,7517,19482,5575,16073,1187,3681,2297,6549,3484,10230
500793,202111,2160,5323,1567,4328,362,1052,528,1345,890,2397
500795,202111,2860,6905,2236,6083,146,353,1715,4907,1861,5260
500797,202111,809,2035,519,1510,159,467,142,439,301,906
500800,202111,3636,8037,2230,5932,605,1938,318,899,923,2837
500830,202111,19575,47439,13338,36263,2827,8078,4424,11400,7251,19478
500840,202111,1524,3613,956,2563,133,353,400,1021,533,1374
510010,202111,1916,4210,1314,3448,133,286,911,2401,1044,2687
510020,202111,4411,10750,2338,6705,397,1233,647,1634,1044,2867
510025,202111,7261,17061,4536,12774,610,1859,2145,5780,2755,7639
510030,202111,3247,6909,2172,5322,307,744,1138,2665,1445,3409
510035,202111,1288,3287,826,2569,138,447,414,1405,552,1852
510040,202111,2549,5521,1904,4690,204,460,1168,3038,1372,3498
510050,202111,2326,4699,1570,3738,225,560,993,2356,1218,2916
510060,202111,1441,3552,905,2591,136,423,261,698,397,1121
510080,202111,1528,3849,1041,3083,200,640,484,1338,684,1978
510100,202111,705,1591,503,1280,68,173,284,693,352,866
510120,202111,289,518,162,368,10,18,122,277,132,295
510125,202111,2184,5372,1732,4712,156,550,986,2495,1142,3045
510130,202111,1644,4032,1132,3219,234,684,392,1150,626,1834
510140,202111,3239,8080,2157,6716,810,2808,651,2085,1461,4893
510160,202111,1869,4666,1403,4069,123,341,1093,3231,1216,3572
510170,202111,5171,13163,3855,11041,859,2568,1613,4533,2472,7101
510180,202111,15676,34039,10241,26394,2089,5883,3631,10188,5720,16071
510185,202111,1884,4799,1203,3812,461,1503,216,939,677,2442
510190,202111,2260,6228,1439,4876,377,1426,252,894,629,2320
510250,202111,18553,45199,13696,37894,2433,7015,6911,19617,9344,26632
510260,202111,1865,7870,1563,7358,245,1242,955,4937,1200,6179
510263,202111,3517,9751,2129,6821,350,1224,430,1210,780,2434
510267,202111,5746,16010,3252,10403,531,1809,503,1337,1034,3146
510268,202111,1342,3321,975,2711,121,351,525,1407,646,1758
510269,202111,1077,2844,676,2084,146,515,236,662,382,1177
510270,202111,3194,8762,2182,6977,341,1235,871,2751,1212,3986
510279,202111,1891,4775,1114,3413,168,548,372,1041,540,1589
510285,202111,1194,3057,786,2336,208,708,221,590,429,1298
510300,202111,3938,9666,2936,8335,449,1245,1729,5197,2178,6442
510305,202111,1523,4098,942,2998,178,592,219,761,397,1353
510310,202111,1017,2417,695,1905,190,539,194,551,384,1090
510320,202111,3941,9485,2754,7507,590,1777,616,1629,1206,3406
510325,202111,4551,13037,3236,10565,860,3000,830,2738,1690,5738
510330,202111,2713,7983,1804,6392,312,1123,621,2604,933,3727
510335,202111,5066,14313,3814,12259,605,2048,1922,6269,2527,8317
510336,202111,462,1265,334,1070,45,141,178,639,223,780
510337,202111,1514,4238,977,3292,342,1277,214,729,556,2006
510340,202111,100046,218458,66125,170023,14631,43345,22406,54444,37037,97789
510343,202111,1196,2976,767,2230,120,406,346,938,466,1344
510345,202111,1322,3684,991,3035,168,501,432,1311,600,1812
510350,202111,3276,8072,2223,6349,522,1500,898,2595,1420,4095
510360,202111,2135,4237,1337,3313,84,137,934,2513,1018,2650
510370,202111,1843,5083,1363,4291,178,623,829,2656,1007,3279
510380,202111,628,1483,362,1040,61,207,150,424,211,631
510385,202111,1258,4110,922,3502,84,366,616,2431,700,2797
510390,202111,1385,3448,931,2906,293,895,284,1086,577,1981
510395,202111,749,1600,504,1244,26,60,333,867,359,927
510410,202111,5131,13587,3692,11143,678,2135,1873,5887,2551,8022
510420,202111,2636,5309,1785,4193,139,292,1199,2846,1338,3138
510450,202111,602,1442,339,984,77,228,60,175,137,403
510452,202111,880,2442,653,2019,79,252,393,1177,472,1429
510454,202111,1043,2775,787,2346,92,260,481,1512,573,1772
510455,202111,1027,2693,695,2073,139,462,249,673,388,1135
510460,202111,2008,4955,1477,4151,208,632,809,2154,1017,2786
510480,202111,5171,12128,3505,9149,599,1719,1416,3471,2015,5190
510490,202111,1800,4500,1343,3924,261,718,790,2375,1051,3093
510500,202111,1625,3900,996,2920,207,632,270,779,477,1411
510510,202111,3960,10796,2804,8849,658,2302,884,2894,1542,5196
510515,202111,5575,13791,3677,10475,742,2399,1170,2931,1912,5330
510517,202111,1540,3786,1010,2984,303,1030,186,501,489,1531
510520,202111,2395,4725,1320,3381,126,317,592,1674,718,1991
510523,202111,1335,3069,943,2480,150,414,580,1502,730,1916
510525,202111,8158,21709,5957,17436,914,2843,2741,7548,3655,10391
510530,202111,568,1455,415,1232,29,99,272,805,301,904
510550,202111,2569,7247,1883,6092,369,1254,903,2876,1272,4130
510558,202111,2460,6446,1823,5477,257,712,854,2846,1111,3558
510560,202111,1719,4799,1049,3492,198,710,228,810,426,1520
510562,202111,6190,14969,4479,12075,998,2778,1591,4632,2589,7410
510590,202111,3131,7657,2304,6579,162,470,1665,4901,1827,5371
510600,202111,1532,3303,1034,2586,154,378,523,1279,677,1657
510610,202111,2750,6455,1861,5293,273,816,1011,2858,1284,3674
510615,202111,2959,7082,2059,5676,306,935,1173,3216,1479,4151
510617,202111,1057,3127,832,2769,82,315,583,1995,665,2310
510618,202111,1287,3336,917,2738,197,644,414,1214,611,1858
510619,202111,828,2042,474,1408,68,190,87,227,155,417
510620,202111,1479,3299,686,2000,175,620,34,65,209,685
510621,202111,1689,4411,1015,3149,224,756,262,717,486,1473
510622,202111,5225,14092,3534,10618,1127,3662,472,1307,1599,4969
510623,202111,2907,7054,2106,5786,479,1407,693,1911,1172,3318
510624,202111,1694,4304,845,2724,97,342,178,507,275,849
510625,202111,3289,7740,1846,5234,313,992,469,1327,782,2319
510626,202111,1552,3693,967,2769,245,808,196,561,441,1369
510627,202111,683,1708,370,1115,88,302,88,275,176,577
510628,202111,1571,3506,1034,2812,253,718,390,1062,643,1780
510629,202111,1765,4809,1247,3880,242,822,374,1174,616,1996
510630,202111,3609,9703,2156,6982,478,1659,390,1406,868,3065
510631,202111,593,1388,428,1143,17,37,325,905,342,942
510637,202111,3919,9009,2777,7370,639,1879,857,2305,1496,4184
510642,202111,5822,15855,4438,13775,968,3329,2103,6507,3071,9836
510645,202111,1120,2139,695,1626,198,414,270,693,468,1107
510650,202111,7482,18288,5861,16518,673,1696,3866,12339,4539,14035
510665,202111,1877,3999,1175,2909,253,584,424,1170,677,1754
510670,202111,447,945,256,671,34,93,138,364,172,457
510675,202111,6663,17767,4494,13778,1119,3820,787,2262,1906,6082
510677,202111,2350,5911,1644,4870,230,758,883,2587,1113,3345
510680,202111,743,1846,418,1246,78,261,107,268,185,529
510682,202111,1648,4574,1200,3857,387,1416,307,916,694,2332
510685,202111,520,1450,361,1135,53,168,187,605,240,773
510700,202111,4247,9817,2959,8084,257,760,2259,6140,2516,6900
510704,202111,11650,27000,7786,20523,1830,5147,1830,4683,3660,9830
510706,202111,2350,6746,1614,5517,344,1202,689,2612,1033,3814
510710,202111,3067,7361,1967,5279,451,1223,571,1489,1022,2712
510715,202111,646,1369,464,1131,27,67,279,672,306,739
510718,202111,2452,5512,1455,4161,360,1000,570,1975,930,2975
510719,202111,489,1009,291,744,38,103,164,390,202,493
510720,202111,941,2117,632,1679,129,359,267,685,396,1044
510724,202111,921,2457,647,1945,93,289,331,958,424,1247
510726,202111,1069,1936,587,1354,67,163,306,717,373,880
510729,202111,648,1488,298,847,29,93,81,253,110,346
510730,202111,3117,7326,2115,5802,279,861,1082,2851,1361,3712
510735,202111,1170,3163,909,2803,89,315,676,2057,765,2372
510740,202111,1064,2555,686,1868,109,302,354,925,463,1227
510757,202111,512,1622,395,1439,131,504,121,415,252,919
510760,202111,47532,102148,28630,73590,5944,17146,8949,20918,14893,38064
510770,202111,4453,9774,3060,8031,181,417,2123,5847,2304,6264
510774,202111,382,940,273,778,43,126,145,420,188,546
510775,202111,672,1736,419,1318,94,312,79,239,173,551
510776,202111,595,1417,421,1121,75,216,182,457,257,673
510777,202111,1668,4265,1207,3670,157,507,822,2498,979,3005
510779,202111,839,2158,624,1812,60,156,378,1176,438,1332
510780,202111,4116,10208,3040,8664,700,1951,1294,4173,1994,6124
510785,202111,2111,5365,1230,3814,353,1135,188,690,541,1825
510787,202111,3144,8613,1987,6248,523,1747,140,396,663,2143
510788,202111,601,1359,415,1082,63,165,192,573,255,738
510790,202111,20061,49924,12755,37046,2927,9291,1821,4865,4748,14156
510792,202111,10203,27469,6267,19836,1264,4448,1072,3044,2336,7492
510794,202111,1269,3375,902,2764,300,1011,159,419,459,1430
510795,202111,9765,24529,6594,18945,1382,4411,1866,5050,3248,9461
510800,202111,1659,4179,1109,3263,321,991,118,307,439,1298
510805,202111,1621,4363,1139,3508,235,799,428,1209,663,2008
510810,202111,705,1385,463,1071,146,334,141,373,287,707
510820,202111,836,1534,477,1095,22,58,275,632,297,690
510830,202111,967,2190,728,1893,41,92,554,1513,595,1605
510835,202111,617,1457,408,1154,48,149,252,693,300,842
510840,202111,61682,127666,42431,104206,8563,19595,20412,55246,28975,74841
510850,202111,2003,4791,1238,3611,393,1314,118,283,511,1597
510860,202111,2588,6549,1631,4984,483,1757,219,646,702,2403
510880,202111,810,2188,603,1820,156,499,168,517,324,1016
510885,202111,697,1633,457,1281,93,275,114,330,207,605
510890,202111,827,2275,622,1925,161,524,257,795,418,1319
510895,202111,1396,3498,905,2674,155,563,402,1096,557,1659
520005,202111,3203,8024,2497,7113,746,2128,880,2996,1626,5124
520010,202111,2693,7284,1929,5827,429,1459,624,1664,1053,3123
520013,202111,3526,8570,2307,6410,536,1501,625,1903,1161,3404
520015,202111,539,1303,391,1088,96,262,147,436,243,698
520017,202111,1304,3184,956,2663,241,680,360,959,601,1639
520020,202111,476,1024,369,901,23,69,302,721,325,790
520025,202111,36120,97260,30606,89554,3856,11411,20573,60532,24429,71943
520030,202111,6250,15073,5084,13494,333,893,3852,10192,4185,11085
520050,202111,442,1032,264,709,22,46,158,444,180,490
520055,202111,2002,4697,1264,3274,193,439,611,1573,804,2012
520060,202111,1772,4531,1243,3596,271,934,293,797,564,1731
520080,202111,1945,4915,1491,4303,272,766,703,2263,975,3029
520082,202111,985,2398,723,1965,79,230,354,1006,433,1236
520085,202111,1070,2605,836,2253,163,458,401,1073,564,1531
520090,202111,901,1739,632,1446,81,137,452,1097,533,1234
520110,202111,39553,103499,27221,82773,7384,25604,2768,7702,10152,33306
520120,202111,238,553,135,377,12,39,61,162,73,201
520130,202111,4226,9875,3259,8361,648,1688,1330,3479,1978,5167
520140,202111,45312,117079,31261,92987,10733,34590,3700,11500,14433,46090
520145,202111,638,1426,431,1131,84,239,214,508,298,747
520150,202111,678,1542,503,1326,67,179,262,703,329,882
520160,202111,914,2101,628,1608,120,292,218,608,338,900
520170,202111,5055,10182,3371,8257,205,587,2535,6140,2740,6727
520180,202111,2656,6815,2144,6064,327,1015,1228,3397,1555,4412
520215,202111,1836,4308,1312,3523,263,736,519,1350,782,2086
520235,202111,770,1688,514,1321,56,162,276,704,332,866
520250,202111,1635,4032,1162,3272,347,1052,278,890,625,1942
520260,202111,855,1941,536,1441,96,254,207,570,303,824
520280,202111,887,1989,685,1691,129,307,334,862,463,1169
520310,202111,1094,2283,682,1673,176,486,198,524,374,1010
520320,202111,1880,4873,1424,4137,180,514,802,2399,982,2913
520330,202111,4964,12546,3717,10495,559,1796,1871,5110,2430,6906
520340,202111,2629,5593,1616,4214,176,405,969,2635,1145,3040
520350,202111,3033,7105,2141,5771,596,1707,798,2213,1394,3920
520355,202111,2005,5349,1421,4199,422,1294,183,470,605,1764
520357,202111,844,1994,615,1643,48,100,451,1250,499,1350
520360,202111,757,1924,576,1627,135,400,189,537,324,937
520380,202111,1511,3701,916,2626,135,381,349,941,484,1322
520390,202111,1171,2583,717,1992,214,657,160,469,374,1126
520393,202111,675,1530,430,1136,62,164,173,439,235,603
520396,202111,934,2331,784,2112,50,121,535,1434,585,1555
520400,202111,1675,3997,1281,3470,130,382,925,2489,1055,2871
520410,202111,2216,4707,1452,3579,194,527,785,1811,979,2338
520420,202111,402,902,319,777,22,57,250,581,272,638
520425,202111,1673,3995,906,2513,241,728,115,305,356,1033
520430,202111,2449,5439,1432,3884,258,803,86,224,344,1027
520440,202111,3184,7510,1795,4988,402,1205,390,1021,792,2226
520450,202111,13191,30421,9022,24270,2738,8111,1914,5410,4652,13521
520455,202111,761,2037,547,1700,149,460,136,464,285,924
520460,202111,1089,2453,846,2143,89,195,636,1668,725,1863
520465,202111,864,2106,713,1909,62,192,544,1405,606,1597
520470,202111,2246,5490,1712,4790,498,1450,625,1939,1123,3389
520480,202111,932,2503,646,2024,173,559,189,577,362,1136
520485,202111,1645,4657,1325,4193,206,645,762,2365,968,3010
520490,202111,4330,11449,3253,9755,802,2452,1468,4576,2270,7028
520495,202111,1656,3544,1250,2996,76,182,965,2330,1041,2512
520500,202111,1541,3853,1104,3060,188,553,549,1509,737,2062
520505,202111,819,1756,578,1455,61,154,393,991,454,1145
520510,202111,8096,19652,5516,15712,1036,3327,1898,5418,2934,8745
520520,202111,1276,3075,960,2594,233,671,353,948,586,1619
520530,202111,2560,6809,1893,5622,376,1171,885,2737,1261,3908
520540,202111,3172,8081,2065,5950,388,1191,530,1437,918,2628
520545,202111,1272,3102,1002,2676,252,597,411,1175,663,1772
520547,202111,1129,2858,863,2399,174,506,428,1177,602,1683
520549,202111,15459,39464,12830,35713,1605,4702,8582,23509,10187,28211
520551,202111,4916,12721,4089,11515,449,1395,2852,7841,3301,9236
520552,202111,852,2132,690,1923,160,421,358,1082,518,1503
520570,202111,576,1270,379,963,98,210,121,352,219,562
520580,202111,2366,5157,1762,4458,221,565,1146,2900,1367,3465
520590,202111,1370,3272,931,2558,261,731,280,772,541,1503
520620,202111,8790,22829,6925,20057,1504,4525,3328,9734,4832,14259
520630,202111,906,2216,646,1783,59,161,301,828,360,989
520640,202111,2562,6052,1932,4994,447,1123,776,2121,1223,3244
520650,202111,1088,2336,767,1890,141,351,366,963,507,1314
520660,202111,582,1393,310,906,49,162,81,239,130,401
520670,202111,993,2627,836,2405,69,214,569,1610,638,1824
520680,202111,846,1979,648,1671,106,266,329,892,435,1158
520690,202111,329,755,218,584,75,193,54,155,129,348
520710,202111,449,1062,316,845,17,47,207,529,224,576
520725,202111,1503,3502,1017,2683,135,429,587,1480,722,1909
520735,202111,886,2095,603,1625,129,320,231,665,360,985
520740,202111,2641,5702,1998,4914,355,808,1013,2782,1368,3590
520750,202111,722,1705,508,1372,81,231,249,643,330,874
520753,202111,1358,3571,1006,2911,168,516,415,1123,583,1639
520760,202111,1429,3050,1207,2786,33,65,1097,2566,1130,2631
520780,202111,1587,3661,1137,3018,142,371,593,1573,735,1944
520790,202111,3670,8499,2551,6721,396,1008,1314,3614,1710,4622
520800,202111,17647,44047,13733,38308,1917,5361,8199,23558,10116,28919
520810,202111,1377,2806,1046,2434,172,376,648,1665,820,2041
520815,202111,613,1843,454,1497,87,295,118,407,205,702
520830,202111,1974,4125,1401,3457,121,255,1061,2636,1182,2891
520840,202111,2955,7569,2387,6833,825,2674,656,1935,1481,4609
520850,202111,755,1783,560,1500,152,493,193,501,345,994
520860,202111,7893,20459,5843,17007,1366,4219,2267,6390,3633,10609
520870,202111,124430,283034,85396,223771,17192,48206,32428,82559,49620,130765
520880,202111,8298,23085,6378,19547,1353,4337,2302,6971,3655,11308
520890,202111,4628,10496,3168,8251,493,1433,1499,3757,1992,5190
520910,202111,4896,11943,3148,8995,681,2132,796,2159,1477,4291
520915,202111,763,2048,475,1418,103,331,149,410,252,741
520920,202111,4776,10365,3407,8675,599,1469,1574,4405,2173,5874
520929,202111,711,1661,547,1436,56,126,304,847,360,973
520940,202111,1024,2647,790,2306,51,115,604,1778,655,1893
520945,202111,527,1139,381,950,91,223,176,441,267,664
520960,202111,1164,2643,905,2269,301,701,357,999,658,1700
520970,202111,2952,7713,2290,6670,476,1581,523,1671,999,3252
520980,202111,820,1908,598,1604,100,266,253,669,353,935
520990,202111,3126,7945,2506,7170,349,900,1665,4901,2014,5801
520993,202111,1220,2797,837,2199,141,406,420,1073,561,1479
520995,202111,2571,6292,1932,5401,346,995,683,2053,1029,3048
521000,202111,9581,24473,6274,18333,1131,3455,1711,4852,2842,8307
521010,202111,3835,9744,2827,7970,295,812,1560,4380,1855,5192
521015,202111,824,2012,580,1581,43,131,371,964,414,1095
521020,202111,3911,9635,2274,6475,582,1802,222,639,804,2441
521030,202111,589,1265,422,1012,41,85,276,682,317,767
521040,202111,8364,19953,6176,16529,1374,3718,2331,6637,3705,10355
521056,202111,953,2443,736,2118,250,697,186,615,436,1312
521060,202111,1050,2730,755,2170,142,432,279,797,421,1229
521080,202111,1176,2469,618,1614,87,243,284,674,371,917
521090,202111,3267,8544,2124,6221,467,1530,213,628,680,2158
521100,202111,1973,4326,1458,3614,239,558,895,2271,1134,2829
521120,202111,4885,11371,3645,9816,301,736,1686,5410,1987,6146
521130,202111,1066,2379,555,1469,21,56,272,767,293,823
521140,202111,1520,3779,1133,3094,110,308,628,1678,738,1986
521150,202111,13220,28442,8262,21371,1592,4640,3500,9281,5092,13921
521160,202111,749,1501,506,1165,83,159,293,686,376,845
521170,202111,1131,2569,832,2122,93,263,470,1153,563,1416
521180,202111,8263,21693,6723,19093,1160,3415,3384,9438,4544,12853
521190,202111,11453,27552,6831,19972,1659,5138,1473,4452,3132,9590
521200,202111,740,1724,519,1383,55,146,319,847,374,993
521205,202111,672,1599,518,1362,23,55,398,1004,421,1059
521210,202111,787,2009,437,1272,76,237,103,231,179,468
521220,202111,3937,9166,2658,7225,415,1220,1175,3224,1590,4444
521225,202111,415,873,304,747,63,140,177,456,240,596
521230,202111,1447,3559,1259,3323,415,1098,575,1667,990,2765
521250,202111,34644,87181,27273,76609,9271,26560,8721,26279,17992,52839
521260,202111,566,1280,421,1065,73,178,223,562,296,740
521270,202111,1961,4659,1709,4367,118,254,1288,3367,1406,3621
521280,202111,1893,4919,1411,4138,313,996,557,1662,870,2658
521290,202111,577,1273,399,1045,51,150,248,625,299,775
521295,202111,1248,2677,980,2385,107,211,786,1981,893,2192
521300,202111,1994,4779,1548,4153,287,722,896,2525,1183,3247
521305,202111,740,1689,537,1409,82,191,299,811,381,1002
521308,202111,5152,13110,3553,10190,349,1020,2108,5875,2457,6895
521310,202111,9351,23219,6486,18290,1208,3718,2904,7752,4112,11470
521340,202111,427,949,302,765,25,62,199,508,224,570
521350,202111,2159,5370,1644,4596,155,470,1140,3122,1295,3592
521370,202111,1299,3230,793,2376,210,718,79,254,289,972
521375,202111,1452,3543,983,2788,203,580,274,891,477,1471
521377,202111,1589,3300,1168,2780,145,241,859,2212,1004,2453
521380,202111,6583,16994,4250,12704,461,1471,1042,3337,1503,4808
521385,202111,729,1693,549,1451,69,167,279,817,348,984
521390,202111,747,1825,516,1462,142,449,142,434,284,883
521400,202111,3058,6836,2453,6123,282,657,1683,4325,1965,4982
521405,202111,1510,3770,1048,2935,142,409,564,1547,706,1956
521410,202111,887,2245,679,1896,111,311,352,1011,463,1322
521440,202111,1356,3197,1011,2691,325,934,323,866,648,1800
521450,202111,4218,12113,3037,9778,790,2526,624,2236,1414,4762
521460,202111,6013,15113,4243,12004,1158,3450,1224,3490,2382,6940
521470,202111,764,1936,493,1426,65,181,197,569,262,750
521480,202111,456,1088,286,780,62,161,93,243,155,404
521483,202111,2492,5795,1731,4665,357,977,735,2034,1092,3011
521486,202111,1861,4341,1397,3687,100,215,956,2558,1056,2773
521487,202111,431,1010,310,848,61,162,153,443,214,605
521490,202111,952,2467,708,2059,39,126,491,1380,530,1506
521500,202111,2278,5481,1721,4678,108,363,1195,3128,1303,3491
521520,202111,800,1799,588,1496,95,211,280,746,375,957
521523,202111,12836,37237,10484,33526,2822,9470,3086,10199,5908,19669
521525,202111,1167,2626,892,2240,85,220,615,1512,700,1732
521530,202111,2469,6170,1518,4279,314,872,382,1078,696,1950
521540,202111,875,2187,608,1750,100,320,258,762,358,1082
521550,202111,1760,4327,936,2680,159,523,227,663,386,1186
521560,202111,5209,12867,3606,10699,914,2589,1459,4855,2373,7444
521565,202111,706,1653,497,1314,93,234,230,608,323,842
521570,202111,3741,9938,2552,7652,459,1655,138,414,597,2069
521580,202111,523,1229,311,859,42,124,115,286,157,410
521590,202111,744,1636,546,1362,97,251,304,744,401,995
521600,202111,453,1163,291,856,27,64,132,387,159,451
521630,202111,1795,3779,1127,2842,246,660,352,899,598,1559
521640,202111,2101,4786,1373,3702,253,726,473,1253,726,1979
521645,202111,585,1475,368,1077,141,396,53,143,194,539
521680,202111,1308,3707,998,3141,256,892,182,598,438,1490
521690,202111,579,1377,481,1248,65,182,296,764,361,946
521710,202111,3519,8431,2260,6363,370,1188,640,1591,1010,2779
521720,202111,2482,5453,1649,4246,244,625,897,2338,1141,2963
521730,202111,3922,10424,3027,8940,779,2701,803,1967,1582,4668
521740,202111,4264,10709,3220,9148,859,2627,769,2280,1628,4907
521760,202111,16211,42218,12634,36860,2733,8624,4911,15445,7644,24069
521770,202111,3400,7760,2273,6015,588,1696,532,1458,1120,3154
521800,202111,7056,18086,5104,14912,1191,3544,1975,6321,3166,9865
521805,202111,941,1954,653,1594,172,410,284,760,456,1170
521810,202111,708,1633,510,1362,105,271,276,769,381,1040
521830,202111,5882,15660,4701,13848,306,1014,3424,9888,3730,10902
521839,202111,873,2011,632,1616,91,261,389,914,480,1175
521850,202111,6721,14862,4125,10978,942,2610,700,1950,1642,4560
521860,202111,1686,4413,1145,3412,186,593,349,972,535,1565
521870,202111,746,2007,532,1590,99,340,135,339,234,679
521878,202111,781,1942,554,1512,56,182,317,795,373,977
521880,202111,20432,49112,14052,39120,3592,10386,4703,13143,8295,23529
521890,202111,3534,8833,2371,6790,614,1846,531,1417,1145,3263
521900,202111,1466,3379,770,2210,193,550,36,103,229,653
521910,202111,1455,2999,1015,2479,142,332,534,1390,676,1722
521920,202111,555,1413,402,1161,62,205,203,554,265,759
521925,202111,807,2026,580,1678,95,292,302,862,397,1154
521930,202111,5854,13629,3843,10629,1056,2749,1318,4247,2374,6996
521935,202111,1121,2604,763,1992,83,231,424,1047,507,1278
521940,202111,1406,2954,892,2245,183,511,393,951,576,1462
521945,202111,700,1775,525,1466,92,265,274,780,366,1045
521950,202111,806,1891,560,1511,121,326,234,635,355,961
521960,202111,754,1897,512,1451,48,150,277,727,325,877
521970,202111,3019,6777,2285,5905,217,471,1631,4477,1848,4948
521971,202111,794,1841,552,1465,151,364,140,386,291,750
521973,202111,1595,3965,1318,3595,90,184,1063,2943,1153,3127
521975,202111,13014,33213,10618,29886,2028,5694,6144,17526,8172,23220
521980,202111,2635,5988,2022,5181,160,395,1510,3974,1670,4369
521990,202111,1214,3223,982,2838,211,644,420,1205,631,1849
522000,202111,2874,7259,2256,6480,432,1247,1218,3713,1650,4960
522005,202111,367,852,263,690,54,147,115,301,169,448
522010,202111,4481,10733,3215,8683,644,1868,1203,3125,1847,4993
522015,202111,1116,2811,817,2352,257,699,282,855,539,1554
522020,202111,5783,13311,3741,10148,782,2255,1392,3971,2174,6226
522026,202111,855,2227,553,1684,87,298,152,403,239,701
522028,202111,522,1268,355,987,86,255,99,276,185,531
522040,202111,3633,7754,2598,6370,295,799,1781,4268,2076,5067
522045,202111,19061,50839,14143,42409,3199,10143,3928,11519,7127,21662
522050,202111,1263,3161,862,2459,163,518,318,822,481,1340
522060,202111,3157,8020,2238,6524,291,853,1142,3434,1433,4287
522068,202111,1971,4781,1569,4301,113,260,1260,3524,1373,3784
522070,202111,775,1758,632,1560,12,29,548,1327,560,1356
522100,202111,816,2006,551,1564,73,212,280,777,353,989
522108,202111,1173,2666,924,2322,57,137,750,1862,807,1999
522119,202111,1873,4339,1478,3836,219,575,815,2229,1034,2804
522130,202111,473,1149,346,978,40,107,235,688,275,795
522140,202111,22395,56499,15789,44799,3641,10962,4629,12368,8270,23330
522145,202111,856,2032,599,1655,173,466,231,658,404,1124
522150,202111,1144,2706,789,2130,199,539,212,589,411,1128
522155,202111,1119,2747,866,2373,183,421,484,1415,667,1836
522157,202111,707,1542,575,1381,23,54,471,1158,494,1212
522160,202111,6271,15639,4018,11557,1030,3222,339,1087,1369,4309
522170,202111,2794,6986,2114,5989,338,943,1191,3454,1529,4397
522180,202111,617,1438,394,1024,63,172,104,291,167,463
522185,202111,21261,50608,14973,42021,5469,17010,3065,9258,8534,26268
522190,202111,830,1892,574,1466,120,316,231,572,351,888
522200,202111,1801,4879,1228,3831,265,878,251,754,516,1632
522205,202111,1830,4221,1366,3578,194,512,760,2015,954,2527
522220,202111,1382,3224,1021,2713,134,336,628,1731,762,2067
522230,202111,1361,3262,1094,2881,195,616,571,1458,766,2074
530010,202111,199088,522847,164165,471113,22836,70670,99997,280606,122833,351276
110001,202110,4190,11414,2798,8820,617,2098,1013,3239,1630,5337
110002,202110,14063,35362,10156,28799,2675,8078,2693,7737,5368,15815
110003,202110,631,1845,473,1517,122,403,138,418,260,821
110004,202110,12940,32520,8634,25079,1730,5428,2581,7449,4311,12877
110005,202110,2631,6669,1827,5372,365,1147,487,1561,852,2708
110006,202110,1783,4887,1099,3456,166,581,233,702,399,1283
110007,202110,1347,3366,850,2528,266,830,204,752,470,1582
110008,202110,3631,9360,2682,8003,324,900,1697,5539,2021,6439
110009,202110,4579,12407,2929,9420,588,2035,1144,3694,1732,5729
110010,202110,8350,25068,6176,21003,1256,4284,2990,11113,4246,15397
110011,202110,7575,19546,5110,15170,1627,5154,701,2173,2328,7327
110012,202110,16688,40742,10064,29362,2176,6873,987,3046,3163,9919
110013,202110,5634,15744,3895,12312,1515,5102,421,1502,1936,6604
110014,202110,4143,10604,2802,8052,509,1562,1253,3503,1762,5065
110015,202110,6019,15093,3672,10671,744,2398,967,2514,1711,4912
110018,202110,4019,9902,2345,7006,409,1418,595,1805,1004,3223
110020,202110,80411,186134,58054,155828,13297,36680,22552,67641,35849,104321
110025,202110,5554,13116,3726,10025,672,1946,1728,4590,2400,6536
110026,202110,552,1348,396,1120,92,292,153,463,245,755
110028,202110,7526,18466,4587,13277,1048,3364,594,1715,1642,5079
110029,202110,1647,3949,964,2767,199,589,365,1088,564,1677
110030,202110,13637,30768,8337,22894,1751,5565,1270,3845,3021,9410
110032,202110,3566,9731,2119,6686,687,2170,354,1231,1041,3401
110033,202110,3807,11492,2845,9706,960,3307,708,2736,1668,6043
110034,202110,3440,7897,2268,6297,702,2228,696,2120,1398,4348
110037,202110,1751,5037,1281,4182,295,962,554,1870,849,2832
110040,202110,3105,8365,2226,6771,553,1816,703,2068,1256,3884
110045,202110,5108,14253,3692,11683,958,3272,1164,3840,2122,7112
110050,202110,1865,4928,1275,3882,392,1327,157,435,549,1762
110060,202110,943,2730,635,2010,164,563,135,409,299,972
110070,202110,1673,5022,1182,3930,336,1192,249,774,585,1966
110080,202110,6882,15533,5176,13501,1046,2618,2941,8321,3987,10939
110090,202110,622,1656,427,1305,82,263,127,392,209,655
110092,202110,1334,3748,927,2981,181,588,426,1475,607,2063
110094,202110,2998,8658,2183,7065,844,2956,229,776,1073,3732
110100,202110,1786,5114,1389,4359,382,1272,537,1737,919,3009
110110,202110,1855,4893,1313,4024,461,1474,248,872,709,2346
110120,202110,1372,3831,1033,3179,229,763,371,1124,600,1887
110130,202110,3003,7285,1722,4886,125,367,170,413,295,780
110140,202110,2277,6470,1592,5100,341,1155,502,1618,843,2773
110143,202110,1406,3763,992,2951,293,883,178,535,471,1418
110145,202110,962,2457,582,1744,134,400,210,669,344,1069
110146,202110,523,1313,367,1067,71,177,176,547,247,724
110147,202110,799,2015,509,1465,61,202,205,508,266,710
110148,202110,983,2632,479,1538,123,455,60,186,183,641
110149,202110,3438,8912,2268,7012,766,2498,469,1573,1235,4071
110150,202110,2907,7036,1844,5449,553,1845,401,1386,954,3231
110155,202110,795,2265,559,1706,116,392,195,536,311,928
110160,202110,1535,4564,1108,3626,302,1020,267,896,569,1916
110170,202110,2229,5592,1408,4085,233,723,748,2088,981,2811
110175,202110,1894,5239,1303,4080,209,670,498,1645,707,2315
110180,202110,1532,4014,1068,3096,126,387,561,1596,687,1983
120001,202110,3508,9925,2846,8938,473,1564,1750,5624,2223,7188
120005,202110,2020,7490,1841,7239,152,622,1458,5884,1610,6506
120010,202110,5570,15913,4732,14700,416,1206,3518,11277,3934,12483
120013,202110,2321,7642,2037,7296,447,1528,1236,4769,1683,6297
120017,202110,2695,8148,2334,7605,376,1209,1433,4978,1809,6187
120020,202110,16050,58786,14754,56346,971,4037,11879,45673,12850,49710
120025,202110,3279,8849,2633,8082,318,956,1892,5978,2210,6934
120030,202110,6627,25609,6142,24732,395,1835,4759,19429,5154,21264
120032,202110,1846,7885,1761,7732,92,568,1512,6521,1604,7089
120033,202110,4359,15453,4082,14959,87,502,3579,12960,3666,13462
120034,202110,2857,9919,2451,9231,94,523,2050,7629,2144,8152
120035,202110,3980,14881,3761,14499,251,1120,3137,12063,3388,13183
120038,202110,2850,8757,2415,8055,477,1621,1375,4674,1852,6295
120039,202110,2111,8836,1972,8566,105,642,1606,6959,1711,7601
120040,202110,47954,143098,40862,131897,5184,17507,26196,85320,31380,102827
120042,202110,3564,12585,3289,12099,135,632,2781,10145,2916,10777
120043,202110,1570,6059,1409,5826,37,223,1288,5330,1325,5553
120045,202110,6322,15998,5430,14981,164,588,4857,13266,5021,13854
120050,202110,9703,33978,8873,32741,358,1725,7442,27602,7800,29327
120060,202110,9765,37661,8929,36451,334,2064,7798,31623,8132,33687
120070,202110,3402,10441,2944,9821,265,832,2146,7445,2411,8277
120080,202110,4567,13929,4052,13177,454,1453,2989,9992,3443,11445
130002,202110,3399,12396,3036,11862,180,562,2633,10596,2813,11158
130006,202110,2632,9275,2180,8513,251,875,1545,6297,1796,7172
130008,202110,2855,9654,2522,9182,60,280,2178,7940,2238,8220
130010,202110,4050,11690,3400,10948,110,288,3039,9960,3149,10248
130014,202110,3651,10200,2817,8891,452,1449,1745,5628,2197,7077
130020,202110,3114,11793,2781,11297,98,560,2357,9556,2455,10116
130030,202110,11276,34230,10277,33082,361,824,9241,30439,9602,31263
130040,202110,4418,12504,3657,11508,368,964,2823,9200,3191,10164
130050,202110,7900,28045,6595,26348,201,856,5949,24133,6150,24989
130060,202110,8112,30988,6950,29498,369,1898,5862,24865,6231,26763
130063,202110,6749,21673,6020,20871,196,842,5490,19103,5686,19945
130068,202110,4037,13377,3384,12481,169,871,2646,9676,2815,10547
130070,202110,7996,21498,6551,19932,341,850,5341,16965,5682,17815
130080,202110,7755,26508,6793,25415,243,1130,5837,22338,6080,23468
130083,202110,2900,9162,2579,8768,161,582,2128,7432,2289,8014
130090,202110,3737,11249,3316,10744,38,155,2999,9919,3037,10074
130100,202110,8247,24516,6962,23177,118,254,6465,22162,6583,22416
130110,202110,8787,24380,7165,22384,1082,2719,5065,17221,6147,19940
130115,202110,5305,16462,4554,15609,107,305,4023,14092,4130,14397
130120,202110,14293,49900,12566,47603,1115,4490,10059,38662,11174,43152
130130,202110,5933,17699,4547,15880,460,1592,3255,11624,3715,13216
130140,202110,7563,25744,6584,24627,234,1085,5672,21414,5906,22499
130150,202110,3847,14003,3620,13748,60,369,3353,12789,3413,13158
130160,202110,5610,18862,4809,17842,337,1055,4041,15550,4378,16605
130165,202110,3338,12353,3133,12111,113,478,2830,11063,2943,11541
130170,202110,12285,34440,9870,31675,721,2270,8004,26383,8725,28653
130180,202110,4577,14694,4346,14434,41,201,4197,13924,4238,14125
130185,202110,19669,46922,16073,43069,1270,2085,13092,37912,14362,39997
130190,202110,19956,63678,16035,57965,1611,5392,11595,43829,13206,49221
130195,202110,2575,9105,2079,8429,82,374,1746,7104,1828,7478
130200,202110,2860,7632,2325,6949,83,285,2008,5990,2091,6275
130210,202110,1395,5124,1255,4956,100,558,1028,3949,1128,4507
130220,202110,2540,8124,2138,7634,70,256,1889,6868,1959,7124
130230,202110,5179,20010,4514,19082,182,1087,3962,16728,4144,17815
130240,202110,13108,37953,10647,34791,150,804,9678,31688,9828,32492
130250,202110,27248,79474,23329,75058,1603,4184,18998,63790,20601,67974
130255,202110,4883,15578,4235,14463,133,531,3470,11900,3603,12431
130260,202110,272236,728861,220688,657092,59521,185342,99523,313357,159044,498699
130270,202110,10327,34939,8527,32167,1555,5448,5209,21001,6764,26449
130280,202110,3743,14541,3441,14202,81,386,3211,13408,3292,13794
130290,202110,14427,45737,12596,43458,713,2309,10773,38058,11486,40367
130300,202110,5146,16950,4621,16256,146,754,4027,14183,4173,14937
130310,202110,6800,21593,5877,20432,298,1159,4983,17420,5281,18579
130320,202110,3607,11547,2999,10751,400,1354,2188,8184,2588,9538
130330,202110,4913,15083,3945,13936,205,814,3348,11917,3553,12731
130340,202110,25451,74441,21899,70434,1570,3713,18450,61783,20020,65496
130350,202110,4162,14700,3750,14190,145,699,3313,12514,3458,13213
130353,202110,7979,20752,6387,18747,853,2280,4498,13925,5351,16205
130356,202110,5560,16980,4613,15522,855,2738,2687,9723,3542,12461
130360,202110,3181,10180,2702,9550,77,280,2425,8604,2502,8884
130370,202110,5908,23229,5067,22066,317,1684,3984,17496,4301,19180
130380,202110,7448,30672,6920,29910,384,2119,5902,25353,6286,27472
130390,202110,6442,25824,5747,24721,546,2460,4563,19894,5109,22354
130395,202110,2551,7860,2187,7287,200,649,1693,5731,1893,6380
130400,202110,2967,8846,2543,8297,120,284,2251,7554,2371,7838
130406,202110,11257,37971,9425,35754,1829,6589,6161,24819,7990,31408
130410,202110,4637,15690,3968,14596,1127,4292,1848,7058,2975,11350
130420,202110,14774,49423,12296,46336,963,4111,9515,36338,10478,40449
130423,202110,4656,14107,4081,13452,186,654,3593,11843,3779,12497
130426,202110,2863,11176,2644,10917,57,294,2447,10204,2504,10498
130430,202110,4517,12289,3879,11453,191,600,3372,9927,3563,10527
130440,202110,5348,16040,4489,15017,82,324,4183,14083,4265,14407
140002,202110,2415,6920,2110,6554,102,349,1761,5585,1863,5934
140005,202110,3400,9316,2954,8799,135,339,2510,7732,2645,8071
140010,202110,56702,148453,45377,131720,11079,34059,18664,55728,29743,89787
140015,202110,4002,11481,3398,10754,236,670,2926,9526,3162,10196
140017,202110,5351,13740,4710,12936,352,758,3867,11020,4219,11778
140020,202110,5331,15127,4602,14191,252,959,3787,11624,4039,12583
140023,202110,2641,7612,2166,6940,201,643,1657,5425,1858,6068
140028,202110,2003,5107,1691,4719,77,245,1367,3825,1444,4070
140030,202110,5593,13890,4978,13187,322,576,4400,12041,4722,12617
140040,202110,2713,10278,2504,10003,83,510,2305,9061,2388,9571
140045,202110,2680,9696,2219,9067,391,1335,1389,6356,1780,7691
140047,202110,6561,18125,5457,16540,604,1869,3885,12001,4489,13870
140050,202110,1461,4205,1234,3883,118,336,927,3041,1045,3377
140060,202110,1792,4571,1551,4236,114,284,1272,3555,1386,3839
140070,202110,1944,9941,1881,9819,108,768,1611,8303,1719,9071
150010,202110,47352,116597,42676,110611,1056,2276,38224,99271,39280,101547
150013,202110,2077,5071,1743,4709,151,269,1380,3997,1531,4266
150020,202110,14725,43393,13566,41876,1869,4713,10479,34014,12348,38727
150030,202110,8903,33103,8080,32113,509,1896,6982,28278,7491,30174
150034,202110,4577,10662,3746,9653,274,628,3094,8162,3368,8790
150040,202110,17234,43007,15105,40660,1280,1795,12687,37132,13967,38927
150050,202110,7422,24718,6772,23863,128,523,6256,22272,6384,22795
150060,202110,23256,61407,18739,54716,2651,7843,12299,36643,14950,44486
150070,202110,7445,26532,6523,25438,219,930,5891,23238,6110,24168
150080,202110,97422,214602,79687,190364,20380,53736,19500,57885,39880,111621
150085,202110,8584,23626,7775,22689,136,358,7264,21429,7400,21787
150090,202110,10604,36648,9981,35472,784,2578,8097,29175,8881,31753
150095,202110,6249,16977,5478,16041,297,529,4759,14473,5056,15002
150100,202110,2993,10165,2649,9610,243,723,2052,7708,2295,8431
150110,202110,4466,17928,4154,17578,176,767,3829,16360,4005,17127
150120,202110,8372,25477,7912,24940,285,664,7017,22836,7302,23500
150125,202110,819,2016,599,1725,100,345,367,1034,467,1379
150130,202110,23907,66384,20488,61182,4072,10756,12288,39923,16360,50679
150140,202110,282398,625758,237814,565554,36924,82101,135316,336382,172240,418483
150145,202110,4472,13657,3749,12515,1091,3423,1643,6342,2734,9765
150150,202110,17826,43222,15458,40284,862,2231,12691,33156,13553,35387
150157,202110,3770,9886,2978,8854,317,879,2053,6450,2370,7329
150160,202110,3434,9201,3178,8834,447,1106,2185,6259,2632,7365
150170,202110,26308,81185,23025,75745,4278,12923,13830,48971,18108,61894
150172,202110,5385,14087,4311,12611,319,744,3196,9796,3515,10540
150175,202110,1743,5263,1444,4725,239,809,854,2837,1093,3646
150178,202110,11153,28500,9106,26168,403,723,7901,23465,8304,24188
150180,202110,23836,79570,21555,76995,1435,3415,18672,69393,20107,72808
150190,202110,7136,22607,6618,21985,187,708,6010,19986,6197,20694
150195,202110,5559,16815,5208,16287,200,637,4661,14593,4861,15230
150200,202110,6069,17487,5542,16903,55,133,5244,16110,5299,16243
150210,202110,28750,93877,26908,91559,1516,4338,22580,79683,24096,84021
150215,202110,9227,25201,7980,23298,1384,3950,4661,14084,6045,18034
150220,202110,13444,36342,11725,33918,1167,3009,8032,24009,9199,27018
150230,202110,13446,36782,11891,34705,1337,3372,8068,24792,9405,28164
150240,202110,35051,93366,29068,83373,7074,20937,10901,31195,17975,52132
150250,202110,4411,16257,4102,15914,577,2177,3238,12867,3815,15044
150260,202110,2793,8720,2507,8298,128,368,2045,6892,2173,7260
150270,202110,9551,26228,6697,21135,2050,6852,1510,5130,3560,11982
150275,202110,7132,21973,6479,21062,223,750,5610,18265,5833,19015
150276,202110,2527,6471,2168,6031,274,630,1411,4472,1685,5102
150277,202110,5406,13620,4283,12319,415,1064,3125,9639,3540,10703
150280,202110,7249,28119,6990,27708,388,1444,6094,24493,6482,25937
150285,202110,3400,11722,2970,11042,221,803,2193,8372,2414,9175
150290,202110,10691,28367,9630,27236,409,686,8549,25089,8958,25775
150293,202110,9905,23550,7656,20645,1149,2951,4619,13184,5768,16135
150295,202110,7925,20619,5687,17537,1798,5928,1815,6594,3613,12522
150300,202110,2491,7173,2255,6883,33,104,2085,6401,2118,6505
150304,202110,4449,12623,3656,11406,611,1722,2303,7689,2914,9411
150307,202110,6252,19430,5710,18543,273,834,4589,15060,4862,15894
150309,202110,6885,19351,5511,17069,875,2620,3202,10407,4077,13027
150310,202110,7663,29572,7291,29136,187,934,6509,26305,6696,27239
150320,202110,9476,25493,8635,24279,364,1061,6744,18935,7108,19996
150330,202110,14492,44558,13370,42876,1437,4079,9821,33051,11258,37130
150340,202110,2634,7541,2330,7095,350,975,1588,5017,1938,5992
150345,202110,9040,24759,8077,23502,432,1257,6933,20292,7365,21549
150350,202110,9496,23265,8667,22203,718,1258,7149,18914,7867,20172
150360,202110,24938,66179,19839,59802,2255,4924,13789,45332,16044,50256
150370,202110,11886,34174,9683,31196,1148,2966,6878,24198,8026,27164
150375,202110,3890,15327,3527,14820,215,971,3062,13008,3277,13979
150380,202110,11674,28739,9586,26024,117,399,8513,23085,8630,23484
150390,202110,7934,31041,7080,29723,1118,3885,5006,22594,6124,26479
150400,202110,6869,23868,6580,23346,218,709,5843,20872,6061,21581
150405,202110,9585,24417,8348,22956,527,992,6739,19265,7266,20257
150410,202110,2052,6152,1744,5636,275,707,1089,3751,1364,4458
150420,202110,41993,112388,32098,97941,8462,26899,11273,40328,19735,67227
150430,202110,8767,24627,7953,23589,918,1832,6197,19435,7115,21267
150440,202110,6060,18161,5477,17367,915,2504,3647,12358,4562,14862
150442,202110,29210,65647,24135,59496,2545,5840,16905,42544,19450,48384
150445,202110,6878,20046,6016,18777,231,659,5220,16407,5451,17066
150450,202110,5399,22181,4992,21645,392,1871,4205,18316,4597,20187
150460,202110,8701,27927,7914,26936,229,804,6803,24015,7032,24819
150470,202110,21707,55769,19367,53114,326,894,18274,50105,18600,50999
150475,202110,5452,16232,4637,15013,702,1980,3211,10940,3913,12920
150480,202110,14395,44203,12880,41997,2324,6297,8607,30456,10931,36753
150490,202110,8653,29509,7876,28529,364,1203,6739,24794,7103,25997
150495,202110,5695,18334,5414,17962,94,416,4985,16469,5079,16885
150497,202110,2925,9029,2340,8020,512,1792,1216,4497,1728,6289
150500,202110,3447,8558,3040,7974,287,684,2301,6030,2588,6714
150503,202110,5300,13165,3655,11031,1027,3276,1160,4037,2187,7313
150506,202110,11360,32173,9482,29612,1965,5456,5825,20234,7790,25690
150510,202110,10203,35698,8817,33224,1365,4672,5694,22843,7059,27515
150520,202110,8025,29276,7700,28877,154,807,7057,26397,7211,27204
150530,202110,12778,42228,10993,39645,1331,3727,7997,30771,9328,34498
150540,202110,5297,13722,4525,12584,305,720,3728,10471,4033,11191
150543,202110,7395,19494,6051,17825,430,1222,4701,14534,5131,15756
150548,202110,10543,32130,9443,30607,223,792,8414,27425,8637,28217
150549,202110,2042,5795,1734,5360,48,161,1448,4519,1496,4680
150550,202110,21938,62200,18088,55966,4728,14690,7135,23785,11863,38475
150553,202110,35288,95186,27707,82112,7688,22916,10879,33576,18567,56492
150555,202110,2077,5332,1627,4630,195,426,1077,3265,1272,3691
150560,202110,2015,5773,1784,5334,315,864,1029,3243,1344,4107
150563,202110,2737,7921,2245,7078,446,1437,1235,3951,1681,5388
150565,202110,4749,14671,4233,13868,95,381,3555,11740,3650,12121
150570,202110,6909,20484,6449,19866,465,1145,5408,17076,5873,18221
150580,202110,10896,41501,9251,39677,553,2731,7284,33116,7837,35847
150590,202110,8526,28708,7285,27232,140,809,6683,24940,6823,25749
150600,202110,9912,31993,9200,31148,209,774,8536,29070,8745,29844
150610,202110,3144,8507,2794,7973,120,340,2363,6738,2483,7078
150611,202110,3501,9273,3118,8756,103,302,2770,7772,2873,8074
150613,202110,14667,38684,11078,32737,1998,6215,5527,16280,7525,22495
150616,202110,3843,10350,2803,8594,601,1886,1191,3668,1792,5554
150618,202110,7367,20403,5996,18305,603,1785,3751,12012,4354,13797
150619,202110,7122,18927,5848,17193,298,661,4865,14638,5163,15299
150620,202110,6991,22762,6010,21121,670,2164,4038,14706,4708,16870
150630,202110,6886,17537,6277,16803,313,699,5476,14794,5789,15493
150635,202110,5349,14100,4453,12634,626,1645,2830,8246,3456,9891
150640,202110,2318,6748,2109,6483,41,115,1965,6106,2006,6221
150650,202110,12067,32126,10390,29488,2882,7782,4524,14144,7406,21926
150655,202110,5833,16459,5274,15640,210,581,4568,13615,4778,14196
150658,202110,4777,13269,3623,11378,720,2344,1805,5971,2525,8315
150660,202110,6083,16698,5365,15699,684,1860,3576,10734,4260,12594
150670,202110,9713,21078,7678,18770,737,1349,6148,15872,6885,17221
150680,202110,73964,207844,57099,181538,13753,42183,24451,89186,38204,131369
150690,202110,2912,6913,2496,6443,122,230,2162,5764,2284,5994
150700,202110,6407,18392,5718,17506,394,889,4510,14358,4904,15247
150710,202110,3856,12596,3490,12018,303,959,2611,9254,2914,10213
150715,202110,5335,14514,4378,13080,306,799,3477,10593,3783,11392
150720,202110,7095,24218,6588,23469,443,1502,5435,19805,5878,21307
150730,202110,13160,38109,11125,35135,1252,4031,8184,26579,9436,30610
150740,202110,4226,11336,3683,10491,324,749,2754,8071,3078,8820
150745,202110,5304,14569,4259,13056,628,1955,2943,9214,3571,11169
150746,202110,1825,5148,1650,4902,79,173,1377,4169,1456,4342
150747,202110,5333,15662,4718,14729,734,1891,3198,10646,3932,12537
150750,202110,3932,11823,3240,10763,227,789,2453,8442,2680,9231
150760,202110,12243,35076,11050,33422,1652,4400,7586,24011,9238,28411
150770,202110,6885,23565,6411,23037,247,551,5790,21644,6037,22195
150775,202110,1101,2836,855,2521,123,386,532,1583,655,1969
150780,202110,4613,13892,4083,13262,152,391,3671,12272,3823,12663
150790,202110,6273,16807,5366,15834,319,780,3851,13282,4170,14062
150795,202110,15340,44707,13252,41565,3045,8957,7536,25189,10581,34146
150796,202110,4085,9503,3537,8874,254,496,2936,7593,3190,8089
150797,202110,4378,12785,3760,11925,199,437,3105,10214,3304,10651
150800,202110,13890,42214,12421,40284,1608,4730,9058,30724,10666,35454
150803,202110,7792,23072,7223,22234,471,1136,6122,19244,6593,20380
150805,202110,3703,10921,3134,10112,272,800,2366,7880,2638,8680
150808,202110,6472,18039,4727,15160,1701,5998,689,2592,2390,8590
150810,202110,22079,55338,16642,48815,3314,9864,8301,27537,11615,37401
150812,202110,5910,15754,5209,14641,440,1303,3949,10885,4389,12188
150815,202110,10274,28848,8573,26844,719,2135,6998,22394,7717,24529
150820,202110,12569,32661,10681,30342,1416,3098,7763,23777,9179,26875
150830,202110,12731,43813,11775,42663,483,1704,9977,37878,10460,39582
150835,202110,2872,8639,2468,8004,341,1094,1606,5250,1947,6344
150840,202110,8168,21883,6568,19391,1064,3399,3675,10701,4739,14100
160005,202110,1269,3326,1114,3139,68,226,944,2669,1012,2895
160010,202110,2497,6573,2326,6388,19,88,2253,6133,2272,6221
160015,202110,2978,8272,2641,7870,70,204,2438,7314,2508,7518
160020,202110,2282,6879,1982,6509,173,450,1519,5285,1692,5735
160021,202110,1298,4639,1195,4508,53,266,957,3669,1010,3935
160023,202110,1382,4662,1224,4395,192,665,779,2985,971,3650
160025,202110,1855,5524,1743,5398,15,44,1685,5237,1700,5281
160027,202110,9007,24690,8020,23435,737,1937,6306,18922,7043,20859
160030,202110,81324,220086,65964,199507,14086,39345,34331,115799,48417,155144
160040,202110,6062,19882,5522,19204,91,328,5162,18112,5253,18440
160050,202110,5157,14775,4021,13291,1432,4449,1473,6180,2905,10629
160053,202110,4126,12105,3695,11569,306,801,2951,9713,3257,10514
160055,202110,973,2766,940,2730,24,67,869,2547,893,2614
160060,202110,27577,68391,22605,62782,1619,4016,17321,51110,18940,55126
160070,202110,2744,10060,2410,9545,211,774,1866,7744,2077,8518
160080,202110,3459,10562,3038,10093,23,125,2866,9575,2889,9700
170025,202110,687,1728,486,1418,91,250,232,732,323,982
170030,202110,1319,3834,1031,3342,171,506,460,1576,631,2082
170035,202110,1540,3880,1137,3265,78,239,739,2109,817,2348
170040,202110,2006,5394,1600,4821,107,336,1023,3166,1130,3502
170070,202110,1998,4559,1422,3832,92,258,837,2379,929,2637
170100,202110,2521,7051,2081,6333,260,682,1251,3994,1511,4676
170105,202110,748,2097,521,1624,150,421,153,502,303,923
170110,202110,1039,2991,809,2574,101,344,445,1360,546,1704
170130,202110,1370,3900,1003,3216,177,592,507,1635,684,2227
170190,202110,1538,4077,1153,3481,286,975,393,1217,679,2192
170200,202110,2154,4992,1422,3820,220,598,562,1535,782,2133
170210,202110,26993,70950,20430,60150,6043,19394,3172,10047,9215,29441
170215,202110,1386,3598,1110,3218,41,165,891,2568,932,2733
170220,202110,6172,18429,5121,16544,1423,4457,1761,6527,3184,10984
170230,202110,1307,3706,969,3052,276,902,166,571,442,1473
170240,202110,2725,7358,2175,6482,146,463,1566,4584,1712,5047
170255,202110,4129,11507,2987,9514,635,1959,1237,4127,1872,6086
170270,202110,966,2304,656,1857,61,158,372,1060,433,1218
170290,202110,3043,8653,2652,8143,153,396,2073,6610,2226,7006
170300,202110,2129,5499,1720,4895,203,498,1152,3391,1355,3889
170305,202110,696,1828,587,1652,83,232,296,869,379,1101
170307,202110,1018,3264,835,2928,97,333,486,1738,583,2071
170310,202110,1649,4037,1177,3303,165,484,570,1632,735,2116
170320,202110,1100,2797,826,2356,81,237,508,1487,589,1724
170330,202110,938,2789,845,2656,42,173,702,2151,744,2324
170360,202110,576,1491,406,1211,23,81,276,778,299,859
170370,202110,1322,3395,952,2783,241,672,302,953,543,1625
170380,202110,1940,5346,1476,4633,84,269,866,2848,950,3117
170382,202110,567,1626,472,1469,26,111,357,1069,383,1180
170384,202110,1710,5727,1400,5149,290,1024,694,2711,984,3735
170386,202110,1029,2739,640,1994,73,259,234,690,307,949
170388,202110,656,1767,464,1449,66,220,214,677,280,897
170389,202110,1076,3234,877,2895,54,194,629,2124,683,2318
170390,202110,1877,4090,1408,3536,33,77,1190,3058,1223,3135
170410,202110,638,1713,456,1399,19,76,305,903,324,979
170460,202110,403,1049,333,944,44,127,219,629,263,756
170510,202110,974,2648,708,2192,40,145,453,1297,493,1442
170550,202110,6927,17859,5107,14994,1392,4336,1059,3380,2451,7716
170555,202110,1456,3792,1148,3317,112,289,523,1631,635,1920
170560,202110,1089,2938,837,2587,84,230,504,1681,588,1911
170600,202110,1385,3596,1104,3201,308,761,470,1544,778,2305
170610,202110,1677,4274,1224,3596,87,270,757,2208,844,2478
170625,202110,457,1182,306,892,38,101,118,333,156,434
170650,202110,1289,3693,1021,3255,120,389,625,2033,745,2422
170700,202110,3580,10322,2703,8634,530,1706,1144,3713,1674,5419
170710,202110,1567,3926,1219,3390,184,497,722,2059,906,2556
170720,202110,1828,4446,1399,3768,292,758,694,1951,986,2709
170730,202110,1139,2959,856,2501,137,316,453,1428,590,1744
170740,202110,2180,6938,1873,6387,163,605,1346,4572,1509,5177
170755,202110,926,2451,652,2001,95,305,261,803,356,1108
170765,202110,1179,2980,832,2436,156,447,348,1069,504,1516
170770,202110,1943,5350,1573,4793,146,462,1073,3290,1219,3752
170820,202110,3672,10556,2847,9096,575,1829,1268,4265,1843,6094
170825,202110,1060,2395,870,2153,101,220,629,1579,730,1799
170830,202110,1433,3726,1165,3313,274,718,643,1925,917,2643
170900,202110,2867,8704,2421,8064,224,625,1882,6476,2106,7101
170930,202110,3932,10513,2986,8757,692,2151,878,2604,1570,4755
170950,202110,11731,31607,8163,25219,2111,7476,858,2912,2969,10388
170980,202110,499,1273,380,1088,38,110,236,662,274,772
171050,202110,1709,5223,1487,4849,50,205,1232,4017,1282,4222
171070,202110,1408,3880,1207,3583,325,884,516,1851,841,2735
171090,202110,1105,2704,863,2362,95,268,532,1435,627,1703
171110,202110,600,1565,417,1233,85,236,178,496,263,732
171150,202110,1134,2680,707,1978,74,218,433,1199,507,1417
171180,202110,805,2126,532,1614,99,274,223,690,322,964
171190,202110,2006,6323,1737,5862,272,942,1072,3726,1344,4668
171195,202110,833,2562,662,2237,74,289,414,1372,488,1661
171200,202110,639,1737,478,1473,115,390,165,495,280,885
171215,202110,410,1102,332,977,30,97,216,610,246,707
171240,202110,820,2595,651,2292,27,148,446,1536,473,1684
171245,202110,777,2160,613,1850,57,182,384,1119,441,1301
171250,202110,1039,2724,754,2291,132,428,350,1077,482,1505
171270,202110,512,1735,402,1498,88,330,165,667,253,997
171280,202110,920,2674,740,2356,70,226,447,1470,517,1696
171320,202110,4205,11441,3292,9862,663,1838,1229,3964,1892,5802
171330,202110,2875,7736,2211,6564,523,1536,925,2884,1448,4420
171360,202110,1550,4238,1216,3757,99,282,832,2736,931,3018
171370,202110,745,1816,575,1580,49,130,403,1119,452,1249
171380,202110,1537,4016,1287,3678,157,415,850,2586,1007,3001
171395,202110,1068,2754,737,2171,67,197,473,1356,540,1553
171420,202110,2074,5813,1526,4752,272,823,667,2155,939,2978
171430,202110,1111,3149,936,2829,55,171,648,1885,703,2056
171488,202110,2474,6944,1968,6135,331,1048,1035,3264,1366,4312
171500,202110,995,2451,743,2069,68,169,492,1380,560,1549
171510,202110,848,2654,734,2442,43,166,536,1770,579,1936
171515,202110,504,1236,380,1056,44,130,225,594,269,724
171525,202110,759,2016,574,1730,34,119,365,1064,399,1183
171550,202110,357,997,275,871,39,146,145,432,184,578
171570,202110,1165,3404,983,3085,136,409,565,1860,701,2269
171575,202110,1810,4771,1171,3649,130,413,516,1609,646,2022
171610,202110,6047,16375,4464,13678,901,3156,1084,3635,1985,6791
171620,202110,2710,7411,2294,6819,102,391,1893,5598,1995,5989
171630,202110,1081,2686,829,2348,87,239,580,1697,667,1936
171650,202110,2172,5957,1681,5154,393,1301,478,1649,871,2950
171660,202110,2458,6032,1700,4797,213,535,982,2817,1195,3352
171665,202110,1292,3548,1022,3114,190,625,477,1481,667,2106
171670,202110,2000,5195,1507,4380,230,693,726,2146,956,2839
171700,202110,1248,3418,907,2801,111,313,493,1543,604,1856
171720,202110,818,2057,643,1792,59,168,465,1291,524,1459
171750,202110,1381,3790,930,2934,209,691,133,524,342,1215
171780,202110,1297,3187,962,2700,78,236,679,1893,757,2129
171790,202110,1459,4576,1183,4002,182,591,560,1926,742,2517
171800,202110,759,1970,582,1714,69,229,331,950,400,1179
171820,202110,12028,32775,8875,27409,2133,6850,2305,7803,4438,14653
171830,202110,1624,4985,1391,4590,132,489,875,2927,1007,3416
171840,202110,796,2054,615,1776,21,63,396,1147,417,1210
171845,202110,678,1611,514,1372,47,168,336,852,383,1020
171850,202110,980,3096,819,2744,74,277,560,1848,634,2125
171855,202110,1090,3234,929,2941,62,180,598,1864,660,2044
171865,202110,459,1332,391,1228,61,193,207,628,268,821
171870,202110,868,2304,604,1835,74,208,312,969,386,1177
171875,202110,1373,3802,1109,3397,37,160,851,2563,888,2723
171880,202110,1291,3698,1124,3480,44,112,882,2828,926,2940
171884,202110,972,2685,726,2250,147,478,261,853,408,1331
171886,202110,1532,3971,1093,3289,286,992,224,686,510,1678
171888,202110,709,1961,501,1577,25,101,316,957,341,1058
171889,202110,422,1225,305,1008,71,258,109,345,180,603
171890,202110,1227,3378,890,2836,154,461,503,1618,657,2079
171900,202110,575,1909,439,1598,78,255,178,687,256,942
172000,202110,610,1744,511,1574,68,198,269,829,337,1027
172010,202110,1065,3485,916,3213,78,280,579,2046,657,2326
172015,202110,384,1284,285,1083,47,171,126,493,173,664
172020,202110,2926,7890,2561,7424,164,471,1874,5711,2038,6182
172025,202110,737,1985,541,1671,44,144,378,1171,422,1315
172030,202110,1298,3739,1093,3409,70,213,809,2533,879,2746
172049,202110,1377,3213,915,2587,174,435,443,1395,617,1830
172065,202110,1486,3684,1175,3293,101,214,922,2773,1023,2987
172080,202110,2433,7004,1978,6214,129,392,1296,4102,1425,4494
172085,202110,490,1308,318,957,59,170,111,309,170,479
172090,202110,4215,10221,3285,9004,152,375,2497,6983,2649,7358
172093,202110,482,1401,343,1155,20,96,202,650,222,746
172097,202110,721,1835,503,1457,64,190,221,626,285,816
172100,202110,52196,125418,37692,103000,6315,18593,14190,39617,20505,58210
172110,202110,1694,5881,1454,5516,110,431,1100,4300,1210,4731
172120,202110,5298,15119,4157,13269,518,1692,2306,7584,2824,9276
172125,202110,413,1089,312,930,25,84,188,531,213,615
172130,202110,645,1563,505,1336,19,73,361,883,380,956
172208,202110,2674,6302,2139,5614,242,469,1498,4121,1740,4590
172210,202110,2798,6869,2145,6047,296,885,1243,3721,1539,4606
210005,202110,19704,54487,14753,46456,4087,13329,5609,18526,9696,31855
210010,202110,1959,5967,1769,5740,72,272,1553,5067,1625,5339
210015,202110,3473,10107,3015,9488,156,462,2489,7925,2645,8387
210020,202110,7475,17485,6372,16204,100,284,5853,14962,5953,15246
210030,202110,4769,15425,4380,14842,429,1390,3472,12040,3901,13430
210040,202110,2011,4535,1749,4221,84,203,1454,3421,1538,3624
210043,202110,6163,17259,5220,15940,390,1142,4087,12679,4477,13821
210047,202110,6798,20607,5527,18909,141,645,4748,16313,4889,16958
210050,202110,2273,7434,1809,6579,198,718,1220,4533,1418,5251
210055,202110,2013,6200,1823,5914,48,165,1593,5193,1641,5358
210060,202110,7675,27430,6823,25926,779,2863,4573,18040,5352,20903
210070,202110,7303,20076,6775,19379,40,145,6419,18325,6459,18470
210080,202110,4329,14377,4102,14128,34,193,3794,13153,3828,13346
210083,202110,5814,16181,4817,15103,156,426,4415,14065,4571,14491
210087,202110,3047,8239,2601,7634,138,353,2109,6265,2247,6618
210090,202110,9355,28472,8731,27400,833,1877,7025,22769,7858,24646
210095,202110,6778,21361,6179,20596,333,1143,5126,17618,5459,18761
210100,202110,6868,20834,6058,19475,584,1805,4418,14448,5002,16253
210110,202110,2948,9239,2713,8955,51,256,2432,8007,2483,8263
210120,202110,24235,63674,20045,58337,2023,4427,13539,42548,15562,46975
210125,202110,4540,12062,3938,11356,794,1839,2643,8292,3437,10131
210130,202110,4425,11244,3646,10275,165,341,3090,8821,3255,9162
210135,202110,1664,4490,1381,4064,94,196,1118,3400,1212,3596
210140,202110,20474,51984,15800,45985,3207,8541,8499,26659,11706,35200
210150,202110,4648,10696,4116,9983,221,392,3451,8385,3672,8777
210160,202110,18215,49916,15468,46510,1404,3991,10900,34546,12304,38537
210170,202110,16120,47823,14945,46325,946,2171,12909,40921,13855,43092
210173,202110,2322,8802,2171,8544,96,532,1875,7320,1971,7852
210177,202110,3542,9607,3065,9004,362,894,2372,7323,2734,8217
210180,202110,1450,3833,1262,3605,24,62,1140,3267,1164,3329
210190,202110,5574,14456,4693,13272,85,260,4056,11374,4141,11634
210193,202110,1396,3945,1223,3671,42,121,895,2751,937,2872
210197,202110,2175,6555,1996,6312,159,449,1637,5313,1796,5762
210200,202110,8001,25045,7095,23576,425,1463,5615,18709,6040,20172
210203,202110,7327,21144,6208,19658,372,1140,4963,16115,5335,17255
210207,202110,4022,9603,3119,8611,167,355,2562,7253,2729,7608
210210,202110,8079,25668,7354,24651,136,743,6296,20973,6432,21716
210215,202110,2556,7951,2192,7415,113,540,1643,5487,1756,6027
210220,202110,6378,21474,5997,20919,134,865,5318,18202,5452,19067
210230,202110,5477,15885,4959,15117,442,1047,4106,12871,4548,13918
210232,202110,11779,35531,9638,32278,1837,5875,5606,20397,7443,26272
210235,202110,3435,10307,3026,9714,156,565,2523,8136,2679,8701
210237,202110,3118,9588,2677,9063,23,101,2496,8463,2519,8564
210240,202110,2668,8135,2450,7773,68,208,2052,6433,2120,6641
210250,202110,6006,17700,5462,17015,60,320,4990,15495,5050,15815
210255,202110,2683,7975,2285,7285,288,940,1452,4594,1740,5534
210260,202110,5589,16418,4907,15426,301,901,4086,12977,4387,13878
210270,202110,5168,13855,4605,13145,83,340,4132,11697,4215,12037
210275,202110,3506,8845,3038,8264,100,264,2505,6822,2605,7086
210280,202110,5867,16086,4705,14340,240,842,3555,10727,3795,11569
210290,202110,7769,19691,6954,18685,120,314,6494,17499,6614,17813
210300,202110,33357,89891,27136,80912,3139,9659,16968,53466,20107,63125
210310,202110,3196,7928,2808,7377,109,219,2468,6556,2577,6775
210312,202110,2885,6964,2573,6631,18,73,2456,6297,2474,6370
210315,202110,3138,8476,2703,7991,100,247,2361,7196,2461,7443
210317,202110,4274,13224,3858,12736,87,422,3480,11450,3567,11872
210320,202110,19884,57510,18178,55300,309,1235,16270,49354,16579,50589
210325,202110,3730,10396,3174,9676,128,361,2720,8540,2848,8901
210330,202110,25274,68191,20226,61843,4976,13371,10821,37734,15797,51105
210340,202110,10567,29736,9393,28187,668,1879,7351,22607,8019,24486
210350,202110,9194,26114,8068,24742,127,417,7228,22290,7355,22707
210355,202110,4303,14030,3803,13247,95,433,3222,11300,3317,11733
210360,202110,14158,42881,12465,40238,504,2042,9405,29784,9909,31826
210370,202110,11367,24856,8699,22042,256,408,7920,20578,8176,20986
210375,202110,3379,8866,2546,7674,790,2546,791,2648,1581,5194
210380,202110,5555,13950,4767,13009,268,631,4004,11064,4272,11695
210390,202110,2864,9174,2650,8816,106,394,2287,7597,2393,7991
210400,202110,4588,13633,4042,12985,124,347,3593,11773,3717,12120
210405,202110,7193,18662,5810,16742,1178,3031,3177,9955,4355,12986
210407,202110,2096,6622,1765,6048,74,275,1400,4763,1474,5038
210408,202110,2707,9695,2517,9426,149,640,1998,7551,2147,8191
210409,202110,4032,13303,3652,12785,102,490,3046,10838,3148,11328
210410,202110,3631,10549,3078,9631,126,447,2459,7619,2585,8066
210420,202110,3957,12313,3531,11546,223,590,2920,9749,3143,10339
210430,202110,2304,6644,2039,6302,117,306,1701,5380,1818,5686
210440,202110,4533,11851,3927,11094,85,233,3569,10061,3654,10294
210450,202110,2406,6983,2068,6496,117,341,1677,5304,1794,5645
210455,202110,4624,11758,3506,10336,922,2717,1665,5229,2587,7946
210460,202110,3832,10748,3238,9977,61,201,2823,8692,2884,8893
210462,202110,1754,5134,1475,4684,43,149,1177,3771,1220,3920
210465,202110,2786,7962,2419,7449,78,333,1956,5895,2034,6228
210467,202110,6149,18810,5339,17758,293,991,4436,15014,4729,16005
210470,202110,2011,5297,1497,4566,112,256,1115,3569,1227,3825
210480,202110,17226,48995,14269,45387,1340,3403,10196,35761,11536,39164
210490,202110,3731,9171,3020,8210,73,177,2571,6985,2644,7162
210500,202110,6504,24292,5976,23401,399,1716,4894,19163,5293,20879
210510,202110,5991,19562,5215,18723,94,447,4698,17093,4792,17540
210515,202110,3791,11008,3272,10403,201,639,2643,8664,2844,9303
210520,202110,2582,7380,2305,7000,62,217,1974,5943,2036,6160
210530,202110,53615,130057,41280,112006,6830,21719,12385,40990,19215,62709
210535,202110,3509,11049,3196,10600,136,449,2714,9092,2850,9541
210540,202110,15506,43194,12839,39458,1703,4496,8690,28421,10393,32917
210542,202110,6887,15656,5433,14040,568,1173,4125,11362,4693,12535
210545,202110,2295,6947,2138,6696,32,116,1897,5891,1929,6007
210547,202110,3723,12910,3299,12129,245,851,2538,9557,2783,10408
210550,202110,6137,18272,4794,16106,352,1317,3306,11447,3658,12764
210560,202110,3853,11372,3401,10654,136,377,2836,8875,2972,9252
210565,202110,1506,4718,1257,4362,58,302,974,3387,1032,3689
210570,202110,10867,29097,9626,27581,284,707,8423,24660,8707,25367
210580,202110,3135,8159,2469,7309,151,365,1698,5337,1849,5702
210590,202110,4377,12810,3804,12084,58,298,3407,10780,3465,11078
210592,202110,2702,7806,2466,7430,22,97,2121,6335,2143,6432
210594,202110,2592,6868,1997,5949,112,307,1466,4535,1578,4842
210596,202110,2784,9410,2485,8865,211,647,1925,7083,2136,7730
210598,202110,1894,5288,1747,5069,58,166,1538,4452,1596,4618
210600,202110,3120,8264,2551,7455,169,440,1842,5484,2011,5924
210610,202110,2883,7698,2455,7184,53,206,2119,6210,2172,6416
210620,202110,2926,7451,2397,6807,74,192,2127,6067,2201,6259
210630,202110,3172,10237,2869,9721,108,447,2362,7937,2470,8384
210632,202110,4688,14215,4142,13459,213,812,3324,10771,3537,11583
210635,202110,1778,6195,1670,5994,110,359,1336,4922,1446,5281
210637,202110,2620,8416,2240,7871,131,561,1673,6005,1804,6566
210640,202110,4716,16390,4401,16026,53,234,4059,14828,4112,15062
210650,202110,7553,21230,6834,20301,139,394,6111,18252,6250,18646
210660,202110,8306,23880,7390,22398,232,883,6282,18691,6514,19574
210663,202110,2842,7759,2579,7453,186,358,2099,6402,2285,6760
210667,202110,2041,6446,1828,6137,62,190,1595,5464,1657,5654
210670,202110,5061,16051,4576,15299,104,430,4031,13456,4135,13886
210675,202110,5239,13817,4464,12841,358,819,3504,10559,3862,11378
210680,202110,4795,11305,4037,10419,95,148,3666,9573,3761,9721
210690,202110,7820,23550,6470,22032,244,927,5626,19500,5870,20427
210700,202110,2827,7746,2223,6872,164,432,1583,5119,1747,5551
210710,202110,5162,15439,4550,14590,92,437,4044,12850,4136,13287
210720,202110,3156,9885,2783,9422,55,299,2477,8314,2532,8613
210725,202110,1350,4355,1161,4061,48,159,790,2929,838,3088
210730,202110,1251,3132,1054,2859,47,111,903,2448,950,2559
210735,202110,4879,13695,4148,12766,222,535,3505,11184,3727,11719
210740,202110,5322,13748,4575,12877,93,226,3912,11076,4005,11302
210745,202110,4573,12165,4215,11715,109,258,3812,10587,3921,10845
210750,202110,24304,61571,21009,57366,2657,6216,13747,40291,16404,46507
210760,202110,6063,15605,5077,14556,85,171,4759,13856,4844,14027
210770,202110,6317,15865,5445,14859,51,192,5131,13952,5182,14144
210780,202110,7773,23595,6757,21919,647,1743,5123,17030,5770,18773
210790,202110,4440,13589,3984,12993,205,429,3268,11220,3473,11649
210800,202110,4951,13167,4219,12189,87,323,3742,10718,3829,11041
210805,202110,4092,14388,3888,14077,138,580,3386,12290,3524,12870
210810,202110,4974,14240,4541,13681,354,826,3660,11456,4014,12282
210820,202110,7189,20074,5984,18160,729,2182,3512,11089,4241,13271
210825,202110,7073,21131,6342,20168,339,858,5334,17438,5673,18296
210830,202110,8118,22110,7342,21181,415,963,6315,18698,6730,19661
210840,202110,3315,8508,2982,8068,36,109,2692,7190,2728,7299
210845,202110,6634,17508,5886,16687,52,160,5599,15999,5651,16159
210850,202110,6097,19821,4977,18143,241,1042,3910,14366,4151,15408
210860,202110,21959,54093,18199,49484,1203,2765,14230,40929,15433,43694
210870,202110,7658,19187,6102,17418,214,482,5374,15514,5588,15996
210880,202110,4303,12920,3844,12350,213,698,3015,9747,3228,10445
210890,202110,4056,11424,3657,10962,415,1003,2785,8735,3200,9738
210900,202110,4870,13651,3770,11663,1461,4859,533,1947,1994,6806
210905,202110,2078,5497,1736,5066,58,104,1567,4698,1625,4802
210910,202110,7340,21774,6049,19706,726,2366,3980,13103,4706,15469
210920,202110,3220,10440,2795,9877,59,334,2503,8759,2562,9093
210923,202110,1669,4702,1412,4302,86,231,1048,3220,1134,3451
210927,202110,5182,16395,4519,15593,504,1618,3280,11859,3784,13477
210930,202110,2572,8353,2243,7721,150,463,1714,5923,1864,6386
210940,202110,4090,11384,3805,11056,122,439,3466,9963,3588,10402
210945,202110,7047,19437,6292,18552,259,660,5273,16015,5532,16675
210950,202110,5363,14538,4104,12785,598,1375,2665,9183,3263,10558
210955,202110,1602,4824,1377,4460,361,1096,687,2394,1048,3490
210960,202110,9326,26795,8069,24904,1648,4686,4844,15907,6492,20593
210970,202110,1426,4160,1146,3690,89,261,869,2774,958,3035
210975,202110,1840,5492,1653,5200,99,305,1308,4150,1407,4455
210980,202110,10082,23259,8818,21946,115,250,8301,20799,8416,21049
210990,202110,17371,46786,13363,41616,794,2407,9711,31738,10505,34145
211000,202110,15133,42518,12559,39332,1268,3446,9127,30392,10395,33838
211003,202110,5905,16884,4923,15702,119,453,4241,13858,4360,14311
211010,202110,6533,22607,5814,21686,109,499,5185,19640,5294,20139
211020,202110,8384,23652,7255,22372,231,729,6156,19649,6387,20378
211023,202110,2072,6526,1920,6329,96,288,1611,5323,1707,5611
211027,202110,3275,9908,3104,9644,236,589,2612,8291,2848,8880
211030,202110,3907,10560,3489,10040,297,726,2690,8030,2987,8756
211040,202110,4869,16806,4491,16178,99,558,4038,14450,4137,15008
211050,202110,9198,23488,8351,22397,92,314,7651,20505,7743,20819
211060,202110,7025,20997,6360,20091,165,640,5613,17718,5778,18358
211065,202110,2366,6255,1967,5758,95,237,1625,4876,1720,5113
211070,202110,8377,24983,7156,23186,507,1490,5713,18772,6220,20262
211080,202110,1348,3638,1083,3225,30,148,859,2442,889,2590
211085,202110,2174,5866,1840,5418,98,201,1526,4740,1624,4941
211090,202110,3200,8730,2873,8362,28,128,2664,7727,2692,7855
211100,202110,6891,17148,6360,16513,37,120,5935,15500,5972,15620
211102,202110,3299,10636,3010,10209,255,972,2422,8155,2677,9127
211105,202110,2447,7466,2038,6741,149,495,1478,4860,1627,5355
211107,202110,4977,15224,4212,14094,155,593,3281,11504,3436,12097
211110,202110,6245,16389,4884,14335,372,1007,3630,10838,4002,11845
211120,202110,46414,111062,38046,101247,6304,15198,23264,66569,29568,81767
211125,202110,2107,6220,1767,5688,52,167,1485,4810,1537,4977
211130,202110,183318,428443,156201,393401,24774,56524,79272,223920,104046,280444
211140,202110,5155,14758,4503,13930,248,603,3737,11762,3985,12365
211150,202110,9769,25623,8198,23617,398,947,6802,19893,7200,20840
211153,202110,2506,7160,1994,6532,339,1055,1226,4294,1565,5349
211157,202110,1195,3660,1002,3313,32,132,729,2409,761,2541
211160,202110,4459,11992,3512,10658,138,443,2678,8043,2816,8486
211163,202110,1606,5112,1453,4888,40,164,1277,4327,1317,4491
211167,202110,1629,4929,1514,4761,27,90,1393,4381,1420,4471
211170,202110,6619,15955,6125,15381,71,136,5798,14546,5869,14682
211172,202110,2664,7089,2285,6516,98,289,1830,5108,1928,5397
211174,202110,2910,8275,2632,7963,27,139,2477,7463,2504,7602
211176,202110,4388,12121,3421,10708,158,601,2758,8630,2916,9231
211178,202110,5195,11316,4443,10520,18,73,4295,10090,4313,10163
211180,202110,4204,13531,3857,13038,199,670,3162,10766,3361,11436
211190,202110,3133,9056,2655,8354,32,172,2375,7422,2407,7594
211195,202110,1453,3968,1236,3642,133,259,960,2988,1093,3247
211200,202110,2217,6240,1768,5597,210,596,1203,3884,1413,4480
211210,202110,6347,19201,5714,18358,348,1216,4679,15036,5027,16252
211220,202110,39536,96452,32505,87892,3732,8986,23292,65106,27024,74092
211223,202110,5432,14033,4463,12739,423,1138,3152,9105,3575,10243
211227,202110,1804,5726,1598,5434,61,257,1243,4286,1304,4543
211230,202110,8140,22377,7117,20845,391,848,5827,17508,6218,18356
211240,202110,8091,25210,7646,24636,232,861,6975,22392,7207,23253
211245,202110,7297,17850,6433,16938,89,212,6168,16219,6257,16431
211250,202110,13562,41794,12244,39928,956,3111,9565,31424,10521,34535
211260,202110,8271,26149,7338,24926,218,816,6511,22341,6729,23157
211270,202110,10377,32523,8830,30455,349,1523,7127,24904,7476,26427
211280,202110,13064,34728,11700,32994,833,1868,9757,28470,10590,30338
211285,202110,1939,6066,1730,5785,130,452,1307,4492,1437,4944
211290,202110,7648,22477,6894,21476,240,772,5861,18361,6101,19133
211300,202110,7863,22321,6879,20722,289,883,5566,16590,5855,17473
211400,202110,12113,32967,9856,29872,1103,3179,6468,20807,7571,23986
220005,202110,1947,4826,1761,4567,36,103,1504,3833,1540,3936
220010,202110,1526,4253,1247,3755,20,78,971,2906,991,2984
220020,202110,3954,10333,3373,9536,126,395,2799,7883,2925,8278
220025,202110,2287,5093,1965,4630,26,56,1642,3767,1668,3823
220027,202110,1338,3252,1138,2983,20,62,989,2551,1009,2613
220030,202110,3481,8510,3248,8203,102,237,2822,7069,2924,7306
220040,202110,7609,22412,6624,20553,1634,4634,3223,10716,4857,15350
220045,202110,1547,4548,1271,4091,21,107,1065,3372,1086,3479
220050,202110,4799,12808,4070,11873,58,261,3744,10811,3802,11072
220060,202110,2499,5100,2128,4674,28,63,2016,4416,2044,4479
220070,202110,2504,6140,2118,5582,74,132,1764,4667,1838,4799
220080,202110,764,2118,659,1969,19,58,564,1680,583,1738
220090,202110,1799,4236,1507,3822,11,28,1243,3275,1254,3303
220095,202110,688,1635,647,1593,45,73,558,1420,603,1493
220100,202110,1476,3883,1188,3438,37,124,967,2714,1004,2838
220105,202110,2136,6337,1871,5846,122,369,1407,4410,1529,4779
220110,202110,3481,9515,3153,8963,34,165,2825,7925,2859,8090
220115,202110,2831,7944,2614,7666,89,243,2356,6918,2445,7161
220117,202110,1473,3401,1164,2980,5,20,979,2454,984,2474
220120,202110,13602,35131,12394,33635,78,242,11640,31539,11718,31781
220130,202110,1188,3031,1003,2778,8,44,909,2470,917,2514
220140,202110,2222,4499,1877,4098,100,217,1638,3568,1738,3785
220150,202110,6644,18986,6054,17985,122,463,5130,15029,5252,15492
220155,202110,1236,3444,987,3000,38,104,707,2119,745,2223
220157,202110,1099,2612,928,2352,25,73,738,1820,763,1893
220160,202110,2939,7968,2524,7221,42,149,2051,5764,2093,5913
220170,202110,1679,4286,1429,3921,17,67,1267,3442,1284,3509
220173,202110,2291,6118,1769,5172,49,136,1436,4093,1485,4229
220177,202110,2092,5760,1987,5644,9,33,1962,5565,1971,5598
220180,202110,1165,2729,944,2368,3,15,754,1772,757,1787
220190,202110,7341,17666,6235,16169,359,910,4792,12725,5151,13635
220191,202110,1652,4765,1494,4501,80,255,1051,3130,1131,3385
220192,202110,2126,5489,1561,4512,28,77,1259,3600,1287,3677
220194,202110,1772,4930,1569,4606,50,180,1294,3762,1344,3942
220196,202110,2119,5330,1925,5043,31,116,1680,4328,1711,4444
220198,202110,1314,3510,1120,3260,6,15,1035,3045,1041,3060
220200,202110,5358,15187,4674,14293,75,291,4028,12334,4103,12625
220202,202110,2237,6158,1911,5637,25,119,1640,4752,1665,4871
220205,202110,2569,7252,2290,6743,53,187,1926,5597,1979,5784
220207,202110,798,2366,666,2141,55,185,441,1434,496,1619
220208,202110,1792,5277,1492,4727,165,537,922,2902,1087,3439
220209,202110,1641,4593,1416,4194,27,98,1161,3404,1188,3502
220210,202110,1842,4309,1600,3942,14,49,1401,3357,1415,3406
220211,202110,1686,4132,1541,3938,18,65,1343,3434,1361,3499
220213,202110,1871,4806,1612,4368,18,55,1324,3486,1342,3541
220217,202110,2349,6587,2200,6417,47,81,2037,6064,2084,6145
220220,202110,11117,27831,9284,25109,711,1549,6252,17963,6963,19512
220225,202110,1012,2647,830,2412,4,27,782,2245,786,2272
220230,202110,5729,14156,4893,12999,155,342,4209,11293,4364,11635
220240,202110,3169,8912,2845,8373,102,335,2345,6854,2447,7189
220245,202110,1854,4137,1403,3593,13,50,1275,3294,1288,3344
220250,202110,3064,8346,2682,7867,13,63,2512,7339,2525,7402
220253,202110,1641,4317,1471,4037,56,159,1247,3362,1303,3521
220255,202110,2030,4601,1747,4211,32,127,1528,3560,1560,3687
220260,202110,4637,13533,4030,12439,182,572,3166,9780,3348,10352
220265,202110,1427,4324,1290,4153,39,172,1081,3423,1120,3595
220270,202110,6088,19450,5739,18828,181,846,4804,15292,4985,16138
220271,202110,1525,3855,1334,3585,21,66,1165,3115,1186,3181
220272,202110,1825,5128,1617,4746,54,152,1210,3458,1264,3610
220273,202110,1295,3602,1086,3225,50,172,828,2425,878,2597
220275,202110,2440,5450,1943,4780,34,52,1723,4260,1757,4312
220277,202110,2278,5508,1941,5033,52,116,1617,4142,1669,4258
220280,202110,1746,3928,1448,3544,18,51,1245,3028,1263,3079
220285,202110,1500,3664,1277,3401,7,23,1191,3150,1198,3173
220290,202110,6992,18716,5544,16703,345,1033,4046,12598,4391,13631
220300,202110,2084,5797,1676,5264,32,157,1402,4366,1434,4523
220310,202110,3169,8234,2495,7455,46,158,2126,6335,2172,6493
220320,202110,3182,8994,2456,7680,51,232,1923,5861,1974,6093
220323,202110,1700,4776,1323,4185,55,163,1080,3376,1135,3539
220325,202110,1268,3689,1089,3395,24,106,906,2775,930,2881
220327,202110,1651,4439,1438,4105,34,131,1190,3299,1224,3430
220330,202110,4773,10980,4062,10132,55,164,3678,9129,3733,9293
220335,202110,1700,5075,1533,4851,31,90,1363,4342,1394,4432
220340,202110,1961,5023,1503,4260,54,145,1005,2787,1059,2932
220342,202110,1217,3453,1089,3260,53,155,857,2565,910,2720
220345,202110,3193,7053,2446,6010,17,51,2215,5421,2232,5472
220350,202110,3445,8521,2755,7513,145,367,1945,5377,2090,5744
220360,202110,1269,3210,1004,2774,16,43,796,2196,812,2239
220370,202110,8863,25127,8048,23829,180,595,6940,20418,7120,21013
220375,202110,1681,4634,1487,4400,2,7,1421,4225,1423,4232
220380,202110,1555,3567,1286,3199,18,37,1130,2804,1148,2841
220385,202110,864,2006,713,1748,6,15,623,1512,629,1527
220390,202110,11069,27469,8521,23620,2067,5542,3090,9562,5157,15104
220400,202110,1576,3635,1207,3071,21,67,938,2301,959,2368
220410,202110,1212,3250,986,2861,46,124,804,2314,850,2438
220415,202110,852,2135,719,1921,26,63,575,1519,601,1582
220420,202110,2066,5644,1663,4883,58,162,1258,3646,1316,3808
220430,202110,2701,6787,2463,6450,57,171,2164,5586,2221,5757
220435,202110,1830,4610,1561,4211,38,120,1306,3450,1344,3570
220440,202110,2444,7342,2055,6769,83,367,1741,5592,1824,5959
220450,202110,2597,6627,2106,6021,51,155,1808,5190,1859,5345
220455,202110,1331,4038,1270,3952,6,35,1150,3574,1156,3609
220460,202110,1046,2492,969,2393,27,52,841,2065,868,2117
220465,202110,2493,7362,2191,6898,205,569,1617,5255,1822,5824
220470,202110,3769,10023,3374,9385,169,373,2676,7427,2845,7800
220480,202110,2938,7301,2369,6413,254,498,1515,4233,1769,4731
220490,202110,2538,6206,2191,5772,22,100,1905,4956,1927,5056
220500,202110,3195,7671,2741,6979,111,233,2123,5375,2234,5608
220510,202110,2696,7258,2166,6324,86,203,1707,5048,1793,5251
220515,202110,1729,4051,1599,3872,41,63,1383,3345,1424,3408
220520,202110,5152,13043,4651,12343,93,242,4061,10735,4154,10977
220525,202110,1487,3533,1268,3266,8,35,1163,2985,1171,3020
220527,202110,1361,3650,1179,3390,18,66,1014,2949,1032,3015
220530,202110,1489,3593,1291,3342,35,98,1173,3025,1208,3123
220535,202110,811,2177,759,2107,30,75,612,1702,642,1777
220540,202110,3319,10286,3085,9835,148,472,2567,8189,2715,8661
220545,202110,1501,4328,1391,4154,57,212,1179,3476,1236,3688
220550,202110,8903,26798,7926,25088,452,1469,6022,18899,6474,20368
220551,202110,1451,3956,1284,3693,29,100,1048,2958,1077,3058
220552,202110,1724,4801,1402,4233,22,112,1127,3287,1149,3399
220553,202110,1859,4584,1525,4150,52,76,1263,3553,1315,3629
220554,202110,956,2375,709,1986,53,120,484,1343,537,1463
220555,202110,2593,7090,2251,6665,32,110,1879,5735,1911,5845
220556,202110,1258,3529,1099,3230,39,150,829,2354,868,2504
220557,202110,1789,5224,1475,4539,116,368,1030,3091,1146,3459
220558,202110,1442,3694,1130,3255,18,72,970,2759,988,2831
220559,202110,1867,4469,1588,4043,19,40,1294,3334,1313,3374
220560,202110,1816,3999,1492,3597,48,80,1335,3268,1383,3348
220570,202110,7706,21997,7029,21040,504,1276,5574,16987,6078,18263
220580,202110,7120,18786,6474,17774,109,276,5818,15964,5927,16240
220585,202110,2153,6533,1767,5836,37,95,1463,4873,1500,4968
220590,202110,1450,3788,1199,3423,93,207,864,2538,957,2745
220595,202110,2718,7169,2461,6826,17,68,2207,6078,2224,6146
220600,202110,1511,3212,1280,2940,72,87,1099,2589,1171,2676
220605,202110,1645,4709,1412,4296,18,94,1156,3416,1174,3510
220610,202110,2869,8147,2685,7873,24,116,2518,7338,2542,7454
220620,202110,8271,24465,7567,23515,133,664,6910,21271,7043,21935
220630,202110,390,1117,305,968,24,79,202,628,226,707
220635,202110,1864,5451,1667,5044,40,175,1319,3869,1359,4044
220640,202110,2455,6728,2088,6207,66,246,1703,5025,1769,5271
220650,202110,2206,5825,1894,5357,30,94,1544,4352,1574,4446
220660,202110,2623,8069,2229,7423,64,299,1864,6114,1928,6413
220665,202110,1297,3804,1094,3467,27,134,923,2862,950,2996
220667,202110,1691,5035,1525,4736,63,218,1237,3818,1300,4036
220669,202110,1729,4973,1658,4866,51,178,1480,4273,1531,4451
220670,202110,2274,5727,1808,5087,19,73,1563,4397,1582,4470
220672,202110,3335,7985,2699,7215,82,266,2405,6352,2487,6618
220675,202110,1363,3584,1215,3319,39,92,982,2684,1021,2776
220680,202110,2835,7431,2702,7250,122,208,2439,6684,2561,6892
220690,202110,1645,4231,1448,3933,63,179,1131,3067,1194,3246
220695,202110,934,2533,868,2415,21,60,756,2095,777,2155
220700,202110,10732,25150,8692,22413,351,820,6646,17040,6997,17860
220710,202110,943,2488,696,2036,31,84,529,1509,560,1593
220720,202110,2169,5061,1951,4776,13,52,1713,4143,1726,4195
220730,202110,1364,3690,1161,3361,13,57,990,2807,1003,2864
220735,202110,1030,2298,803,1956,33,81,649,1544,682,1625
220740,202110,1412,3556,1129,3183,32,73,945,2716,977,2789
220750,202110,4006,9807,3520,9119,160,356,3119,8093,3279,8449
220755,202110,1449,3358,1210,3005,21,61,1010,2455,1031,2516
220760,202110,3216,8479,2822,7958,59,170,2580,7319,2639,7489
220770,202110,25032,71667,21218,65274,6191,19997,7381,23887,13572,43884
220775,202110,1230,2971,1093,2800,8,27,1054,2683,1062,2710
220777,202110,1651,4110,1274,3542,41,94,964,2712,1005,2806
220779,202110,1301,3308,1127,3051,24,67,978,2620,1002,2687
220780,202110,6056,14525,5200,13261,221,603,4127,10373,4348,10976
220785,202110,1508,3310,1324,3075,7,15,1267,2926,1274,2941
220790,202110,10548,29029,9500,27536,159,640,8013,23032,8172,23672
220793,202110,966,2475,777,2153,9,13,642,1807,651,1820
220795,202110,1459,3652,1282,3416,27,72,1120,2986,1147,3058
220800,202110,19087,41005,16199,37239,590,1243,12638,29020,13228,30263
220810,202110,3166,8531,2662,7667,45,121,2211,6302,2256,6423
220820,202110,5303,13287,4613,12274,257,514,3574,9602,3831,10116
220830,202110,7506,19253,6713,18136,272,734,5511,14711,5783,15445
220840,202110,12714,37174,10628,33022,2447,7110,4894,16030,7341,23140
220850,202110,3248,9727,2919,9317,41,208,2607,8347,2648,8555
220855,202110,725,1769,635,1650,21,58,573,1481,594,1539
220860,202110,1091,2632,950,2409,13,54,875,2195,888,2249
220865,202110,2503,6479,1926,5452,62,232,1428,3916,1490,4148
220870,202110,3204,8446,2654,7735,27,127,2441,7100,2468,7227
220880,202110,5480,12679,4714,11734,69,242,4335,10680,4404,10922
220885,202110,1465,4224,1211,3806,66,194,936,3008,1002,3202
220887,202110,1618,3388,1354,3053,13,28,1256,2820,1269,2848
220890,202110,1450,4263,1258,3988,47,155,1046,3366,1093,3521
220900,202110,2053,4810,1712,4373,32,76,1497,3809,1529,3885
220910,202110,1591,4200,1338,3827,64,161,1087,3152,1151,3313
220915,202110,1016,2644,807,2272,16,52,619,1673,635,1725
220920,202110,1505,4513,1302,4248,62,200,1066,3525,1128,3725
220930,202110,1855,4789,1552,4366,20,60,1446,4060,1466,4120
220935,202110,1124,3175,900,2691,22,95,583,1639,605,1734
220937,202110,1562,3980,1337,3623,24,83,1080,2876,1104,2959
220940,202110,1637,4384,1310,3818,29,89,1029,2963,1058,3052
220945,202110,499,1624,409,1450,16,85,302,1048,318,1133
220950,202110,1460,3296,971,2552,20,56,772,1959,792,2015
220955,202110,1666,4149,1383,3669,25,61,1184,3106,1209,3167
220960,202110,838,2080,622,1720,30,84,435,1149,465,1233
220965,202110,1848,4922,1603,4565,15,92,1385,3875,1400,3967
220970,202110,2052,4706,1512,3919,23,53,1277,3277,1300,3330
220975,202110,708,1933,605,1805,9,50,544,1581,553,1631
220980,202110,1180,3258,1045,3076,33,114,874,2554,907,2668
220985,202110,1347,3331,1166,3069,62,134,947,2463,1009,2597
220987,202110,1523,4374,1347,4071,56,184,1090,3268,1146,3452
220990,202110,1732,4704,1520,4386,14,80,1296,3692,1310,3772
220995,202110,1205,3423,1000,3046,31,91,750,2290,781,2381
220997,202110,2424,7201,2237,6900,45,171,1982,6050,2027,6221
221000,202110,4620,12332,4051,11511,92,345,3475,9793,3567,10138
221005,202110,1536,3895,1400,3666,14,68,1219,3096,1233,3164
221010,202110,1295,2811,1020,2476,17,46,888,2123,905,2169
221020,202110,1614,4774,1459,4513,17,62,1125,3455,1142,3517
221030,202110,1730,4066,1469,3750,19,52,1280,3327,1299,3379
221035,202110,1585,3963,1375,3682,22,27,1225,3357,1247,3384
221037,202110,745,1952,617,1733,9,25,455,1213,464,1238
221038,202110,544,1480,417,1254,16,53,287,855,303,908
221039,202110,899,2409,761,2180,24,95,610,1695,634,1790
221040,202110,4438,12483,3864,11475,205,536,3081,9219,3286,9755
221050,202110,4037,10249,3577,9670,71,200,3228,8726,3299,8926
221060,202110,9065,24725,7491,22159,353,813,5942,17861,6295,18674
221062,202110,1177,3664,1009,3386,33,138,815,2710,848,2848
221063,202110,1135,3007,976,2777,54,156,765,2151,819,2307
221065,202110,2719,6825,2380,6241,16,50,2096,5431,2112,5481
221070,202110,3562,10633,2872,9201,344,1024,1721,5672,2065,6696
221080,202110,3595,8627,2946,7668,57,185,2426,6214,2483,6399
221090,202110,1452,3616,1192,3212,9,29,1019,2699,1028,2728
221093,202110,1454,3916,1325,3669,133,341,919,2503,1052,2844
221095,202110,894,2310,758,2101,9,24,643,1755,652,1779
221097,202110,888,2218,668,1827,21,53,501,1303,522,1356
221100,202110,124408,321486,103586,286587,10189,29814,67451,181240,77640,211054
221110,202110,10178,29576,9312,28442,123,573,8387,25435,8510,26008
221120,202110,4922,13384,4386,12558,156,441,3798,10926,3954,11367
221130,202110,5781,14234,4396,11654,809,1992,2254,5999,3063,7991
221135,202110,1841,4522,1638,4251,43,94,1464,3821,1507,3915
221140,202110,1392,3173,1166,2891,10,33,1058,2588,1068,2621
221150,202110,1124,2772,879,2355,20,87,683,1718,703,1805
221160,202110,759,1833,671,1721,29,38,538,1404,567,1442
221170,202110,1026,2868,940,2716,8,29,826,2346,834,2375
230010,202110,3166,8091,2604,7150,33,100,2146,5771,2179,5871
230015,202110,3219,10026,2838,9264,153,519,2000,6551,2153,7070
230020,202110,13316,41253,12454,39972,369,1376,10658,34149,11027,35525
230030,202110,13342,32473,11179,29670,254,636,9685,25795,9939,26431
230040,202110,4637,11647,3836,10357,38,175,3230,8599,3268,8774
230050,202110,2805,8511,2143,7007,332,1029,947,3029,1279,4058
230060,202110,2448,6520,1957,5656,31,109,1553,4410,1584,4519
230070,202110,4364,10887,3478,9289,225,616,2442,6458,2667,7074
230075,202110,9271,29059,8468,27659,690,2209,6425,21100,7115,23309
230080,202110,3145,6526,2391,5614,4,9,2188,5155,2192,5164
230090,202110,4582,10887,3868,9764,194,445,3097,7784,3291,8229
230100,202110,19400,47829,16967,44654,1492,3589,11998,31987,13490,35576
230110,202110,13143,38000,10974,33799,1734,5217,5672,17688,7406,22905
230120,202110,8170,20939,7151,19327,535,1213,5271,14452,5806,15665
230125,202110,3273,8437,2653,7471,94,274,2043,5671,2137,5945
230130,202110,5860,17468,4766,15114,407,1298,3090,9721,3497,11019
230140,202110,3521,10349,2979,9245,80,318,2273,6884,2353,7202
230150,202110,1688,4909,1388,4265,231,618,787,2515,1018,3133
230160,202110,6729,16829,5803,15447,111,324,4900,12854,5011,13178
230170,202110,6760,18456,5514,15958,407,1035,3839,11061,4246,12096
230180,202110,1708,4631,1443,4121,17,72,1180,3264,1197,3336
230185,202110,4635,12687,3928,11522,305,880,2844,8414,3149,9294
230190,202110,14600,41274,12234,36940,1338,4015,7220,21677,8558,25692
230195,202110,5646,15958,5108,14979,393,1111,3822,11225,4215,12336
230200,202110,5198,13964,4338,12387,151,415,3337,9361,3488,9776
230205,202110,4557,12495,3986,11667,241,641,3031,8855,3272,9496
230210,202110,10683,24675,9019,22482,402,1052,7068,17386,7470,18438
230220,202110,14571,35775,12770,33224,637,1600,10497,27073,11134,28673
230230,202110,7228,20530,6459,19007,474,1270,4733,13965,5207,15235
230240,202110,13255,34794,11394,31634,277,1129,9400,25448,9677,26577
230250,202110,9166,24831,8479,23780,219,692,6862,18666,7081,19358
230260,202110,15369,43637,13265,39991,2344,6512,6943,21733,9287,28245
230270,202110,7971,20669,6123,17290,586,1557,3849,11050,4435,12607
230280,202110,20903,54433,17109,48143,418,1585,13532,36696,13950,38281
230290,202110,5128,13776,4229,12109,242,569,3208,9174,3450,9743
230300,202110,5046,13006,4566,12359,82,209,4032,10913,4114,11122
230310,202110,4902,13576,4134,12216,125,451,2966,8592,3091,9043
230320,202110,8118,22848,6804,20499,194,755,5248,15480,5442,16235
230330,202110,4935,12989,3921,11100,114,350,2974,8207,3088,8557
230340,202110,3991,11917,3421,10752,212,706,2432,7516,2644,8222
230350,202110,18722,49651,16310,46152,812,2483,11077,31469,11889,33952
230360,202110,3108,7932,2460,6806,124,327,1735,4735,1859,5062
230365,202110,3195,7685,2636,6867,60,233,2243,5768,2303,6001
230370,202110,63391,167388,54142,154027,6867,19691,34298,97772,41165,117463
230380,202110,6601,17652,5220,15144,120,402,3891,11022,4011,11424
230390,202110,3605,10223,3103,9423,80,307,2419,7254,2499,7561
230393,202110,3542,9957,2812,8488,64,320,2190,6333,2254,6653
230395,202110,5979,15919,5157,14565,455,1185,3495,9957,3950,11142
230400,202110,5645,15079,4984,14021,60,290,4051,11089,4111,11379
230410,202110,14046,40778,11598,36367,955,3122,7838,24705,8793,27827
230420,202110,30667,81133,24961,71466,2879,8320,14227,40317,17106,48637
230423,202110,4989,14353,4362,13143,192,623,3366,10019,3558,10642
230425,202110,5997,17785,5474,16742,511,1536,3829,11655,4340,13191
230426,202110,2966,7510,2188,6046,29,92,1654,4472,1683,4564
230427,202110,1957,5298,1388,4140,93,273,875,2500,968,2773
230428,202110,10326,26652,8842,24444,1483,3831,4836,13488,6319,17319
230430,202110,5123,13980,4050,12123,161,506,3040,8973,3201,9479
230435,202110,6419,16014,5334,14133,742,1799,3126,8367,3868,10166
230440,202110,447312,1066976,373633,960930,32827,88269,250968,634138,283795,722407
230445,202110,4402,11428,3522,9887,220,575,2385,6541,2605,7116
230450,202110,3735,10375,3253,9678,221,773,2388,6909,2609,7682
230460,202110,2208,5990,1909,5522,47,188,1611,4604,1658,4792
230465,202110,4422,11879,3726,10569,118,373,2826,7741,2944,8114
230470,202110,11670,37529,10463,35344,877,3196,7302,24432,8179,27628
230480,202110,1527,4310,1274,3862,60,232,936,2736,996,2968
230490,202110,2723,7378,2304,6597,165,515,1448,3908,1613,4423
230495,202110,6026,17076,5295,15782,604,1784,3262,9802,3866,11586
230500,202110,9659,30088,8542,28073,261,992,6937,22850,7198,23842
230510,202110,1744,4866,1365,4082,149,460,760,2224,909,2684
230520,202110,4931,13179,4252,12007,383,919,2903,8308,3286,9227
230523,202110,16151,46277,12847,39401,2835,8559,3094,10185,5929,18744
230526,202110,3946,10765,3359,9805,202,487,2442,7240,2644,7727
230530,202110,5729,17447,4805,15670,521,1708,3217,10457,3738,12165
230533,202110,4798,10850,3918,9501,122,277,3243,7765,3365,8042
230535,202110,5414,14767,4577,13356,345,986,2996,8825,3341,9811
230540,202110,16457,43867,14082,40346,288,959,11654,33193,11942,34152
230550,202110,22438,56952,18050,49680,1503,4119,11746,32045,13249,36164
230560,202110,8177,19764,6627,17352,59,208,5704,14804,5763,15012
230565,202110,3225,8684,2700,7734,124,431,2073,5814,2197,6245
230570,202110,3541,8858,2997,8098,83,195,2452,6617,2535,6812
230580,202110,11899,29289,10199,26895,449,1032,8323,22037,8772,23069
230590,202110,9566,26221,7989,23398,497,1492,5866,16749,6363,18241
230600,202110,3942,9649,3121,8255,95,225,2111,5647,2206,5872
230610,202110,6903,18597,6116,17297,478,1259,4780,13504,5258,14763
230620,202110,2197,5740,1708,4820,102,303,1072,2914,1174,3217
230625,202110,8893,23831,7500,21371,1925,5712,2504,7313,4429,13025
230630,202110,11777,32697,10306,29950,1371,3628,6371,18893,7742,22521
230640,202110,28506,84037,25780,79706,1148,4165,20674,63071,21822,67236
230650,202110,5601,14436,4735,12980,117,400,3888,10385,4005,10785
230655,202110,9491,31353,8914,30378,636,2094,7134,24612,7770,26706
230660,202110,6239,18098,5070,16064,128,653,4092,12694,4220,13347
230670,202110,6461,14877,4673,12072,153,400,3702,9343,3855,9743
230680,202110,2807,7414,2347,6608,109,253,1678,4764,1787,5017
230690,202110,7506,21489,6432,19406,398,1343,4144,12317,4542,13660
230700,202110,10920,26703,8819,22941,422,896,6495,16682,6917,17578
230710,202110,7118,21840,6224,19958,732,2136,4028,13028,4760,15164
230720,202110,2005,5698,1643,5013,105,285,1157,3454,1262,3739
230725,202110,4473,12599,4000,11790,394,1222,2493,7270,2887,8492
230730,202110,61661,158532,48449,139055,10907,32921,14647,45559,25554,78480
230740,202110,6384,17267,5403,15706,144,402,4290,12502,4434,12904
230750,202110,8786,22767,7301,20314,163,480,5809,15778,5972,16258
230760,202110,11553,29545,10004,27214,488,1520,7561,20034,8049,21554
230763,202110,5198,13590,4329,12077,104,449,3497,9429,3601,9878
230765,202110,43174,112815,35832,101181,5176,15008,18941,52607,24117,67615
230770,202110,26887,63187,22522,57567,2238,5519,15175,38874,17413,44393
230780,202110,6728,22799,6046,21195,910,2967,3385,12337,4295,15304
230790,202110,3208,8798,2872,8262,102,397,2222,6190,2324,6587
230800,202110,8746,26547,7668,24421,1117,3500,4290,13594,5407,17094
230810,202110,11427,33680,10251,31793,381,1256,8009,24527,8390,25783
230820,202110,3700,11508,3058,10132,255,956,1895,5955,2150,6911
230830,202110,7866,20861,6691,18951,127,477,5515,15227,5642,15704
230835,202110,4380,10154,3388,8627,96,259,2726,6855,2822,7114
230837,202110,3308,9587,2949,8980,114,394,2367,7084,2481,7478
230840,202110,9832,27694,8434,25300,1021,2736,5794,17613,6815,20349
230850,202110,10234,28408,8611,25313,366,1090,6315,18349,6681,19439
230860,202110,5710,13805,4721,12401,58,179,4171,10866,4229,11045
230870,202110,16787,40032,14441,36177,465,1178,11755,28966,12220,30144
230880,202110,2211,6440,2021,6132,41,203,1613,4766,1654,4969
230890,202110,4662,14507,4248,13713,302,1014,3129,9996,3431,11010
230900,202110,3214,8838,2785,8052,157,523,1941,5426,2098,5949
230910,202110,3327,8636,2657,7627,59,252,2138,6137,2197,6389
230920,202110,4984,13439,4170,12160,96,332,3326,9507,3422,9839
230930,202110,7093,19056,5897,16943,283,764,4080,11672,4363,12436
230940,202110,8556,20937,7437,19270,203,438,6247,16149,6450,16587
230945,202110,6847,18932,5836,17044,303,978,4138,11819,4441,12797
230950,202110,6402,15722,5652,14705,120,252,4840,12690,4960,12942
230960,202110,14260,39451,12489,36180,2277,6393,5881,17080,8158,23473
230970,202110,14815,37797,12388,34069,1647,4250,7418,20523,9065,24773
230980,202110,2853,7953,2486,7315,332,902,1590,4846,1922,5748
230990,202110,1729,4710,1425,4122,64,230,1011,2804,1075,3034
231000,202110,2697,6981,2173,5974,96,215,1600,4294,1696,4509
231010,202110,3846,8649,3025,7285,26,93,2655,6214,2681,6307
231020,202110,8676,25430,7726,23651,1310,3574,4526,14394,5836,17968
231025,202110,8007,20918,6967,19240,775,1974,4889,13702,5664,15676
231030,202110,7732,22246,6068,18817,1058,2983,3045,9678,4103,12661
231040,202110,3066,8419,2657,7688,114,316,2091,5960,2205,6276
231050,202110,12370,30422,10088,26477,643,1536,7584,19547,8227,21083
231060,202110,3009,8272,2646,7701,59,160,2200,6429,2259,6589
231070,202110,8387,23450,7216,21403,651,1915,4846,14225,5497,16140
231080,202110,4105,11262,3472,10235,136,500,2623,7583,2759,8083
231085,202110,7195,16687,5736,14998,229,486,4479,11820,4708,12306
231090,202110,4659,11816,3431,9502,108,393,2331,6186,2439,6579
231095,202110,2337,6783,1851,5767,173,526,1209,3765,1382,4291
231100,202110,3388,9420,2752,8215,141,434,2067,6123,2208,6557
231110,202110,3842,10823,3519,10234,133,449,2652,7563,2785,8012
231120,202110,2472,6897,2057,6182,81,258,1496,4454,1577,4712
231123,202110,2001,5049,1672,4490,94,207,1194,3218,1288,3425
231126,202110,5777,15307,4717,13332,318,770,3366,9477,3684,10247
231130,202110,22744,55552,18853,50746,1126,3155,13980,37267,15106,40422
231135,202110,4320,11871,3575,10460,179,538,2523,7317,2702,7855
231140,202110,17340,47420,14008,41767,640,2214,10017,29197,10657,31411
231150,202110,6247,16384,4637,13334,630,1825,1957,5793,2587,7618
231160,202110,6527,19507,5795,18177,814,2336,3259,10619,4073,12955
231170,202110,4776,13167,3966,11659,259,777,2768,7871,3027,8648
231180,202110,15285,41719,12423,35884,2791,7842,4943,14512,7734,22354
231190,202110,4166,11330,3405,9980,74,244,2628,7576,2702,7820
231195,202110,5388,15416,4475,13604,264,834,3239,9796,3503,10630
231200,202110,8129,24216,7075,22141,166,782,5681,17238,5847,18020
231210,202110,5112,14386,4342,13108,147,486,3353,9900,3500,10386
231220,202110,13197,32515,10357,27344,513,1311,7605,19482,8118,20793
231230,202110,9418,29418,8308,27376,595,2071,5967,19806,6562,21877
231240,202110,12152,34332,10677,31599,1781,4996,6228,18788,8009,23784
231250,202110,2212,5465,1452,3838,113,310,864,2206,977,2516
231260,202110,3408,9194,2970,8503,281,725,1980,5858,2261,6583
231270,202110,6581,16765,5267,14605,147,527,4004,10791,4151,11318
231280,202110,1814,5458,1649,5173,90,262,1231,3853,1321,4115
231290,202110,39269,113660,32690,100734,5481,16544,15030,45964,20511,62508
231300,202110,4325,11519,3395,9703,155,497,2340,6497,2495,6994
231310,202110,7921,19539,6284,16574,566,1478,4252,10917,4818,12395
231320,202110,7942,21335,6137,18170,95,372,4902,14294,4997,14666
231325,202110,2608,6466,2144,5793,186,334,1491,4174,1677,4508
231330,202110,10269,29142,8530,25753,1654,4557,4496,14322,6150,18879
231335,202110,5832,15123,4938,13712,73,294,4336,11927,4409,12221
231340,202110,19120,56013,17204,52679,1199,3512,12949,40063,14148,43575
231350,202110,16316,43750,14885,41708,239,798,13401,37239,13640,38037
231355,202110,4589,13155,4134,12326,243,710,3235,9559,3478,10269
231360,202110,8036,23337,6944,21474,301,958,5480,16908,5781,17866
231370,202110,2252,6040,1799,5233,36,102,1374,3979,1410,4081
231375,202110,4409,13385,4032,12770,109,445,3388,10621,3497,11066
231380,202110,6247,16471,5636,15641,197,448,4604,12924,4801,13372
231390,202110,3575,10050,3207,9426,108,374,2386,6827,2494,7201
231395,202110,4364,12183,3626,11008,288,865,2378,7203,2666,8068
231400,202110,10055,28248,8402,25245,240,1000,6362,18706,6602,19706
231410,202110,15325,46111,13957,43893,700,2094,11213,35333,11913,37427
240010,202110,2680,6825,2080,5762,224,599,1202,3308,1426,3907
240020,202110,13204,35751,11016,31901,660,2186,7214,20661,7874,22847
240030,202110,3160,7297,2813,6786,114,303,2436,5811,2550,6114
240040,202110,866,2422,723,2158,28,104,498,1416,526,1520
240050,202110,3514,9154,2816,7911,45,122,2145,5899,2190,6021
240060,202110,1476,3818,1196,3309,26,72,961,2612,987,2684
240070,202110,2333,6450,2071,5893,214,601,1475,4102,1689,4703
240080,202110,3054,8011,2451,6963,72,244,1835,5145,1907,5389
240090,202110,2332,5658,1896,4935,16,41,1581,4065,1597,4106
240100,202110,10780,25645,8584,21825,193,545,6774,16641,6967,17186
240110,202110,4688,12994,3896,11535,184,649,2852,8263,3036,8912
240120,202110,3519,9503,2873,8701,202,594,2035,6313,2237,6907
240130,202110,3920,7817,3211,6892,29,61,2914,6190,2943,6251
240140,202110,1883,5520,1602,4979,180,580,1053,3251,1233,3831
240145,202110,6885,18603,5579,16374,870,2593,3149,9353,4019,11946
240150,202110,999,2785,879,2547,49,142,679,1924,728,2066
240160,202110,1497,4404,1246,3936,34,126,941,2987,975,3113
240165,202110,1013,2692,842,2369,23,89,701,1924,724,2013
240170,202110,2792,7185,2344,6397,243,649,1521,4133,1764,4782
240180,202110,3114,9074,2470,7771,579,1767,1030,3439,1609,5206
240185,202110,1300,3928,1200,3757,56,191,1003,3123,1059,3314
240190,202110,1114,3144,958,2893,20,76,799,2429,819,2505
240200,202110,11582,28392,9217,24419,931,2543,5249,13629,6180,16172
240210,202110,3419,8199,2773,7162,24,111,2337,5835,2361,5946
240220,202110,7561,22323,6787,21122,335,1350,5386,16558,5721,17908
240230,202110,6040,14972,4809,12947,241,566,3719,10119,3960,10685
240240,202110,1866,5248,1213,3772,113,352,415,1166,528,1518
240250,202110,3124,7891,2711,7315,68,199,2330,6233,2398,6432
240260,202110,14168,41361,12204,38082,1750,5072,7321,24226,9071,29298
240270,202110,2502,7126,2158,6555,118,346,1575,4927,1693,5273
240280,202110,1779,4413,1478,3923,64,146,1153,3047,1217,3193
240290,202110,1218,3472,989,2985,26,107,701,1999,727,2106
240300,202110,2398,5971,1723,4758,79,209,1055,2861,1134,3070
240310,202110,8781,22831,6892,19469,888,2643,3479,9666,4367,12309
240320,202110,2152,5669,1555,4520,32,130,1168,3247,1200,3377
240325,202110,33518,86451,26766,74999,4398,12571,12430,34509,16828,47080
240330,202110,1865,4950,1427,4132,57,188,983,2723,1040,2911
240340,202110,2045,4611,1661,4044,52,123,1363,3250,1415,3373
240350,202110,2330,5694,2069,5400,38,93,1873,4913,1911,5006
240360,202110,10206,27079,9011,25234,1068,2857,5962,17045,7030,19902
240370,202110,2125,5268,1627,4292,72,175,1140,2921,1212,3096
240375,202110,964,2358,803,2084,26,87,630,1575,656,1662
240380,202110,2288,6381,1707,5116,143,396,947,2832,1090,3228
240390,202110,1083,2537,777,1975,24,43,497,1178,521,1221
240400,202110,1570,3718,1196,3095,35,122,840,2026,875,2148
240410,202110,605,1740,494,1525,45,153,310,908,355,1061
240420,202110,4836,16195,4271,15000,455,1800,2592,8931,3047,10731
240430,202110,3609,8955,2984,7887,177,532,2225,5696,2402,6228
240440,202110,2622,5708,2220,5137,155,301,1750,4081,1905,4382
240450,202110,4720,12462,3693,10573,375,1053,2118,5860,2493,6913
240460,202110,3230,8629,2871,8064,245,714,2263,6344,2508,7058
240470,202110,3690,10991,2780,9102,664,2003,1145,4032,1809,6035
240480,202110,621,1643,417,1197,31,73,196,553,227,626
240485,202110,2284,6162,1834,5369,123,342,1244,3665,1367,4007
240490,202110,1675,4166,1309,3513,82,163,928,2523,1010,2686
240500,202110,2214,5887,1899,5337,111,291,1496,4226,1607,4517
240510,202110,1748,4552,1504,4179,88,260,1189,3276,1277,3536
240520,202110,1608,3695,1226,3179,93,186,877,2388,970,2574
240530,202110,2434,6405,2178,6005,88,247,1807,4902,1895,5149
240540,202110,2421,5840,2134,5403,66,118,1832,4673,1898,4791
240550,202110,752,1996,677,1852,15,62,580,1535,595,1597
240560,202110,3353,8464,2827,7769,279,658,2034,5761,2313,6419
240570,202110,2927,7458,1960,5390,299,800,675,1758,974,2558
240580,202110,8273,23979,7242,22109,684,1888,5567,17283,6251,19171
240590,202110,825,1959,725,1803,8,24,583,1411,591,1435
240600,202110,1888,4972,1388,3966,44,123,929,2555,973,2678
240610,202110,4426,11447,3789,10331,116,335,2921,7811,3037,8146
240615,202110,1310,3294,1054,2851,112,286,710,1897,822,2183
240620,202110,1911,5148,1637,4693,123,294,1276,3706,1399,4000
240630,202110,2150,5783,1937,5426,150,305,1348,3969,1498,4274
240640,202110,996,2579,791,2246,26,86,583,1624,609,1710
240650,202110,4202,11549,3570,10280,241,623,2607,7478,2848,8101
240660,202110,3186,7912,2828,7461,70,179,2554,6759,2624,6938
240670,202110,2609,7032,2077,5980,143,410,1357,3812,1500,4222
240680,202110,1677,4311,1354,3770,73,188,995,2713,1068,2901
240690,202110,1085,2608,849,2218,15,61,684,1715,699,1776
240700,202110,2590,7278,2108,6401,86,265,1590,4773,1676,5038
240710,202110,17191,42721,14458,38173,1672,4302,9326,24392,10998,28694
240720,202110,5514,13143,4717,12017,534,1306,3303,8426,3837,9732
240725,202110,1189,3278,904,2745,38,115,612,1802,650,1917
240730,202110,2376,6412,1893,5473,52,166,1441,4099,1493,4265
240740,202110,1977,5212,1587,4447,61,200,1117,2950,1178,3150
240750,202110,2211,7062,1867,6338,236,824,1047,3610,1283,4434
240760,202110,1763,3890,1268,3153,83,106,974,2493,1057,2599
240770,202110,3304,8998,2790,8265,131,446,2261,6645,2392,7091
240780,202110,4789,13158,3954,11770,561,1617,2395,7346,2956,8963
240790,202110,924,2509,758,2210,16,64,573,1617,589,1681
240800,202110,52134,120830,40593,103620,5182,13094,21400,54514,26582,67608
240810,202110,96530,240663,82005,217269,8663,23559,54404,141299,63067,164858
240820,202110,6033,17363,5223,15907,710,2082,3210,9976,3920,12058
240830,202110,8952,25007,7904,23450,269,975,6466,19030,6735,20005
240840,202110,1123,2731,897,2375,25,63,647,1655,672,1718
240850,202110,1486,3936,1042,3001,65,182,575,1604,640,1786
240860,202110,1408,3625,1060,3014,13,55,819,2223,832,2278
240870,202110,1118,2766,838,2296,147,416,444,1248,591,1664
240880,202110,1329,4109,1163,3787,73,288,867,2761,940,3049
240890,202110,4654,12391,3562,10358,469,1454,1810,5031,2279,6485
240895,202110,3007,8926,2747,8507,248,715,2169,6876,2417,7591
240910,202110,3661,9540,3091,8546,51,170,2528,6837,2579,7007
240920,202110,1054,2633,842,2307,101,199,461,1365,562,1564
240930,202110,3802,8412,3127,7585,242,346,2253,5877,2495,6223
240933,202110,1720,4166,1451,3785,35,127,1263,3231,1298,3358
240940,202110,6379,15406,4951,12968,612,1545,2776,7161,3388,8706
240950,202110,1142,3274,989,2997,31,118,800,2361,831,2479
240960,202110,698,2097,624,1951,21,63,488,1502,509,1565
240970,202110,1931,4863,1543,4200,62,213,1261,3348,1323,3561
240980,202110,3425,9899,3022,9199,103,440,2453,7311,2556,7751
240990,202110,2754,7407,2429,6811,248,766,1721,4646,1969,5412
241000,202110,972,2484,768,2121,28,68,574,1553,602,1621
241010,202110,2944,9034,2666,8458,174,595,1958,6157,2132,6752
241020,202110,2247,5788,1701,4726,90,253,1159,3101,1249,3354
241025,202110,1851,5141,1484,4485,35,143,1083,3201,1118,3344
241030,202110,2529,7811,2034,6766,245,785,1275,4291,1520,5076
241040,202110,2328,7133,2027,6611,80,367,1580,5121,1660,5488
241050,202110,1449,3940,1170,3438,31,103,850,2438,881,2541
241060,202110,809,2185,702,1969,36,98,488,1336,524,1434
241070,202110,720,1860,598,1666,13,33,466,1262,479,1295
241080,202110,1149,3208,873,2647,32,113,619,1840,651,1953
241090,202110,2065,5858,1686,5221,51,223,1300,3955,1351,4178
241100,202110,1258,3364,951,2750,64,165,607,1711,671,1876
241105,202110,978,2886,791,2536,241,770,262,863,503,1633
241110,202110,1030,2794,771,2259,39,107,497,1403,536,1510
241120,202110,7866,21817,6620,19672,874,2485,3959,12151,4833,14636
241140,202110,3516,9043,2707,7446,136,371,1957,5258,2093,5629
241142,202110,812,2143,600,1749,29,89,358,997,387,1086
241150,202110,6234,15543,5508,14409,189,437,4412,11455,4601,11892
241160,202110,1274,3367,1002,2867,156,463,561,1540,717,2003
241170,202110,1433,3533,1209,3148,37,113,990,2482,1027,2595
241180,202110,1108,2773,822,2232,96,263,393,1071,489,1334
241190,202110,1213,3089,1013,2698,14,61,745,1905,759,1966
241200,202110,21067,52965,18203,48343,2763,7252,10629,28109,13392,35361
241210,202110,1546,3976,1101,3129,105,323,628,1740,733,2063
241220,202110,9639,26854,8459,24915,1757,5121,4083,12447,5840,17568
241230,202110,2996,7775,2639,7220,115,315,2176,5914,2291,6229
241240,202110,1312,3562,829,2522,83,261,310,945,393,1206
241250,202110,5851,16197,4694,14090,165,641,3475,10060,3640,10701
241255,202110,2451,7284,2167,6729,135,457,1621,4949,1756,5406
241260,202110,5213,13089,4157,11378,109,358,3319,8906,3428,9264
241270,202110,1713,4878,1422,4331,114,342,1001,3065,1115,3407
241280,202110,2283,5534,1957,4955,73,161,1651,4133,1724,4294
241290,202110,3444,8255,2533,6805,76,214,1963,5145,2039,5359
241300,202110,1581,4120,1278,3597,29,85,864,2374,893,2459
241310,202110,2267,5413,1950,4969,27,67,1692,4358,1719,4425
241320,202110,982,3109,841,2843,85,338,536,1801,621,2139
241330,202110,1832,4565,1441,4048,14,70,1266,3534,1280,3604
241335,202110,3596,9649,3137,8830,124,374,2553,7089,2677,7463
241340,202110,1627,4436,1276,3737,226,713,569,1593,795,2306
241350,202110,2261,6017,1970,5496,121,303,1497,4165,1618,4468
241355,202110,1397,3684,1129,3168,12,30,850,2355,862,2385
241360,202110,2129,5375,1591,4312,43,107,1178,3119,1221,3226
241370,202110,1445,3808,1122,3153,67,189,789,2150,856,2339
241380,202110,729,1907,563,1599,89,235,271,782,360,1017
241390,202110,2839,8031,2517,7552,208,519,1887,5820,2095,6339
241400,202110,3760,10181,3321,9517,166,511,2626,7491,2792,8002
241410,202110,2562,7397,2077,6411,307,970,1137,3524,1444,4494
241415,202110,1799,4996,1498,4426,46,152,1122,3240,1168,3392
241420,202110,2566,7627,2226,7054,446,1517,1229,3893,1675,5410
241430,202110,639,1671,445,1263,17,45,290,787,307,832
241440,202110,8163,24114,7286,22575,329,1080,5781,17922,6110,19002
241445,202110,1296,3085,1117,2849,44,78,951,2529,995,2607
241450,202110,2951,6910,2470,6157,374,780,1655,4275,2029,5055
241460,202110,4088,10708,3282,9073,213,514,2212,6019,2425,6533
241470,202110,1444,3764,1183,3372,25,79,971,2765,996,2844
241475,202110,1314,3522,1043,3017,19,82,785,2158,804,2240
241480,202110,3159,9494,2581,8251,784,2496,797,2848,1581,5344
241490,202110,731,1654,549,1397,18,40,418,1047,436,1087
241500,202110,818,2238,738,2137,3,10,699,2038,702,2048
250010,202110,2739,7909,2293,6997,53,188,1692,5046,1745,5234
250020,202110,1721,4433,1254,3557,58,98,879,2515,937,2613
250030,202110,7146,19140,6285,17814,586,1621,4608,13006,5194,14627
250040,202110,4352,12510,3771,11469,364,1061,2660,7979,3024,9040
250050,202110,3742,9733,3377,9264,91,318,2851,7801,2942,8119
250053,202110,1289,3470,1178,3300,88,215,869,2446,957,2661
250057,202110,709,2351,653,2268,10,47,597,2093,607,2140
250060,202110,5855,14709,5273,13979,307,744,4360,11662,4667,12406
250070,202110,4242,11403,3561,10251,22,85,2883,8102,2905,8187
250073,202110,798,2051,647,1816,12,24,518,1438,530,1462
250077,202110,2447,6138,1855,5197,53,166,1451,4013,1504,4179
250080,202110,5380,12713,4524,11650,59,199,4012,10190,4071,10389
250090,202110,3561,8292,3099,7687,59,151,2673,6525,2732,6676
250100,202110,3725,10957,3341,10272,162,507,2609,7890,2771,8397
250110,202110,4996,13684,4502,12987,276,907,3469,9891,3745,10798
250115,202110,765,1855,567,1552,11,43,434,1161,445,1204
250120,202110,1928,5455,1614,4944,24,118,1291,3913,1315,4031
250130,202110,5788,15261,4876,13974,59,295,4179,11816,4238,12111
250135,202110,1268,3412,1100,3123,16,59,964,2730,980,2789
250140,202110,2372,6678,2201,6467,105,366,1903,5599,2008,5965
250150,202110,4843,14695,4334,13835,131,505,3479,10943,3610,11448
250153,202110,1408,3658,1160,3294,39,94,911,2582,950,2676
250157,202110,1973,5447,1750,5075,58,190,1408,4020,1466,4210
250160,202110,4090,9782,3262,8670,49,128,2828,7531,2877,7659
250170,202110,1930,4912,1735,4639,23,80,1506,3972,1529,4052
250180,202110,21849,50542,18655,46505,710,1991,14905,36233,15615,38224
250190,202110,4264,11021,3582,10026,310,893,2542,6999,2852,7892
250200,202110,2135,5342,1812,4921,78,179,1493,4105,1571,4284
250205,202110,893,2690,772,2506,10,45,627,2020,637,2065
250210,202110,1584,4659,1429,4425,41,164,1139,3472,1180,3636
250215,202110,1685,4420,1412,4041,78,231,818,2388,896,2619
250220,202110,689,1868,546,1649,23,81,369,1096,392,1177
250230,202110,1758,3864,1236,3096,23,61,992,2439,1015,2500
250240,202110,2533,7279,2227,6744,33,137,1905,5700,1938,5837
250250,202110,4747,12824,4152,11977,96,277,3529,10261,3625,10538
250260,202110,1727,4720,1456,4249,55,125,1142,3337,1197,3462
250270,202110,1226,3649,1115,3508,57,194,843,2736,900,2930
250280,202110,3661,9493,3258,8922,161,355,2549,7055,2710,7410
250290,202110,1579,4110,1346,3763,16,45,1076,2983,1092,3028
250300,202110,5642,14606,5063,13923,149,632,4305,11469,4454,12101
250310,202110,1231,3341,1026,2998,40,125,769,2239,809,2364
250320,202110,12951,28068,11177,26057,253,652,10092,23242,10345,23894
250330,202110,2492,6641,2086,6084,205,457,1594,4771,1799,5228
250340,202110,1205,2950,1059,2762,13,34,965,2505,978,2539
250350,202110,4310,11766,3783,10858,222,466,2958,8790,3180,9256
250355,202110,2114,6122,1893,5829,26,137,1710,5251,1736,5388
250360,202110,1860,4933,1663,4672,36,126,1411,3919,1447,4045
250370,202110,14468,35583,12011,31919,226,736,10212,26701,10438,27437
250375,202110,1244,3119,1001,2830,4,17,943,2683,947,2700
250380,202110,1694,4208,1555,4035,35,120,1373,3470,1408,3590
250390,202110,1924,4793,1618,4320,73,191,1303,3454,1376,3645
250400,202110,72089,173674,53343,145033,14554,43112,13860,40254,28414,83366
250403,202110,1877,5039,1674,4806,55,283,1328,3634,1383,3917
250407,202110,1404,3276,1084,2816,106,217,673,1916,779,2133
250410,202110,693,1798,594,1637,7,15,483,1293,490,1308
250415,202110,1954,5265,1709,4888,28,105,1471,4180,1499,4285
250420,202110,1242,3339,1112,3162,24,81,1007,2848,1031,2929
250430,202110,6440,15581,5452,14288,152,412,4455,11471,4607,11883
250435,202110,1620,4470,1293,3917,11,44,983,2929,994,2973
250440,202110,4797,12408,4153,11597,83,171,3657,10224,3740,10395
250450,202110,1859,4832,1528,4382,32,98,1251,3617,1283,3715
250460,202110,7644,20058,6790,18831,462,1261,5337,14818,5799,16079
250470,202110,1605,4076,1316,3626,53,167,1029,2779,1082,2946
250480,202110,4073,10901,3449,10142,36,116,3052,9064,3088,9180
250485,202110,759,1656,565,1386,47,78,396,956,443,1034
250490,202110,5320,12314,4729,11638,150,400,4206,10186,4356,10586
250500,202110,2082,5603,1857,5222,61,148,1505,4237,1566,4385
250510,202110,5634,13782,4841,12725,81,159,4219,11204,4300,11363
250520,202110,1977,5100,1683,4702,114,321,1237,3431,1351,3752
250523,202110,2231,5453,1958,5097,70,265,1637,4117,1707,4382
250527,202110,1702,4272,1534,4087,25,67,1358,3636,1383,3703
250530,202110,669,1676,576,1538,15,39,502,1339,517,1378
250535,202110,1436,4045,1289,3780,21,80,1035,2949,1056,3029
250540,202110,3175,6978,2646,6392,80,143,2325,5737,2405,5880
250550,202110,801,2509,705,2320,19,66,514,1672,533,1738
250560,202110,1825,4917,1596,4592,39,120,1344,3798,1383,3918
250570,202110,2861,8164,2448,7422,88,273,1905,5715,1993,5988
250580,202110,1090,2792,960,2613,46,160,807,2146,853,2306
250590,202110,905,2355,800,2205,19,55,674,1840,693,1895
250600,202110,8318,21320,6912,19461,251,735,5502,15410,5753,16145
250610,202110,3010,8390,2687,7922,101,359,2227,6516,2328,6875
250620,202110,878,2211,752,2001,18,45,535,1413,553,1458
250625,202110,2484,7031,2216,6594,38,176,1901,5531,1939,5707
250630,202110,10975,29047,8996,25693,962,2760,5811,16240,6773,19000
250640,202110,3707,9698,3315,9187,78,299,2904,7947,2982,8246
250650,202110,1040,2412,867,2183,14,40,755,1862,769,1902
250660,202110,1701,4109,1352,3633,49,111,1092,2853,1141,2964
250670,202110,2434,7389,2210,7001,37,149,1926,5993,1963,6142
250680,202110,6079,13803,5440,13085,50,193,5082,12047,5132,12240
250690,202110,6961,15449,5840,14070,110,234,5136,12331,5246,12565
250700,202110,4547,12475,3952,11580,641,1810,2420,7210,3061,9020
250710,202110,4498,12724,3921,11901,279,818,2847,8712,3126,9530
250720,202110,2917,7605,2606,7170,28,140,2339,6371,2367,6511
250730,202110,4361,11283,3805,10533,122,443,3164,8529,3286,8972
250740,202110,2052,4947,1693,4475,100,222,1314,3509,1414,3731
250750,202110,114005,271458,96868,247482,7918,20775,70278,176648,78196,197423
250760,202110,2467,6089,2154,5584,66,174,1772,4479,1838,4653
250770,202110,4237,12311,3790,11712,494,1361,2600,8337,3094,9698
250780,202110,1834,4802,1545,4296,66,195,1200,3271,1266,3466
250790,202110,2613,7452,2265,6940,83,332,1677,5017,1760,5349
250800,202110,2534,6529,2223,6038,109,209,1782,4932,1891,5141
250810,202110,1345,3422,1121,3110,41,75,930,2636,971,2711
250820,202110,2020,5521,1855,5339,29,118,1680,4802,1709,4920
250830,202110,6206,18066,5068,15753,247,845,3373,10148,3620,10993
250840,202110,789,2453,683,2250,19,66,514,1710,533,1776
250850,202110,1853,5328,1655,4984,32,120,1371,4039,1403,4159
250855,202110,1077,2962,930,2730,56,176,723,2111,779,2287
250860,202110,3483,9903,2860,8857,506,1476,1490,4777,1996,6253
250870,202110,1080,2885,914,2613,43,131,728,2062,771,2193
250880,202110,1681,4231,1396,3795,89,260,1051,2848,1140,3108
250890,202110,10845,26674,9555,24987,409,1326,7734,19422,8143,20748
250900,202110,3113,8094,2695,7369,100,220,2261,6147,2361,6367
250905,202110,2638,7048,2436,6772,42,129,2237,6219,2279,6348
250910,202110,6438,15343,5325,14093,62,173,4679,12445,4741,12618
250915,202110,2223,5050,1564,4342,24,46,1367,3883,1391,3929
250920,202110,3677,9114,3236,8449,273,610,2492,6509,2765,7119
250930,202110,2390,6280,2154,5976,45,194,1870,5061,1915,5255
250933,202110,1244,3582,1103,3329,26,107,875,2589,901,2696
250937,202110,751,1994,628,1797,22,74,493,1430,515,1504
250939,202110,1944,4903,1701,4597,59,131,1338,3624,1397,3755
250940,202110,4137,10766,3626,10102,23,74,3249,9054,3272,9128
250950,202110,1815,4568,1463,4105,30,110,1190,3287,1220,3397
250960,202110,1145,3313,1006,3093,26,119,818,2444,844,2563
250970,202110,8493,21396,7438,19695,206,594,6112,15874,6318,16468
250980,202110,2454,6384,2219,6049,21,92,1949,5184,1970,5276
250990,202110,2140,6299,1790,5700,56,213,1341,4227,1397,4440
251000,202110,2096,5796,1691,5104,30,112,1373,4128,1403,4240
251010,202110,2773,7531,2516,7132,23,81,2251,6389,2274,6470
251020,202110,1688,4529,1512,4254,32,134,1309,3613,1341,3747
251030,202110,1081,2805,884,2461,51,126,588,1641,639,1767
251040,202110,1933,5196,1633,4701,27,122,1359,3879,1386,4001
251050,202110,1080,2919,905,2581,44,141,649,1778,693,1919
251060,202110,1113,2328,843,1988,12,31,640,1497,652,1528
251065,202110,504,1342,382,1118,8,23,267,748,275,771
251070,202110,779,1943,647,1755,8,29,560,1477,568,1506
251080,202110,19785,48653,15979,42955,2349,6417,9373,25664,11722,32081
251090,202110,2930,8236,2475,7441,59,175,1952,5847,2011,6022
251100,202110,841,2616,739,2415,23,78,581,1831,604,1909
251110,202110,1825,4697,1542,4205,76,159,1161,3190,1237,3349
251120,202110,8070,21408,6784,19839,363,1099,5188,15330,5551,16429
251130,202110,4049,8751,3554,8192,51,132,3246,7439,3297,7571
251140,202110,4486,12173,3986,11473,68,261,3290,9369,3358,9630
251150,202110,2712,7678,2473,7289,67,291,2116,6091,2183,6382
251160,202110,2291,6485,1978,6022,30,140,1699,5078,1729,5218
251170,202110,1682,4387,1475,4123,19,61,1325,3678,1344,3739
251180,202110,2716,7087,2226,6399,148,411,1569,4529,1717,4940
251190,202110,4577,11698,4129,11189,33,172,3759,10004,3792,10176
251200,202110,4549,12922,4006,12233,67,252,3516,10777,3583,11029
251203,202110,1031,3214,941,3005,24,89,706,2195,730,2284
251207,202110,1163,3067,878,2609,17,70,608,1763,625,1833
251210,202110,8168,19860,6663,17824,355,721,4949,13621,5304,14342
251220,202110,1316,3030,982,2594,75,145,719,1980,794,2125
251230,202110,4915,13325,4237,12109,113,334,3344,9349,3457,9683
251240,202110,3762,10249,3154,9215,185,447,2312,6750,2497,7197
251250,202110,11209,29152,9809,26777,678,1849,7324,19460,8002,21309
251260,202110,528,1417,475,1332,13,52,379,1030,392,1082
251270,202110,4403,13444,3943,12814,115,443,3210,10634,3325,11077
251272,202110,1350,3638,1235,3486,66,206,1019,2829,1085,3035
251274,202110,937,2538,751,2203,56,171,494,1390,550,1561
251275,202110,1279,3489,1081,3163,28,100,853,2433,881,2533
251276,202110,1353,3637,1172,3390,22,113,958,2685,980,2798
251278,202110,629,1672,565,1577,41,108,434,1226,475,1334
251280,202110,2328,6158,2123,5858,57,148,1779,4883,1836,5031
251290,202110,6568,14523,5982,13819,185,502,5301,11940,5486,12442
251300,202110,911,2622,820,2480,9,45,699,2098,708,2143
251310,202110,2942,7977,2558,7399,34,162,2127,6017,2161,6179
251315,202110,1835,5543,1655,5186,124,331,1233,3870,1357,4201
251320,202110,1665,4346,1220,3574,29,96,918,2646,947,2742
251330,202110,2172,4985,1787,4529,28,79,1591,4062,1619,4141
251335,202110,1144,3148,1021,2964,24,99,898,2558,922,2657
251340,202110,3881,9014,3084,7970,130,325,2349,6102,2479,6427
251350,202110,1102,3055,1004,2893,31,92,823,2347,854,2439
251360,202110,1923,5232,1544,4692,11,63,1265,3838,1276,3901
251365,202110,786,2047,618,1727,6,20,495,1360,501,1380
251370,202110,26021,66553,22234,61198,3526,9440,12376,35454,15902,44894
251380,202110,1334,3572,1128,3232,14,83,966,2699,980,2782
251385,202110,797,1998,617,1677,23,59,454,1196,477,1255
251390,202110,6694,18905,5899,17675,549,1593,3889,11814,4438,13407
251392,202110,1036,2758,875,2511,27,106,690,1947,717,2053
251394,202110,656,1830,526,1606,39,109,367,1120,406,1229
251396,202110,684,1824,580,1642,18,46,396,1103,414,1149
251398,202110,1061,2619,751,2080,17,51,558,1508,575,1559
251400,202110,1356,3108,1063,2715,21,72,864,2134,885,2206
251410,202110,1616,3696,1297,3249,21,79,1100,2650,1121,2729
251420,202110,2072,5228,1695,4779,33,112,1352,3757,1385,3869
251430,202110,1599,4739,1437,4459,33,146,1233,3804,1266,3950
251440,202110,1137,3096,916,2692,47,99,701,2120,748,2219
251445,202110,1602,4381,1473,4195,28,75,1265,3566,1293,3641
251450,202110,4453,12977,3980,12251,77,285,3327,10173,3404,10458
251455,202110,904,2666,827,2526,17,64,666,1990,683,2054
251460,202110,1005,2766,844,2516,15,43,695,2084,710,2127
251465,202110,484,1363,413,1224,5,20,312,895,317,915
251470,202110,1231,3307,924,2695,78,234,531,1489,609,1723
251480,202110,1066,2704,869,2364,13,47,673,1758,686,1805
251490,202110,2015,5158,1610,4594,75,199,1191,3435,1266,3634
251500,202110,2049,5593,1878,5377,40,139,1690,4830,1730,4969
251510,202110,2784,8077,2320,7164,115,362,1584,4780,1699,5142
251520,202110,1091,2720,842,2283,73,179,543,1443,616,1622
251530,202110,15155,35466,12209,31819,97,492,10826,27739,10923,28231
251540,202110,3182,8762,2860,8194,71,249,2423,6844,2494,7093
251550,202110,4039,9106,3225,8132,145,223,2647,6800,2792,7023
251560,202110,573,1726,512,1632,50,168,356,1097,406,1265
251570,202110,973,2695,797,2347,23,99,635,1821,658,1920
251580,202110,2042,4814,1833,4514,33,116,1578,3752,1611,3868
251590,202110,1665,3972,1406,3665,71,161,1166,3011,1237,3172
251593,202110,972,2781,872,2611,90,254,562,1684,652,1938
251597,202110,2161,5955,1934,5655,17,84,1736,5018,1753,5102
251600,202110,6535,17272,5685,15971,208,565,4634,12906,4842,13471
251610,202110,3223,9051,2790,8260,271,703,1871,5673,2142,6376
251615,202110,1369,3288,1098,2883,22,63,892,2272,914,2335
251620,202110,19997,44348,15319,38652,71,240,13264,33738,13335,33978
251630,202110,5126,11577,4081,10132,219,504,3026,7475,3245,7979
251640,202110,2321,6058,2073,5683,20,93,1858,4991,1878,5084
251650,202110,4098,10740,3553,10035,129,366,2993,8465,3122,8831
251660,202110,3704,10745,3268,9993,57,232,2723,8219,2780,8451
251670,202110,4268,11677,3766,10974,37,174,3388,9804,3425,9978
251675,202110,734,1919,663,1834,95,231,457,1292,552,1523
251680,202110,2716,6849,2273,6278,43,127,1880,5224,1923,5351
251690,202110,3262,8947,2776,8119,78,201,2110,6153,2188,6354
251700,202110,2309,6227,1924,5746,39,150,1626,4762,1665,4912
251710,202110,815,2052,579,1578,36,106,337,866,373,972
251720,202110,1366,3785,1100,3329,13,55,853,2502,866,2557
251740,202110,621,1709,493,1470,42,149,328,939,370,1088
260005,202110,30961,64295,25498,57294,2026,4309,19187,42454,21213,46763
260010,202110,10799,27491,8916,24482,485,1310,5249,14556,5734,15866
260020,202110,7145,16226,5949,14532,66,276,5089,12185,5155,12461
260030,202110,7168,17773,6013,16111,121,356,4927,13099,5048,13455
260040,202110,8040,19658,6782,17901,456,1156,4917,13216,5373,14372
260050,202110,14525,36744,12059,34016,247,659,11051,31407,11298,32066
260060,202110,4385,10345,3751,9355,313,619,2795,7180,3108,7799
260070,202110,11193,27200,9606,24937,347,1101,7769,19678,8116,20779
260080,202110,6707,15050,5817,13886,110,300,4880,11481,4990,11781
260090,202110,4945,12272,4347,11455,384,991,3257,8646,3641,9637
260100,202110,3088,8170,2590,7436,29,152,2185,6174,2214,6326
260105,202110,5130,13835,4599,13119,135,429,3891,10972,4026,11401
260110,202110,22908,62410,20360,58734,839,2677,16861,48025,17700,50702
260120,202110,15203,38834,12811,35367,1498,3898,8243,23189,9741,27087
260130,202110,3319,8080,2923,7515,213,495,2204,5605,2417,6100
260140,202110,13438,29353,11577,27164,531,1293,9797,22696,10328,23989
260150,202110,3656,8341,3163,7736,98,218,2776,6775,2874,6993
260160,202110,6748,17129,5709,15867,94,297,5192,14540,5286,14837
260170,202110,21667,49401,18395,44977,975,2295,14663,35514,15638,37809
260180,202110,3677,9438,3174,8761,75,239,2736,7450,2811,7689
260190,202110,19023,37285,16053,33821,210,468,14271,29556,14481,30024
260200,202110,11585,26959,9974,24916,523,1012,8362,21296,8885,22308
260210,202110,11927,32842,10119,29931,279,914,8070,23798,8349,24712
260220,202110,11260,25620,10388,24527,184,445,9258,21600,9442,22045
260230,202110,11193,26541,9688,24568,207,513,8174,20504,8381,21017
260240,202110,2881,8379,2513,7675,88,303,1939,5838,2027,6141
260250,202110,2374,5862,2056,5383,120,222,1620,4273,1740,4495
260260,202110,13325,33373,11831,31151,379,1103,9498,24627,9877,25730
260270,202110,4512,10556,3949,9901,101,356,3365,8310,3466,8666
260280,202110,13044,38290,11753,36451,399,1574,10055,30752,10454,32326
260290,202110,43262,105920,37171,97243,3938,10404,25318,65995,29256,76399
260300,202110,9981,26257,8645,24437,188,641,7340,20720,7528,21361
260310,202110,5706,13896,5023,13052,378,791,3843,10250,4221,11041
260320,202110,8096,22684,6868,20620,208,572,5615,16915,5823,17487
260330,202110,2685,8006,2343,7310,60,189,1874,5723,1934,5912
260340,202110,2139,5561,1856,5152,22,85,1631,4436,1653,4521
260345,202110,27273,67655,22797,61231,3421,9656,12157,31907,15578,41563
260350,202110,5870,13227,5062,12312,46,126,4563,11036,4609,11162
260360,202110,2679,6696,2411,6224,41,126,1759,4449,1800,4575
260370,202110,5779,16003,4981,14689,204,586,3867,11327,4071,11913
260380,202110,5233,14894,4474,13657,162,456,3406,10322,3568,10778
260390,202110,4920,14203,4043,12437,220,605,2709,8229,2929,8834
260392,202110,3611,11015,3257,10565,88,509,2718,8798,2806,9307
260400,202110,19853,44111,17124,40565,468,1156,13715,31309,14183,32465
260410,202110,78381,183819,61294,160236,11024,29881,26890,72773,37914,102654
260415,202110,4604,11838,3966,10826,40,160,3335,8933,3375,9093
260420,202110,12879,26467,10915,24304,85,244,10183,22490,10268,22734
260430,202110,2900,8698,2465,7853,146,454,1668,5279,1814,5733
260440,202110,3892,9643,3457,9024,66,206,2972,7637,3038,7843
260450,202110,5912,14486,5274,13654,284,533,4394,11586,4678,12119
260460,202110,5530,15706,4708,14294,480,1584,2867,8563,3347,10147
260470,202110,5009,12910,4220,12005,84,181,3856,11113,3940,11294
260480,202110,4265,10705,3601,9788,314,825,2436,6774,2750,7599
260490,202110,5501,12441,4848,11522,27,120,4438,10377,4465,10497
260500,202110,6305,15175,5382,13891,398,860,3831,10029,4229,10889
260510,202110,10375,24760,8696,22419,86,302,7672,19577,7758,19879
260515,202110,4649,11941,3643,10103,146,332,2535,6830,2681,7162
260520,202110,17319,39048,15094,36254,721,1649,12459,29599,13180,31248
260530,202110,10190,28559,8654,26214,105,473,7501,22465,7606,22938
260540,202110,7425,15936,6557,14851,132,279,5920,13336,6052,13615
260545,202110,78,236,51,171,3,12,20,63,23,75
260550,202110,3301,8702,2664,7669,139,420,1839,5187,1978,5607
260560,202110,6234,15570,5217,14093,109,378,4403,11699,4512,12077
260570,202110,8286,21277,7320,19993,326,898,5994,16370,6320,17268
260580,202110,4619,10769,4153,10158,22,67,3808,9266,3830,9333
260590,202110,7361,15810,6224,14564,211,428,5361,12644,5572,13072
260600,202110,33087,82568,27082,73596,1085,3020,20716,55198,21801,58218
260610,202110,7882,19687,7009,18540,444,1131,5239,13921,5683,15052
260620,202110,17946,44173,15737,41063,1298,3688,11601,29648,12899,33336
260630,202110,2480,6530,2023,5827,42,128,1638,4644,1680,4772
260640,202110,23326,50568,19670,46399,805,1859,16189,37927,16994,39786
260650,202110,6531,16336,5236,14767,516,868,4150,12255,4666,13123
260660,202110,7440,18572,6483,17332,257,762,5553,14640,5810,15402
260670,202110,2378,6054,1936,5346,83,218,1361,3668,1444,3886
260680,202110,30576,70942,25764,64201,2073,5141,17903,43970,19976,49111
260690,202110,3667,9299,3050,8343,66,235,2409,6544,2475,6779
260700,202110,6576,17672,6058,17088,20,69,5877,16648,5897,16717
260710,202110,1433,3612,1210,3283,34,121,953,2572,987,2693
260720,202110,27460,63297,23274,58073,2303,5414,16697,42401,19000,47815
260730,202110,8333,22902,7262,21420,234,715,6131,17900,6365,18615
260740,202110,1375,3853,1149,3482,13,65,908,2809,921,2874
260750,202110,7758,20254,6220,18327,254,506,5380,16428,5634,16934
260760,202110,6196,13844,5347,12854,156,353,4556,10968,4712,11321
260765,202110,8692,23885,7574,22345,381,1349,5424,15661,5805,17010
260770,202110,4096,10056,3377,8884,118,339,2672,6925,2790,7264
260775,202110,5580,14254,4880,13218,172,559,3893,10208,4065,10767
260780,202110,3870,11066,3454,10406,424,1288,2115,6300,2539,7588
260790,202110,128763,280100,106586,251750,16238,36869,65781,156007,82019,192876
260795,202110,3136,7698,2682,7122,97,265,2140,5744,2237,6009
260800,202110,5684,12666,5130,11924,189,478,4472,10094,4661,10572
260805,202110,3804,10373,3228,9394,202,619,2345,6766,2547,7385
260810,202110,6902,17886,6052,16314,444,1058,4509,11992,4953,13050
260820,202110,4727,10584,4191,9972,89,244,3507,8254,3596,8498
260825,202110,3104,8877,2728,8233,114,344,2055,6165,2169,6509
260830,202110,4372,12342,3612,11013,493,1281,2236,7117,2729,8398
260840,202110,4387,10983,3919,10355,238,526,3279,8729,3517,9255
260845,202110,4752,12009,4187,11064,261,720,3138,8110,3399,8830
260850,202110,5407,14159,4512,12516,349,1008,2907,7800,3256,8808
260860,202110,3525,9752,3020,8890,95,288,2439,7021,2534,7309
260870,202110,4640,10834,3978,10028,58,199,3568,8886,3626,9085
260875,202110,7822,18181,6339,16050,549,1263,4397,11306,4946,12569
260880,202110,9992,27414,8689,25235,412,1187,6859,19885,7271,21072
260890,202110,13613,33595,11723,30778,738,1902,8404,21621,9142,23523
260900,202110,5794,15439,4787,14031,293,857,3264,9535,3557,10392
260910,202110,3391,8953,2952,8300,105,276,2321,6496,2426,6772
260915,202110,5170,14902,4509,14129,46,202,4146,13011,4192,13213
260920,202110,3638,8320,3096,7737,121,221,2638,6704,2759,6925
260930,202110,4266,12299,3657,11230,169,565,2830,8469,2999,9034
260940,202110,15672,36095,13613,33260,1249,2955,10024,24205,11273,27160
260950,202110,7616,19483,6147,17018,358,1157,4074,10686,4432,11843
260960,202110,76182,163519,61673,145237,6315,14913,40360,93872,46675,108785
260970,202110,6077,15113,5394,14202,299,587,3981,10814,4280,11401
260980,202110,4776,13480,4187,12752,49,150,3829,11779,3878,11929
260990,202110,19135,49841,16170,45807,850,2276,12649,35586,13499,37862
261000,202110,17463,39168,14729,35772,416,1115,11982,28500,12398,29615
261010,202110,2433,6169,2124,5767,105,230,1810,4963,1915,5193
261020,202110,6893,17246,5990,15801,333,795,4872,12621,5205,13416
261030,202110,4215,11929,3703,11032,121,445,2931,8499,3052,8944
261040,202110,5685,15734,4642,13813,144,453,3569,10346,3713,10799
261050,202110,8501,20716,7709,19575,379,641,6149,15705,6528,16346
261060,202110,14982,36315,13044,33999,264,775,10979,28296,11243,29071
261070,202110,70023,148229,58083,132656,3618,7749,43817,98259,47435,106008
261080,202110,7112,16396,6454,15598,154,302,5967,14437,6121,14739
261090,202110,20486,46718,18201,43754,366,1027,15961,37764,16327,38791
261100,202110,9062,23552,7890,21847,540,1441,5887,16321,6427,17762
261110,202110,72116,194081,60466,173192,8062,24041,36012,101751,44074,125792
261120,202110,3807,9271,3295,8557,69,145,2855,7399,2924,7544
261130,202110,7660,18084,6704,16812,127,351,5920,14706,6047,15057
261140,202110,3874,8702,3466,8164,204,480,2709,6312,2913,6792
261150,202110,5452,13895,4801,12928,84,251,4149,11082,4233,11333
261153,202110,2003,5873,1675,5237,58,176,1122,3542,1180,3718
261160,202110,230359,514928,187768,457304,44825,112051,78750,195879,123575,307930
261170,202110,6851,15827,6008,14690,243,502,5021,12177,5264,12679
261180,202110,9807,23783,8554,22171,506,1159,6221,16372,6727,17531
261190,202110,4806,13497,4321,12723,138,598,3492,9982,3630,10580
261200,202110,3573,7894,3157,7348,197,451,2596,5961,2793,6412
261210,202110,2002,4742,1721,4346,80,187,1419,3539,1499,3726
261220,202110,14817,39604,12488,35509,1414,4140,7529,21046,8943,25186
261230,202110,4231,11674,3526,10734,37,122,2968,9138,3005,9260
261240,202110,5851,13818,5131,12715,348,713,4102,10185,4450,10898
261245,202110,3953,10619,3294,9477,68,294,2650,7344,2718,7638
261247,202110,3166,9020,2617,8053,146,440,1850,5643,1996,6083
261250,202110,24467,53625,21259,49918,2972,6242,14545,35677,17517,41919
261255,202110,4344,12258,3552,10740,134,494,2741,8097,2875,8591
261260,202110,13458,34781,11714,32543,293,982,10258,28234,10551,29216
261270,202110,4749,11112,4145,10372,202,444,3421,8564,3623,9008
261280,202110,2617,7116,2296,6583,66,219,1823,5083,1889,5302
261290,202110,3047,7631,2534,7054,64,220,2064,5800,2128,6020
261300,202110,13407,35598,11487,32447,434,1478,8768,24095,9202,25573
261310,202110,9666,23336,8299,21501,621,1663,6168,15658,6789,17321
261320,202110,6364,17216,5495,15823,68,262,4706,13383,4774,13645
261330,202110,5891,14120,5308,13371,118,402,4629,11421,4747,11823
261340,202110,4461,11964,3878,11227,122,429,3271,9365,3393,9794
261350,202110,9011,25979,7950,24173,116,451,6470,19491,6586,19942
261360,202110,8575,19860,7216,17941,275,682,5772,13998,6047,14680
261370,202110,25481,61386,21372,55834,2522,6046,13657,36303,16179,42349
261380,202110,4352,12449,3836,11584,422,1331,2588,7748,3010,9079
261390,202110,17679,48525,14901,44124,1176,3676,9977,29259,11153,32935
261400,202110,4876,14774,4259,13485,238,807,3135,9758,3373,10565
261410,202110,10185,24452,8359,21709,343,976,6768,17128,7111,18104
261420,202110,7784,22248,7027,21331,646,2171,5175,15673,5821,17844
261430,202110,3707,9946,3152,9090,46,188,2667,7538,2713,7726
261440,202110,1522,4401,1271,3935,47,191,910,2713,957,2904
261450,202110,15175,40029,13383,37340,163,540,11023,30913,11186,31453
261460,202110,8092,21245,7073,19681,288,795,5680,15804,5968,16599
261470,202110,4300,10405,3709,9595,35,119,3186,8205,3221,8324
261480,202110,5480,16046,4695,14732,219,746,3638,11257,3857,12003
261485,202110,5296,14421,4611,13379,372,1129,3401,9770,3773,10899
261500,202110,6397,15679,5559,14549,433,918,3801,10445,4234,11363
261510,202110,1963,5678,1705,5264,58,207,1298,4033,1356,4240
261520,202110,2414,7213,2176,6738,63,196,1610,4963,1673,5159
261530,202110,12762,35611,10368,31408,828,2839,5600,16213,6428,19052
261540,202110,8982,24411,8129,23221,1310,3468,4487,13728,5797,17196
261550,202110,3869,9980,3348,9183,272,733,2383,6433,2655,7166
261560,202110,8405,23577,7302,21958,307,980,5736,17238,6043,18218
261570,202110,3620,9546,2868,8314,172,553,1969,5633,2141,6186
261580,202110,7084,18132,6117,16814,92,414,5527,14994,5619,15408
261590,202110,2843,7010,2311,6263,78,236,1750,4695,1828,4931
261600,202110,5630,13376,4781,12165,297,593,3439,8906,3736,9499
261610,202110,2212,6250,1773,5441,129,439,1144,3505,1273,3944
261618,202110,2642,6336,2311,5869,82,187,1867,4706,1949,4893
261620,202110,4327,11920,3934,11340,786,1979,2523,7634,3309,9613
261630,202110,6323,17470,5354,15656,381,1216,3512,9912,3893,11128
261640,202110,39468,85328,33666,78289,2057,3548,25345,61159,27402,64707
261650,202110,4406,10414,3744,9586,195,440,2825,7266,3020,7706
270010,202110,4578,14833,3960,13779,119,653,3201,10849,3320,11502
270020,202110,4085,9902,3583,9276,123,374,3074,7761,3197,8135
270030,202110,35779,94692,29914,85345,3264,9191,20670,58715,23934,67906
270040,202110,11350,28891,9766,27006,388,1130,8221,22647,8609,23777
270050,202110,5704,12935,4851,11972,414,760,4046,10293,4460,11053
270060,202110,2339,5809,1961,5366,174,415,1514,4220,1688,4635
270070,202110,4848,13286,4207,12405,101,354,3547,10268,3648,10622
270080,202110,1517,4041,1282,3649,53,144,989,2738,1042,2882
270090,202110,1842,5474,1657,5120,44,166,1394,4223,1438,4389
270100,202110,5944,14600,5149,13460,212,585,4312,11078,4524,11663
270110,202110,3427,7649,2788,6920,156,295,2209,5783,2365,6078
270120,202110,2715,7351,2356,6863,69,266,1976,5659,2045,5925
270130,202110,5322,13368,4609,12499,177,510,3916,10639,4093,11149
270135,202110,2100,4939,1775,4579,30,99,1638,4189,1668,4288
270140,202110,9979,22936,8033,20259,380,1054,6238,15056,6618,16110
270150,202110,2703,8082,2459,7736,3,15,2317,7275,2320,7290
270160,202110,6225,16561,5316,15519,123,420,4860,14238,4983,14658
270170,202110,3481,9937,2925,9169,171,710,2194,6597,2365,7307
270180,202110,2349,7131,2156,6891,37,183,1958,6185,1995,6368
270190,202110,1827,5112,1620,4862,23,98,1473,4398,1496,4496
270200,202110,2608,7656,2258,7157,108,320,1675,5335,1783,5655
270210,202110,5949,13642,5058,12631,57,189,4675,11534,4732,11723
270220,202110,1726,4335,1375,3830,177,497,881,2411,1058,2908
270230,202110,10095,26437,8449,23928,907,2487,5907,16825,6814,19312
270235,202110,6169,18387,5337,17062,157,496,4470,14208,4627,14704
270240,202110,11729,30683,9674,27884,936,2703,6923,20184,7859,22887
270250,202110,3002,7156,2646,6655,193,415,2137,5405,2330,5820
270255,202110,4685,12994,3709,11278,111,409,2867,8560,2978,8969
270260,202110,5670,16543,5129,15652,93,423,4484,13420,4577,13843
270270,202110,1111,2778,924,2547,108,272,683,1908,791,2180
270280,202110,4029,9415,3220,8422,538,763,2222,6351,2760,7114
270290,202110,8027,24560,7235,23294,115,554,6415,20429,6530,20983
270300,202110,4446,11232,3468,10166,209,478,2687,8139,2896,8617
270310,202110,7295,19757,6254,18177,75,371,5447,15492,5522,15863
270320,202110,5720,16491,4950,15019,295,895,3661,10808,3956,11703
270330,202110,4222,13162,3735,12418,230,899,2965,9814,3195,10713
270340,202110,1701,4331,1449,3998,47,107,1241,3407,1288,3514
270350,202110,1969,4452,1596,4022,129,332,1153,2940,1282,3272
270360,202110,2772,6728,2483,6407,86,175,2293,5959,2379,6134
270370,202110,1473,4408,1342,4172,32,139,1156,3545,1188,3684
270375,202110,3191,7341,2666,6766,23,61,2502,6364,2525,6425
270380,202110,5775,15533,4873,14391,529,1382,3454,10587,3983,11969
270390,202110,1278,3139,1032,2853,11,42,875,2432,886,2474
270400,202110,6856,17164,5771,15574,242,542,4675,12574,4917,13116
270410,202110,4920,13724,4271,12757,134,450,3597,10714,3731,11164
270420,202110,6001,17072,5398,16200,115,477,4715,13887,4830,14364
270430,202110,146841,336303,115127,295793,21219,55854,55840,146049,77059,201903
270440,202110,4920,12866,4279,12085,75,289,3804,10645,3879,10934
270450,202110,7501,19362,6569,18233,290,791,5453,15461,5743,16252
270460,202110,3855,8430,3292,7762,160,294,2959,7018,3119,7312
270470,202110,11603,31200,10108,29113,620,1863,7918,22850,8538,24713
270480,202110,3079,7907,2595,7223,93,299,2127,5816,2220,6115
270490,202110,978,2625,852,2471,57,167,680,1969,737,2136
270500,202110,5109,15069,4545,14128,236,755,3633,11184,3869,11939
270510,202110,5934,15076,4991,13888,381,1198,3728,10078,4109,11276
270520,202110,4342,11805,3453,10345,732,2206,1389,4381,2121,6587
270530,202110,1378,3842,1162,3502,62,161,812,2492,874,2653
270540,202110,2382,6428,2029,5978,63,180,1757,5151,1820,5331
270550,202110,7124,17759,5674,16156,745,1701,4025,12051,4770,13752
270560,202110,3154,7847,2663,7183,177,481,2109,5659,2286,6140
270570,202110,4444,11856,3785,10888,277,682,2983,8652,3260,9334
270580,202110,2381,6549,2152,6227,124,346,1832,5283,1956,5629
270590,202110,1619,4831,1490,4654,16,83,1409,4387,1425,4470
270600,202110,2868,8621,2594,8202,40,187,2318,7247,2358,7434
270610,202110,3742,9600,3244,8941,86,213,2874,7881,2960,8094
270620,202110,1315,3828,1211,3631,22,78,1053,3076,1075,3154
270630,202110,18271,43536,15752,40115,706,1923,13146,32898,13852,34821
270640,202110,5667,15665,4958,14545,168,601,4129,11925,4297,12526
270642,202110,2607,8239,2307,7774,157,610,1750,5828,1907,6438
270644,202110,3844,9339,3168,8465,436,997,2222,6189,2658,7186
270650,202110,3365,9475,2942,8901,307,957,2231,6766,2538,7723
270660,202110,2039,5119,1746,4709,78,242,1338,3556,1416,3798
270670,202110,17558,38926,14695,35442,410,1009,12654,29881,13064,30890
270680,202110,5811,13392,5194,12720,126,183,4863,12072,4989,12255
270690,202110,9824,23549,8240,21547,368,960,6673,17308,7041,18268
270700,202110,552,1610,482,1491,42,124,346,1063,388,1187
270710,202110,5844,16845,5163,15793,296,935,4096,12464,4392,13399
270720,202110,3769,10659,3358,9979,55,254,2988,8724,3043,8978
270730,202110,8523,18186,7453,17047,354,554,5799,14794,6153,15348
270740,202110,2440,6288,2148,5948,91,286,1789,4912,1880,5198
270750,202110,5903,15063,5154,14139,64,247,4598,12525,4662,12772
270760,202110,3501,9497,2961,8766,54,213,2476,7296,2530,7509
270770,202110,21921,52770,17609,47393,3035,7191,10434,29863,13469,37054
270780,202110,1916,4991,1771,4789,56,177,1584,4242,1640,4419
270790,202110,1762,4575,1480,4184,114,328,1121,3148,1235,3476
270800,202110,11455,30296,10332,28700,366,1166,8841,24313,9207,25479
270810,202110,3502,9599,2771,8420,176,574,1946,5834,2122,6408
270820,202110,1675,4840,1423,4442,42,175,1142,3498,1184,3673
270830,202110,5330,12428,4289,11150,160,485,3516,8988,3676,9473
270840,202110,8734,25348,7744,23910,149,695,6756,20463,6905,21158
270850,202110,9208,21317,8123,20044,770,1892,6604,16241,7374,18133
270860,202110,15165,32582,12054,29094,588,1183,9794,23690,10382,24873
270870,202110,2348,6370,1919,5675,278,727,1195,3738,1473,4465
270880,202110,8199,24044,7310,22698,171,674,6114,18681,6285,19355
270890,202110,3291,8633,2779,7911,234,648,1867,5318,2101,5966
270895,202110,3306,9749,2976,9326,62,339,2657,8176,2719,8515
270900,202110,1810,4534,1377,3857,26,62,1091,3039,1117,3101
270910,202110,4229,11765,3658,10889,98,276,3060,9014,3158,9290
270915,202110,10155,27785,8228,24698,654,2160,5675,16616,6329,18776
270920,202110,5962,16866,5405,15994,72,322,4708,13579,4780,13901
270930,202110,18168,40732,14083,36000,1755,3884,9465,25705,11220,29589
270940,202110,6780,17268,5723,16000,184,659,4567,12432,4751,13091
280010,202110,703,1925,566,1646,17,58,401,1073,418,1131
280020,202110,5158,12692,4344,11436,384,964,3047,8030,3431,8994
280030,202110,81810,185684,65335,162735,12671,31266,31415,80590,44086,111856
280040,202110,3060,8126,2668,7542,274,706,1840,5247,2114,5953
280050,202110,4229,11680,3605,10712,705,2020,1923,5784,2628,7804
280060,202110,6901,16887,5441,14709,958,2692,2631,7371,3589,10063
280067,202110,7330,17365,6214,15663,290,691,4592,11445,4882,12136
280070,202110,1914,5604,1776,5381,114,334,1459,4410,1573,4744
280100,202110,4200,10723,3524,9673,358,974,2360,6515,2718,7489
280110,202110,1543,3887,1344,3598,14,50,1211,3176,1225,3226
280120,202110,7828,21792,6932,20365,858,2258,4865,14705,5723,16963
280130,202110,9290,21305,8085,19647,431,1080,6508,15721,6939,16801
280140,202110,5738,13248,5040,12296,279,675,4141,10101,4420,10776
280150,202110,4360,10656,3789,9886,499,1116,2719,7294,3218,8410
280160,202110,1233,3448,1043,3137,94,318,719,2113,813,2431
280170,202110,5384,13697,4829,13001,273,629,3867,10495,4140,11124
280190,202110,1371,2903,1221,2706,49,110,1036,2252,1085,2362
280200,202110,1324,3355,1096,3034,60,193,839,2283,899,2476
280210,202110,18048,42579,15681,39269,1763,4183,10059,25363,11822,29546
280220,202110,1782,4663,1511,4311,44,176,1254,3549,1298,3725
280230,202110,4571,11085,3771,9896,330,652,2595,6958,2925,7610
280240,202110,3435,8939,3046,8356,34,169,2645,7065,2679,7234
280250,202110,965,2216,801,1972,81,198,564,1356,645,1554
280260,202110,2332,5456,2038,5086,40,94,1852,4666,1892,4760
280270,202110,2556,6694,2260,6250,170,416,1803,5025,1973,5441
280280,202110,4242,12248,3767,11545,566,1460,2528,8201,3094,9661
280290,202110,19403,48899,16644,45041,1391,3757,11155,30444,12546,34201
280300,202110,12879,29222,11282,27510,395,790,8169,22143,8564,22933
280310,202110,1439,3633,1201,3247,41,118,905,2399,946,2517
280320,202110,9109,23683,7887,21861,1020,2612,5210,14457,6230,17069
280330,202110,4892,11736,4131,10703,247,666,3039,7892,3286,8558
280340,202110,5705,11752,4733,10681,283,439,4029,9341,4312,9780
280350,202110,27459,62173,24108,57763,1127,2655,19198,45319,20325,47974
280360,202110,5871,15867,5148,14702,674,1914,3106,9038,3780,10952
280370,202110,2302,5386,1888,4715,57,117,1514,3702,1571,3819
280380,202110,1070,2721,901,2502,76,182,614,1749,690,1931
280390,202110,3880,9136,3282,8225,213,419,2554,6467,2767,6886
280400,202110,4053,9769,3521,9056,531,1174,2225,6015,2756,7189
280410,202110,2569,6699,2112,5991,165,452,1329,3713,1494,4165
280420,202110,4482,11555,4115,11091,68,247,3791,10160,3859,10407
280430,202110,2194,5165,1926,4807,68,185,1579,3839,1647,4024
280440,202110,4497,11428,3965,10634,135,433,3372,8816,3507,9249
280445,202110,2450,6081,2195,5655,48,121,1693,4212,1741,4333
280450,202110,10518,24214,9077,22271,1388,3073,5341,13831,6729,16904
280460,202110,7177,16366,6486,15435,438,908,5399,12810,5837,13718
280470,202110,1763,4815,1491,4312,105,306,1073,3059,1178,3365
280480,202110,46635,109042,40252,100116,3482,8813,28278,68975,31760,77788
280490,202110,3912,10884,3313,9848,106,388,2510,7203,2616,7591
280500,202110,1047,2416,900,2221,26,56,768,1875,794,1931
280510,202110,2793,6621,2414,6102,63,203,1924,4729,1987,4932
280520,202110,1825,4351,1601,4045,94,196,1260,3177,1354,3373
280530,202110,2508,6143,2179,5678,209,448,1615,4285,1824,4733
280540,202110,9026,23706,8187,22503,250,763,7164,19512,7414,20275
280550,202110,6777,15402,5608,13773,155,523,4673,11094,4828,11617
280560,202110,7663,20353,7183,19638,111,383,6402,17267,6513,17650
280570,202110,6726,15872,5434,14272,257,695,3953,10546,4210,11241
280580,202110,5969,15119,5203,14011,536,1217,3771,10330,4307,11547
280590,202110,2984,6678,2561,6173,129,428,2007,4616,2136,5044
280600,202110,3948,9844,3523,9260,295,681,2492,6610,2787,7291
280610,202110,2649,6238,2362,5845,139,325,1939,4749,2078,5074
280620,202110,5801,13582,4987,12524,428,890,3541,9245,3969,10135
280630,202110,4125,10864,3794,10424,203,551,3076,8480,3279,9031
280640,202110,2449,6365,2159,6038,55,137,1935,5453,1990,5590
280650,202110,1254,3247,1026,2906,88,276,734,1993,822,2269
280660,202110,3876,8188,3322,7550,299,462,2685,6317,2984,6779
280670,202110,20621,46039,17760,42346,1515,3480,13337,31802,14852,35282
280680,202110,2881,6706,2476,6130,238,432,1751,4461,1989,4893
280690,202110,1006,2366,854,2174,55,126,680,1705,735,1831
280700,202110,1222,2965,1055,2723,21,52,838,2134,859,2186
280710,202110,15968,34879,13531,32112,694,1116,11301,27669,11995,28785
280720,202110,2792,6232,2309,5655,38,120,1735,4411,1773,4531
280730,202110,1116,2798,983,2589,66,177,726,1843,792,2020
280740,202110,15146,35233,13004,32029,976,2341,9366,22657,10342,24998
280750,202110,3783,10191,3267,9299,191,539,2374,6671,2565,7210
280760,202110,6866,17370,5951,16006,678,1594,3808,10668,4486,12262
290010,202110,3284,6746,2137,4998,5,13,1776,3992,1781,4005
290020,202110,5529,14350,5029,13726,352,627,4223,11965,4575,12592
290030,202110,4839,10686,3902,9667,194,403,3263,8242,3457,8645
290035,202110,5428,11418,4449,10159,338,482,3451,8125,3789,8607
290040,202110,4554,10537,3853,9693,156,329,2922,7922,3078,8251
290050,202110,2139,6681,1797,5958,109,413,1257,4076,1366,4489
290060,202110,1438,3236,1054,2657,147,336,649,1652,796,1988
290070,202110,38889,82749,33427,76010,1898,4389,26059,58551,27957,62940
290080,202110,5529,15716,4791,14630,509,1541,3268,10185,3777,11726
290090,202110,2241,4227,1572,3510,18,47,1427,3176,1445,3223
290100,202110,10102,25716,8151,22878,1421,3666,4204,12486,5625,16152
290110,202110,5525,13994,4866,12977,532,1328,3212,8618,3744,9946
290115,202110,4207,12008,3563,10876,291,820,2688,8277,2979,9097
290120,202110,6797,16303,5684,14749,149,444,4834,12327,4983,12771
290130,202110,4971,11668,3870,10215,178,394,2950,7904,3128,8298
290135,202110,4521,10328,3693,8990,164,391,2924,6886,3088,7277
290140,202110,4631,11822,3589,10458,79,286,3063,8903,3142,9189
290150,202110,2680,6543,2285,6074,142,333,1743,4732,1885,5065
290160,202110,3678,7944,3275,7397,233,424,2677,6067,2910,6491
290170,202110,3473,8631,3065,8188,106,232,2727,7412,2833,7644
290180,202110,3126,8294,2581,7410,73,236,2129,6067,2202,6303
290190,202110,4468,11978,3942,11277,93,337,3314,9332,3407,9669
290195,202110,2454,5902,1965,5263,33,116,1682,4476,1715,4592
290200,202110,4359,11736,3503,10283,151,452,2634,7656,2785,8108
290205,202110,3662,9064,3255,8474,193,527,2537,6490,2730,7017
290210,202110,13532,35981,11952,33571,900,2217,9258,26388,10158,28605
290220,202110,3052,7205,2670,6718,115,275,2197,5524,2312,5799
290225,202110,3347,6943,2543,6099,125,212,2183,5310,2308,5522
290230,202110,2676,6751,2445,6469,43,105,2205,5858,2248,5963
290240,202110,3856,9428,3046,8434,69,221,2570,7104,2639,7325
290250,202110,4047,11548,3357,10526,100,285,2749,8812,2849,9097
290260,202110,5599,13364,4715,12094,200,588,3908,9836,4108,10424
290265,202110,3677,10367,2986,9088,226,628,2061,6301,2287,6929
290270,202110,10860,36801,10117,35550,513,2160,8144,28454,8657,30614
290280,202110,6365,18570,5480,16806,286,999,3955,11954,4241,12953
290290,202110,10385,29342,8472,25897,769,2454,5718,17275,6487,19729
290300,202110,4326,11600,3197,9468,173,511,2264,6725,2437,7236
290310,202110,1759,4024,1414,3615,30,129,1197,2986,1227,3115
290320,202110,26042,65817,20775,57965,4376,11721,10090,29886,14466,41607
290323,202110,3872,10407,3352,9601,117,323,2583,7504,2700,7827
290327,202110,4323,12076,3689,10871,299,810,2617,7707,2916,8517
290330,202110,2457,4861,1935,4305,55,69,1692,3877,1747,3946
290340,202110,6065,14534,4615,12789,450,1163,3323,9424,3773,10587
290350,202110,4959,13483,4127,12062,273,742,2896,8513,3169,9255
290360,202110,5129,13092,4481,12256,133,299,3856,10653,3989,10952
290370,202110,5426,12772,3975,10872,207,467,2788,7749,2995,8216
290380,202110,5903,15142,4877,13755,112,229,4159,11928,4271,12157
290390,202110,15267,42270,12598,38000,1412,4022,8038,24724,9450,28746
290395,202110,3116,8519,2496,7465,63,250,1903,5629,1966,5879
290400,202110,3920,10303,3186,9107,120,390,2450,6882,2570,7272
290405,202110,4846,13617,4114,12371,324,961,2770,8525,3094,9486
290410,202110,5906,15541,4529,13367,103,406,3437,9946,3540,10352
290420,202110,3274,8600,2716,7741,93,270,2164,6104,2257,6374
290430,202110,3467,8937,2849,7981,216,634,2011,5504,2227,6138
290440,202110,3027,7210,2194,5921,104,222,1532,4265,1636,4487
290450,202110,3753,9000,2972,7850,119,253,2278,6023,2397,6276
290460,202110,12818,35085,10722,31217,2337,6856,4245,12476,6582,19332
290470,202110,4888,11314,3599,9554,481,1254,1951,5334,2432,6588
290475,202110,6806,19282,5742,17454,65,344,4781,14266,4846,14610
290480,202110,1876,4586,1527,4089,69,220,1098,2799,1167,3019
290485,202110,4803,13491,4218,12678,101,424,3610,10714,3711,11138
290490,202110,9443,21593,8480,20283,464,951,6751,16360,7215,17311
290500,202110,4329,12418,3385,10455,535,1706,1478,4466,2013,6172
290510,202110,3700,8853,3090,8070,58,181,2736,7101,2794,7282
290515,202110,3764,10305,3264,9603,43,142,2955,8823,2998,8965
290520,202110,12275,33800,9542,28635,672,1967,5714,17074,6386,19041
290530,202110,5163,14454,4342,13125,109,435,3680,11035,3789,11470
290540,202110,3488,8939,3141,8562,38,118,2932,7987,2970,8105
290550,202110,4371,11295,3815,10638,16,71,3513,9913,3529,9984
290560,202110,6466,16382,4900,14111,376,1312,3231,8987,3607,10299
290570,202110,46139,110867,40856,104187,2303,5779,33059,83800,35362,89579
290580,202110,8517,23425,7317,21722,706,1846,5253,16234,5959,18080
290590,202110,7185,21684,6042,19667,151,499,4850,15942,5001,16441
290600,202110,19874,53757,17307,49629,858,2244,13679,39414,14537,41658
290610,202110,2684,8056,2107,6874,82,293,1488,4825,1570,5118
290620,202110,6316,17621,5451,16199,247,666,4541,13526,4788,14192
290630,202110,9878,22808,7870,20254,732,1738,5822,15304,6554,17042
290640,202110,2915,7169,2241,6212,119,301,1573,4548,1692,4849
290650,202110,13351,32085,11790,30332,2292,5618,7720,20684,10012,26302
290660,202110,3811,9604,3132,8558,63,166,2355,6595,2418,6761
290670,202110,7043,18662,5976,16977,378,1000,4589,13267,4967,14267
290680,202110,11369,30573,9521,27864,189,910,7900,22761,8089,23671
290682,202110,4904,12354,4256,11488,143,291,3572,9775,3715,10066
290685,202110,3590,7970,2585,6539,232,521,1523,4169,1755,4690
290687,202110,6988,17986,5698,15874,728,1882,3609,10342,4337,12224
290689,202110,2982,7997,2256,6683,197,609,1500,4477,1697,5086
290690,202110,5413,13874,4348,12399,271,816,3165,8896,3436,9712
290700,202110,2831,7200,2511,6798,44,156,2215,5968,2259,6124
290710,202110,8608,23459,7380,21777,256,691,6163,18319,6419,19010
290720,202110,19194,51338,17390,48576,936,2723,13984,38698,14920,41421
290730,202110,7194,16850,6172,15660,320,606,4795,12406,5115,13012
290740,202110,1098,2831,868,2473,25,75,741,2103,766,2178
290750,202110,12099,28781,10475,26211,716,1753,7825,19087,8541,20840
290755,202110,2117,5820,1695,5071,103,281,1152,3503,1255,3784
290760,202110,3883,11008,3188,9730,156,403,2180,6845,2336,7248
290770,202110,2758,8417,2515,8117,45,190,2121,6975,2166,7165
290780,202110,8365,20421,7202,18899,270,523,5562,15024,5832,15547
290790,202110,5011,13273,4348,12308,196,467,3559,10238,3755,10705
290800,202110,7217,14451,5034,11931,293,574,3760,9055,4053,9629
290810,202110,5377,13833,4357,12364,109,312,3321,9656,3430,9968
290820,202110,5147,13323,4638,12610,223,568,3458,9559,3681,10127
290830,202110,4625,10545,4081,9816,35,115,3516,8224,3551,8339
290840,202110,18217,46601,15543,42479,2073,4647,9902,28847,11975,33494
290850,202110,7554,16874,6672,15924,280,513,5754,13902,6034,14415
290860,202110,6301,17486,5451,16513,213,595,4582,14236,4795,14831
290870,202110,4929,13202,3737,10948,245,652,2502,7378,2747,8030
290880,202110,1472,3521,1184,3153,115,274,738,2111,853,2385
290890,202110,9711,19142,8691,18013,148,308,8113,16726,8261,17034
290900,202110,2562,6488,1988,5505,134,296,1211,3367,1345,3663
290910,202110,5398,12502,4099,10563,38,95,3507,8960,3545,9055
290920,202110,5335,13091,4763,12421,122,168,4417,11781,4539,11949
290930,202110,7786,21208,6304,18652,208,752,4861,14048,5069,14800
290940,202110,3730,10299,3149,9460,171,532,2507,7545,2678,8077
290950,202110,1491,3708,1213,3293,73,174,838,2297,911,2471
290960,202110,5935,14643,5278,13826,233,495,4389,11571,4622,12066
290970,202110,3283,9605,2682,8505,97,359,2077,6596,2174,6955
290980,202110,13204,30504,11106,27381,718,1884,7210,17238,7928,19122
290990,202110,9923,25977,8805,24209,277,1009,7389,19714,7666,20723
291000,202110,3506,8779,2708,7764,121,325,2189,6373,2310,6698
291005,202110,16084,38760,14184,36321,1552,3485,10724,27882,12276,31367
291010,202110,3173,9431,2577,8144,148,498,1652,5092,1800,5590
291020,202110,1323,3154,1069,2724,28,84,780,1866,808,1950
291030,202110,2647,6219,1883,4942,126,284,1161,2999,1287,3283
291040,202110,5690,15054,4676,13613,158,513,3677,10699,3835,11212
291050,202110,8607,20985,7391,19342,823,2140,5271,13681,6094,15821
291060,202110,6763,19054,5754,17712,315,1167,4443,13564,4758,14731
291070,202110,16895,44034,14092,39599,383,1208,11490,32038,11873,33246
291072,202110,26977,65314,19703,53346,3208,8867,9199,24716,12407,33583
291075,202110,5663,13575,5116,12757,107,248,4301,10512,4408,10760
291077,202110,1754,4505,1366,3823,79,148,940,2676,1019,2824
291080,202110,122560,289184,97056,254084,26012,68378,29804,85121,55816,153499
291085,202110,5915,14419,4846,12832,168,469,4046,10672,4214,11141
291090,202110,2163,3942,1606,3325,45,74,1351,2765,1396,2839
291100,202110,3326,7071,2274,5832,89,244,1754,4462,1843,4706
291110,202110,6381,18286,5411,16673,284,973,4216,12611,4500,13584
291120,202110,8110,19077,6851,17491,313,776,5275,13457,5588,14233
291125,202110,2347,4039,1772,3394,89,134,1443,2802,1532,2936
291130,202110,3404,9469,2511,7728,57,274,1898,5619,1955,5893
291140,202110,5061,13160,3645,10616,526,1326,2151,6300,2677,7626
291150,202110,2622,5543,2032,4883,4,16,1941,4670,1945,4686
291160,202110,5241,14067,4349,12798,399,1169,2901,8533,3300,9702
291165,202110,2270,6070,1677,4902,26,106,1205,3389,1231,3495
291170,202110,21864,54073,18173,47950,1014,2830,12040,31042,13054,33872
291180,202110,6714,14876,4938,12553,225,516,3917,9966,4142,10482
291185,202110,3206,8221,2820,7625,131,314,2201,6020,2332,6334
291190,202110,8151,19217,6758,17459,260,667,5478,14194,5738,14861
291200,202110,2926,7808,2153,6343,68,211,1385,3906,1453,4117
291210,202110,7588,15627,5592,13362,146,407,4140,9960,4286,10367
291220,202110,4516,12157,4079,11525,268,762,3148,8884,3416,9646
291230,202110,4738,9775,3595,8531,43,96,3274,7820,3317,7916
291240,202110,4234,10717,3563,9599,59,202,3050,8119,3109,8321
291250,202110,3509,10023,2736,8612,147,425,1748,5555,1895,5980
291260,202110,1506,3458,1239,3113,29,86,1007,2552,1036,2638
291270,202110,5900,14374,4624,12568,297,782,3445,9433,3742,10215
291280,202110,2808,6554,2072,5509,202,494,1307,3460,1509,3954
291290,202110,5901,15156,4505,13014,365,1078,3047,8775,3412,9853
291300,202110,3996,10481,3151,9086,109,336,2399,6806,2508,7142
291310,202110,5230,13754,4487,12432,182,490,3729,10278,3911,10768
291320,202110,6496,17271,5074,14712,1127,3059,2463,7578,3590,10637
291330,202110,1952,4798,1629,4272,68,172,1243,3177,1311,3349
291340,202110,4502,11281,3608,9769,112,287,2691,7229,2803,7516
291345,202110,3042,8752,2744,8304,106,322,2282,6943,2388,7265
291350,202110,7170,17029,5569,15131,59,171,4853,13366,4912,13537
291360,202110,38262,85210,30048,75494,3134,7177,19520,50913,22654,58090
291370,202110,8495,22442,7480,20848,605,1681,5521,15138,6126,16819
291380,202110,3669,9617,3213,9007,99,345,2712,7543,2811,7888
291390,202110,13618,28523,10467,25059,478,1028,8630,20698,9108,21726
291400,202110,15027,36038,12453,32294,1309,3022,7999,21736,9308,24758
291410,202110,3132,8029,2446,6847,33,122,1805,4982,1838,5104
291420,202110,2042,4849,1585,4285,18,70,1414,3805,1432,3875
291430,202110,2819,7687,2425,7037,104,334,1896,5369,2000,5703
291440,202110,6721,18666,5831,17228,320,924,4498,13418,4818,14342
291450,202110,10350,23484,8512,21380,82,138,7572,19473,7654,19611
291460,202110,16551,42367,14494,39355,730,2054,10938,29421,11668,31475
291465,202110,9378,22489,7336,20158,124,526,6354,17317,6478,17843
291470,202110,18521,39744,15428,36196,874,1728,11440,27584,12314,29312
291480,202110,45843,97839,34405,82586,3574,8787,19277,45776,22851,54563
291490,202110,5796,14103,4995,13202,140,418,4511,11877,4651,12295
291500,202110,5305,12473,4451,11355,61,204,4075,10411,4136,10615
291510,202110,4611,10905,3406,9369,46,217,2876,7809,2922,8026
291520,202110,4700,10330,3545,8823,194,502,2739,6763,2933,7265
291530,202110,2437,5338,1738,4452,286,651,1014,2818,1300,3469
291535,202110,3611,10295,3115,9392,173,467,2368,7396,2541,7863
291540,202110,2319,5036,1601,4185,87,224,1297,3400,1384,3624
291550,202110,5912,13130,4567,11454,472,938,3018,7848,3490,8786
291560,202110,19151,44369,13983,37588,1660,4139,7877,22367,9537,26506
291570,202110,2439,5635,1906,4991,65,151,1577,4284,1642,4435
291580,202110,6702,16707,5262,14805,286,730,3778,10664,4064,11394
291590,202110,2345,5438,2062,5117,80,244,1850,4507,1930,4751
291600,202110,5612,12678,4331,10750,388,989,2961,7141,3349,8130
291610,202110,5753,14649,5153,13988,57,204,4740,12843,4797,13047
291620,202110,3243,7109,2432,6223,128,295,1871,4906,1999,5201
291630,202110,3580,7608,2683,6472,231,580,2009,4835,2240,5415
291640,202110,17509,40888,13272,34877,1931,4603,6314,17090,8245,21693
291650,202110,9491,23202,8371,21885,560,961,7002,18888,7562,19849
291660,202110,2129,5089,1560,4234,125,373,1018,2598,1143,2971
291670,202110,2113,5427,1770,4932,117,282,1286,3660,1403,3942
291680,202110,4236,9999,3416,8839,365,928,2276,5985,2641,6913
291685,202110,5074,11915,4063,10555,213,413,3112,8315,3325,8728
291690,202110,4305,9223,3019,7378,390,770,2140,5351,2530,6121
291700,202110,9124,25418,8036,23574,331,1045,6583,18993,6914,20038
291710,202110,5524,12550,4144,10659,380,862,2855,7402,3235,8264
291720,202110,4641,13512,3868,11987,730,2283,2076,6413,2806,8696
291730,202110,6604,16131,5689,14928,254,711,4778,12474,5032,13185
291733,202110,2838,7189,2409,6632,59,148,1758,5124,1817,5272
291735,202110,3062,7950,2440,6870,72,146,1872,5274,1944,5420
291740,202110,4166,10499,3048,8411,97,198,2108,5823,2205,6021
291750,202110,21127,48530,17166,42731,1987,4584,11001,28140,12988,32724
291760,202110,10991,30369,8593,26574,2504,8737,2256,6997,4760,15734
291770,202110,7655,19746,6395,17591,291,885,4888,13030,5179,13915
291780,202110,5337,13771,4799,13030,91,286,4196,11298,4287,11584
291790,202110,2845,7529,2580,7194,239,518,1947,5623,2186,6141
291800,202110,32183,77385,24314,65972,4341,11065,11137,31817,15478,42882
291810,202110,10910,25060,9181,22959,374,827,7618,19377,7992,20204
291820,202110,4062,10242,3532,9556,94,258,2848,7733,2942,7991
291830,202110,4766,10740,3886,9558,233,409,3037,7576,3270,7985
291835,202110,6868,19930,5458,17287,461,1472,3627,11650,4088,13122
291840,202110,49330,132028,42925,122152,4000,12045,30697,86731,34697,98776
291845,202110,2784,6835,2218,6152,99,266,1875,5263,1974,5529
291850,202110,4332,11637,3619,10490,140,384,2891,8460,3031,8844
291855,202110,2323,4397,1812,3833,28,66,1658,3500,1686,3566
291860,202110,2358,6023,1643,4670,35,74,1101,3036,1136,3110
291870,202110,1351,3308,913,2550,36,91,630,1736,666,1827
291875,202110,3075,9036,2644,8154,45,170,1962,5860,2007,6030
291880,202110,5869,16092,5003,14669,272,689,3662,10938,3934,11627
291890,202110,1684,3393,1097,2717,164,345,683,1743,847,2088
291900,202110,1416,3191,1077,2693,21,66,862,2097,883,2163
291905,202110,2498,6255,2048,5562,77,254,1597,4173,1674,4427
291910,202110,3164,7627,2659,7017,53,172,2276,6196,2329,6368
291915,202110,7619,20999,6182,18577,184,570,4651,14186,4835,14756
291920,202110,29239,72450,24983,66692,1947,5717,18319,47694,20266,53411
291930,202110,2644,6709,2269,6206,221,590,1577,4377,1798,4967
291940,202110,4131,10137,2778,7900,220,586,1622,4631,1842,5217
291950,202110,9397,27917,7913,25131,289,994,5464,17260,5753,18254
291955,202110,16269,39750,14429,37397,1205,3154,11375,29507,12580,32661
291960,202110,3462,8336,2919,7623,162,314,2300,6213,2462,6527
291970,202110,4820,11674,4024,10696,152,443,3047,8151,3199,8594
291980,202110,10344,28246,8339,24862,1028,2623,5280,16283,6308,18906
291990,202110,2411,6085,1970,5543,19,65,1818,5122,1837,5187
291992,202110,4125,9638,3370,8675,307,642,2641,6997,2948,7639
291995,202110,2280,5923,1861,5251,51,191,1456,4012,1507,4203
292000,202110,2754,6230,2241,5622,83,251,1800,4499,1883,4750
292010,202110,5948,13487,4843,11921,147,366,4076,9861,4223,10227
292020,202110,4915,13444,4119,12072,164,537,3192,9082,3356,9619
292030,202110,2064,5896,1845,5510,107,331,1208,3529,1315,3860
292040,202110,4704,11471,3670,9961,224,500,2785,7751,3009,8251
292045,202110,4281,10664,3200,9093,33,91,2867,8275,2900,8366
292050,202110,6849,18398,5546,16188,253,793,3616,10432,3869,11225
292060,202110,11819,26376,10925,25265,430,888,9635,22028,10065,22916
292070,202110,5910,14872,5147,13978,320,795,4358,11833,4678,12628
292080,202110,3395,8033,2777,7247,57,182,2516,6521,2573,6703
292090,202110,4680,9909,3274,8206,193,439,2496,6304,2689,6743
292100,202110,13226,30222,11300,27844,1793,4103,6550,16982,8343,21085
292105,202110,3794,9021,3303,8366,75,168,2795,7083,2870,7251
292110,202110,6379,14720,4519,11910,886,2423,2275,5967,3161,8390
292120,202110,7364,18235,6075,16077,371,975,4505,11743,4876,12718
292130,202110,3593,8364,2982,7615,146,396,2276,5765,2422,6161
292140,202110,5628,12378,4765,11165,180,392,4106,9574,4286,9966
292145,202110,2679,7076,2241,6344,95,222,1787,5073,1882,5295
292150,202110,15572,40008,13477,36688,256,926,11184,29830,11440,30756
292160,202110,3093,7247,2328,6272,33,80,1902,5396,1935,5476
292170,202110,9170,23090,7700,20772,387,1085,5908,15604,6295,16689
292180,202110,3028,7988,2240,6549,144,422,1418,4066,1562,4488
292190,202110,3075,7847,2621,7192,150,427,1956,5396,2106,5823
292200,202110,9304,22057,6920,18730,1247,3430,3239,9224,4486,12654
292205,202110,3849,10507,3333,9746,59,258,2900,8436,2959,8694
292210,202110,6812,15234,5519,13622,86,298,4993,12230,5079,12528
292220,202110,2312,5199,1998,4736,78,167,1551,3566,1629,3733
292225,202110,3386,9529,2990,8940,55,236,2625,7717,2680,7953
292230,202110,9090,21024,8130,19823,177,537,7045,16901,7222,17438
292240,202110,5006,13995,4381,12889,297,851,3102,9098,3399,9949
292250,202110,6171,15266,5547,14376,348,871,4274,10994,4622,11865
292260,202110,3464,8844,3082,8352,82,208,2693,7309,2775,7517
292265,202110,3610,9404,3028,8535,55,231,2468,6813,2523,7044
292270,202110,4431,9930,3521,8849,130,291,2865,7232,2995,7523
292273,202110,2891,6055,2312,5354,61,102,1669,4154,1730,4256
292275,202110,1678,4297,1319,3820,53,151,999,2934,1052,3085
292280,202110,2732,6272,2199,5663,101,178,1824,4865,1925,5043
292285,202110,2727,6293,2166,5542,82,164,1763,4571,1845,4735
292290,202110,7785,19797,6117,17501,165,518,5034,14408,5199,14926
292300,202110,10493,25543,8246,22585,821,2330,5645,15522,6466,17852
292303,202110,3041,8435,2638,7803,91,188,2186,6561,2277,6749
292305,202110,2325,6167,2145,5925,42,163,1932,5267,1974,5430
292310,202110,7238,17234,6280,16082,107,318,5588,14135,5695,14453
292320,202110,6401,16804,5109,14492,220,689,3819,10559,4039,11248
292330,202110,2804,6003,2281,5419,108,173,1756,4404,1864,4577
292335,202110,5068,12757,4467,11878,243,545,3738,10108,3981,10653
292340,202110,5581,15481,4608,13638,230,644,3364,9924,3594,10568
292350,202110,2609,6922,2175,6331,77,252,1764,5176,1841,5428
292360,202110,5200,13415,4331,11962,228,667,3080,8434,3308,9101
292370,202110,10455,24311,8983,22410,116,362,8344,20607,8460,20969
292380,202110,7077,19299,6311,17940,454,1248,4761,13428,5215,14676
292390,202110,4819,8912,3541,7459,102,174,3131,6591,3233,6765
292400,202110,23250,63926,20002,58862,1935,5513,13716,40791,15651,46304
292405,202110,4699,11094,3958,9944,93,228,3304,8164,3397,8392
292410,202110,2276,5348,1894,4864,66,133,1670,4329,1736,4462
292420,202110,3768,10527,3424,10016,95,374,2996,8575,3091,8949
292430,202110,5118,14823,3878,12558,285,906,2532,8275,2817,9181
292440,202110,8931,27664,8232,26621,106,484,7381,23767,7487,24251
292450,202110,4231,11679,3289,9894,95,334,2578,7709,2673,8043
292460,202110,5519,13998,4561,12466,239,606,3574,9694,3813,10300
292465,202110,2830,6926,2414,6402,92,186,1606,4702,1698,4888
292467,202110,2017,5407,1770,5077,291,697,1175,3558,1466,4255
292470,202110,3119,7674,2407,6578,81,137,1814,5010,1895,5147
292480,202110,6440,14840,5217,13363,69,238,4731,12030,4800,12268
292490,202110,2471,5793,2083,5239,105,185,1661,4228,1766,4413
292500,202110,7272,18434,5801,16011,402,1103,3953,10844,4355,11947
292510,202110,14313,36454,11164,31569,550,1564,7854,22224,8404,23788
292520,202110,7494,18199,6576,16840,434,1157,5176,13066,5610,14223
292525,202110,6324,14542,5197,13288,125,252,4574,11882,4699,12134
292530,202110,31887,80702,24885,69224,5235,14868,11278,31571,16513,46439
292540,202110,4631,8275,3662,7249,130,199,3309,6590,3439,6789
292550,202110,8554,21485,6537,19092,483,1260,4557,14288,5040,15548
292560,202110,4604,11300,3886,10299,130,325,2924,7698,3054,8023
292570,202110,3846,9768,3210,8640,50,169,2725,7157,2775,7326
292575,202110,7005,19617,6417,18846,538,1480,4966,14860,5504,16340
292580,202110,7876,19242,6481,17206,117,320,5518,14486,5635,14806
292590,202110,7658,19911,6417,17718,330,922,5087,13832,5417,14754
292593,202110,2968,7243,2458,6400,80,192,2058,5320,2138,5512
292595,202110,5724,14616,4902,13608,136,422,4182,11546,4318,11968
292600,202110,11159,29556,9637,27288,455,1169,7623,21741,8078,22910
292610,202110,4489,11171,3840,10075,160,365,2985,7888,3145,8253
292620,202110,6686,17708,5494,16263,139,279,4944,14964,5083,15243
292630,202110,9267,21748,7422,18833,823,2002,4585,11826,5408,13828
292640,202110,8621,24264,7459,22368,220,715,5391,16350,5611,17065
292650,202110,4547,11092,4055,10450,105,250,3694,9444,3799,9694
292660,202110,11803,31116,9959,28388,483,1399,7410,21344,7893,22743
292665,202110,2245,6439,1923,6012,72,192,1585,5070,1657,5262
292670,202110,3670,9764,2849,8248,129,369,1916,5447,2045,5816
292680,202110,4209,10632,3325,9112,163,383,2483,6669,2646,7052
292690,202110,2758,6900,1910,5525,196,502,1135,3452,1331,3954
292700,202110,10412,27483,9077,25431,725,1660,6291,18307,7016,19967
292710,202110,2780,7991,2586,7739,51,126,2365,7133,2416,7259
292720,202110,9380,21607,7913,19921,213,525,6325,16265,6538,16790
292730,202110,5148,11425,4693,10730,356,579,3862,9085,4218,9664
292740,202110,335440,785092,289695,721184,38794,95564,184957,457940,223751,553504
292750,202110,6608,16585,5831,15500,224,525,4670,12621,4894,13146
292760,202110,4140,11369,3617,10471,172,487,2730,7824,2902,8311
292770,202110,6834,16937,5515,15127,742,2053,3647,10272,4389,12325
292780,202110,2215,4203,1651,3535,76,162,1327,2735,1403,2897
292790,202110,4125,8540,3115,7445,170,359,2558,6184,2728,6543
292800,202110,11775,28792,10051,26189,364,894,8315,21519,8679,22413
292805,202110,3848,8882,3029,7842,115,301,2402,6195,2517,6496
292810,202110,11629,28504,9288,24913,631,1421,6832,18137,7463,19558
292820,202110,7494,20418,5484,17038,350,1172,3877,11827,4227,12999
292830,202110,3029,6956,2577,6412,88,192,2194,5519,2282,5711
292840,202110,9200,23388,7749,21447,136,446,6822,18658,6958,19104
292850,202110,2592,6552,2170,5948,154,395,1501,4110,1655,4505
292860,202110,17099,36986,15367,34964,425,1017,13355,30062,13780,31079
292870,202110,19946,47304,17239,43579,977,2329,12153,30284,13130,32613
292880,202110,11700,31040,9956,28415,278,978,7862,21736,8140,22714
292890,202110,7555,20019,6663,18758,164,622,5862,16405,6026,17027
292895,202110,3258,6671,2450,5500,105,222,1995,4429,2100,4651
292900,202110,2750,7164,2494,6778,46,164,2076,5495,2122,5659
292905,202110,4499,11220,3574,9847,93,279,2742,7466,2835,7745
292910,202110,4838,12932,4420,12350,183,475,3457,9601,3640,10076
292920,202110,10017,27017,9292,26033,281,962,8012,22175,8293,23137
292925,202110,5496,15261,4579,13603,240,650,3255,9677,3495,10327
292930,202110,6757,19073,5852,17464,525,1648,3749,10983,4274,12631
292935,202110,2563,6155,2007,5538,14,64,1800,5000,1814,5064
292937,202110,2935,7257,2537,6749,75,191,2086,5554,2161,5745
292940,202110,3070,7462,2442,6519,259,571,1649,4612,1908,5183
292950,202110,9973,24634,8698,22791,534,1144,6561,17196,7095,18340
292960,202110,5374,12752,4481,11486,136,320,3579,9120,3715,9440
292970,202110,4020,11010,3569,10351,73,281,2982,8716,3055,8997
292975,202110,4468,9494,3961,8925,119,205,3597,8177,3716,8382
292980,202110,3644,8247,2988,7307,70,191,2527,6085,2597,6276
292990,202110,11795,31760,9824,28345,549,1653,7324,20750,7873,22403
293000,202110,2831,6545,2426,5936,48,158,1963,4783,2011,4941
293010,202110,19268,47472,15562,41824,1905,5202,9630,25919,11535,31121
293015,202110,9128,26636,7232,23041,485,1501,4913,15997,5398,17498
293020,202110,10167,28815,9146,27371,127,431,8238,24732,8365,25163
293030,202110,5371,13790,4102,11844,116,319,2818,8408,2934,8727
293040,202110,4703,11652,3926,10562,81,212,3429,9216,3510,9428
293050,202110,24148,56309,21265,52069,1363,3153,15868,38542,17231,41695
293060,202110,3763,9695,3028,8324,213,607,2101,5643,2314,6250
293070,202110,26436,61851,23254,57856,1961,4990,17434,43166,19395,48156
293075,202110,3793,11335,3304,10525,99,445,2747,8706,2846,9151
293076,202110,3692,8732,3354,8339,66,132,2990,7532,3056,7664
293077,202110,6748,17934,5389,15814,481,1472,3286,10223,3767,11695
293080,202110,4943,14173,4224,12928,79,360,3449,10364,3528,10724
293090,202110,3338,9503,2575,8214,212,624,1696,5493,1908,6117
293100,202110,6093,15580,5055,13750,255,625,3958,10783,4213,11408
293105,202110,3997,12246,3481,11194,248,791,2432,7788,2680,8579
293110,202110,2513,6037,2099,5447,71,200,1703,4357,1774,4557
293120,202110,4817,12333,4332,11603,263,495,3539,9692,3802,10187
293130,202110,3908,10399,3399,9753,59,222,3005,8543,3064,8765
293135,202110,32408,73576,23937,62419,3581,10053,11037,29100,14618,39153
293140,202110,2575,5379,2240,4981,58,101,1923,4278,1981,4379
293150,202110,5567,16233,4577,14388,306,960,3165,9971,3471,10931
293160,202110,3790,9244,3230,8635,244,393,2713,7623,2957,8016
293170,202110,5138,10359,4488,9569,103,204,3964,8420,4067,8624
293180,202110,4622,12540,3845,11146,70,256,3088,8742,3158,8998
293190,202110,14874,38934,13039,36334,115,480,11638,32176,11753,32656
293200,202110,9116,21537,7391,18836,219,566,6036,15238,6255,15804
293210,202110,5432,13790,4651,12592,336,843,3541,9634,3877,10477
293220,202110,5418,13252,3991,10919,745,2032,1959,5463,2704,7495
293230,202110,4214,10194,3150,8748,235,640,2211,6268,2446,6908
293240,202110,4706,11966,3798,10513,76,146,2828,8251,2904,8397
293245,202110,4017,10525,3641,9980,156,420,3087,8399,3243,8819
293250,202110,6190,14068,5004,12517,222,557,4064,10136,4286,10693
293260,202110,4960,12604,4091,11247,146,329,2869,8006,3015,8335
293270,202110,7506,16028,5917,14331,458,611,4593,12108,5051,12719
293280,202110,4630,11846,4032,10988,245,567,3113,8643,3358,9210
293290,202110,16465,44517,14591,41600,1686,4813,9937,28462,11623,33275
293300,202110,6073,14291,5231,13070,315,731,3843,9642,4158,10373
293305,202110,4364,10146,3791,9432,72,157,3416,8524,3488,8681
293310,202110,2199,5456,1847,4921,41,121,1478,3877,1519,3998
293315,202110,4347,9861,3574,8732,197,411,2933,7162,3130,7573
293317,202110,2806,6330,2488,5885,169,281,1937,4626,2106,4907
293320,202110,12530,29259,11100,27681,201,529,10071,24989,10272,25518
293325,202110,1870,4466,1446,3906,211,539,904,2493,1115,3032
293330,202110,66538,177733,54243,156617,8760,26149,26784,76116,35544,102265
293340,202110,2278,6251,1872,5542,114,317,1271,3753,1385,4070
293345,202110,3845,9941,3084,8782,430,956,1904,6045,2334,7001
293350,202110,6608,18398,5660,17251,53,257,5139,15830,5192,16087
293360,202110,15496,38338,13225,35322,254,999,11723,30783,11977,31782
310010,202110,1021,2222,661,1732,40,132,246,608,286,740
310020,202110,3027,7790,2293,6506,438,1320,660,1804,1098,3124
310030,202110,1946,5347,1502,4573,217,731,972,2858,1189,3589
310040,202110,898,2263,706,1935,64,212,381,922,445,1134
310050,202110,1530,4440,1280,4049,111,443,860,2623,971,3066
310060,202110,3282,8994,2829,8396,86,306,2344,6886,2430,7192
310070,202110,344,774,246,634,12,25,179,459,191,484
310080,202110,735,1932,532,1567,73,231,260,730,333,961
310090,202110,4998,12587,4105,11150,251,727,3099,8284,3350,9011
310100,202110,3722,9796,3146,8875,72,298,2635,7240,2707,7538
310110,202110,4953,12509,3817,10613,671,2034,1866,4957,2537,6991
310120,202110,658,1541,417,1162,49,163,237,598,286,761
310130,202110,375,952,318,867,26,100,243,635,269,735
310140,202110,299,801,209,656,36,132,87,246,123,378
310150,202110,6125,15241,4563,12451,512,1600,2303,5871,2815,7471
310160,202110,9394,22459,6907,18467,1123,3243,2779,7321,3902,10564
310163,202110,1154,3318,920,2859,185,620,288,825,473,1445
310170,202110,9923,24199,7932,21173,700,1824,5534,14842,6234,16666
310180,202110,2009,4722,1456,3859,161,470,877,2246,1038,2716
310190,202110,2886,8043,2359,7110,534,1772,415,1175,949,2947
310200,202110,2110,5917,1561,4891,185,648,766,2338,951,2986
310205,202110,1177,3113,934,2725,123,397,544,1599,667,1996
310210,202110,2626,6939,2149,6090,131,357,1503,4154,1634,4511
310220,202110,1306,3458,1006,2860,90,262,644,1762,734,2024
310230,202110,2333,6223,1876,5395,230,709,1168,3150,1398,3859
310240,202110,1061,3041,900,2764,51,183,623,1840,674,2023
310250,202110,1102,2821,900,2499,17,61,662,1805,679,1866
310260,202110,3396,8519,2262,6508,612,2061,715,1664,1327,3725
310270,202110,2856,6717,2276,5942,86,249,1890,4935,1976,5184
310280,202110,2602,5875,2061,5113,234,607,1293,3090,1527,3697
310285,202110,1934,5954,1611,5376,152,535,991,3299,1143,3834
310290,202110,1288,3291,1074,2928,182,577,600,1474,782,2051
310300,202110,1673,4601,1422,4180,135,473,831,2272,966,2745
310310,202110,325,775,212,582,39,102,100,265,139,367
310320,202110,550,1340,390,1092,17,63,236,628,253,691
310330,202110,514,1193,311,831,44,132,118,273,162,405
310340,202110,8595,21736,6871,18831,940,2527,3419,9537,4359,12064
310350,202110,13618,32081,9470,25486,1502,4299,4560,11755,6062,16054
310360,202110,577,1271,457,1119,18,47,304,727,322,774
310370,202110,1329,3973,1137,3623,208,733,343,1179,551,1912
310375,202110,895,2169,637,1791,93,272,357,1004,450,1276
310380,202110,408,917,229,637,33,97,109,287,142,384
310390,202110,525,1495,422,1299,79,264,147,398,226,662
310400,202110,11913,28349,8770,23579,740,2301,5601,14482,6341,16783
310410,202110,922,2606,581,1933,71,258,234,711,305,969
310420,202110,4972,12502,3548,9941,481,1463,1550,4011,2031,5474
310430,202110,1715,4497,1157,3473,215,703,438,1131,653,1834
310440,202110,695,1785,483,1400,41,150,263,703,304,853
310445,202110,1456,3993,1066,3232,73,214,747,2223,820,2437
310450,202110,4696,11540,3576,9788,138,473,2750,7324,2888,7797
310460,202110,1851,4805,1427,4041,219,673,532,1366,751,2039
310470,202110,3805,8292,2963,7183,287,646,2095,5210,2382,5856
310480,202110,1038,2607,811,2238,92,258,493,1316,585,1574
310490,202110,2935,7778,2306,6760,250,868,1304,3545,1554,4413
310500,202110,1452,3879,1098,3302,182,606,581,1672,763,2278
310510,202110,2247,5716,1540,4428,261,822,628,1794,889,2616
310520,202110,1212,3085,893,2514,138,361,463,1329,601,1690
310530,202110,796,1972,538,1526,71,231,191,440,262,671
310540,202110,3138,8633,2588,7649,499,1610,1200,3295,1699,4905
310550,202110,1319,3216,943,2596,72,246,556,1411,628,1657
310560,202110,16292,41406,11608,33090,1486,4678,5149,13208,6635,17886
310570,202110,1086,2784,859,2467,49,169,655,1849,704,2018
310590,202110,4403,11225,3526,9612,227,680,2085,5344,2312,6024
310600,202110,1436,4058,1170,3511,142,485,626,1759,768,2244
310610,202110,497,1327,327,1051,118,394,49,147,167,541
310620,202110,199970,492126,148221,399374,17568,54695,78484,191401,96052,246096
310630,202110,4894,12918,3793,10761,445,1284,2238,6208,2683,7492
310640,202110,1281,3561,1049,3129,162,543,511,1421,673,1964
310650,202110,2576,6923,1898,5636,152,480,1170,3323,1322,3803
310660,202110,1387,3653,1132,3296,27,79,966,2812,993,2891
310665,202110,1459,3608,1186,3237,18,66,971,2693,989,2759
310670,202110,62883,156497,53114,140083,4714,13931,36745,92161,41459,106092
310680,202110,814,1863,673,1664,20,71,573,1366,593,1437
310690,202110,2227,5439,1624,4476,114,352,992,2589,1106,2941
310700,202110,505,1081,395,944,20,60,315,739,335,799
310710,202110,6200,16938,4505,14366,833,3113,779,2225,1612,5338
310720,202110,1120,2507,876,2202,29,95,670,1618,699,1713
310730,202110,10739,27344,9149,24869,359,1173,6877,18203,7236,19376
310740,202110,6868,18217,5002,14488,671,2151,2025,5282,2696,7433
310750,202110,1348,3129,1028,2668,108,336,575,1352,683,1688
310760,202110,705,1728,485,1392,36,106,270,785,306,891
310770,202110,1143,3016,802,2492,80,299,414,1177,494,1476
310780,202110,4395,10182,3643,9215,97,264,2918,7358,3015,7622
310790,202110,1898,5853,1630,5278,317,1085,277,769,594,1854
310800,202110,2487,7144,1811,5775,335,1303,107,270,442,1573
310810,202110,1382,3311,1145,2931,55,143,818,2027,873,2170
310820,202110,1266,3148,771,2328,162,499,172,552,334,1051
310825,202110,2734,7839,2202,6975,49,270,1808,5555,1857,5825
310830,202110,2030,5479,1496,4476,258,914,622,1718,880,2632
310840,202110,2271,5985,1725,5082,355,1195,467,1181,822,2376
310850,202110,1467,3989,1216,3624,34,156,938,2695,972,2851
310855,202110,3222,8292,2498,7131,166,529,1791,5012,1957,5541
310860,202110,7121,20016,5768,17489,588,1732,3507,10824,4095,12556
310870,202110,1002,2337,791,2036,53,129,590,1508,643,1637
310880,202110,1019,2974,814,2563,109,331,457,1427,566,1758
310890,202110,2314,6470,1501,4852,258,908,226,625,484,1533
310900,202110,4073,11046,2830,8373,431,1358,1226,3341,1657,4699
310910,202110,2300,5440,1618,4371,138,445,368,911,506,1356
310920,202110,1978,4987,1507,4297,174,517,910,2553,1084,3070
310925,202110,1029,2661,841,2361,43,147,618,1652,661,1799
310930,202110,5979,14982,4212,12172,816,2339,1870,5704,2686,8043
310940,202110,7043,15947,5699,14028,190,520,4460,10740,4650,11260
310945,202110,1366,3428,1073,2955,184,530,541,1438,725,1968
310950,202110,1982,5748,1328,4294,220,776,368,1006,588,1782
310960,202110,757,1969,424,1270,75,255,89,237,164,492
310970,202110,1197,3480,843,2738,212,743,134,389,346,1132
310980,202110,353,798,199,537,23,67,112,297,135,364
310990,202110,1384,3658,1092,3170,146,435,593,1677,739,2112
311000,202110,4033,10926,2971,9202,715,2291,1202,3676,1917,5967
311010,202110,986,2637,792,2295,193,622,380,1078,573,1700
311020,202110,1215,3012,784,2236,45,138,420,1155,465,1293
311030,202110,1851,4465,1318,3591,276,850,564,1440,840,2290
311040,202110,284,873,231,756,72,244,72,217,144,461
311050,202110,3187,7647,2397,6497,365,1123,1223,3135,1588,4258
311060,202110,3485,8677,2612,7106,342,1051,1061,2654,1403,3705
311070,202110,2488,5961,1819,4946,152,537,1064,2695,1216,3232
311080,202110,1217,2676,977,2311,58,162,766,1718,824,1880
311090,202110,2398,7213,1941,6354,419,1484,605,1939,1024,3423
311100,202110,2558,7022,1523,4938,273,979,300,833,573,1812
311110,202110,3814,7655,2144,5324,438,1093,670,1720,1108,2813
311115,202110,1450,3123,1226,2833,73,154,988,2272,1061,2426
311120,202110,7363,18755,5670,15773,833,2570,2138,5229,2971,7799
311130,202110,1963,5041,1495,4390,105,378,888,2533,993,2911
311140,202110,1562,3760,1241,3316,78,236,888,2338,966,2574
311150,202110,1480,4630,1152,3984,169,661,623,2100,792,2761
311160,202110,4093,11379,2928,9258,699,2387,905,2719,1604,5106
311170,202110,948,2347,759,2092,49,134,470,1377,519,1511
311180,202110,1440,3163,928,2423,189,505,387,1023,576,1528
311190,202110,910,2479,677,2015,113,394,264,662,377,1056
311200,202110,2222,5837,1602,4635,291,929,574,1485,865,2414
311205,202110,921,2593,760,2298,40,150,483,1370,523,1520
311210,202110,1072,3038,929,2835,125,336,644,2042,769,2378
311220,202110,791,2090,665,1862,38,126,456,1193,494,1319
311230,202110,8447,24278,6397,20198,1139,3742,2318,7412,3457,11154
311240,202110,1135,2832,881,2474,185,510,392,1115,577,1625
311250,202110,1253,3444,974,2921,179,536,397,1104,576,1640
311260,202110,2894,6871,1858,5089,254,775,835,2005,1089,2780
311265,202110,1353,3416,993,2825,41,150,693,1928,734,2078
311270,202110,3076,8958,2678,8320,141,578,1960,5869,2101,6447
311280,202110,1161,2970,599,1831,92,314,100,259,192,573
311290,202110,1949,5708,1777,5363,122,360,1226,3707,1348,4067
311300,202110,4930,13158,4056,11716,157,544,3260,9236,3417,9780
311310,202110,590,1602,498,1438,32,96,329,915,361,1011
311320,202110,3415,10092,2943,9089,301,1093,1528,4293,1829,5386
311330,202110,5937,14627,4693,12660,496,1343,2584,7115,3080,8458
311340,202110,11193,30100,8832,25984,2065,6546,2647,7307,4712,13853
311350,202110,2548,6050,1832,4790,178,487,993,2358,1171,2845
311360,202110,1162,2777,774,2216,196,638,266,761,462,1399
311370,202110,4958,11644,3673,9650,243,785,2362,5786,2605,6571
311380,202110,381,1126,277,912,62,203,129,437,191,640
311390,202110,1834,5414,1468,4918,635,2366,359,1098,994,3464
311400,202110,1653,4405,1213,3566,225,673,343,878,568,1551
311410,202110,1902,5378,1512,4762,213,749,865,2632,1078,3381
311420,202110,1627,4667,1166,3722,207,743,324,872,531,1615
311430,202110,4537,11577,3035,8688,455,1342,1117,3074,1572,4416
311440,202110,3182,8540,2421,7272,649,2256,483,1336,1132,3592
311450,202110,1887,5500,1370,4526,349,1296,331,922,680,2218
311455,202110,1069,2318,729,1823,144,381,325,816,469,1197
311460,202110,549,1627,364,1227,68,272,82,225,150,497
311470,202110,549,1622,364,1202,86,323,51,156,137,479
311480,202110,1145,2763,936,2442,78,186,698,1816,776,2002
311490,202110,258,743,194,628,29,117,91,259,120,376
311500,202110,491,1167,381,1002,23,74,250,633,273,707
311510,202110,3465,8686,2437,6960,296,934,1065,2837,1361,3771
311520,202110,666,1793,585,1645,76,257,333,922,409,1179
311530,202110,8976,20425,5823,15464,1309,3882,1615,4046,2924,7928
311535,202110,874,2322,603,1767,91,279,228,613,319,892
311540,202110,518,1576,462,1472,60,212,333,1030,393,1242
311545,202110,2051,5726,1759,5276,96,306,1353,4032,1449,4338
311547,202110,1580,3818,1371,3503,52,118,1029,2627,1081,2745
311550,202110,3022,8035,2428,6994,339,1093,1059,2869,1398,3962
311560,202110,329,689,212,513,80,184,52,117,132,301
311570,202110,1624,3666,1138,2996,37,105,882,2351,919,2456
311580,202110,2257,4207,1527,3334,186,321,984,2188,1170,2509
311590,202110,553,1417,446,1257,83,259,244,676,327,935
311600,202110,1753,3980,1458,3587,127,338,1121,2696,1248,3034
311610,202110,2373,7168,1967,6386,150,561,1217,3853,1367,4414
311615,202110,3447,9303,2776,8211,100,346,2233,6487,2333,6833
311620,202110,452,1134,383,1052,118,369,203,511,321,880
311630,202110,1376,3710,1138,3239,126,370,693,1932,819,2302
311640,202110,750,1967,605,1741,59,207,309,807,368,1014
311650,202110,2030,4937,1635,4329,196,550,992,2538,1188,3088
311660,202110,3046,8543,2251,6957,317,1090,598,1504,915,2594
311670,202110,1661,4152,1233,3389,150,452,537,1453,687,1905
311680,202110,2310,6252,1755,5264,116,329,1266,3778,1382,4107
311690,202110,641,1344,502,1172,37,71,373,908,410,979
311700,202110,2265,5266,1781,4582,16,80,1511,3794,1527,3874
311710,202110,1591,4487,1172,3745,276,971,398,1266,674,2237
311720,202110,447,1268,358,1112,37,131,187,589,224,720
311730,202110,3752,9448,2498,7021,689,2079,578,1590,1267,3669
311740,202110,984,2485,815,2255,73,183,660,1889,733,2072
311750,202110,4104,11765,3298,10340,346,1175,2070,6236,2416,7411
311760,202110,677,1860,553,1647,70,253,288,740,358,993
311770,202110,2255,6214,1774,5374,301,932,804,2335,1105,3267
311780,202110,1453,4033,1069,3299,157,562,384,1027,541,1589
311783,202110,2368,6167,1922,5435,35,157,1569,4271,1604,4428
311787,202110,879,2464,688,2032,100,328,303,774,403,1102
311790,202110,1569,4187,1031,3182,221,738,301,868,522,1606
311800,202110,5304,15429,4226,13137,834,2711,609,1522,1443,4233
311810,202110,969,2823,762,2464,47,155,514,1642,561,1797
311820,202110,840,1976,629,1661,60,190,400,992,460,1182
311830,202110,8887,24518,6198,18779,1670,5381,799,2346,2469,7727
311840,202110,3902,9443,3157,8386,227,629,2356,6228,2583,6857
311850,202110,382,986,310,858,13,36,207,539,220,575
311860,202110,67093,163654,51868,137865,6471,18671,30462,76503,36933,95174
311870,202110,1989,5135,1400,4115,257,864,580,1547,837,2411
311880,202110,6747,16800,5642,15280,319,711,4198,11676,4517,12387
311890,202110,1779,4142,1375,3588,82,236,979,2415,1061,2651
311900,202110,780,1945,587,1684,56,169,371,1057,427,1226
311910,202110,4261,10609,3227,9248,558,1562,1629,4836,2187,6398
311920,202110,2225,5652,1790,5027,126,294,1134,3308,1260,3602
311930,202110,4217,9539,3054,7933,828,2311,1029,2533,1857,4844
311940,202110,16696,42200,12193,33817,1665,5031,5513,14171,7178,19202
311950,202110,2461,6325,1869,5326,137,405,1150,3304,1287,3709
311960,202110,508,1224,400,1062,31,105,239,572,270,677
311970,202110,441,1379,324,1088,52,217,76,215,128,432
311980,202110,483,1263,259,833,22,75,101,310,123,385
311990,202110,544,1249,340,939,61,206,139,341,200,547
311995,202110,994,2716,529,1643,18,61,76,150,94,211
312000,202110,811,1938,607,1639,54,132,390,1070,444,1202
312010,202110,1035,2729,816,2382,39,133,566,1579,605,1712
312015,202110,1435,3995,1274,3743,42,158,1037,2974,1079,3132
312020,202110,1783,5311,1284,4209,201,683,274,792,475,1475
312030,202110,2125,5060,1840,4747,14,55,1733,4463,1747,4518
312040,202110,870,2507,625,2030,83,271,270,853,353,1124
312050,202110,1242,3712,1004,3258,212,836,353,1019,565,1855
312060,202110,964,2278,614,1800,154,455,254,745,408,1200
312070,202110,960,2646,686,2104,30,106,408,1172,438,1278
312080,202110,2838,6830,2164,5843,120,330,1456,3769,1576,4099
312083,202110,970,2418,747,2077,53,182,548,1470,601,1652
312087,202110,2627,6645,2131,5882,58,167,1702,4734,1760,4901
312090,202110,11143,28299,8791,24617,1142,3519,4661,12444,5803,15963
312100,202110,1626,4573,1297,3966,92,346,801,2335,893,2681
312110,202110,1072,3218,886,2848,174,647,335,970,509,1617
312120,202110,1066,2823,735,2247,180,633,218,543,398,1176
312125,202110,1858,4595,1571,4203,101,292,1218,3163,1319,3455
312130,202110,1128,2677,844,2211,71,208,375,893,446,1101
312140,202110,731,2072,606,1824,111,369,273,765,384,1134
312150,202110,486,1309,414,1173,21,67,280,737,301,804
312160,202110,9669,25279,7452,21426,837,2602,3676,10102,4513,12704
312170,202110,941,2413,719,2007,37,132,466,1249,503,1381
312180,202110,1439,3739,1159,3232,148,421,615,1674,763,2095
312190,202110,732,1953,547,1621,70,237,238,663,308,900
312200,202110,4698,12385,3682,10744,726,2006,1716,5126,2442,7132
312210,202110,1424,3092,1045,2562,47,129,793,1895,840,2024
312220,202110,1643,4940,1420,4530,94,319,931,2973,1025,3292
312230,202110,16464,40982,11461,32099,2386,7599,3037,7102,5423,14701
312235,202110,2054,4994,1614,4381,104,317,1154,3026,1258,3343
312240,202110,763,2361,587,2002,109,410,171,560,280,970
312245,202110,2806,6893,2321,6169,52,118,1964,5197,2016,5315
312247,202110,1076,2440,789,2037,111,311,465,1170,576,1481
312250,202110,979,2568,619,1852,79,242,217,631,296,873
312260,202110,994,2594,794,2293,36,134,617,1701,653,1835
312270,202110,754,2043,575,1681,32,121,315,849,347,970
312280,202110,427,1219,333,1057,89,298,54,159,143,457
312290,202110,874,2463,715,2191,132,446,231,660,363,1106
312300,202110,1026,3024,686,2201,166,586,130,346,296,932
312310,202110,1006,2889,804,2488,117,394,400,1178,517,1572
312320,202110,2137,5325,1558,4346,339,973,329,915,668,1888
312330,202110,899,2523,733,2184,75,246,451,1296,526,1542
312340,202110,269,674,192,553,31,122,103,251,134,373
312350,202110,266,530,194,452,20,54,134,302,154,356
312352,202110,1600,4710,1413,4363,95,292,836,2780,931,3072
312360,202110,3244,9087,2413,7549,419,1450,877,2527,1296,3977
312370,202110,2010,5012,1652,4417,163,494,1032,2630,1195,3124
312380,202110,2279,5047,1894,4560,9,31,1680,3978,1689,4009
312385,202110,1308,3423,1004,2886,198,620,325,960,523,1580
312390,202110,1959,5430,1440,4470,214,778,410,1069,624,1847
312400,202110,3023,8327,2531,7506,677,2199,820,2443,1497,4642
312410,202110,12885,34086,10486,30146,1728,5041,5964,16830,7692,21871
312420,202110,4086,10481,3344,9279,661,1969,1693,4512,2354,6481
312430,202110,8267,21335,6772,18738,322,1016,4910,13238,5232,14254
312440,202110,984,3110,803,2718,364,1322,132,407,496,1729
312450,202110,1271,3640,965,3102,265,886,305,1031,570,1917
312460,202110,480,1177,346,975,52,147,192,550,244,697
312470,202110,488,1166,301,825,31,96,103,243,134,339
312480,202110,1064,2592,754,2138,82,272,394,1051,476,1323
312490,202110,2370,5412,1898,4757,167,472,1129,2759,1296,3231
312500,202110,1078,2560,891,2311,41,144,659,1682,700,1826
312510,202110,4308,11285,3120,9036,719,1997,781,2258,1500,4255
312520,202110,292,724,224,621,44,136,107,288,151,424
312530,202110,692,1598,584,1475,30,75,454,1197,484,1272
312540,202110,1682,4470,1160,3480,139,435,641,1859,780,2294
312550,202110,822,2116,638,1761,46,148,415,1059,461,1207
312560,202110,2012,5158,1622,4542,78,219,1180,3301,1258,3520
312570,202110,2540,5791,1904,5008,445,1159,838,2329,1283,3488
312580,202110,641,1706,445,1313,57,196,194,519,251,715
312590,202110,1633,4579,1260,3817,75,294,785,2186,860,2480
312595,202110,2150,5978,1778,5381,261,715,1045,3379,1306,4094
312600,202110,1228,2889,722,1905,110,358,127,386,237,744
312610,202110,7502,18531,5056,14073,714,2176,1795,4498,2509,6674
312620,202110,2605,6554,1930,5608,51,162,1525,4510,1576,4672
312630,202110,314,858,221,690,31,115,81,251,112,366
312640,202110,543,1456,387,1189,35,127,187,561,222,688
312650,202110,2180,5288,1535,4118,74,207,1091,2759,1165,2966
312660,202110,1372,3249,1041,2702,103,262,682,1714,785,1976
312670,202110,5254,13286,4376,11918,151,538,3308,8617,3459,9155
312675,202110,1350,3351,1105,3001,57,158,904,2424,961,2582
312680,202110,1471,3972,1273,3658,42,159,1064,2981,1106,3140
312690,202110,3074,6323,2367,5475,38,97,1986,4598,2024,4695
312695,202110,1036,2661,870,2394,54,118,672,1850,726,1968
312700,202110,2137,5483,1569,4472,142,477,917,2471,1059,2948
312705,202110,1511,3477,1302,3176,13,40,1201,2905,1214,2945
312707,202110,1489,4104,1117,3463,71,283,720,2131,791,2414
312710,202110,6881,15554,4204,11431,991,2879,1189,3386,2180,6265
312720,202110,1151,2922,859,2462,91,276,538,1469,629,1745
312730,202110,1699,3900,1199,3218,96,272,718,1874,814,2146
312733,202110,1424,3667,1074,3019,29,101,735,1934,764,2035
312735,202110,786,2008,622,1691,75,197,363,924,438,1121
312737,202110,829,1792,595,1466,59,156,406,980,465,1136
312738,202110,747,1848,536,1495,51,153,315,837,366,990
312740,202110,453,1117,267,801,48,169,63,132,111,301
312750,202110,1628,4537,1205,3735,190,608,528,1547,718,2155
312760,202110,1882,5360,1343,4240,229,735,508,1555,737,2290
312770,202110,46707,109568,29459,80209,5496,16188,10173,26559,15669,42747
312780,202110,2554,7284,2152,6631,248,783,1394,4299,1642,5082
312790,202110,259,595,136,393,1,3,40,81,41,84
312800,202110,5314,14415,4066,12064,804,2522,1690,4797,2494,7319
312810,202110,1599,4204,1069,3319,261,897,380,1072,641,1969
312820,202110,1841,4732,1489,4126,71,220,1100,2988,1171,3208
312825,202110,1442,3247,1247,2995,19,55,1082,2541,1101,2596
312830,202110,2918,7993,1805,5758,339,1181,473,1423,812,2604
312840,202110,1514,3839,1203,3339,71,247,728,1896,799,2143
312850,202110,1041,2400,734,1952,20,73,465,1136,485,1209
312860,202110,1133,2859,773,2307,188,578,178,504,366,1082
312870,202110,6367,16626,4040,12215,618,1967,1047,2879,1665,4846
312880,202110,1530,3752,1185,3180,51,142,698,1909,749,2051
312890,202110,2353,5668,1746,4696,133,323,899,2440,1032,2763
312900,202110,1294,3235,1051,2913,145,446,514,1538,659,1984
312910,202110,1597,2900,877,1962,197,380,328,766,525,1146
312920,202110,1021,2668,716,2184,116,419,265,710,381,1129
312930,202110,2546,6059,1932,5145,401,1074,859,2362,1260,3436
312940,202110,1039,2764,826,2466,64,244,487,1390,551,1634
312950,202110,3203,7694,2148,6024,441,1382,805,2146,1246,3528
312960,202110,1909,4867,1604,4410,90,218,1208,3417,1298,3635
312965,202110,1708,4540,1417,4099,123,315,962,2804,1085,3119
312970,202110,1516,4129,1221,3646,146,505,752,2123,898,2628
312980,202110,26105,69362,21006,60303,4052,12373,9500,25582,13552,37955
312990,202110,541,1293,364,994,55,171,186,464,241,635
313000,202110,495,1384,369,1154,21,94,226,662,247,756
313005,202110,2646,7374,2235,6700,139,374,1596,4709,1735,5083
313010,202110,5606,14726,4454,12875,718,2260,2624,7434,3342,9694
313020,202110,1142,3349,838,2679,129,443,175,495,304,938
313030,202110,1203,2649,817,2107,64,214,550,1347,614,1561
313040,202110,871,2602,720,2304,39,164,445,1358,484,1522
313050,202110,1848,4952,1288,4103,200,767,407,1145,607,1912
313055,202110,2003,5209,1772,4875,129,359,1441,3951,1570,4310
313060,202110,1028,2456,737,1960,138,444,167,402,305,846
313065,202110,1693,4884,1490,4556,40,142,1176,3511,1216,3653
313070,202110,970,2478,746,2112,76,226,445,1218,521,1444
313080,202110,408,1124,300,917,54,183,102,256,156,439
313090,202110,5500,13943,4662,12624,311,951,3212,8596,3523,9547
313100,202110,1365,3463,1050,3011,28,112,798,2231,826,2343
313110,202110,1541,3965,1145,3288,108,373,621,1631,729,2004
313115,202110,2938,8053,2349,6939,262,909,1289,3484,1551,4393
313120,202110,3961,9164,2910,7790,196,587,1956,5244,2152,5831
313130,202110,33601,83664,25423,68890,2525,7771,14477,36747,17002,44518
313140,202110,716,1502,457,1147,29,72,333,837,362,909
313150,202110,1435,3920,1066,3273,319,1064,181,496,500,1560
313160,202110,1284,3132,1006,2724,19,67,773,2021,792,2088
313170,202110,11723,32190,8651,26481,1349,4486,3310,9267,4659,13753
313180,202110,2328,5979,1698,4725,272,711,938,2617,1210,3328
313190,202110,4628,12981,3363,10405,571,1887,1166,3336,1737,5223
313200,202110,1175,3130,1013,2841,14,47,864,2359,878,2406
313210,202110,4149,11290,3415,10012,376,1116,2078,5931,2454,7047
313220,202110,1830,4677,1213,3470,157,502,521,1313,678,1815
313230,202110,3009,8197,2456,7505,44,146,2038,6368,2082,6514
313240,202110,10753,25685,7076,19933,943,3035,3392,8888,4335,11923
313250,202110,6449,18403,4876,15004,900,2731,2139,6331,3039,9062
313260,202110,747,1874,545,1524,65,231,277,690,342,921
313270,202110,6116,14576,4971,13031,526,1206,3513,9510,4039,10716
313280,202110,485,1313,319,978,38,133,131,382,169,515
313290,202110,1034,3116,779,2659,183,697,285,957,468,1654
313300,202110,1723,4503,1285,3755,305,957,345,894,650,1851
313310,202110,1312,3802,1032,3221,155,555,307,809,462,1364
313320,202110,2171,5620,1560,4650,270,906,574,1763,844,2669
313330,202110,4326,10996,3287,9435,145,481,2160,6161,2305,6642
313340,202110,1486,3276,1074,2709,76,210,774,1918,850,2128
313350,202110,3130,8429,2063,6075,229,764,809,2055,1038,2819
313360,202110,1602,3825,1091,3004,165,562,581,1449,746,2011
313370,202110,1638,4367,1332,3777,194,589,585,1504,779,2093
313375,202110,1909,4919,1228,3638,228,727,259,705,487,1432
313380,202110,6715,16390,4877,13081,746,2252,2400,5722,3146,7974
313390,202110,828,2581,720,2395,52,219,479,1537,531,1756
313400,202110,3846,9178,2951,7925,109,315,2264,5973,2373,6288
313410,202110,1429,3565,1083,2969,91,278,734,1927,825,2205
313420,202110,16454,35876,8735,23095,1983,5886,1145,2957,3128,8843
313430,202110,1012,2838,789,2384,110,415,384,1006,494,1421
313440,202110,6471,13718,4400,11054,308,800,2987,7476,3295,8276
313450,202110,780,2027,551,1589,92,283,200,496,292,779
313460,202110,2236,6173,1765,5424,349,1207,799,2346,1148,3553
313470,202110,2948,7314,2328,6410,198,539,1598,4459,1796,4998
313480,202110,1105,3079,678,2151,49,174,236,686,285,860
313490,202110,3131,7615,1656,4885,369,1176,425,1218,794,2394
313500,202110,578,1547,423,1221,31,88,182,484,213,572
313505,202110,10554,27069,8986,24945,331,1027,7214,20038,7545,21065
313507,202110,1523,3811,1241,3377,35,138,994,2613,1029,2751
313510,202110,14963,40002,11644,33518,1346,3763,5567,15702,6913,19465
313520,202110,15443,41445,12299,36114,576,1836,9232,26550,9808,28386
313530,202110,587,1694,442,1391,51,183,142,372,193,555
313535,202110,2468,6663,2022,5822,270,706,1237,3576,1507,4282
313540,202110,851,2443,684,2054,117,362,294,797,411,1159
313545,202110,1178,3781,994,3427,122,446,543,1793,665,2239
313550,202110,1886,5524,1570,4790,270,903,869,2556,1139,3459
313560,202110,2872,5432,2154,4567,61,94,1826,3901,1887,3995
313570,202110,1045,2891,854,2559,204,620,347,1029,551,1649
313580,202110,6277,15267,4925,13047,481,1296,3039,7970,3520,9266
313590,202110,1150,3065,922,2730,169,525,476,1499,645,2024
313600,202110,4304,10938,3593,9862,86,292,3082,8319,3168,8611
313610,202110,1103,2667,891,2311,82,230,584,1430,666,1660
313620,202110,5586,14434,4389,12295,471,1520,2625,7047,3096,8567
313630,202110,9273,21745,6629,17809,631,1949,4029,10504,4660,12453
313640,202110,1299,2713,817,2107,127,346,463,1202,590,1548
313650,202110,1749,5099,1371,4468,93,351,882,2914,975,3265
313652,202110,822,2438,739,2284,83,267,503,1499,586,1766
313655,202110,1181,2872,915,2540,64,176,659,1846,723,2022
313657,202110,1215,3120,955,2702,29,98,720,1934,749,2032
313660,202110,1023,2791,832,2461,69,247,544,1544,613,1791
313665,202110,5385,13837,4282,11932,402,1250,2737,7247,3139,8497
313670,202110,53547,128182,35120,97197,4630,13984,16487,42849,21117,56833
313680,202110,1105,2837,915,2523,52,148,632,1706,684,1854
313690,202110,921,2698,662,2178,141,516,197,603,338,1119
313695,202110,1939,4978,1443,4161,105,293,918,2747,1023,3040
313700,202110,2988,9055,2596,8536,233,711,1978,6594,2211,7305
313710,202110,1541,3393,1098,2807,71,187,738,1896,809,2083
313720,202110,6323,16825,4524,13122,617,1888,1887,5000,2504,6888
313730,202110,1472,3142,1089,2645,85,167,712,1761,797,1928
313740,202110,1765,6145,1479,5408,293,1211,296,944,589,2155
313750,202110,2156,5561,1689,4764,280,884,854,2231,1134,3115
313753,202110,2292,5415,1521,4142,157,481,816,2133,973,2614
313760,202110,5954,15951,4622,13395,795,2570,2195,5874,2990,8444
313770,202110,4244,11498,3360,10104,169,479,2530,7738,2699,8217
313780,202110,4269,10877,3167,9108,273,839,976,2923,1249,3762
313790,202110,547,1583,484,1472,57,185,293,861,350,1046
313800,202110,1444,3139,1053,2603,95,259,578,1363,673,1622
313810,202110,1733,4211,1400,3747,48,157,1100,2871,1148,3028
313820,202110,18671,46731,11769,32206,1966,5472,2983,7907,4949,13379
313830,202110,414,1176,294,908,53,188,107,299,160,487
313835,202110,935,2653,772,2366,70,260,422,1204,492,1464
313840,202110,7986,20340,6200,17426,1350,4081,1338,3855,2688,7936
313850,202110,1019,2440,807,2155,142,437,375,902,517,1339
313860,202110,2753,7070,2088,5863,283,928,970,2461,1253,3389
313862,202110,1327,2750,652,1778,42,120,294,793,336,913
313865,202110,2707,6935,2237,6190,91,265,1697,4592,1788,4857
313867,202110,1458,4289,1213,3841,223,693,614,2012,837,2705
313868,202110,1774,5224,1462,4633,46,179,1117,3426,1163,3605
313870,202110,1072,2713,718,2072,94,284,283,741,377,1025
313880,202110,1975,4975,1452,4082,171,539,749,1926,920,2465
313890,202110,2209,4548,1650,3829,27,83,1281,2884,1308,2967
313900,202110,4905,13520,3481,10589,812,2697,865,2316,1677,5013
313910,202110,739,2100,558,1748,99,336,111,338,210,674
313920,202110,3055,8876,2539,7820,476,1461,1277,3977,1753,5438
313925,202110,1682,4101,1362,3560,128,323,940,2442,1068,2765
313930,202110,4974,14163,4032,12499,276,939,2671,8136,2947,9075
313940,202110,9511,26570,7080,22402,678,2597,1798,6435,2476,9032
313950,202110,5597,11951,4255,10315,300,895,2799,6822,3099,7717
313960,202110,6005,14031,4023,10732,733,2210,1289,3083,2022,5293
313970,202110,1588,4140,1336,3727,22,69,866,2367,888,2436
313980,202110,1330,3393,887,2719,143,480,370,1066,513,1546
313990,202110,2029,6217,1490,5032,305,1203,582,1734,887,2937
314000,202110,10590,25966,8694,22815,636,2031,5776,14852,6412,16883
314010,202110,1498,3484,1180,3053,33,103,910,2277,943,2380
314015,202110,2106,5587,1626,4755,175,601,936,2615,1111,3216
314020,202110,543,1426,372,1135,87,316,70,238,157,554
314030,202110,838,2325,658,1989,88,251,319,968,407,1219
314040,202110,611,1636,504,1440,80,262,259,703,339,965
314050,202110,1998,5141,1478,4178,132,444,842,2213,974,2657
314053,202110,2004,5764,1609,4987,315,941,864,2806,1179,3747
314055,202110,2326,5978,1964,5436,40,152,1631,4492,1671,4644
314060,202110,1366,3519,1035,3002,32,102,738,2108,770,2210
314070,202110,5069,13326,3998,11448,727,2092,1845,5171,2572,7263
314080,202110,2239,5614,1554,4457,168,532,694,1799,862,2331
314085,202110,2455,6457,1994,5775,189,543,1198,3503,1387,4046
314090,202110,5150,13118,4423,12060,264,785,2937,8299,3201,9084
314100,202110,3131,7399,2414,6407,38,111,1810,4835,1848,4946
314110,202110,5303,14359,4289,12453,499,1606,2323,6213,2822,7819
314120,202110,745,1699,331,952,58,190,94,248,152,438
314130,202110,671,1761,438,1333,24,84,258,762,282,846
314140,202110,4721,12757,3757,11009,482,1448,1925,5542,2407,6990
314150,202110,1569,3825,1145,3105,70,180,772,2054,842,2234
314160,202110,2408,5989,1762,4834,217,644,784,2140,1001,2784
314170,202110,967,2628,783,2270,39,149,521,1403,560,1552
314180,202110,5770,15387,4635,13575,358,1084,2813,8244,3171,9328
314190,202110,657,1611,493,1373,77,248,264,686,341,934
314200,202110,3135,8488,2592,7586,173,526,1795,5158,1968,5684
314210,202110,2187,5518,1737,4726,240,690,777,2043,1017,2733
314220,202110,1569,4129,1203,3513,216,700,486,1310,702,2010
314225,202110,1140,3192,936,2831,79,214,657,1995,736,2209
314230,202110,854,2166,695,1956,73,216,448,1295,521,1511
314240,202110,1132,2955,876,2564,186,569,358,1051,544,1620
314250,202110,500,1393,311,985,45,127,116,341,161,468
314260,202110,1068,2714,825,2387,154,492,439,1233,593,1725
314270,202110,3410,9319,2799,8371,65,249,2092,6193,2157,6442
314280,202110,3625,8172,2463,6417,256,742,1432,3512,1688,4254
314290,202110,4672,11732,3882,10341,348,921,2628,6854,2976,7775
314300,202110,2128,5831,1378,4258,246,838,468,1279,714,2117
314310,202110,4046,10351,2710,8059,795,2620,403,1034,1198,3654
314315,202110,1010,3159,860,2845,41,167,609,1969,650,2136
314320,202110,3264,8670,2158,6610,366,1220,797,2297,1163,3517
314330,202110,53240,144934,40484,122568,10122,31910,8702,27478,18824,59388
314340,202110,2590,6364,1639,4682,296,984,420,1036,716,2020
314345,202110,1503,4257,1214,3739,129,389,760,2310,889,2699
314350,202110,849,2273,552,1734,121,396,125,316,246,712
314360,202110,570,1637,370,1215,53,178,121,355,174,533
314370,202110,782,2015,630,1791,52,160,416,1151,468,1311
314380,202110,1181,3127,782,2432,178,622,182,550,360,1172
314390,202110,15086,36913,10155,28185,1524,4602,3592,8804,5116,13406
314400,202110,4099,11978,3156,10111,787,2637,1179,3955,1966,6592
314410,202110,2962,8101,2059,6377,262,952,619,1973,881,2925
314420,202110,867,2092,637,1721,30,105,435,1123,465,1228
314430,202110,8371,19551,5889,15509,871,2399,2809,7005,3680,9404
314435,202110,1975,5159,1528,4425,163,494,924,2623,1087,3117
314437,202110,938,2328,673,1903,72,216,352,988,424,1204
314440,202110,644,1799,459,1437,144,505,86,206,230,711
314450,202110,1484,3836,1231,3416,135,398,690,1843,825,2241
314460,202110,3283,9724,2411,7943,581,2039,601,1872,1182,3911
314465,202110,2306,6427,1959,5786,43,142,1532,4419,1575,4561
314467,202110,917,2363,773,2136,18,49,614,1645,632,1694
314470,202110,2447,6760,2013,5898,342,1083,934,2529,1276,3612
314480,202110,8045,21658,6066,17565,924,2968,2446,6239,3370,9207
314490,202110,1140,2886,841,2292,59,169,550,1449,609,1618
314500,202110,1782,4153,1287,3501,338,870,430,1242,768,2112
314505,202110,2180,5113,1782,4561,86,240,1338,3315,1424,3555
314510,202110,2117,5341,1497,4397,300,981,679,1929,979,2910
314520,202110,5554,16304,4245,13726,853,3005,693,1984,1546,4989
314530,202110,5581,17248,5002,16176,289,1094,3726,11777,4015,12871
314535,202110,2699,6739,2187,6004,81,274,1709,4670,1790,4944
314537,202110,1212,3328,931,2879,49,156,675,2058,724,2214
314540,202110,429,1044,300,834,21,63,179,474,200,537
314545,202110,2032,4691,1819,4445,33,83,1590,3972,1623,4055
314550,202110,778,1821,561,1488,37,124,333,808,370,932
314560,202110,4862,13925,3557,11090,476,1687,1376,3761,1852,5448
314570,202110,327,893,234,724,29,97,111,344,140,441
314580,202110,469,1377,373,1187,97,313,125,394,222,707
314585,202110,682,2044,525,1700,55,213,240,748,295,961
314587,202110,2243,5866,1721,5041,329,906,935,2774,1264,3680
314590,202110,4380,11461,3258,9411,407,1308,1525,4024,1932,5332
314600,202110,2010,5295,1221,3824,260,856,137,406,397,1262
314610,202110,9524,22999,6926,19198,956,3130,3226,9084,4182,12214
314620,202110,2365,5357,1887,4753,46,134,1593,3990,1639,4124
314625,202110,1611,4245,1383,3927,24,136,1194,3317,1218,3453
314630,202110,5657,13710,4604,12283,114,427,3807,10077,3921,10504
314640,202110,732,1685,539,1385,61,181,324,767,385,948
314650,202110,853,1950,541,1461,48,153,312,747,360,900
314655,202110,1620,4343,1163,3545,170,492,578,1791,748,2283
314660,202110,343,765,233,576,12,26,153,366,165,392
314670,202110,1706,3759,1183,3012,23,66,807,2002,830,2068
314675,202110,1780,4497,1507,4051,68,193,1184,3114,1252,3307
314690,202110,2137,5720,1611,4939,391,1307,577,1763,968,3070
314700,202110,11653,31007,7843,23880,1345,4447,2934,8533,4279,12980
314710,202110,8500,23174,6239,18456,920,3030,2394,6148,3314,9178
314720,202110,2324,6752,1620,5286,286,993,362,1079,648,2072
314730,202110,2506,6362,1784,5075,293,894,649,1688,942,2582
314740,202110,3169,8704,2487,7496,336,1030,1265,3705,1601,4735
314750,202110,295,792,225,649,26,85,137,348,163,433
314760,202110,2035,5835,1308,4228,229,829,317,796,546,1625
314770,202110,1117,3159,631,1975,67,214,192,545,259,759
314780,202110,373,906,252,715,37,120,141,357,178,477
314790,202110,12615,32520,8974,25865,1555,5068,3620,9639,5175,14707
314795,202110,1604,4092,1358,3675,28,115,1098,2851,1126,2966
314800,202110,11514,28715,7323,21110,1257,3915,1997,5092,3254,9007
314810,202110,9657,24841,7040,20378,1809,5524,2227,6305,4036,11829
314820,202110,1333,3110,1035,2660,62,202,656,1589,718,1791
314830,202110,1758,4983,1460,4446,202,639,754,2245,956,2884
314840,202110,882,2685,686,2337,47,210,472,1522,519,1732
314850,202110,2330,5030,1884,4476,48,137,1628,3846,1676,3983
314860,202110,3389,9512,2832,8520,148,586,2033,5932,2181,6518
314870,202110,6720,15804,5094,13751,222,611,3810,10445,4032,11056
314875,202110,1917,5560,1696,5264,196,494,1301,4194,1497,4688
314880,202110,871,2067,676,1765,42,114,415,1086,457,1200
314890,202110,460,1340,353,1121,54,184,154,458,208,642
314900,202110,858,2164,653,1809,84,259,300,792,384,1051
314910,202110,1745,4808,1299,4072,206,749,642,1861,848,2610
314915,202110,2238,6426,1871,5771,126,370,1228,3739,1354,4109
314920,202110,516,1312,350,1066,18,46,227,709,245,755
314930,202110,5978,16382,4569,13733,725,2465,1915,5247,2640,7712
314940,202110,429,1009,357,895,38,88,231,558,269,646
314950,202110,589,1441,405,1154,27,87,220,580,247,667
314960,202110,895,2041,687,1708,24,69,503,1185,527,1254
314970,202110,1054,3066,808,2567,125,438,370,1068,495,1506
314980,202110,1689,4183,1284,3588,209,654,661,1787,870,2441
314990,202110,2713,7678,1937,5933,371,1169,423,1174,794,2343
314995,202110,1732,4666,1379,4045,24,93,946,2610,970,2703
315000,202110,1165,2904,837,2397,64,182,535,1522,599,1704
315010,202110,385,1039,300,896,47,168,151,427,198,595
315015,202110,2399,6527,2077,5981,199,655,1375,3871,1574,4526
315020,202110,805,2319,571,1808,58,212,254,755,312,967
315030,202110,632,1640,428,1274,96,300,89,227,185,527
315040,202110,956,2487,786,2195,95,304,510,1347,605,1651
315050,202110,1284,3172,953,2652,53,188,531,1402,584,1590
315053,202110,1228,3090,914,2558,60,160,536,1432,596,1592
315057,202110,1860,5320,1498,4724,148,411,990,3266,1138,3677
315060,202110,628,1839,461,1502,93,305,112,355,205,660
315070,202110,594,1488,433,1216,103,307,142,373,245,680
315080,202110,3352,8821,2597,7460,133,414,1818,4961,1951,5375
315090,202110,833,2455,626,2061,81,297,263,822,344,1119
315100,202110,1404,3988,927,2920,126,470,416,1143,542,1613
315110,202110,2181,5019,1584,4136,139,358,817,2177,956,2535
315120,202110,13385,30069,9898,24936,1178,2682,5597,14589,6775,17271
315130,202110,1741,4651,1457,4174,147,486,617,1641,764,2127
315140,202110,3072,8309,2412,7152,445,1467,1193,3306,1638,4773
315150,202110,4563,10826,3244,8753,435,1372,1565,4123,2000,5495
315160,202110,1905,4591,1288,3624,264,792,582,1589,846,2381
315170,202110,1416,4383,1002,3389,200,736,270,859,470,1595
315180,202110,18499,43962,10605,29643,1306,4094,3693,9008,4999,13102
315190,202110,2302,4958,1798,4306,242,580,1240,3019,1482,3599
315200,202110,4233,11543,3123,9657,832,2793,774,2324,1606,5117
315210,202110,9347,23438,6542,17744,686,2017,3358,8181,4044,10198
315213,202110,1145,2972,991,2755,19,68,820,2225,839,2293
315217,202110,2952,8185,2233,6981,76,292,1520,4569,1596,4861
315220,202110,8934,23564,7063,20362,1000,2973,3364,9717,4364,12690
315230,202110,3128,7035,2605,6327,206,329,1832,4808,2038,5137
315240,202110,2544,7183,2112,6439,449,1430,988,3021,1437,4451
315250,202110,14616,38380,10684,31038,1604,4992,4517,12443,6121,17435
315260,202110,949,2528,535,1677,81,254,39,107,120,361
315270,202110,910,2566,669,2112,87,296,238,653,325,949
315280,202110,2982,7366,1884,5425,462,1414,341,957,803,2371
315290,202110,1209,2923,720,2146,181,596,212,616,393,1212
315300,202110,656,1572,476,1322,55,169,281,780,336,949
315310,202110,1299,3489,986,2917,66,214,583,1605,649,1819
315320,202110,677,1931,476,1532,66,237,194,573,260,810
315330,202110,831,2624,481,1727,64,258,165,524,229,782
315340,202110,3101,7340,2171,5952,358,990,1050,2852,1408,3842
315350,202110,1665,4392,1345,3896,160,541,824,2325,984,2866
315360,202110,1844,5237,1422,4383,198,654,617,1747,815,2401
315370,202110,567,1523,458,1321,79,223,215,599,294,822
315380,202110,275,764,199,601,33,113,25,61,58,174
315390,202110,1227,3345,990,2922,123,436,530,1425,653,1861
315400,202110,4263,11178,3374,9613,386,1165,1975,5339,2361,6504
315410,202110,2608,5746,1939,4778,377,1020,413,1058,790,2078
315415,202110,1504,3980,1216,3534,255,856,433,1246,688,2102
315420,202110,1567,4245,1086,3358,183,600,235,683,418,1283
315430,202110,3799,9013,2671,7338,434,1393,1208,3134,1642,4527
315440,202110,1095,2803,861,2426,71,235,506,1324,577,1559
315445,202110,2050,4741,1501,3961,83,255,1139,2955,1222,3210
315450,202110,2421,6407,1977,5678,267,667,1200,3507,1467,4174
315460,202110,41964,111669,34678,98891,4353,14156,20179,53682,24532,67838
315470,202110,691,1866,488,1381,39,123,270,720,309,843
315480,202110,1209,3388,865,2671,148,466,299,886,447,1352
315490,202110,3020,7436,2119,6007,279,799,823,2204,1102,3003
315500,202110,550,1441,347,1008,41,148,180,452,221,600
315510,202110,1322,3328,1110,3034,11,40,983,2640,994,2680
315520,202110,1054,2764,867,2466,47,139,676,1878,723,2017
315530,202110,645,1730,518,1508,107,357,283,769,390,1126
315540,202110,1716,4418,1159,3374,93,308,512,1411,605,1719
315550,202110,1918,4976,1267,3780,242,832,339,996,581,1828
315560,202110,6688,19357,5709,17618,320,916,3939,12288,4259,13204
315570,202110,2204,5703,1748,4937,185,582,887,2382,1072,2964
315580,202110,3277,7487,2540,6333,395,1054,949,2219,1344,3273
315590,202110,960,2318,747,1997,49,160,490,1231,539,1391
315600,202110,2639,7846,1852,6305,326,993,883,3252,1209,4245
315610,202110,1040,2547,779,2088,102,341,368,853,470,1194
315620,202110,546,1420,419,1230,45,142,218,648,263,790
315630,202110,1109,2855,842,2368,123,384,408,1045,531,1429
315640,202110,365,887,272,773,29,107,168,453,197,560
315645,202110,1019,2559,709,2060,151,477,190,513,341,990
315650,202110,1764,4124,1424,3653,42,115,1143,2855,1185,2970
315660,202110,2440,5978,1848,4947,83,246,1320,3403,1403,3649
315670,202110,14973,39461,11463,33173,2070,6335,5317,14591,7387,20926
315680,202110,3330,9173,2484,7600,263,941,1402,4045,1665,4986
315690,202110,3821,9123,2351,6653,489,1377,591,1823,1080,3200
315700,202110,8805,23309,6653,19162,968,2927,3019,8247,3987,11174
315710,202110,1949,4635,1396,3813,53,169,980,2617,1033,2786
315720,202110,4611,12422,3813,11010,169,628,2711,7522,2880,8150
315725,202110,2337,5862,1788,4988,220,577,1084,3170,1304,3747
315727,202110,589,1460,445,1232,52,173,196,512,248,685
315730,202110,619,1828,535,1668,91,321,185,508,276,829
315733,202110,1400,3446,1044,2856,156,481,399,1014,555,1495
315737,202110,1215,3290,953,2785,28,100,686,1928,714,2028
315740,202110,833,2273,671,1947,64,208,445,1209,509,1417
315750,202110,1315,3351,1050,2941,91,258,658,1862,749,2120
315760,202110,1207,2780,1051,2570,47,150,873,2077,920,2227
315765,202110,2044,5175,1672,4692,30,103,1479,4133,1509,4236
315770,202110,1061,2850,824,2519,324,1089,164,444,488,1533
315780,202110,32511,85840,27125,76225,1442,4863,18698,49854,20140,54717
315790,202110,3719,11174,3161,10144,311,1043,1944,6392,2255,7435
315800,202110,1383,4507,1042,3687,143,554,386,1188,529,1742
315810,202110,1383,3336,1141,2930,67,183,883,2198,950,2381
315820,202110,2762,7049,2204,6274,209,592,1540,4418,1749,5010
315830,202110,1260,3637,844,2714,85,292,272,743,357,1035
315840,202110,925,2187,659,1723,50,161,352,828,402,989
315850,202110,1257,3512,991,3057,171,539,498,1467,669,2006
315860,202110,509,1413,355,1144,56,197,125,349,181,546
315870,202110,490,1296,387,1121,26,81,274,764,300,845
315880,202110,1159,2868,806,2246,95,282,247,648,342,930
315890,202110,1784,4922,1444,4455,355,1223,714,2179,1069,3402
315895,202110,6643,17475,4959,14209,454,1455,2576,6840,3030,8295
315900,202110,833,2113,716,1948,66,180,520,1384,586,1564
315910,202110,544,1446,456,1314,70,189,302,879,372,1068
315920,202110,1498,3732,853,2520,131,465,280,732,411,1197
315930,202110,1158,2507,777,1959,134,318,330,842,464,1160
315935,202110,939,2754,747,2383,147,481,266,835,413,1316
315940,202110,642,1689,506,1489,67,207,264,749,331,956
315950,202110,1187,3235,980,2900,98,284,741,2194,839,2478
315960,202110,5889,16075,4045,12399,1038,3471,593,1305,1631,4776
315970,202110,597,1565,478,1406,57,174,315,944,372,1118
315980,202110,4464,9375,2493,6208,457,1190,975,2211,1432,3401
315990,202110,3678,9256,2871,7866,336,930,1569,4160,1905,5090
316000,202110,680,1621,521,1390,52,164,286,720,338,884
316010,202110,827,2238,614,1854,58,191,304,819,362,1010
316020,202110,971,2807,776,2428,120,417,417,1210,537,1627
316030,202110,2843,7739,2187,6556,256,773,1376,4212,1632,4985
316040,202110,2767,7672,2043,6302,323,1160,572,1523,895,2683
316045,202110,2154,5385,1979,5171,84,158,1729,4624,1813,4782
316050,202110,414,1120,323,968,48,131,178,501,226,632
316060,202110,718,1706,527,1454,17,68,378,996,395,1064
316070,202110,5720,15328,4663,13365,818,2325,2164,6030,2982,8355
316080,202110,786,2384,615,2037,153,548,99,273,252,821
316090,202110,438,1178,340,991,45,135,174,460,219,595
316095,202110,1362,4095,1057,3340,269,910,379,1124,648,2034
316100,202110,2552,7218,1856,5788,319,1090,679,1914,998,3004
316105,202110,868,2210,706,1958,40,126,486,1390,526,1516
316110,202110,14449,39850,12061,35903,813,2667,8370,24537,9183,27204
316120,202110,1296,3505,853,2511,134,408,281,654,415,1062
316130,202110,1294,2889,860,2175,72,209,511,1238,583,1447
316140,202110,1278,3329,800,2427,83,271,366,1099,449,1370
316150,202110,2201,4789,1768,4192,213,618,808,1799,1021,2417
316160,202110,1056,2761,848,2383,37,122,607,1663,644,1785
316165,202110,912,2162,720,1872,116,342,411,1006,527,1348
316170,202110,1294,3102,984,2646,48,148,685,1750,733,1898
316180,202110,1551,4259,1078,3332,161,554,270,746,431,1300
316190,202110,2833,7855,1686,5124,247,794,660,1768,907,2562
316200,202110,3477,9690,2699,8354,565,1853,874,2636,1439,4489
316210,202110,4997,14342,3528,10929,1138,3914,206,472,1344,4386
316220,202110,693,2048,466,1572,84,319,60,239,144,558
316225,202110,1634,3650,1230,3019,48,174,940,2149,988,2323
316230,202110,455,1212,352,1040,56,175,169,489,225,664
316240,202110,5777,16317,5047,15019,378,1198,3786,11100,4164,12298
316245,202110,3332,10168,3015,9635,104,546,2415,7384,2519,7930
316250,202110,11376,26564,8436,21891,1669,4637,3132,8044,4801,12681
316255,202110,3038,8189,2636,7560,119,320,1978,5784,2097,6104
316257,202110,1456,3400,1058,2726,89,242,677,1660,766,1902
316260,202110,2373,5643,1881,4876,226,573,1018,2681,1244,3254
316265,202110,1167,3083,911,2646,15,52,690,1958,705,2010
316270,202110,3904,11560,3347,10380,493,1588,1715,5090,2208,6678
316280,202110,3116,8386,2647,7530,344,1062,1438,3930,1782,4992
316290,202110,3803,10194,3069,8824,391,1196,1160,3213,1551,4409
316292,202110,5695,14577,4532,12704,590,1692,2829,7690,3419,9382
316294,202110,910,2594,688,2229,111,436,178,520,289,956
316295,202110,3518,9637,2868,8521,149,545,2009,5684,2158,6229
316300,202110,1064,2897,841,2542,32,98,592,1772,624,1870
316310,202110,823,2161,555,1685,120,414,114,285,234,699
316320,202110,710,1934,557,1698,59,204,263,781,322,985
316330,202110,1125,2834,859,2392,51,161,660,1791,711,1952
316340,202110,1021,2685,761,2220,84,303,419,1153,503,1456
316350,202110,1389,3741,1147,3335,156,457,704,2027,860,2484
316360,202110,654,1690,545,1512,47,138,414,1148,461,1286
316370,202110,5878,14614,4511,12255,597,1843,2172,5276,2769,7119
316380,202110,1790,4241,1405,3685,56,113,971,2563,1027,2676
316390,202110,797,2116,571,1725,236,809,84,216,320,1025
316400,202110,1253,3463,828,2611,106,365,294,824,400,1189
316410,202110,1179,3151,984,2859,53,165,801,2269,854,2434
316420,202110,2041,5441,1780,5107,37,125,1465,4119,1502,4244
316430,202110,907,2282,619,1804,98,331,260,671,358,1002
316440,202110,877,2635,702,2323,124,478,184,528,308,1006
316443,202110,577,1568,427,1286,93,310,102,292,195,602
316447,202110,2130,5505,1845,5061,24,76,1618,4391,1642,4467
316450,202110,2243,6508,1714,5409,247,818,976,2983,1223,3801
316460,202110,1316,3297,1077,2928,115,349,710,1831,825,2180
316470,202110,7480,20818,5449,16596,804,2743,2211,6059,3015,8802
316480,202110,207,554,181,521,45,130,85,238,130,368
316490,202110,335,882,235,699,37,114,81,204,118,318
316500,202110,1271,3822,855,2847,177,653,188,558,365,1211
316510,202110,823,2584,655,2249,110,380,329,1133,439,1513
316520,202110,1421,3353,1112,2853,130,408,590,1356,720,1764
316530,202110,1182,3016,858,2440,85,314,446,1131,531,1445
316540,202110,989,2453,798,2170,101,298,440,1089,541,1387
316550,202110,1414,3983,1204,3603,37,134,948,2809,985,2943
316553,202110,4695,13365,3399,10343,446,1490,1402,3737,1848,5227
316555,202110,2764,8169,2471,7769,82,262,2088,6596,2170,6858
316556,202110,546,1305,420,1082,24,67,263,604,287,671
316557,202110,1141,3379,987,3142,323,1129,350,1057,673,2186
316560,202110,356,980,258,834,40,149,104,313,144,462
316570,202110,1439,3956,1197,3533,291,847,400,1244,691,2091
316580,202110,414,859,262,618,37,93,134,295,171,388
316590,202110,1403,3496,978,2684,213,511,464,1250,677,1761
316600,202110,967,2896,832,2627,129,418,430,1360,559,1778
316610,202110,615,1862,504,1692,52,215,301,978,353,1193
316620,202110,2250,5642,1965,5235,88,242,1577,4179,1665,4421
316630,202110,1620,4712,1341,4194,354,1120,503,1753,857,2873
316640,202110,156,410,125,365,19,65,54,129,73,194
316650,202110,1104,3303,885,2964,81,291,562,1875,643,2166
316660,202110,204,477,88,246,11,34,20,40,31,74
316670,202110,1815,4488,1371,3789,348,1000,419,1123,767,2123
316680,202110,2396,5994,1776,4827,110,326,1290,3387,1400,3713
316690,202110,1482,4062,1123,3417,186,603,490,1439,676,2042
316695,202110,1053,2989,872,2664,32,114,603,1817,635,1931
316700,202110,416,921,342,838,14,40,276,651,290,691
316710,202110,3385,10512,2664,9033,435,1611,1237,4052,1672,5663
316720,202110,22251,58891,16629,48285,2710,8384,7396,20124,10106,28508
316730,202110,493,1247,396,1073,40,123,199,503,239,626
316740,202110,799,2233,692,2066,79,274,435,1304,514,1578
316750,202110,421,1177,321,995,71,238,133,382,204,620
316760,202110,3642,11267,3066,10155,1132,4097,820,2604,1952,6701
316770,202110,1672,3642,1265,3104,29,72,1020,2560,1049,2632
316780,202110,572,1635,448,1397,161,537,95,276,256,813
316790,202110,767,2029,562,1624,97,313,160,424,257,737
316800,202110,6797,18480,5431,16014,657,2085,2569,7385,3226,9470
316805,202110,1105,2368,885,2125,54,152,690,1649,744,1801
316810,202110,642,1744,464,1412,77,259,266,778,343,1037
316820,202110,337,789,187,526,17,64,87,231,104,295
316830,202110,864,2174,680,1881,73,195,413,1148,486,1343
316840,202110,2933,7281,2334,6306,173,565,1679,4326,1852,4891
316850,202110,2056,5186,1512,4253,222,681,715,1869,937,2550
316860,202110,21294,52767,15657,44298,2291,7528,7300,19898,9591,27426
316870,202110,8521,22297,6377,18232,867,2743,2998,7947,3865,10690
316880,202110,1031,2672,845,2401,141,454,447,1203,588,1657
316890,202110,1205,2655,734,2036,82,295,474,1238,556,1533
316900,202110,2475,6451,1951,5441,402,1186,621,1619,1023,2805
316905,202110,518,1517,415,1314,108,371,168,537,276,908
316910,202110,907,2312,552,1690,122,410,52,143,174,553
316920,202110,1862,4469,1324,3674,205,612,688,1854,893,2466
316930,202110,8605,23827,6528,20132,1500,4899,1872,5402,3372,10301
316935,202110,4412,11517,3250,9383,550,1751,1317,3466,1867,5217
316940,202110,6762,19273,5270,16263,754,2527,2292,6553,3046,9080
316950,202110,2020,4581,1570,3965,45,128,1314,3276,1359,3404
316960,202110,5333,11725,3848,9743,364,998,2624,6503,2988,7501
316970,202110,4057,10953,3492,9951,490,1417,1546,4151,2036,5568
316980,202110,719,2112,549,1789,163,598,81,268,244,866
316990,202110,13084,34150,9702,27398,2188,6667,1630,4191,3818,10858
317000,202110,2562,7318,2247,6877,193,448,1655,5182,1848,5630
317005,202110,2693,7277,2137,6178,334,1003,1147,3249,1481,4252
317010,202110,25770,59481,16413,45175,2943,8995,6638,18287,9581,27282
317020,202110,65882,154738,39555,109254,7028,21226,13033,33019,20061,54245
317030,202110,695,1798,546,1593,12,43,421,1216,433,1259
317040,202110,11620,28502,8158,22640,1723,5123,2818,8076,4541,13199
317043,202110,939,2040,678,1677,49,125,494,1196,543,1321
317047,202110,1204,2873,834,2281,65,198,538,1415,603,1613
317050,202110,1265,3810,917,3008,121,442,371,1038,492,1480
317052,202110,2498,6669,2000,5892,253,726,1260,3732,1513,4458
317057,202110,2090,4625,1538,3788,25,85,1123,2686,1148,2771
317060,202110,560,1446,349,1016,45,140,146,382,191,522
317065,202110,1190,3421,978,3017,64,179,610,1795,674,1974
317070,202110,7765,21183,5688,17185,929,3107,1953,5490,2882,8597
317075,202110,991,2492,742,2080,83,267,399,1029,482,1296
317080,202110,6606,15013,4902,12324,1221,3328,1753,4280,2974,7608
317090,202110,5007,13940,4417,12998,302,795,3263,9680,3565,10475
317100,202110,2720,6344,1776,4808,407,1127,645,1729,1052,2856
317103,202110,2356,5945,2017,5470,69,291,1618,4224,1687,4515
317107,202110,1535,3973,1170,3305,69,227,719,1832,788,2059
317110,202110,684,1580,356,1067,66,232,109,330,175,562
317115,202110,1112,3142,948,2834,69,203,623,1860,692,2063
317120,202110,17624,45788,14419,40598,1076,3589,9337,24951,10413,28540
317130,202110,12232,27720,8088,20967,1195,3401,2948,7513,4143,10914
317140,202110,960,2253,754,1939,49,139,518,1352,567,1491
317150,202110,1017,2399,780,2098,32,95,623,1646,655,1741
317160,202110,3745,8687,2502,6757,126,350,1376,3842,1502,4192
317170,202110,1894,4670,1398,3814,167,536,693,1675,860,2211
317180,202110,2076,6222,1517,4898,292,965,398,1150,690,2115
317190,202110,1229,3270,909,2743,207,611,399,1203,606,1814
317200,202110,6413,16610,4751,13332,989,2971,1184,3003,2173,5974
317210,202110,1248,2943,964,2559,29,107,707,1900,736,2007
317220,202110,290,848,245,763,44,147,119,367,163,514
320010,202110,4951,14031,3852,11790,415,1402,2347,6941,2762,8343
320013,202110,2197,5789,1524,4479,233,689,682,2106,915,2795
320016,202110,3122,7803,2455,6787,206,540,1751,4884,1957,5424
320020,202110,4359,11028,3231,9060,601,1876,1283,3640,1884,5516
320030,202110,1835,4988,1191,3698,208,696,414,1223,622,1919
320035,202110,2041,5364,1669,4742,374,1194,802,2162,1176,3356
320040,202110,4648,12762,3867,11352,530,1629,2154,6041,2684,7670
320050,202110,1802,4054,1555,3706,182,509,932,2145,1114,2654
320060,202110,14629,38774,10859,31142,1663,5140,4980,13176,6643,18316
320070,202110,1755,4702,1255,3712,199,663,496,1311,695,1974
320080,202110,6059,15183,4230,11548,836,2393,1553,3983,2389,6376
320090,202110,9121,23622,6041,17350,1335,4067,2156,5704,3491,9771
320100,202110,3362,8820,2751,7773,427,1294,1469,4129,1896,5423
320110,202110,2280,5209,1596,4130,192,540,861,2107,1053,2647
320115,202110,2199,6683,1875,6146,778,2675,547,1887,1325,4562
320120,202110,26382,65658,18598,51734,2513,7465,8892,23228,11405,30693
320130,202110,54041,143786,44370,126358,5186,16111,26594,72803,31780,88914
320140,202110,3912,10469,2637,7948,362,1275,1120,3243,1482,4518
320150,202110,15102,38094,10807,30043,2591,7929,1533,3741,4124,11670
320160,202110,6779,18224,5012,14879,763,2457,2192,6341,2955,8798
320170,202110,1885,5268,1354,4203,370,1128,481,1607,851,2735
320180,202110,725,2255,576,1969,191,711,146,438,337,1149
320190,202110,3096,9581,2382,8004,585,2124,560,1706,1145,3830
320200,202110,1419,3764,964,2946,213,719,294,866,507,1585
320210,202110,4654,11643,3570,9796,579,1708,1799,4670,2378,6378
320220,202110,3560,8937,2753,7617,385,1145,1521,3953,1906,5098
320225,202110,1462,4410,1039,3426,353,1254,212,679,565,1933
320230,202110,5574,14817,4216,12522,897,2859,1523,4408,2420,7267
320240,202110,18119,44681,13511,37310,3299,9921,3924,10675,7223,20596
320245,202110,3345,9595,2564,7984,847,2816,399,1195,1246,4011
320250,202110,2808,7436,1895,5360,405,1298,645,1559,1050,2857
320255,202110,2060,6174,1765,5634,451,1540,781,2497,1232,4037
320260,202110,1531,4193,937,2893,181,616,232,583,413,1199
320265,202110,2529,7636,2011,6579,842,2980,274,854,1116,3834
320270,202110,2368,6635,1824,5550,456,1509,600,1819,1056,3328
320280,202110,8195,21032,6670,18451,1285,3759,3407,9101,4692,12860
320290,202110,1444,4195,926,2969,231,806,217,643,448,1449
320300,202110,4245,12254,3378,10504,881,3038,1033,3000,1914,6038
320305,202110,5550,15198,4245,12652,767,2463,1992,5745,2759,8208
320310,202110,2422,6421,1693,4926,295,930,730,1979,1025,2909
320313,202110,2652,6389,1802,4847,343,1016,503,1173,846,2189
320316,202110,1734,4678,1335,4006,217,659,717,2149,934,2808
320320,202110,24163,61498,17170,49330,3965,11805,5921,17050,9886,28855
320330,202110,3093,8186,2402,6952,413,1237,1259,3665,1672,4902
320332,202110,8834,23128,6987,19678,1475,4500,3054,8271,4529,12771
320334,202110,1919,5271,1320,4041,262,952,320,741,582,1693
320335,202110,1682,4771,1177,3604,224,798,330,919,554,1717
320340,202110,5284,12739,4349,11369,528,1457,2499,6600,3027,8057
320350,202110,5778,13803,4081,10815,430,1258,2242,5516,2672,6774
320360,202110,1509,3814,1117,3085,136,373,527,1409,663,1782
320370,202110,2748,8166,2010,6588,603,2129,586,1869,1189,3998
320380,202110,2864,7370,2367,6571,280,841,1443,3903,1723,4744
320390,202110,8073,20932,5894,16625,1218,3682,2266,5955,3484,9637
320400,202110,3502,9660,2564,7658,714,2275,778,2178,1492,4453
320405,202110,5599,14137,4242,11750,594,1784,2214,5897,2808,7681
320410,202110,5098,12850,3826,10785,706,1911,1831,5405,2537,7316
320420,202110,3673,9146,2807,7701,561,1715,906,2336,1467,4051
320425,202110,2323,5466,1769,4531,150,387,1072,2682,1222,3069
320430,202110,3438,8474,2724,7220,404,1122,1612,4097,2016,5219
320435,202110,2365,7207,1820,6047,623,2216,549,1820,1172,4036
320440,202110,1647,4451,1221,3629,194,607,529,1482,723,2089
320450,202110,1928,5370,1501,4561,273,959,686,1921,959,2880
320455,202110,4781,14151,3220,10465,739,2626,792,2265,1531,4891
320460,202110,2276,6523,1643,5207,390,1352,426,1227,816,2579
320465,202110,1493,4046,1115,3327,190,566,557,1688,747,2254
320470,202110,3966,10579,2881,8328,588,1835,773,2020,1361,3855
320480,202110,2054,5203,1657,4539,187,565,1056,2794,1243,3359
320490,202110,25590,63295,19203,52237,3153,8906,8405,22600,11558,31506
320495,202110,1470,3945,1067,3152,251,846,307,831,558,1677
320500,202110,56907,147848,45495,128264,5945,18230,26652,71606,32597,89836
320501,202110,4952,14049,3689,11724,996,3555,1073,3314,2069,6869
320503,202110,2457,6888,1578,5051,462,1586,365,1135,827,2721
320506,202110,2873,8447,2096,6711,633,2174,171,551,804,2725
320510,202110,11890,30955,9671,27200,987,3130,6021,16157,7008,19287
320515,202110,1897,5123,1473,4256,382,1222,477,1298,859,2520
320517,202110,2307,6742,1844,5746,543,1846,587,1780,1130,3626
320520,202110,41619,104344,31226,86776,4880,14987,13711,36155,18591,51142
320530,202110,36888,93984,29134,80337,2377,7670,18520,47814,20897,55484
330010,202110,26015,65309,21639,58223,2274,6760,15083,39148,17357,45908
330015,202110,1486,3522,1175,3070,199,580,670,1676,869,2256
330020,202110,20998,51128,17670,46365,2404,6884,12198,31379,14602,38263
330022,202110,2036,5340,1600,4639,253,722,854,2483,1107,3205
330023,202110,5955,13500,4530,11555,640,1800,2773,6857,3413,8657
330025,202110,7617,17000,4675,12222,934,2701,1261,3030,2195,5731
330030,202110,11052,28600,8491,24535,760,2569,5425,14874,6185,17443
330040,202110,16434,41312,13242,36052,955,2967,9304,24220,10259,27187
330045,202110,91820,209040,75876,188953,5632,13601,60661,150393,66293,163994
330050,202110,2950,7478,2240,6303,399,1229,1180,3122,1579,4351
330060,202110,5751,14503,4498,12296,820,2516,1927,4790,2747,7306
330070,202110,25614,61690,20792,54872,2855,8137,12914,33555,15769,41692
330080,202110,9539,23056,8122,21090,961,2657,5586,14267,6547,16924
330090,202110,3545,7283,2505,5875,143,353,1791,4195,1934,4548
330093,202110,2914,6792,2202,5818,133,369,1670,4367,1803,4736
330095,202110,1511,4016,1176,3410,127,395,676,1821,803,2216
330100,202110,76882,194954,65844,178911,3413,10919,51369,137067,54782,147986
330110,202110,2186,5921,1759,5228,243,788,1056,3033,1299,3821
330115,202110,2746,6423,1954,5200,272,799,1079,2760,1351,3559
330120,202110,3828,8103,2909,6950,206,566,2141,4886,2347,5452
330130,202110,4659,12161,3812,10912,480,1413,2432,6897,2912,8310
330140,202110,4125,10172,3302,9025,367,1152,2269,5981,2636,7133
330150,202110,2470,6294,1925,5435,325,923,981,2685,1306,3608
330160,202110,1455,3822,1082,3165,206,629,569,1587,775,2216
330170,202110,122625,290557,99189,259158,13094,33411,67469,178059,80563,211470
330180,202110,2107,4865,1630,4215,90,266,1156,2903,1246,3169
330185,202110,10914,26106,9133,23667,467,1447,7437,18806,7904,20253
330187,202110,4994,12021,3938,10312,552,1498,2368,6115,2920,7613
330190,202110,38689,88924,32755,80825,1980,5250,26365,64080,28345,69330
330200,202110,17704,42879,14440,38850,2725,6822,9101,25323,11826,32145
330205,202110,2388,5695,1811,4770,133,373,1231,3106,1364,3479
330210,202110,3542,8442,2606,6849,337,921,1364,3396,1701,4317
330220,202110,13537,32192,9695,25842,1752,5266,3917,9595,5669,14861
330225,202110,4223,10214,3224,8723,201,654,2321,6111,2522,6765
330227,202110,18395,42726,15379,39067,682,1692,13107,33060,13789,34752
330230,202110,2285,4899,1510,3901,139,390,839,2144,978,2534
330240,202110,26196,65032,21904,58559,2054,6235,15648,40514,17702,46749
330245,202110,1847,4422,1118,3158,230,623,400,1137,630,1760
330250,202110,42633,104017,35159,93061,5206,14257,22517,58888,27723,73145
330260,202110,5489,12607,4185,10840,298,907,3152,7868,3450,8775
330270,202110,35192,78117,21671,55852,3130,8699,9212,22307,12342,31006
330280,202110,2559,6369,1944,5354,204,603,1178,3108,1382,3711
330285,202110,27595,63051,21849,54878,1235,3656,16820,40781,18055,44437
330290,202110,4379,10164,3511,9016,318,954,2582,6360,2900,7314
330300,202110,6199,14067,4584,11802,330,934,3256,8140,3586,9074
330310,202110,2876,6781,2067,5475,158,346,1388,3666,1546,4012
330320,202110,18736,42045,14546,36821,1726,3917,10357,26707,12083,30624
330330,202110,47121,98886,36836,85016,2938,7412,26803,60138,29741,67550
330340,202110,19667,44893,14183,36479,1985,5835,7522,17908,9507,23743
330350,202110,159722,353649,132435,320619,7446,18671,110931,266115,118377,284786
330360,202110,7723,18292,6594,16929,226,525,5596,14346,5822,14871
330370,202110,5422,14850,4182,12773,942,2895,1764,5569,2706,8464
330380,202110,6139,15426,4683,12941,595,1996,2696,6985,3291,8981
330385,202110,4348,11857,3565,10728,723,2405,1819,5309,2542,7714
330390,202110,29481,75616,22710,64337,2770,9034,13856,36781,16626,45815
330395,202110,3470,8178,2825,7363,147,451,2132,5396,2279,5847
330400,202110,3655,9253,3113,8411,143,511,2377,6046,2520,6557
330410,202110,3628,9180,2604,7438,483,1502,1217,3226,1700,4728
330411,202110,3044,7985,2380,6791,149,501,1668,4534,1817,5035
330412,202110,1757,4732,1440,4212,127,410,955,2646,1082,3056
330414,202110,26045,63061,21283,56561,1451,4109,16234,42318,17685,46427
330415,202110,5159,13349,3869,11097,398,1183,2201,6139,2599,7322
330420,202110,13560,32447,9767,26377,1020,3141,5480,13671,6500,16812
330430,202110,10288,23784,8666,21600,267,826,7059,17078,7326,17904
330440,202110,2990,7521,2277,6335,264,840,1419,3788,1683,4628
330450,202110,1532,4164,1215,3631,148,473,679,1975,827,2448
330452,202110,19602,47752,15705,41748,1750,5269,10374,26452,12124,31721
330455,202110,610888,1393032,479225,1207211,59468,159626,320222,788206,379690,947832
330460,202110,1215,3185,911,2759,155,502,485,1432,640,1934
330470,202110,5700,13553,4068,11037,1145,3225,1185,3247,2330,6472
330475,202110,10518,25821,8515,23251,1223,3872,5550,14629,6773,18501
330480,202110,6291,15757,5275,14279,420,1224,3679,9652,4099,10876
330490,202110,121712,270671,98912,240142,10743,26737,70806,169912,81549,196649
330500,202110,8342,19606,6914,17690,624,1775,5044,12601,5668,14376
330510,202110,44991,106605,33774,90924,4893,14240,21392,56399,26285,70639
330513,202110,1353,3322,1096,2987,212,587,595,1666,807,2253
330515,202110,2684,6955,2160,6222,348,1125,1257,3475,1605,4600
330520,202110,12613,31841,10364,28413,1098,3348,6801,18058,7899,21406
330530,202110,1804,4249,1320,3538,241,702,625,1667,866,2369
330540,202110,3062,7804,2351,6600,610,1744,855,2381,1465,4125
330550,202110,10889,25759,8398,22524,1949,5800,4054,10597,6003,16397
330555,202110,20108,40594,16706,36636,734,1717,13987,30919,14721,32636
330560,202110,4375,11081,3528,9707,549,1520,2097,5631,2646,7151
330570,202110,2887,7591,2474,6999,397,1210,1599,4486,1996,5696
330575,202110,5941,14769,5106,13370,314,907,4126,10473,4440,11380
330580,202110,20230,51421,16006,43933,2365,7072,8567,22165,10932,29237
330590,202110,1573,4050,1300,3694,242,680,794,2315,1036,2995
330600,202110,13646,34207,11040,30028,877,2758,7297,19125,8174,21883
330610,202110,10161,26088,8185,23012,758,2357,5492,15072,6250,17429
330615,202110,2227,5881,1765,5265,334,1003,1094,3339,1428,4342
330620,202110,4464,12137,3509,10513,700,2234,1532,4317,2232,6551
330630,202110,27352,66355,21464,57203,1260,3944,15470,39684,16730,43628
350010,202110,2272,5917,1296,3851,262,843,271,601,533,1444
350020,202110,747,1858,431,1260,48,153,146,396,194,549
350030,202110,3812,10261,2913,8739,662,2219,1369,3774,2031,5993
350040,202110,800,2231,461,1507,62,231,142,347,204,578
350050,202110,1525,3661,1020,2804,214,660,357,803,571,1463
350055,202110,974,2513,775,2204,92,280,461,1243,553,1523
350060,202110,251,628,145,411,19,62,61,162,80,224
350070,202110,3462,8988,2291,6873,453,1476,796,2114,1249,3590
350075,202110,647,1808,486,1501,168,549,71,227,239,776
350080,202110,695,1780,471,1394,58,195,196,529,254,724
350090,202110,624,1446,380,1033,66,191,158,400,224,591
350100,202110,2554,6566,1789,5251,106,393,1142,3120,1248,3513
350110,202110,515,1255,358,986,20,59,218,589,238,648
350115,202110,1273,3572,1035,3095,164,550,527,1402,691,1952
350120,202110,692,1583,392,1051,32,102,216,512,248,614
350130,202110,3390,8776,2660,7443,475,1347,1274,3338,1749,4685
350140,202110,811,2192,571,1748,46,187,303,838,349,1025
350150,202110,562,1655,452,1443,97,305,133,396,230,701
350160,202110,12182,30480,8336,23333,1056,3328,4918,12962,5974,16290
350170,202110,2638,7222,2198,6284,328,1049,1145,2949,1473,3998
350180,202110,1047,2498,578,1645,84,257,210,545,294,802
350190,202110,3107,8658,2100,6440,347,1221,920,2379,1267,3600
350200,202110,485,1332,369,1112,20,65,241,676,261,741
350210,202110,6382,14525,4387,11424,471,1364,2747,6785,3218,8149
350220,202110,3106,8352,2120,6429,420,1315,714,1949,1134,3264
350230,202110,1050,2611,869,2361,157,458,496,1298,653,1756
350240,202110,680,1912,437,1347,99,318,109,290,208,608
350250,202110,3386,9087,2474,7554,629,2060,731,2174,1360,4234
350260,202110,891,2011,573,1496,62,179,342,836,404,1015
350270,202110,4898,12638,3886,10756,517,1608,2148,5437,2665,7045
350275,202110,2607,6806,2073,6006,293,930,1303,3613,1596,4543
350280,202110,19689,44184,12173,32025,1832,5055,5158,12848,6990,17903
350290,202110,3317,8990,2280,6878,404,1322,919,2555,1323,3877
350300,202110,677,1770,507,1455,59,173,290,773,349,946
350310,202110,1012,2796,753,2295,113,401,330,917,443,1318
350315,202110,631,1527,423,1186,26,81,228,581,254,662
350320,202110,16663,41784,12305,34134,2316,7121,5090,12977,7406,20098
350330,202110,14978,35848,10860,28190,1070,3078,6971,17014,8041,20092
350335,202110,401,1104,309,931,37,125,146,413,183,538
350340,202110,1265,3165,787,2293,121,412,338,869,459,1281
350350,202110,774,1891,598,1700,64,210,373,1043,437,1253
350360,202110,1122,3253,858,2718,201,653,293,935,494,1588
350370,202110,721,1756,511,1360,165,417,167,428,332,845
350380,202110,4777,12871,3434,10092,990,2849,911,2718,1901,5567
350390,202110,11668,29678,9221,25620,1560,4592,4831,12783,6391,17375
350395,202110,464,1150,240,725,25,76,90,242,115,318
350400,202110,8760,20921,6132,16670,1522,4406,1672,4470,3194,8876
350410,202110,10964,29738,8114,24351,1551,5131,3243,8950,4794,14081
350420,202110,913,2386,619,1771,91,273,160,390,251,663
350430,202110,742,1910,593,1684,74,236,355,934,429,1170
350440,202110,2176,5281,1767,4682,136,373,1147,2964,1283,3337
350450,202110,6804,18451,5248,15751,1108,3652,2140,6009,3248,9661
350460,202110,1968,4990,1128,3305,165,503,407,1073,572,1576
350470,202110,267,678,209,579,10,33,150,401,160,434
350480,202110,1044,2493,690,1906,133,418,184,415,317,833
350490,202110,2071,5262,1466,4288,315,962,475,1247,790,2209
350500,202110,692,1832,508,1507,56,187,232,651,288,838
350510,202110,1279,3172,963,2622,99,300,588,1513,687,1813
350520,202110,2378,6925,1856,5942,264,949,821,2358,1085,3307
350530,202110,3091,7664,2338,6232,241,734,1387,3410,1628,4144
350535,202110,1576,4162,1355,3851,183,566,842,2326,1025,2892
350540,202110,2115,4779,1586,4025,172,436,1030,2514,1202,2950
350550,202110,8933,21687,6213,17168,637,2096,3573,9039,4210,11135
350560,202110,3991,10879,3196,9530,266,855,2095,6015,2361,6870
350570,202110,27112,73500,22049,64073,3714,11955,11540,31877,15254,43832
350580,202110,2211,5752,1374,4059,357,1145,280,676,637,1821
350590,202110,5286,13954,3884,10875,493,1568,2295,5911,2788,7479
350600,202110,36864,84125,23160,60655,3314,9861,10768,25673,14082,35534
350610,202110,7415,19645,5279,15522,789,2579,2637,7221,3426,9800
350620,202110,452,1122,275,834,23,69,154,435,177,504
350630,202110,1622,3983,1192,3249,79,277,786,1963,865,2240
350635,202110,10385,24694,7690,20450,935,2734,4786,12110,5721,14844
350640,202110,967,2544,509,1542,78,227,142,376,220,603
350650,202110,9216,23934,6388,18458,1105,3458,2577,6874,3682,10332
350660,202110,4785,12113,3700,10327,574,1562,2042,5719,2616,7281
350670,202110,1858,4914,1514,4409,191,560,947,2768,1138,3328
350680,202110,1144,3035,786,2386,135,436,327,940,462,1376
350690,202110,1367,3480,968,2800,150,480,515,1440,665,1920
350700,202110,5120,12684,3759,10571,803,2547,1644,4410,2447,6957
350710,202110,3061,8141,2582,7302,445,1421,1363,3536,1808,4957
350715,202110,810,2260,683,2050,103,365,341,919,444,1284
350720,202110,166,430,123,359,18,51,44,112,62,163
350730,202110,658,1773,551,1584,30,103,398,1079,428,1182
350740,202110,1817,4684,1256,3594,213,657,456,1178,669,1835
350745,202110,626,1534,359,1047,30,116,158,404,188,520
350750,202110,10893,27908,8494,23734,1419,4607,4031,10112,5450,14719
350760,202110,16089,39033,11755,31624,2225,6671,5304,12749,7529,19420
350770,202110,1141,2734,694,1962,50,156,425,1156,475,1312
350775,202110,744,1697,516,1363,62,158,259,695,321,853
350780,202110,2539,5988,1836,4989,333,1049,603,1908,936,2957
350790,202110,2207,5764,1414,4281,259,796,397,1004,656,1800
350800,202110,3723,10388,3191,9473,255,857,2222,6364,2477,7221
350810,202110,3071,7238,2337,6180,436,1070,1042,2803,1478,3873
350820,202110,1004,2305,583,1564,77,239,271,651,348,890
350830,202110,911,2462,524,1624,78,248,153,388,231,636
350840,202110,3553,10193,2706,8622,569,2053,1206,3484,1775,5537
350850,202110,8535,22828,6731,19583,1263,3971,3386,9221,4649,13192
350860,202110,3827,9907,3288,9177,109,389,2560,7077,2669,7466
350870,202110,2762,7510,2066,6391,251,861,1203,3605,1454,4466
350880,202110,1438,3962,1139,3385,290,915,282,786,572,1701
350890,202110,562,1451,360,1031,53,161,135,338,188,499
350900,202110,8633,22561,5751,16630,1021,3193,2393,6315,3414,9508
350910,202110,967,2279,818,2057,94,247,588,1449,682,1696
350920,202110,12970,31216,10996,28074,403,1275,9119,22412,9522,23687
350925,202110,4329,11444,3113,9306,546,1780,1516,4164,2062,5944
350930,202110,1544,3943,1083,3065,72,211,673,1844,745,2055
350940,202110,2355,6056,1811,5175,177,584,1146,3092,1323,3676
350945,202110,919,2523,710,2123,107,341,364,999,471,1340
350950,202110,96573,242064,74755,201757,9009,26481,46698,120060,55707,146541
350960,202110,6737,17859,5205,15031,642,2088,3070,8410,3712,10498
350970,202110,3691,10062,2644,8161,747,2538,602,1574,1349,4112
350980,202110,689,1820,551,1562,129,388,253,703,382,1091
350990,202110,1929,5195,1447,4425,315,1079,539,1569,854,2648
350995,202110,873,2645,787,2474,60,219,545,1649,605,1868
351000,202110,3055,7942,2069,6070,397,1216,700,2003,1097,3219
351010,202110,389,942,245,699,27,86,119,321,146,407
351015,202110,917,2681,750,2330,115,389,352,986,467,1375
351020,202110,9066,24099,6901,20434,1575,4563,3083,8991,4658,13554
351030,202110,3027,8731,2412,7525,337,1159,1328,3979,1665,5138
351040,202110,5363,13018,4494,11725,218,666,3692,9370,3910,10036
351050,202110,17729,42265,12981,35043,2366,6760,6088,16125,8454,22885
351060,202110,52005,127723,39994,107500,3772,11264,27284,70529,31056,81793
351070,202110,1427,3473,798,2411,197,638,124,366,321,1004
351080,202110,2862,6773,2067,5828,207,678,1387,3725,1594,4403
351090,202110,339,947,251,789,48,149,74,241,122,390
351100,202110,2850,7482,1879,5567,387,1209,524,1540,911,2749
351110,202110,6479,16229,4311,12307,655,2094,1974,5243,2629,7337
351120,202110,772,1983,543,1588,71,222,202,567,273,789
351130,202110,1185,3018,562,1697,95,299,149,408,244,707
351140,202110,2375,6452,1781,5342,347,1167,786,2063,1133,3230
351150,202110,2941,8205,1997,6196,265,906,744,2069,1009,2975
351160,202110,1149,3478,837,2761,156,562,202,530,358,1092
351170,202110,1401,3784,1196,3429,89,288,845,2322,934,2610
351190,202110,1073,2926,737,2255,139,420,267,774,406,1194
351200,202110,1678,3921,1256,3319,94,285,895,2222,989,2507
351210,202110,1665,4005,1060,2891,76,245,622,1546,698,1791
351220,202110,3528,9608,3025,8792,281,821,2056,5885,2337,6706
351230,202110,1982,5180,1489,4321,270,889,715,1856,985,2745
351240,202110,2562,6389,1587,4403,357,1080,533,1306,890,2386
351250,202110,1150,2959,682,2028,64,202,266,779,330,981
351260,202110,955,2327,693,1855,158,432,235,585,393,1017
351270,202110,546,1445,387,1121,42,143,189,473,231,616
351280,202110,4108,10493,3173,8778,626,1776,1364,3634,1990,5410
351290,202110,1310,3203,927,2539,120,368,574,1490,694,1858
351300,202110,20225,53137,14195,41778,2353,7515,6475,18013,8828,25528
351310,202110,3705,8849,2830,7495,143,479,2114,5312,2257,5791
351320,202110,997,2798,724,2257,124,419,235,638,359,1057
351330,202110,505,1221,411,1048,22,73,284,635,306,708
351340,202110,6663,18274,5379,16014,1268,3892,2434,7192,3702,11084
351350,202110,12527,30527,10369,27138,911,2573,7682,19457,8593,22030
351360,202110,4024,10415,3315,9371,667,2059,1516,3953,2183,6012
351370,202110,2134,5805,1432,4349,313,1036,434,1185,747,2221
351380,202110,50318,118664,35692,93569,4076,11521,21279,53060,25355,64581
351385,202110,428,1076,177,533,25,70,57,148,82,218
351390,202110,1405,3360,874,2583,114,392,510,1414,624,1806
351400,202110,1020,2747,841,2398,97,280,550,1512,647,1792
351410,202110,2799,7583,2007,6044,342,1022,780,2283,1122,3305
351420,202110,513,1219,293,834,38,98,168,445,206,543
351430,202110,996,2598,798,2273,60,170,567,1569,627,1739
351440,202110,3638,9371,2419,6922,434,1322,663,1613,1097,2935
351450,202110,1831,4744,1223,3636,245,820,234,506,479,1326
351460,202110,944,2385,748,2083,145,408,433,1188,578,1596
351470,202110,1271,3149,1006,2720,79,270,674,1699,753,1969
351480,202110,2651,7536,2073,6563,365,1266,918,2681,1283,3947
351490,202110,2132,5837,1837,5311,59,237,1516,4244,1575,4481
351492,202110,363,966,303,838,7,21,232,624,239,645
351495,202110,207,518,161,433,15,36,98,261,113,297
351500,202110,41948,100077,32012,83766,4378,12019,19855,49689,24233,61708
351510,202110,13206,31898,9595,25856,1075,3333,6080,15571,7155,18904
351512,202110,516,1354,378,1055,68,196,127,326,195,522
351515,202110,3426,7630,2147,5594,370,1085,596,1623,966,2708
351518,202110,2650,6526,1750,4953,224,728,945,2347,1169,3075
351519,202110,682,1833,421,1320,76,246,68,187,144,433
351520,202110,1375,3364,618,1829,56,190,296,784,352,974
351530,202110,364,932,211,611,37,115,94,227,131,342
351535,202110,1911,4607,1379,3693,213,608,691,1744,904,2352
351540,202110,2803,6791,1895,5189,217,690,856,2053,1073,2743
351550,202110,7649,18683,5208,14310,498,1555,2956,7490,3454,9045
351560,202110,471,1329,364,1118,79,259,109,304,188,563
351565,202110,264,738,210,635,40,134,55,136,95,270
351570,202110,23068,59533,17639,48939,1690,5089,11255,29868,12945,34957
351580,202110,238,604,136,419,16,45,59,187,75,232
351590,202110,525,1171,274,733,23,86,161,383,184,469
351600,202110,1402,3709,1077,3094,122,383,592,1579,714,1962
351610,202110,800,1857,501,1332,31,84,288,716,319,800
351620,202110,25124,64716,18369,53310,2774,9170,8638,22636,11412,31806
351630,202110,30453,77099,24550,67212,2980,8813,16032,42040,19012,50853
351640,202110,18736,47557,14733,40497,1320,4256,10111,26357,11431,30613
351650,202110,380,1002,188,596,26,84,55,156,81,240
351660,202110,776,2096,505,1540,76,232,108,286,184,518
351670,202110,6414,16839,4221,12148,913,2595,1706,4584,2619,7179
351680,202110,446,1228,294,901,37,124,83,205,120,329
351685,202110,407,1156,329,1033,87,277,110,327,197,604
351690,202110,1206,2974,671,1931,90,301,307,780,397,1081
351700,202110,1377,3363,1009,2744,208,573,484,1233,692,1806
351710,202110,815,2141,600,1746,57,191,334,877,391,1068
351720,202110,1547,3903,1034,3012,162,517,432,1151,594,1668
351730,202110,1002,2562,824,2292,71,219,496,1317,567,1536
351740,202110,3628,8934,2902,7562,485,1383,1501,3549,1986,4932
351750,202110,1608,4022,954,2853,155,500,411,1147,566,1647
351760,202110,3464,9466,2586,7795,484,1660,1080,2929,1564,4589
351770,202110,1966,5510,1590,4811,256,829,919,2656,1175,3485
351780,202110,1247,3089,745,2175,103,362,296,784,399,1146
351790,202110,1439,3407,1149,3020,175,477,670,1777,845,2254
351800,202110,542,1220,273,716,31,83,109,240,140,323
351810,202110,1137,2928,946,2647,69,177,639,1709,708,1886
351820,202110,2827,7709,2024,6157,496,1647,503,1388,999,3035
351830,202110,4769,12444,3672,10549,304,999,2347,6407,2651,7406
351840,202110,9450,25082,7150,20898,895,2980,4040,10925,4935,13905
351850,202110,1611,4352,1058,3243,148,510,374,958,522,1468
351860,202110,2829,7925,2172,6721,318,1106,1212,3708,1530,4814
351870,202110,25493,63286,19014,52713,4405,12700,7869,21830,12274,34530
351880,202110,146376,364772,110713,304342,21073,64482,57652,149263,78725,213745
351885,202110,970,2535,755,2184,53,187,510,1409,563,1596
351890,202110,904,2310,572,1756,110,357,115,308,225,665
351900,202110,1208,3103,915,2665,123,343,548,1588,671,1931
351905,202110,476,1300,338,1029,30,102,172,466,202,568
351907,202110,22649,58060,17736,49458,1882,5903,11514,30572,13396,36475
351910,202110,1767,4435,1254,3369,93,281,745,1788,838,2069
351920,202110,939,2479,709,2023,109,345,298,768,407,1113
351925,202110,942,2429,721,2036,90,294,380,988,470,1282
351930,202110,3416,9280,3050,8617,530,1535,2086,5785,2616,7320
351940,202110,1133,2850,819,2301,127,393,400,1106,527,1499
351950,202110,1787,3942,1354,3316,65,192,986,2313,1051,2505
351960,202110,5383,13297,3936,10752,893,2603,1713,4372,2606,6975
351970,202110,7935,22450,6301,19648,923,3289,3564,10615,4487,13904
351980,202110,1085,2538,711,1926,91,291,403,978,494,1269
351990,202110,1553,3614,1134,2989,49,175,570,1332,619,1507
352000,202110,2822,7813,2437,7022,254,832,1633,4411,1887,5243
352010,202110,2467,6373,2002,5617,518,1633,447,1266,965,2899
352020,202110,1479,3959,1138,3379,161,542,566,1562,727,2104
352030,202110,6204,15946,4849,13725,809,2484,2559,6943,3368,9427
352040,202110,3803,9618,2690,7437,438,1316,990,2404,1428,3720
352042,202110,3454,8105,2349,6372,374,1152,1207,3100,1581,4252
352044,202110,2207,5714,1301,3998,188,642,273,774,461,1416
352050,202110,13708,35671,9120,26706,2071,6922,1876,4685,3947,11607
352060,202110,782,2057,581,1685,95,299,253,663,348,962
352070,202110,967,1945,630,1505,58,157,344,746,402,903
352080,202110,499,1257,292,847,32,107,98,255,130,362
352090,202110,1605,4612,1331,4090,157,556,648,1793,805,2349
352100,202110,3641,9982,2898,8576,569,1841,1286,3633,1855,5474
352110,202110,676,1908,504,1568,101,325,204,587,305,912
352115,202110,575,1515,479,1361,65,206,282,786,347,992
352120,202110,932,2653,749,2294,73,194,451,1288,524,1482
352130,202110,2185,5913,1453,4174,225,639,606,1639,831,2278
352140,202110,1191,3209,851,2541,143,439,376,1089,519,1528
352150,202110,940,2439,729,2088,80,247,500,1387,580,1634
352160,202110,1060,2566,770,2104,65,219,436,1142,501,1361
352170,202110,3155,8214,2520,7003,269,830,1640,4277,1909,5107
352180,202110,2494,6560,1868,5448,426,1392,577,1491,1003,2883
352190,202110,1316,3481,1052,3080,182,467,543,1654,725,2121
352200,202110,338,1011,241,818,30,113,88,297,118,410
352210,202110,21388,48903,16734,42638,923,2648,13135,32656,14058,35304
352215,202110,712,1804,590,1612,86,251,331,872,417,1123
352220,202110,24011,57304,17075,45433,2718,8028,8855,21466,11573,29494
352230,202110,15912,44196,12316,37527,2856,9643,4351,12135,7207,21778
352240,202110,10543,26564,8057,22502,1708,5344,3526,9166,5234,14510
352250,202110,24596,66639,19767,58505,2817,8990,12344,35678,15161,44668
352260,202110,5214,12740,3560,9583,525,1621,2058,4959,2583,6580
352265,202110,974,2656,859,2490,108,332,580,1624,688,1956
352270,202110,1530,4452,1133,3619,232,788,395,1166,627,1954
352280,202110,2507,6161,1884,5271,200,655,1124,2941,1324,3596
352290,202110,1348,3740,1075,3232,134,434,572,1548,706,1982
352300,202110,931,2429,635,1825,82,273,344,922,426,1195
352310,202110,44028,114677,33023,95815,7454,22243,15148,43874,22602,66117
352320,202110,7018,17707,5448,14794,717,2190,3046,7428,3763,9618
352330,202110,2409,6127,1848,5340,270,923,1093,2927,1363,3850
352340,202110,6758,17445,5071,14379,764,2455,2584,6710,3348,9165
352350,202110,2387,6549,1866,5418,156,542,1174,3180,1330,3722
352360,202110,1355,3527,1099,3078,86,279,807,2164,893,2443
352370,202110,1137,3134,982,2879,17,69,802,2301,819,2370
352380,202110,881,2330,659,1944,141,422,222,629,363,1051
352390,202110,15700,37955,10747,29260,1701,5041,5867,15024,7568,20065
352400,202110,3747,10229,3036,8900,612,2077,1375,3753,1987,5830
352410,202110,3602,9026,2755,7620,228,744,1725,4559,1953,5303
352420,202110,882,2155,639,1810,128,392,242,639,370,1031
352430,202110,8729,21063,6366,16976,1072,3261,3305,8245,4377,11506
352440,202110,19889,52831,14938,43343,3416,10271,5394,15065,8810,25336
352450,202110,803,1916,417,1265,59,198,157,448,216,646
352460,202110,3207,8507,2259,6830,432,1404,968,2753,1400,4157
352470,202110,3491,8748,2677,7432,276,895,1695,4427,1971,5322
352480,202110,4438,10338,2981,7768,417,1290,1460,3310,1877,4600
352490,202110,824,2313,658,2020,107,360,301,861,408,1221
352500,202110,11075,27999,7554,21471,2894,9068,952,1555,3846,10623
352510,202110,4114,11040,3095,9221,557,1767,1528,4376,2085,6143
352520,202110,3064,7771,2376,6636,384,1221,1376,3497,1760,4718
352530,202110,11642,29234,7966,22362,1316,4172,2991,7158,4307,11330
352540,202110,616,1766,462,1447,66,219,170,480,236,699
352550,202110,1047,2818,735,2238,120,409,262,714,382,1123
352560,202110,617,1668,481,1415,67,217,270,729,337,946
352570,202110,2531,7032,1650,5157,349,1202,207,465,556,1667
352580,202110,643,1647,536,1451,44,136,370,953,414,1089
352585,202110,357,940,260,769,18,70,165,439,183,509
352590,202110,13875,35688,9817,28115,2259,7093,4646,12302,6905,19395
352600,202110,1985,5313,1562,4552,144,456,991,2740,1135,3196
352610,202110,2915,7907,2184,6665,421,1448,914,2591,1335,4039
352620,202110,5933,14602,4502,12570,1232,3472,1825,5140,3057,8612
352630,202110,887,2139,665,1824,110,347,317,813,427,1160
352640,202110,3177,7987,2304,6436,231,654,1337,3556,1568,4210
352650,202110,631,1741,438,1330,60,200,169,475,229,675
352660,202110,1147,3281,950,2881,100,327,587,1716,687,2043
352670,202110,10314,27204,7021,20793,1577,5151,2326,6235,3903,11386
352680,202110,3416,9753,2397,7484,382,1394,1104,3023,1486,4417
352690,202110,28883,70978,22721,60713,1251,3943,16461,42140,17712,46083
352700,202110,697,1713,520,1461,126,396,190,515,316,911
352710,202110,5544,14023,3975,11193,944,2885,1648,4314,2592,7199
352720,202110,8717,22837,6806,19338,2203,6485,2144,5688,4347,12173
352725,202110,605,1409,346,948,22,61,186,478,208,539
352730,202110,5679,16437,5130,15200,601,1919,2326,5951,2927,7870
352740,202110,2441,5769,1850,4900,179,555,1116,2764,1295,3319
352750,202110,452,1119,282,817,42,138,118,290,160,428
352760,202110,1810,4869,1407,4091,116,326,803,2328,919,2654
352770,202110,954,2492,673,1954,119,360,283,780,402,1140
352780,202110,686,1897,486,1488,101,277,122,395,223,672
352790,202110,465,1198,346,971,31,91,147,362,178,453
352800,202110,1377,4032,955,3067,236,786,143,362,379,1148
352810,202110,1258,2913,811,2140,154,419,446,1126,600,1545
352820,202110,472,1303,346,1079,68,215,74,209,142,424
352830,202110,616,1530,297,878,27,82,85,208,112,290
352840,202110,4168,11549,3400,10176,991,3262,1247,3508,2238,6770
352850,202110,11692,27866,8127,22136,2009,6037,2885,6970,4894,13007
352860,202110,1118,3042,854,2572,144,469,329,931,473,1400
352870,202110,909,2222,635,1687,54,160,393,995,447,1155
352880,202110,1802,4243,1256,3279,203,549,566,1422,769,1971
352885,202110,321,856,248,734,27,79,145,414,172,493
352890,202110,727,1735,478,1223,49,140,278,614,327,754
352900,202110,19164,48921,12688,36201,1981,5943,5420,14424,7401,20367
352910,202110,425,1108,246,736,24,73,88,222,112,295
352920,202110,2793,6999,2073,5800,116,370,1445,3886,1561,4256
352930,202110,6068,16076,4569,13166,792,2519,2203,5912,2995,8431
352940,202110,23811,62402,17643,49886,3049,9388,8839,23366,11888,32754
352950,202110,592,1535,369,1117,88,275,80,220,168,495
352960,202110,786,2050,466,1394,69,230,135,317,204,547
352965,202110,237,657,153,489,40,125,42,122,82,247
352970,202110,3101,7293,2398,6142,217,612,1638,4101,1855,4713
352980,202110,1415,3617,1111,3170,252,805,568,1563,820,2368
352990,202110,4504,12029,3390,10181,628,2061,1698,4897,2326,6958
353000,202110,505,1333,293,847,40,128,76,169,116,297
353010,202110,2743,6671,1817,4972,333,1066,796,1952,1129,3018
353020,202110,3699,9398,2214,6366,305,967,775,2092,1080,3059
353030,202110,4812,11873,3337,9357,726,2215,964,2542,1690,4757
353040,202110,692,1564,485,1256,114,289,216,539,330,828
353050,202110,5466,15173,3899,12015,716,2365,1798,5283,2514,7648
353060,202110,51099,127757,42267,113773,2785,8797,31994,83124,34779,91921
353070,202110,10553,29337,7745,23340,1324,4394,3454,9442,4778,13836
353080,202110,4596,12237,3031,9235,538,1882,1162,3039,1700,4921
353090,202110,635,1839,512,1592,30,100,328,977,358,1077
353100,202110,311,819,146,458,23,72,40,102,63,174
353110,202110,7759,19850,6211,17686,1409,4131,2945,8811,4354,12942
353120,202110,430,1054,329,884,40,132,170,400,210,532
353130,202110,2743,6269,1736,4544,404,1185,625,1440,1029,2625
353140,202110,2852,6959,2095,5698,94,311,1518,3958,1612,4269
353150,202110,1663,4033,1191,3266,249,702,489,1275,738,1977
353160,202110,661,1686,472,1371,61,174,212,564,273,738
353170,202110,562,1461,417,1256,77,243,194,596,271,839
353180,202110,10688,25576,8425,21964,1149,3156,5581,14023,6730,17179
353190,202110,3593,9445,2887,8034,376,1120,1681,4347,2057,5467
353200,202110,1890,4958,1079,3335,164,572,343,942,507,1514
353205,202110,434,1277,364,1127,57,184,174,521,231,705
353210,202110,942,2107,616,1587,22,55,438,1095,460,1150
353215,202110,403,1064,319,915,47,147,150,397,197,544
353220,202110,764,2011,500,1479,94,279,89,251,183,530
353230,202110,850,2271,666,1989,183,581,239,659,422,1240
353240,202110,2452,6490,2040,5834,275,903,1231,3367,1506,4270
353250,202110,1304,2907,820,2129,105,301,458,1129,563,1430
353260,202110,1228,2799,685,1911,94,288,325,846,419,1134
353270,202110,734,1868,616,1666,47,144,427,1087,474,1231
353280,202110,718,1904,508,1533,133,395,127,375,260,770
353282,202110,1912,5253,1599,4701,175,549,987,2749,1162,3298
353284,202110,376,832,208,534,19,70,104,230,123,300
353286,202110,181,439,110,326,19,54,39,109,58,163
353290,202110,1517,3978,931,2805,172,496,274,757,446,1253
353300,202110,2227,5842,1647,4717,268,881,740,1869,1008,2750
353310,202110,421,1010,311,825,22,73,207,518,229,591
353320,202110,708,1694,596,1542,10,36,508,1294,518,1330
353325,202110,718,2041,505,1569,105,323,173,521,278,844
353330,202110,630,1583,435,1230,59,169,220,567,279,736
353340,202110,3220,8580,2406,6986,461,1479,1187,3155,1648,4634
353350,202110,3938,9751,2818,7632,626,1730,898,2206,1524,3936
353360,202110,684,1867,525,1565,55,172,306,883,361,1055
353370,202110,599,1656,499,1498,46,141,350,1023,396,1164
353380,202110,306,877,250,774,29,96,117,333,146,429
353390,202110,6773,16396,5096,13636,429,1295,3214,8119,3643,9414
353400,202110,508,1337,380,1098,67,217,155,373,222,590
353410,202110,548,1442,411,1195,71,197,231,677,302,874
353420,202110,440,1123,272,783,62,172,26,70,88,242
353430,202110,2347,6296,1829,5355,327,1042,899,2481,1226,3523
353440,202110,71208,186461,52594,150856,7909,24657,29241,78919,37150,103576
353450,202110,394,975,268,762,33,109,131,336,164,445
353460,202110,3436,9080,2558,7471,264,819,1032,2860,1296,3679
353470,202110,9031,23164,6580,18614,1064,3399,2983,7755,4047,11154
353475,202110,1726,4261,1174,3205,162,492,590,1485,752,1977
353480,202110,1668,4363,1339,3811,54,189,974,2678,1028,2867
353490,202110,1146,2952,786,2281,109,360,367,986,476,1346
353500,202110,1100,2569,801,2108,166,450,447,1139,613,1589
353510,202110,889,2538,637,1971,143,451,183,490,326,941
353520,202110,1069,2738,680,2047,67,230,338,919,405,1149
353530,202110,2562,6608,2023,5639,252,800,1119,2893,1371,3693
353540,202110,2208,5810,1820,5194,274,818,1073,2947,1347,3765
353550,202110,6195,15515,5032,13660,763,2126,2927,7630,3690,9756
353560,202110,2454,6383,1879,5529,504,1592,575,1514,1079,3106
353570,202110,645,1653,460,1337,61,202,228,611,289,813
353580,202110,2279,5897,1722,4805,378,1041,760,2071,1138,3112
353590,202110,731,1851,504,1447,80,240,249,718,329,958
353600,202110,1779,4343,1341,3588,166,435,733,1921,899,2356
353610,202110,700,2016,512,1646,88,348,186,539,274,887
353620,202110,2880,7362,2066,5990,376,1208,749,1974,1125,3182
353625,202110,562,1379,368,1043,31,98,210,573,241,671
353630,202110,1465,4297,1236,3829,219,741,544,1546,763,2287
353640,202110,1411,3589,1131,3159,154,431,639,1761,793,2192
353650,202110,8054,21117,6156,17616,710,2194,3580,9640,4290,11834
353657,202110,405,1039,295,859,28,95,134,351,162,446
353660,202110,1360,2850,938,2291,297,753,364,837,661,1590
353670,202110,4267,11568,3308,9724,616,2026,1568,4207,2184,6233
353680,202110,732,1883,548,1625,71,244,328,894,399,1138
353690,202110,443,1141,213,633,21,74,49,118,70,192
353700,202110,2182,5529,1797,4900,120,388,1329,3473,1449,3861
353710,202110,5597,12507,3341,8512,409,1066,1722,3880,2131,4946
353715,202110,460,1212,273,836,7,27,99,288,106,315
353720,202110,2100,5360,1608,4604,237,720,899,2505,1136,3225
353730,202110,4565,11746,3513,9895,447,1480,1958,5045,2405,6525
353740,202110,2132,5472,1508,4394,337,1074,518,1357,855,2431
353750,202110,942,2778,688,2292,147,539,175,546,322,1085
353760,202110,13603,30523,10450,26351,2184,5499,5387,13468,7571,18967
353770,202110,698,2026,419,1364,64,232,53,158,117,390
353780,202110,5888,15494,4737,13419,1000,3139,2359,6180,3359,9319
353790,202110,2959,8614,2163,6943,521,1832,442,1217,963,3049
353800,202110,19888,50538,15663,43755,2347,6774,8565,23795,10912,30569
353810,202110,1299,3406,857,2497,124,407,381,1043,505,1450
353820,202110,1851,4857,1266,3718,250,808,420,1132,670,1940
353830,202110,673,1665,490,1367,85,243,214,573,299,816
353850,202110,1691,4546,1312,3846,262,780,486,1375,748,2155
353860,202110,2782,7394,2118,6285,473,1601,980,2591,1453,4192
353870,202110,31821,81554,22916,64571,2886,8929,12074,31109,14960,40038
353880,202110,3291,8880,2595,7588,217,724,1596,4461,1813,5185
353890,202110,3020,6361,2192,5169,163,425,1558,3417,1721,3842
353900,202110,775,2133,572,1738,78,268,239,669,317,937
353910,202110,2665,7137,2234,6460,207,680,1573,4450,1780,5130
353920,202110,2015,5431,1461,4389,334,1113,357,897,691,2010
353930,202110,4744,12306,3242,9493,536,1811,1395,3547,1931,5358
353940,202110,1254,3535,879,2779,141,476,291,828,432,1304
353950,202110,3381,8946,2581,7461,507,1564,1333,3610,1840,5174
353960,202110,869,2193,611,1710,127,336,215,583,342,919
353970,202110,669,1570,499,1312,40,119,353,911,393,1030
353980,202110,17096,42072,13362,35717,792,2497,9798,25000,10590,27497
353990,202110,994,2396,613,1710,109,326,288,755,397,1081
354000,202110,2680,6298,1511,4123,333,929,260,663,593,1592
354010,202110,360,917,255,748,51,156,130,373,181,529
354020,202110,3906,10236,3105,8637,642,1947,1403,3549,2045,5496
354025,202110,749,2027,495,1531,69,242,140,402,209,644
354030,202110,536,1158,296,776,63,172,144,348,207,520
354040,202110,833,1898,540,1435,30,92,400,1023,430,1115
354050,202110,979,2733,698,2223,153,540,240,708,393,1248
354060,202110,3662,10093,2602,7864,471,1551,1065,2859,1536,4410
354070,202110,3987,10197,2698,7698,443,1439,1220,3000,1663,4439
354075,202110,2927,8079,2329,7002,310,980,1361,4005,1671,4985
354080,202110,1438,3897,963,2955,186,609,291,797,477,1406
354085,202110,456,927,364,809,0,0,279,570,279,570
354090,202110,1706,4693,1467,4211,81,248,1143,3205,1224,3453
354100,202110,20748,54474,14383,43554,3044,9889,5549,16609,8593,26498
354105,202110,1480,3677,1033,2876,122,345,511,1335,633,1680
354110,202110,460,1273,331,1022,58,175,113,342,171,517
354120,202110,1424,3767,985,2846,202,626,327,840,529,1466
354130,202110,5655,14666,3734,10956,874,2703,210,402,1084,3105
354140,202110,20559,49838,14109,38033,2204,6626,6360,15591,8564,22217
354150,202110,3033,7072,2327,5965,472,1258,936,2351,1408,3609
354160,202110,2967,8388,2245,6966,576,1944,692,1930,1268,3874
354165,202110,714,2050,545,1719,83,306,283,825,366,1131
354170,202110,1971,5353,1641,4742,105,344,994,2728,1099,3072
354180,202110,399,1088,292,868,46,140,137,365,183,505
354190,202110,1639,4498,1154,3504,72,246,586,1678,658,1924
354200,202110,919,2184,702,1853,69,206,462,1144,531,1350
354210,202110,933,2425,769,2163,53,167,531,1395,584,1562
354220,202110,3314,8700,2517,7157,366,1138,1342,3577,1708,4715
354230,202110,823,2000,667,1814,34,113,496,1306,530,1419
354240,202110,1822,4944,1219,3738,204,662,386,1060,590,1722
354250,202110,653,1575,409,1153,90,273,115,301,205,574
354260,202110,8387,21650,6388,18188,1170,3603,2985,8052,4155,11655
354270,202110,1055,3101,861,2722,175,536,337,1029,512,1565
354280,202110,847,2057,723,1874,59,185,496,1188,555,1373
354290,202110,956,2982,805,2679,121,394,418,1437,539,1831
354300,202110,3665,10479,3100,9447,754,2327,1339,4009,2093,6336
354310,202110,751,2193,622,1947,145,479,247,716,392,1195
354320,202110,1027,2448,677,1865,101,310,272,664,373,974
354323,202110,520,1209,325,854,55,130,136,337,191,467
354325,202110,1584,4613,1111,3541,190,600,341,1030,531,1630
354330,202110,9896,24520,6798,18370,811,2453,4050,10167,4861,12620
354340,202110,36087,88723,25092,69696,3326,10500,14225,37458,17551,47958
354350,202110,1262,3171,1002,2749,147,414,584,1525,731,1939
354360,202110,649,1630,390,1207,86,267,87,269,173,536
354370,202110,1038,2878,835,2559,123,399,504,1490,627,1889
354380,202110,686,1783,496,1474,87,341,137,310,224,651
354390,202110,14840,35185,9908,26615,1614,4654,4782,12026,6396,16680
354400,202110,1621,5088,1264,4259,215,761,448,1489,663,2250
354410,202110,6654,17138,5057,14062,892,2735,2540,6559,3432,9294
354420,202110,1575,3996,1170,3271,148,446,710,1871,858,2317
354425,202110,2872,6889,2048,5457,467,1277,823,2177,1290,3454
354430,202110,1598,4195,1245,3649,109,341,761,2129,870,2470
354440,202110,641,1632,427,1210,67,207,189,488,256,695
354450,202110,467,1216,275,856,37,119,92,245,129,364
354460,202110,900,2229,608,1722,86,254,306,856,392,1110
354470,202110,483,1194,338,919,22,71,172,404,194,475
354480,202110,1351,2988,877,2236,81,192,543,1317,624,1509
354490,202110,842,2425,623,1951,115,380,275,792,390,1172
354500,202110,2265,6142,1814,5435,555,1730,429,1299,984,3029
354510,202110,756,2070,616,1811,42,128,362,969,404,1097
354515,202110,371,1027,268,816,41,141,107,315,148,456
354520,202110,7317,19570,5172,15066,667,2249,2884,7760,3551,10009
354530,202110,4618,12814,3584,10811,914,2740,1190,3727,2104,6467
354540,202110,1403,3611,1023,2935,215,646,383,1071,598,1717
354550,202110,633,1645,499,1388,72,221,280,733,352,954
354560,202110,2403,5717,1305,3625,170,480,671,1708,841,2188
354570,202110,1311,3223,539,1490,97,269,74,194,171,463
354580,202110,8764,22781,5806,17107,905,2879,2893,8124,3798,11003
354600,202110,2123,5382,1674,4596,190,569,1086,2827,1276,3396
354610,202110,468,1192,275,809,24,71,141,404,165,475
354620,202110,504,1355,311,985,37,149,131,372,168,521
354625,202110,319,849,190,603,32,110,37,86,69,196
354630,202110,2262,6536,1835,5709,616,1968,359,1045,975,3013
354640,202110,3489,9768,2628,8068,368,1257,1108,3130,1476,4387
354650,202110,917,2356,742,2073,65,178,469,1290,534,1468
354660,202110,3802,8792,2044,5871,184,634,940,2443,1124,3077
354670,202110,1121,3044,782,2361,152,499,290,801,442,1300
354680,202110,5664,14362,4272,12132,908,2751,2192,6259,3100,9010
354690,202110,513,1559,368,1239,80,290,113,349,193,639
354700,202110,965,2533,694,2011,81,246,371,985,452,1231
354710,202110,534,1391,380,1082,49,150,170,418,219,568
354720,202110,301,722,141,411,63,181,23,71,86,252
354730,202110,10462,28933,8022,24271,1032,3415,4616,13392,5648,16807
354740,202110,324,872,128,416,13,51,28,76,41,127
354750,202110,2868,7264,1888,5431,259,805,823,2081,1082,2886
354760,202110,2271,5924,1620,4736,350,1106,557,1440,907,2546
354765,202110,378,1005,162,508,17,60,43,120,60,180
354770,202110,2577,6257,1886,5023,295,837,904,2255,1199,3092
354780,202110,59793,147605,45815,120669,3870,11645,30604,75394,34474,87039
354790,202110,1036,2803,804,2432,74,247,498,1441,572,1688
354800,202110,2718,6864,2075,5833,504,1436,900,2392,1404,3828
354805,202110,1409,3184,982,2567,114,283,570,1406,684,1689
354810,202110,668,1917,397,1354,54,209,111,351,165,560
354820,202110,996,2777,698,2212,101,355,197,493,298,848
354830,202110,505,1209,320,879,63,187,99,256,162,443
354840,202110,942,2336,583,1609,59,170,310,791,369,961
354850,202110,21976,55678,15386,44116,1577,5125,9460,25679,11037,30804
354860,202110,1811,4938,1136,3544,175,591,344,969,519,1560
354870,202110,63097,156888,48890,130855,4756,13954,31444,79311,36200,93265
354880,202110,6160,14956,3060,8528,336,1073,1220,2792,1556,3865
354890,202110,16493,40943,12765,34676,1708,5197,7304,19210,9012,24407
354900,202110,426,1054,283,800,63,198,86,187,149,385
354910,202110,6256,16180,3881,11849,864,2796,799,2249,1663,5045
354920,202110,544,1423,273,880,33,117,62,169,95,286
354925,202110,316,886,188,604,25,87,46,129,71,216
354930,202110,396,957,260,714,27,85,123,308,150,393
354940,202110,2493,7179,1813,5713,595,2024,435,1237,1030,3261
354950,202110,1608,3992,1278,3553,54,190,948,2506,1002,2696
354960,202110,950,2495,714,2138,80,269,376,1048,456,1317
354970,202110,4455,12043,3498,10430,358,1221,2266,6514,2624,7735
354980,202110,35435,82795,24242,63692,2451,7637,15059,36749,17510,44386
354990,202110,72756,179976,54443,146564,4112,12851,36325,91487,40437,104338
354995,202110,2976,6498,2244,5548,141,407,1689,4032,1830,4439
355000,202110,1663,4048,1244,3430,209,665,605,1508,814,2173
355010,202110,4126,10911,2553,7592,820,2487,370,1124,1190,3611
355020,202110,3818,10347,2819,8606,535,1832,1207,3441,1742,5273
355030,202110,1461826,3540208,1067749,2785666,152544,436892,557649,1337664,710193,1774556
355040,202110,3198,7619,2473,6677,259,725,1824,4892,2083,5617
355050,202110,1083,2384,801,1995,185,524,330,729,515,1253
355060,202110,6557,17189,4781,13937,735,2492,2471,6539,3206,9031
355070,202110,10438,25832,8506,22759,977,2982,5444,13630,6421,16612
355080,202110,997,2785,631,2104,131,471,99,273,230,744
355090,202110,1261,3470,991,3020,206,651,410,1167,616,1818
355100,202110,23440,59782,18266,52093,2727,8233,11154,31327,13881,39560
355110,202110,917,2487,664,2094,166,588,92,257,258,845
355120,202110,755,1937,540,1616,48,151,260,761,308,912
355130,202110,855,1887,442,1137,31,102,281,661,312,763
355140,202110,2079,4549,1747,4098,90,237,1451,3312,1541,3549
355150,202110,4526,11640,3607,10030,383,1177,2318,6182,2701,7359
355160,202110,2329,6227,1675,5074,396,1298,410,1146,806,2444
355170,202110,11806,29042,9246,24785,1575,4545,4956,12869,6531,17414
355180,202110,2997,7764,2139,6339,402,1325,884,2403,1286,3728
355190,202110,1945,5024,1523,4344,398,1117,748,2281,1146,3398
355200,202110,866,2599,734,2383,207,729,294,919,501,1648
355210,202110,3170,8477,2444,6993,436,1384,1175,3138,1611,4522
355220,202110,49733,128431,39562,109081,7844,23029,18015,45916,25859,68945
355230,202110,1229,3045,664,1942,124,361,242,656,366,1017
355240,202110,26808,69525,18938,54001,2238,6951,10651,28382,12889,35333
355250,202110,39841,103917,29726,84518,7454,22166,11362,30852,18816,53018
355255,202110,675,1661,364,1095,51,167,133,387,184,554
355260,202110,1612,3780,1140,3026,127,406,674,1646,801,2052
355270,202110,1209,3494,937,2949,208,690,364,1045,572,1735
355280,202110,32920,81831,23675,64809,2909,8656,12610,32283,15519,40939
355290,202110,961,2536,744,2170,141,389,325,910,466,1299
355300,202110,1380,3967,1097,3426,190,640,409,1189,599,1829
355310,202110,967,2627,724,2227,95,287,416,1291,511,1578
355320,202110,549,1419,413,1169,73,231,168,387,241,618
355330,202110,3093,7727,2391,6520,119,406,1825,4753,1944,5159
355340,202110,4322,9513,3296,8150,400,924,2032,5120,2432,6044
355350,202110,1408,3925,1049,3238,196,634,413,1228,609,1862
355360,202110,1260,3162,966,2716,115,347,571,1569,686,1916
355365,202110,379,965,201,653,46,146,27,94,73,240
355370,202110,5642,14216,4360,12161,1041,2643,1848,5696,2889,8339
355380,202110,3009,7907,2269,6560,385,1220,846,2111,1231,3331
355385,202110,1512,3904,1249,3526,112,372,792,2042,904,2414
355390,202110,856,2301,618,1794,129,404,240,616,369,1020
355395,202110,2071,5563,1468,4360,237,740,530,1387,767,2127
355400,202110,9664,26892,7643,22921,1729,5865,2870,7656,4599,13521
355410,202110,24130,65372,14997,46420,2883,9772,4238,12664,7121,22436
355420,202110,641,2011,533,1812,139,513,139,437,278,950
355430,202110,3865,9633,2902,7896,608,1682,1349,3598,1957,5280
355440,202110,796,2134,495,1511,80,241,142,400,222,641
355450,202110,3449,8752,2315,6554,350,1075,1023,2594,1373,3669
355460,202110,528,1249,331,924,44,152,168,416,212,568
355465,202110,456,1168,353,1004,45,139,201,559,246,698
355470,202110,1185,3003,682,2004,183,591,192,491,375,1082
355475,202110,353,815,290,731,14,33,219,537,233,570
355480,202110,4213,11376,3414,10173,465,1585,2207,6417,2672,8002
355490,202110,980,2572,550,1690,47,159,273,760,320,919
355495,202110,855,2340,619,1942,68,259,231,639,299,898
355500,202110,7211,18184,4426,12848,655,2074,1621,4294,2276,6368
355510,202110,1458,3496,939,2632,133,405,385,968,518,1373
355520,202110,390,881,193,557,36,105,61,178,97,283
355530,202110,383,905,149,440,10,36,61,162,71,198
355535,202110,529,1403,404,1208,74,278,190,523,264,801
355540,202110,11363,27672,9339,24828,1187,3463,6362,16338,7549,19801
355550,202110,642,1869,529,1647,60,208,294,841,354,1049
355560,202110,1224,3111,696,2090,157,540,27,76,184,616
355570,202110,288,776,151,473,21,70,35,85,56,155
355580,202110,1252,2962,777,2157,143,470,284,689,427,1159
355590,202110,178,452,138,388,15,47,85,228,100,275
355600,202110,1618,3916,1062,2969,163,484,375,1046,538,1530
355610,202110,1901,4608,1259,3492,136,416,683,1768,819,2184
355620,202110,5345,13849,3997,11210,395,1329,2268,5812,2663,7141
355630,202110,2555,6806,1809,5440,264,830,944,2724,1208,3554
355635,202110,937,2684,689,2198,107,371,214,615,321,986
355640,202110,3403,9161,2316,7031,468,1423,665,2037,1133,3460
355645,202110,4325,11886,3156,9834,455,1546,1694,5085,2149,6631
355650,202110,6745,17913,5201,15083,1308,3977,1507,3870,2815,7847
355660,202110,1467,3699,1023,2915,164,494,299,844,463,1338
355670,202110,4053,10695,2776,7858,331,1099,1438,3584,1769,4683
355680,202110,3016,8122,1419,4401,329,1116,98,287,427,1403
355690,202110,821,2351,542,1810,129,478,11,19,140,497
355695,202110,266,737,156,487,13,58,31,66,44,124
355700,202110,7937,22149,6546,19119,977,3118,3721,10193,4698,13311
355710,202110,9717,22657,6448,16709,864,2530,3241,7401,4105,9931
355715,202110,501,1333,273,827,57,184,46,119,103,303
355720,202110,1515,4198,1197,3632,174,562,663,1894,837,2456
355730,202110,977,2630,800,2314,123,395,416,1123,539,1518
410010,202110,1322,3623,1017,2988,190,609,251,699,441,1308
410020,202110,1082,3170,821,2585,274,807,177,556,451,1363
410030,202110,1627,4347,1392,3986,199,594,755,2200,954,2794
410040,202110,13709,37092,10000,30096,2151,6920,3106,8604,5257,15524
410045,202110,852,2259,615,1793,90,286,237,617,327,903
410050,202110,2390,5903,1658,4642,250,796,623,1607,873,2403
410060,202110,2157,5966,1692,5060,362,1149,518,1467,880,2616
410070,202110,2066,5136,1536,4186,232,711,607,1472,839,2183
410080,202110,1402,3685,993,2945,268,821,198,585,466,1406
410090,202110,1172,2918,990,2632,109,271,562,1581,671,1852
410100,202110,2022,5682,1330,4067,195,673,126,370,321,1043
410105,202110,512,1271,298,856,34,97,108,286,142,383
410110,202110,3462,8515,2453,6630,315,902,1152,2923,1467,3825
410115,202110,596,1517,429,1223,54,160,164,421,218,581
410120,202110,2762,7420,2383,6871,469,1431,1316,3693,1785,5124
410130,202110,1316,3465,1134,3122,201,616,602,1551,803,2167
410140,202110,17421,41686,11513,31143,2034,6044,3147,7715,5181,13759
410150,202110,17410,40325,8917,23970,1502,4482,2204,5247,3706,9729
410160,202110,3079,8360,2462,7282,558,1780,813,2373,1371,4153
410165,202110,688,1813,555,1542,64,201,316,816,380,1017
410170,202110,3023,7695,2001,5549,430,1281,114,331,544,1612
410180,202110,15754,43144,12101,35795,1703,5494,6149,16789,7852,22283
410185,202110,446,1284,322,972,57,183,95,248,152,431
410190,202110,2263,5562,1635,4448,326,918,427,1082,753,2000
410200,202110,6157,13715,3389,8957,530,1593,454,1159,984,2752
410210,202110,3377,8261,2164,6129,356,1140,711,1702,1067,2842
410220,202110,565,1446,371,1089,56,171,92,251,148,422
410230,202110,1881,4953,1436,4071,222,675,600,1530,822,2205
410240,202110,5470,14090,3720,10687,723,2311,521,1329,1244,3640
410250,202110,2636,6238,1950,5148,136,430,957,2457,1093,2887
410260,202110,1946,4799,1209,3425,161,467,561,1526,722,1993
410270,202110,496,1309,356,1056,44,152,141,404,185,556
410275,202110,660,1826,470,1419,76,245,187,516,263,761
410280,202110,2487,6442,1641,4786,207,688,674,1785,881,2473
410290,202110,3545,9692,2438,7367,710,2112,574,1721,1284,3833
410300,202110,728,1768,573,1527,60,181,278,665,338,846
410302,202110,356,901,203,612,16,51,101,294,117,345
410304,202110,1330,3380,1104,2958,123,349,686,1763,809,2112
410305,202110,1787,4218,1249,3444,106,329,802,2124,908,2453
410310,202110,2752,7481,2227,6516,304,1003,1189,3371,1493,4374
410315,202110,673,1562,419,1159,153,419,96,275,249,694
410320,202110,1093,2991,735,2267,109,382,125,358,234,740
410322,202110,676,1754,352,1016,40,118,147,371,187,489
410330,202110,1593,3818,1096,2896,181,501,308,812,489,1313
410335,202110,894,2366,680,1962,101,309,276,728,377,1037
410337,202110,867,2112,600,1593,84,234,204,487,288,721
410340,202110,533,1498,356,1071,28,86,161,392,189,478
410345,202110,2660,6858,1449,4240,268,813,406,1028,674,1841
410347,202110,782,1994,574,1609,58,197,183,515,241,712
410350,202110,1696,4089,1215,3308,144,427,583,1462,727,1889
410360,202110,4444,10899,3383,9049,510,1428,1396,3616,1906,5044
410370,202110,14611,38487,9439,26533,1090,3323,3983,9743,5073,13066
410380,202110,1759,4309,1278,3462,207,598,403,967,610,1565
410390,202110,2840,6942,1898,5314,369,1147,652,1619,1021,2766
410395,202110,958,2673,774,2298,158,474,290,886,448,1360
410400,202110,7185,18197,5460,14977,751,2186,2831,7276,3582,9462
410405,202110,905,2058,631,1656,105,311,296,720,401,1031
410410,202110,1357,3513,1272,3384,148,466,811,2239,959,2705
410420,202110,11870,31579,8932,25713,1351,4359,3774,9705,5125,14064
410425,202110,3533,9689,2417,7407,386,1274,876,2425,1262,3699
410430,202110,13891,34190,9762,26683,1432,4293,3604,9104,5036,13397
410440,202110,2408,6980,2061,6347,324,1112,1064,3193,1388,4305
410442,202110,2519,7358,1979,6178,496,1606,531,1540,1027,3146
410445,202110,2349,6599,1695,5339,323,1145,270,924,593,2069
410450,202110,1567,3813,1166,3188,222,641,441,1146,663,1787
410460,202110,2322,5687,1706,4634,193,565,807,2062,1000,2627
410465,202110,2947,8330,2317,7142,417,1351,783,2240,1200,3591
410470,202110,2232,5986,1551,4764,392,1390,212,701,604,2091
410480,202110,40165,94841,21912,62642,3153,10039,5101,12319,8254,22358
410490,202110,12025,32396,8594,25424,1471,4626,3457,9449,4928,14075
410500,202110,1963,5018,1326,3832,248,794,344,854,592,1648
410510,202110,1909,4704,1288,3556,252,667,382,1054,634,1721
410520,202110,3137,9634,2748,8853,948,3166,799,2639,1747,5805
410530,202110,1698,4066,787,2175,102,301,207,464,309,765
410540,202110,2980,7907,2047,6030,319,1024,861,2394,1180,3418
410550,202110,8030,21009,5360,15306,883,2752,1456,3570,2339,6322
410560,202110,1602,4128,1174,3259,246,740,373,870,619,1610
410570,202110,2733,7247,1973,5918,546,1959,194,573,740,2532
410580,202110,28131,71330,20485,57484,3437,10416,9330,24363,12767,34779
410590,202110,1626,4552,1133,3419,149,473,342,859,491,1332
410600,202110,1853,4835,1431,4032,332,913,423,1256,755,2169
410610,202110,744,1882,557,1542,63,209,256,648,319,857
410620,202110,2639,7312,1780,5358,389,1252,242,700,631,1952
410630,202110,2663,6778,1737,4952,297,1015,378,853,675,1868
410640,202110,5057,11681,3484,8958,735,2183,421,1105,1156,3288
410645,202110,1155,3162,947,2901,273,871,456,1393,729,2264
410650,202110,2499,6655,1724,5102,322,1014,629,1704,951,2718
410655,202110,935,2218,651,1715,26,69,331,828,357,897
410657,202110,643,1711,390,1164,53,169,114,277,167,446
410660,202110,3666,9083,2165,5864,364,1011,680,1658,1044,2669
410670,202110,1068,2618,650,1831,132,357,197,509,329,866
410680,202110,2672,7836,1834,5777,420,1329,270,870,690,2199
410685,202110,555,1391,415,1156,97,309,156,388,253,697
410690,202110,141982,337969,95807,253984,14224,42784,39042,91014,53266,133798
410700,202110,2579,6434,2134,5741,400,1089,956,2501,1356,3590
410710,202110,930,2306,610,1718,112,331,248,633,360,964
410712,202110,687,1879,567,1661,103,338,271,743,374,1081
410715,202110,890,2520,555,1769,64,203,227,690,291,893
410720,202110,3520,8800,2834,7572,420,1348,797,2059,1217,3407
410725,202110,1176,2844,687,1934,145,436,90,209,235,645
410730,202110,749,1983,582,1670,116,379,123,357,239,736
410740,202110,919,2528,673,2057,84,288,269,815,353,1103
410750,202110,1894,4651,1508,3956,240,671,708,1777,948,2448
410752,202110,387,938,211,600,27,80,102,267,129,347
410753,202110,361,1045,254,805,39,140,59,165,98,305
410754,202110,1131,2859,936,2572,68,165,640,1833,708,1998
410755,202110,604,1529,430,1193,53,153,198,496,251,649
410760,202110,3858,9852,2774,7874,644,2104,683,1791,1327,3895
410765,202110,15584,42396,12143,35643,2045,6489,2945,7512,4990,14001
410770,202110,1115,2584,782,2026,71,173,392,1023,463,1196
410773,202110,1335,3473,1166,3218,117,357,755,2013,872,2370
410775,202110,1581,3836,1381,3541,59,175,938,2340,997,2515
410780,202110,673,1641,454,1229,65,177,140,354,205,531
410785,202110,752,1909,570,1599,89,282,183,508,272,790
410790,202110,936,2595,777,2300,187,577,66,143,253,720
410800,202110,3578,7875,2871,6857,52,155,1864,4309,1916,4464
410810,202110,472,1234,354,1003,34,105,136,325,170,430
410820,202110,998,2736,529,1557,94,290,95,236,189,526
410830,202110,43375,101985,29958,79821,5763,17047,11829,29353,17592,46400
410832,202110,1073,2761,859,2387,95,303,510,1322,605,1625
410840,202110,9285,22886,5460,15697,995,3112,1462,3842,2457,6954
410845,202110,1203,2939,929,2519,171,478,387,1025,558,1503
410850,202110,2291,6412,2000,5894,325,985,931,2698,1256,3683
410855,202110,805,1976,514,1417,56,156,248,623,304,779
410860,202110,4684,11220,3665,9574,262,818,2302,5681,2564,6499
410865,202110,1514,4272,1300,3873,129,409,751,2299,880,2708
410870,202110,1281,3366,1041,2968,100,294,669,1881,769,2175
410880,202110,4885,12701,3372,9938,525,1572,510,1591,1035,3163
410890,202110,1069,2924,819,2447,165,553,264,733,429,1286
410895,202110,1047,3247,879,2892,271,974,216,673,487,1647
410900,202110,904,2377,631,1847,97,290,150,365,247,655
410910,202110,437,1003,270,689,13,49,143,321,156,370
410920,202110,905,2166,656,1763,82,247,326,848,408,1095
410930,202110,1793,4511,1232,3524,279,923,211,572,490,1495
410940,202110,24215,64243,17616,52620,3536,11561,5617,16224,9153,27785
410950,202110,1997,5750,1794,5447,71,214,1465,4433,1536,4647
410960,202110,8242,19792,5740,15712,1252,3797,2261,6132,3513,9929
410965,202110,1230,3019,835,2288,76,231,507,1353,583,1584
410970,202110,4341,11457,3066,8970,663,2290,438,1061,1101,3351
410975,202110,1430,3428,1087,2900,124,366,517,1324,641,1690
410980,202110,8070,19724,5228,14656,560,1733,2351,5938,2911,7671
410990,202110,1475,3452,996,2693,186,594,392,1023,578,1617
411000,202110,713,1862,499,1468,67,224,156,387,223,611
411005,202110,501,1221,295,790,51,151,98,224,149,375
411007,202110,2543,6827,1934,5707,452,1417,638,1807,1090,3224
411010,202110,4387,12904,3447,11010,835,2898,367,1060,1202,3958
411020,202110,2453,6764,1984,5936,556,1710,512,1509,1068,3219
411030,202110,811,1957,569,1474,49,161,297,676,346,837
411040,202110,1049,2623,567,1594,66,215,177,408,243,623
411050,202110,2069,6296,1679,5450,380,1352,269,732,649,2084
411060,202110,2162,5667,1396,4067,273,888,267,740,540,1628
411065,202110,452,1136,289,813,35,104,118,314,153,418
411070,202110,7920,19614,6236,16835,765,2254,3246,8484,4011,10738
411080,202110,1887,4971,1566,4432,375,1240,352,947,727,2187
411090,202110,850,2222,558,1652,46,162,151,415,197,577
411095,202110,2837,6549,1564,4241,195,550,380,940,575,1490
411100,202110,1276,3249,897,2556,90,291,317,912,407,1203
411110,202110,664,1693,313,940,35,103,22,47,57,150
411120,202110,1408,3749,1157,3299,303,1017,283,723,586,1740
411125,202110,5507,15749,4903,14641,1107,3251,2279,7142,3386,10393
411130,202110,757,1969,541,1570,104,274,183,593,287,867
411140,202110,2363,7040,1977,6257,590,1976,524,1646,1114,3622
411150,202110,4175,10401,2797,7608,494,1561,250,489,744,2050
411155,202110,1033,2629,646,1898,102,299,285,783,387,1082
411160,202110,388,882,266,701,29,72,67,183,96,255
411170,202110,802,2271,613,1863,138,446,226,647,364,1093
411180,202110,5919,15312,4619,13088,683,2084,2234,5909,2917,7993
411190,202110,1945,4876,1428,3929,202,605,567,1390,769,1995
411200,202110,5087,13535,3684,10942,861,2868,833,2122,1694,4990
411210,202110,3459,7640,2351,5843,426,1149,792,1864,1218,3013
411220,202110,932,2330,651,1801,147,451,181,467,328,918
411230,202110,895,2337,651,1874,135,414,211,573,346,987
411240,202110,1700,3969,1158,3021,135,415,572,1365,707,1780
411250,202110,2345,6096,1698,4935,326,1124,511,1377,837,2501
411260,202110,351,880,229,645,24,73,95,234,119,307
411270,202110,2103,5474,1553,4391,217,644,744,1948,961,2592
411275,202110,1559,3543,1082,2770,147,451,520,1225,667,1676
411280,202110,1389,3714,950,2881,237,735,128,359,365,1094
411290,202110,882,2260,553,1620,74,223,270,767,344,990
411295,202110,1328,3305,952,2588,120,343,415,1050,535,1393
411300,202110,1089,2698,709,1963,74,233,323,763,397,996
411310,202110,934,2106,723,1820,90,234,314,770,404,1004
411320,202110,5771,14543,4201,11738,616,1850,1838,4596,2454,6446
411325,202110,1464,4058,1213,3597,240,674,610,1885,850,2559
411330,202110,3486,9218,2539,7483,565,1824,748,2195,1313,4019
411340,202110,872,2352,529,1601,86,274,145,398,231,672
411342,202110,1109,2654,617,1685,109,305,200,504,309,809
411345,202110,1178,2954,897,2499,63,185,643,1797,706,1982
411350,202110,3058,8037,1973,5837,460,1487,339,878,799,2365
411360,202110,766,1816,553,1488,72,210,222,551,294,761
411370,202110,63551,154152,46291,124631,3406,10760,27362,68059,30768,78819
411373,202110,1487,3694,1202,3270,115,332,645,1786,760,2118
411375,202110,1177,2898,836,2259,131,365,319,845,450,1210
411380,202110,1213,2757,819,2015,48,129,512,1163,560,1292
411390,202110,1566,4224,1228,3490,203,620,477,1167,680,1787
411400,202110,2493,6017,1861,4844,160,502,995,2420,1155,2922
411410,202110,2845,7757,2097,6198,428,1393,468,1278,896,2671
411420,202110,4607,11007,2463,6945,329,1046,472,975,801,2021
411430,202110,3805,10026,2884,8315,578,1812,974,2565,1552,4377
411435,202110,442,1198,280,866,61,181,82,228,143,409
411440,202110,2675,7310,2137,6300,436,1384,654,1808,1090,3192
411450,202110,2548,6715,1922,5666,237,703,1068,3185,1305,3888
411460,202110,4573,11577,2858,8270,414,1399,553,1389,967,2788
411470,202110,856,2132,633,1717,104,319,240,563,344,882
411480,202110,5487,14260,3982,11470,651,2227,1543,3972,2194,6199
411490,202110,1697,4308,1304,3657,143,468,569,1409,712,1877
411500,202110,1383,3619,936,2671,150,465,181,408,331,873
411510,202110,2431,5996,1959,5226,341,1071,545,1490,886,2561
411520,202110,35166,84874,20824,57048,2351,7361,8288,20016,10639,27377
411530,202110,1001,2572,603,1813,91,297,97,248,188,545
411535,202110,539,1544,352,1102,45,165,102,286,147,451
411540,202110,2714,6561,1876,5055,113,370,1032,2721,1145,3091
411545,202110,941,2679,790,2412,74,238,507,1552,581,1790
411550,202110,748,1853,551,1494,83,233,108,322,191,555
411560,202110,2108,5685,1200,3721,134,462,64,155,198,617
411570,202110,7534,17180,5080,13523,1135,3250,953,2556,2088,5806
411573,202110,804,2128,660,1876,112,328,286,778,398,1106
411575,202110,2131,5679,1581,4580,270,823,412,1133,682,1956
411580,202110,5114,11713,3102,8577,426,1442,552,1317,978,2759
411585,202110,645,1898,308,989,57,178,53,163,110,341
411590,202110,431,1152,318,932,41,120,163,445,204,565
411600,202110,341,836,210,622,34,101,69,189,103,290
411605,202110,1637,3770,1062,2867,139,471,523,1395,662,1866
411610,202110,2746,6325,1944,4919,64,213,1344,3173,1408,3386
411620,202110,2864,7488,2422,6812,369,1097,1328,3723,1697,4820
411630,202110,859,2140,536,1548,67,235,203,517,270,752
411640,202110,474,1203,325,886,40,113,96,227,136,340
411650,202110,222,636,147,471,29,99,31,75,60,174
411660,202110,956,2432,690,1935,56,158,276,726,332,884
411670,202110,1544,3628,1054,2711,113,301,550,1294,663,1595
411680,202110,1503,3961,1126,3224,186,605,430,1177,616,1782
411690,202110,4166,10368,3123,8577,675,1828,810,2419,1485,4247
411695,202110,664,1945,454,1402,50,169,188,529,238,698
411700,202110,1820,4590,1208,3418,254,748,192,519,446,1267
411705,202110,2382,6875,2002,6214,383,1088,1113,3758,1496,4846
411710,202110,2112,5277,1443,4021,315,870,353,941,668,1811
411720,202110,1135,2609,802,2023,132,342,317,770,449,1112
411721,202110,1062,2566,799,2084,130,319,248,639,378,958
411722,202110,956,2506,547,1604,97,306,187,465,284,771
411725,202110,1277,3504,853,2667,193,648,169,498,362,1146
411727,202110,1572,4294,1017,3107,219,677,101,279,320,956
411729,202110,685,1648,390,1075,49,163,133,318,182,481
411730,202110,5585,14459,4311,12023,804,2434,1980,5345,2784,7779
411740,202110,543,1382,285,824,76,198,55,149,131,347
411745,202110,857,2402,597,1819,66,230,149,354,215,584
411750,202110,5953,15408,4324,12217,565,1713,2057,5453,2622,7166
411760,202110,7190,18760,5542,15938,1676,5023,1032,3364,2708,8387
411770,202110,3275,9263,2360,7261,517,1706,421,1130,938,2836
411780,202110,2797,7706,2422,7029,688,2079,789,2347,1477,4426
411790,202110,3035,7208,1726,4851,334,1070,437,1049,771,2119
411800,202110,1173,3319,829,2481,133,436,166,430,299,866
411810,202110,1669,4249,1245,3418,216,623,525,1326,741,1949
411820,202110,12650,35061,10317,31032,2424,7832,4555,13225,6979,21057
411830,202110,575,1398,429,1138,88,254,67,181,155,435
411840,202110,12999,33872,8956,25565,1431,4397,2555,6503,3986,10900
411845,202110,625,1744,369,1155,55,199,93,251,148,450
411850,202110,7870,19663,5341,15222,1233,3839,1016,2609,2249,6448
411860,202110,741,2018,532,1590,77,237,118,311,195,548
411870,202110,611,1734,431,1332,85,282,98,284,183,566
411880,202110,2430,5850,1749,4781,250,742,678,1746,928,2488
411885,202110,1168,3001,845,2412,125,420,254,641,379,1061
411890,202110,1493,3911,1071,3130,183,596,106,286,289,882
411900,202110,849,2303,527,1618,116,373,104,305,220,678
411910,202110,1121,3229,812,2586,178,671,307,881,485,1552
411915,202110,16368,39677,11274,30395,1592,4710,4772,11577,6364,16287
411920,202110,1240,3477,1005,3017,212,735,373,1022,585,1757
411925,202110,517,1343,371,1076,80,236,151,407,231,643
411930,202110,5149,15152,4307,13611,1830,6292,285,1092,2115,7384
411940,202110,3445,9835,2668,8194,621,1919,885,2467,1506,4386
411950,202110,15401,40698,12721,36256,1566,5069,7635,20713,9201,25782
411960,202110,6356,16460,4996,13778,864,2536,2051,5409,2915,7945
411965,202110,499,1353,355,1062,49,165,158,436,207,601
411970,202110,1254,2773,966,2389,187,435,409,1170,596,1605
411980,202110,1554,3696,1118,2984,288,764,404,1064,692,1828
411990,202110,40156,102845,25838,77046,4576,15060,9176,25655,13752,40715
411995,202110,4270,10211,3267,8636,915,2641,826,2078,1741,4719
412000,202110,1904,4366,1306,3359,34,109,906,2167,940,2276
412010,202110,653,1953,485,1579,76,260,123,352,199,612
412015,202110,560,1548,450,1349,68,211,249,743,317,954
412020,202110,471,1296,299,935,43,156,125,355,168,511
412030,202110,620,1730,459,1435,67,209,159,487,226,696
412033,202110,1005,2592,714,2018,84,244,267,633,351,877
412035,202110,754,2016,482,1525,60,206,250,753,310,959
412040,202110,712,1878,393,1211,58,173,49,142,107,315
412050,202110,1654,4076,1118,3084,242,733,244,664,486,1397
412060,202110,7639,21598,6304,18938,1612,5490,1689,4837,3301,10327
412065,202110,653,1780,477,1424,99,323,114,333,213,656
412070,202110,1268,3248,990,2708,131,390,379,935,510,1325
412080,202110,2416,6481,1683,5032,239,763,533,1410,772,2173
412085,202110,338,801,115,346,14,38,23,55,37,93
412090,202110,6519,16415,4772,13233,1058,3087,1753,4879,2811,7966
412100,202110,1819,4739,1358,3902,433,1413,303,889,736,2302
412110,202110,962,2474,625,1798,87,271,210,566,297,837
412120,202110,2204,6094,1657,5067,330,1132,429,1098,759,2230
412125,202110,691,1931,465,1445,86,262,91,287,177,549
412130,202110,857,2093,582,1590,96,259,143,401,239,660
412135,202110,650,1703,311,927,47,154,95,237,142,391
412140,202110,1856,4426,1266,3404,192,615,268,684,460,1299
412150,202110,2948,7443,2473,6602,407,1201,1386,3474,1793,4675
412160,202110,934,2848,522,1728,62,232,61,152,123,384
412170,202110,4546,12188,3797,10980,686,2226,1604,4259,2290,6485
412175,202110,1364,3796,1133,3404,246,788,456,1356,702,2144
412180,202110,1773,4809,1299,3935,159,551,568,1582,727,2133
412190,202110,3492,8591,2558,6966,312,917,1070,2871,1382,3788
412200,202110,1962,5571,1309,4102,309,1060,191,555,500,1615
412210,202110,694,1617,433,1179,60,184,173,418,233,602
412215,202110,3352,8903,2471,7176,600,1699,930,2885,1530,4584
412217,202110,1035,2639,859,2322,40,105,612,1587,652,1692
412220,202110,5855,16114,4803,14217,1326,3805,1423,4518,2749,8323
412230,202110,2810,8037,2200,6867,339,1216,514,1369,853,2585
412240,202110,7985,20302,5092,14590,866,2675,1495,3812,2361,6487
412250,202110,2112,5335,1553,4262,362,1029,296,722,658,1751
412260,202110,1341,3471,1003,2789,159,449,294,775,453,1224
412265,202110,971,2552,765,2196,162,479,306,834,468,1313
412270,202110,1081,2921,697,2112,87,295,269,732,356,1027
412280,202110,433,1159,337,998,80,246,91,255,171,501
412290,202110,1086,2733,760,2152,116,369,254,646,370,1015
412300,202110,1746,4484,1228,3577,247,744,279,837,526,1581
412310,202110,762,2140,578,1761,102,357,171,478,273,835
412320,202110,811,2054,519,1466,47,160,145,400,192,560
412330,202110,1662,4332,1140,3368,243,755,390,1174,633,1929
412340,202110,1292,3454,854,2510,104,349,113,307,217,656
412350,202110,3170,8176,2058,5973,361,1144,372,968,733,2112
412360,202110,273,730,197,569,6,28,130,350,136,378
412370,202110,884,2468,599,1865,119,407,74,217,193,624
412380,202110,1609,4313,1135,3379,282,877,121,392,403,1269
412382,202110,504,1207,332,925,38,131,151,344,189,475
412385,202110,2286,6109,1865,5323,599,1611,573,1810,1172,3421
412390,202110,2622,6167,2097,5354,359,938,725,1840,1084,2778
412395,202110,734,2037,531,1581,75,196,226,684,301,880
412400,202110,966,2499,696,1982,132,418,196,532,328,950
412402,202110,2402,5812,1663,4600,425,1179,231,691,656,1870
412405,202110,3247,8415,2124,6333,525,1782,135,377,660,2159
412410,202110,6574,16720,4813,13847,777,2596,1566,4140,2343,6736
412420,202110,561,1383,375,1009,27,81,184,424,211,505
412430,202110,617,1543,334,965,34,103,132,352,166,455
412440,202110,2943,7670,1971,5874,448,1408,423,1275,871,2683
412450,202110,523,1479,347,1040,42,127,37,82,79,209
412460,202110,1154,2918,898,2483,166,497,390,1028,556,1525
412470,202110,1616,4933,1327,4294,288,997,286,906,574,1903
412480,202110,1125,2891,750,2116,126,388,260,644,386,1032
412490,202110,1404,3363,1103,2828,139,359,558,1337,697,1696
412500,202110,2100,5198,1582,4254,319,890,450,1088,769,1978
412510,202110,2015,5997,1386,4440,310,1065,173,488,483,1553
412520,202110,1369,3404,758,2150,167,457,108,290,275,747
412530,202110,723,1885,518,1473,76,243,115,316,191,559
412535,202110,854,2189,579,1661,110,348,115,268,225,616
412540,202110,1225,3044,886,2448,88,313,293,849,381,1162
412545,202110,719,1833,498,1397,85,264,137,365,222,629
412550,202110,36195,94344,25831,73858,3954,12218,10658,27495,14612,39713
412555,202110,305,791,206,582,25,82,64,142,89,224
412560,202110,5126,14352,3859,11466,667,2214,1154,3387,1821,5601
412570,202110,4665,11555,2713,7809,474,1583,344,1015,818,2598
412575,202110,1080,2687,860,2315,123,365,451,1135,574,1500
412580,202110,1523,3852,1081,3027,77,251,597,1576,674,1827
412590,202110,418,1090,235,718,27,88,29,75,56,163
412600,202110,1723,4517,1317,3724,172,536,629,1655,801,2191
412610,202110,891,2321,639,1785,80,238,286,687,366,925
412620,202110,1313,3369,1009,2915,185,612,317,843,502,1455
412625,202110,9167,23864,5651,16866,752,2508,340,939,1092,3447
412627,202110,1181,3267,770,2421,144,500,212,660,356,1160
412630,202110,2978,8538,2148,6768,382,1263,598,1690,980,2953
412635,202110,439,1166,293,852,34,107,94,213,128,320
412640,202110,1087,2815,629,1849,79,246,167,419,246,665
412650,202110,1774,4709,1399,3969,229,735,535,1318,764,2053
412660,202110,2637,6708,1911,5322,247,734,670,1679,917,2413
412665,202110,412,1006,320,844,68,185,133,343,201,528
412667,202110,1894,4850,1369,3815,190,573,590,1578,780,2151
412670,202110,903,2092,582,1575,110,330,147,373,257,703
412680,202110,2198,5702,1519,4423,179,600,536,1351,715,1951
412690,202110,1204,3132,860,2473,149,472,299,804,448,1276
412700,202110,2000,5191,1670,4674,209,641,913,2501,1122,3142
412710,202110,6111,17350,4518,13966,814,2766,1190,3147,2004,5913
412720,202110,1218,3485,942,2890,140,464,235,587,375,1051
412730,202110,2691,6881,1882,5303,309,999,740,1898,1049,2897
412740,202110,2019,5529,1394,4271,214,746,188,576,402,1322
412750,202110,4193,10704,3403,9573,278,884,2222,5973,2500,6857
412760,202110,3071,8179,2542,7283,481,1542,1357,3635,1838,5177
412770,202110,11170,28353,6085,18294,797,2559,1281,3183,2078,5742
412780,202110,1240,3223,941,2690,195,609,350,959,545,1568
412785,202110,2249,5195,1585,4102,170,442,1045,2657,1215,3099
412788,202110,1480,4089,1208,3615,338,1004,448,1303,786,2307
412790,202110,1406,3655,815,2472,110,383,259,670,369,1053
412795,202110,1303,3326,705,2116,94,302,126,363,220,665
412796,202110,2302,6435,1902,5721,395,1256,594,1632,989,2888
412800,202110,3863,9239,2697,7102,280,861,1309,3044,1589,3905
412810,202110,12921,32552,8446,23601,1001,3246,3358,8269,4359,11515
412820,202110,6433,17377,4545,13566,1081,3452,1287,3774,2368,7226
412830,202110,357,999,258,790,40,118,67,192,107,310
412840,202110,1963,4753,1404,3691,144,425,687,1631,831,2056
412850,202110,2899,7437,2122,6136,301,938,904,2528,1205,3466
412853,202110,1575,3911,1306,3443,172,506,683,1592,855,2098
412855,202110,1388,3543,827,2378,116,371,209,521,325,892
412860,202110,779,1907,526,1496,80,241,269,715,349,956
412862,202110,692,1688,462,1295,100,287,172,449,272,736
412863,202110,1317,3854,1153,3544,293,923,403,1201,696,2124
412865,202110,736,1968,538,1570,156,477,114,346,270,823
412870,202110,884,2260,636,1856,176,567,148,484,324,1051
412880,202110,906,2408,610,1829,101,342,126,333,227,675
420005,202110,435,1251,258,844,28,92,121,397,149,489
420010,202110,3388,8178,2277,6314,124,372,1684,4717,1808,5089
420020,202110,444,1355,294,970,43,167,68,161,111,328
420030,202110,100,353,63,256,17,76,17,69,34,145
420040,202110,524,1547,323,1099,65,239,30,82,95,321
420050,202110,732,1638,486,1209,86,227,280,629,366,856
420055,202110,164,495,83,295,20,89,22,68,42,157
420060,202110,113,311,71,210,7,23,16,41,23,64
420070,202110,756,2212,564,1813,110,353,225,708,335,1061
420075,202110,80,198,39,117,5,21,12,18,17,39
420080,202110,394,1094,302,878,72,235,116,323,188,558
420090,202110,427,1297,273,937,62,228,49,139,111,367
420100,202110,1310,3295,1095,2970,64,186,885,2364,949,2550
420110,202110,262,825,232,756,38,131,125,399,163,530
420120,202110,612,1639,413,1211,58,192,213,545,271,737
420125,202110,368,1092,254,833,65,235,82,245,147,480
420127,202110,320,817,127,376,16,54,49,132,65,186
420130,202110,3823,10280,2918,8797,424,1515,1347,3679,1771,5194
420140,202110,3962,10411,2902,8592,759,2527,534,1610,1293,4137
420150,202110,686,1707,476,1357,45,152,283,772,328,924
420160,202110,192,453,69,212,8,28,18,54,26,82
420165,202110,159,436,97,301,20,60,34,89,54,149
420170,202110,293,904,197,660,27,98,63,180,90,278
420180,202110,172,543,106,374,17,59,26,84,43,143
420190,202110,210,636,123,416,28,101,46,149,74,250
420195,202110,1612,4036,1210,3404,296,976,337,841,633,1817
420200,202110,5399,12824,3346,9050,426,1377,1457,3401,1883,4778
420205,202110,1965,5161,1328,3866,186,575,697,2020,883,2595
420207,202110,2043,5199,1287,3763,199,653,533,1441,732,2094
420208,202110,329,921,188,647,56,200,43,122,99,322
420209,202110,156,488,100,314,13,45,50,142,63,187
420210,202110,3474,8717,2428,7024,355,1190,1259,3455,1614,4645
420213,202110,820,2431,693,2185,145,510,276,825,421,1335
420215,202110,216,643,151,494,40,146,37,116,77,262
420220,202110,302,875,186,622,30,124,80,238,110,362
420230,202110,5491,14495,4194,12091,571,1777,2274,6237,2845,8014
420240,202110,15036,41074,9668,28693,1152,3908,4645,11946,5797,15854
420243,202110,406,1108,333,969,50,171,214,591,264,762
420245,202110,1590,4000,1190,3310,90,304,748,1945,838,2249
420250,202110,464,1262,396,1149,53,174,244,673,297,847
420253,202110,473,1133,331,927,34,95,190,533,224,628
420257,202110,159,405,101,304,13,50,55,162,68,212
420260,202110,1150,2924,845,2511,111,389,572,1665,683,2054
420270,202110,573,1481,301,881,40,129,119,323,159,452
420280,202110,1325,3847,1044,3256,179,628,416,1219,595,1847
420285,202110,130,280,63,172,8,36,26,46,34,82
420287,202110,461,1039,331,866,82,224,127,333,209,557
420290,202110,5099,14224,3946,11672,537,1791,2298,6296,2835,8087
420300,202110,7748,21560,4526,13935,789,2673,1454,3858,2243,6531
420310,202110,823,1868,430,1173,44,137,239,610,283,747
420315,202110,803,2202,548,1768,86,298,259,819,345,1117
420320,202110,5427,14287,3886,11752,1045,3489,1016,2878,2061,6367
420325,202110,349,974,247,770,32,103,105,304,137,407
420330,202110,1000,2849,631,2068,101,370,196,588,297,958
420340,202110,952,2586,714,2162,153,464,151,410,304,874
420350,202110,1216,3079,902,2527,69,234,632,1736,701,1970
420360,202110,3029,8139,1635,5142,291,999,115,345,406,1344
420370,202110,1225,3175,1008,2821,77,261,740,1993,817,2254
420380,202110,4529,11661,3049,8958,592,1857,1210,3335,1802,5192
420390,202110,1091,2628,757,1959,129,384,310,575,439,959
420395,202110,1228,3425,847,2658,134,457,134,308,268,765
420400,202110,1033,2819,730,2207,117,404,321,914,438,1318
420410,202110,595,1540,461,1267,33,95,330,894,363,989
420415,202110,292,849,216,686,50,171,85,287,135,458
420417,202110,604,1751,471,1484,127,421,180,575,307,996
420419,202110,142,503,114,437,42,167,9,37,51,204
420420,202110,12330,31524,8280,24132,2158,7125,2429,6392,4587,13517
420425,202110,653,1720,451,1297,33,112,231,635,264,747
420430,202110,3225,8486,1923,5705,411,1288,644,1729,1055,3017
420435,202110,275,701,141,448,20,75,68,204,88,279
420440,202110,721,1887,452,1336,127,400,144,385,271,785
420445,202110,263,630,173,470,32,87,77,189,109,276
420450,202110,768,2198,546,1716,88,340,204,547,292,887
420455,202110,2072,4912,1511,4078,249,695,721,1889,970,2584
420460,202110,9624,25169,7267,20831,983,3183,3800,10361,4783,13544
420470,202110,616,1588,321,991,59,209,58,152,117,361
420475,202110,68,180,26,85,6,21,2,6,8,27
420480,202110,5322,12886,3275,9524,608,1951,1200,3415,1808,5366
420490,202110,382,1058,271,824,50,163,109,320,159,483
420500,202110,1369,3677,886,2804,136,493,408,1259,544,1752
420510,202110,159,446,80,265,12,49,20,59,32,108
420515,202110,76,209,48,142,7,34,16,45,23,79
420517,202110,768,2079,647,1851,72,217,416,1187,488,1404
420519,202110,309,744,219,611,19,62,136,381,155,443
420520,202110,281,741,147,480,19,66,10,29,29,95
420530,202110,828,2365,561,1786,74,287,225,617,299,904
420535,202110,233,682,96,328,16,60,38,124,54,184
420540,202110,40490,95733,26954,72916,3705,11271,10206,23843,13911,35114
420543,202110,219,632,166,514,22,71,77,212,99,283
420545,202110,1292,3807,976,3116,170,606,338,948,508,1554
420550,202110,3698,9640,2431,7527,364,1333,1092,3395,1456,4728
420555,202110,310,880,221,694,22,76,129,388,151,464
420560,202110,397,972,262,770,47,147,155,453,202,600
420570,202110,2583,6712,1998,5638,316,1002,934,2520,1250,3522
420580,202110,1850,4734,1309,3871,283,883,408,1211,691,2094
420590,202110,2840,7549,1737,5167,281,991,488,1127,769,2118
420600,202110,1103,3097,860,2653,98,370,523,1526,621,1896
420610,202110,378,1089,245,794,62,204,82,274,144,478
420620,202110,788,1910,533,1499,120,345,200,564,320,909
420630,202110,927,2773,679,2178,75,272,406,1227,481,1499
420640,202110,513,1365,260,847,80,259,44,135,124,394
420650,202110,3767,9779,2382,6929,336,1084,958,2411,1294,3495
420660,202110,438,1113,276,772,58,162,57,150,115,312
420665,202110,683,1765,450,1370,74,246,197,540,271,786
420670,202110,1266,3468,802,2497,128,493,288,758,416,1251
420675,202110,194,510,116,362,17,68,61,174,78,242
420680,202110,317,721,168,514,29,94,83,243,112,337
420690,202110,876,2563,553,1822,73,292,148,412,221,704
420700,202110,2728,7062,2074,5979,211,665,1281,3588,1492,4253
420710,202110,1066,2974,833,2483,83,311,506,1331,589,1642
420720,202110,1196,3259,861,2681,143,486,456,1335,599,1821
420730,202110,3256,8367,2440,7024,402,1295,1309,3587,1711,4882
420740,202110,506,1474,276,966,55,213,17,68,72,281
420750,202110,2008,5701,1291,4048,211,779,525,1486,736,2265
420757,202110,85,203,38,111,3,5,18,53,21,58
420760,202110,317,907,174,529,33,114,52,138,85,252
420765,202110,463,1304,222,716,24,82,106,325,130,407
420768,202110,1390,3807,1210,3517,139,396,904,2629,1043,3025
420770,202110,441,1217,203,707,21,83,64,213,85,296
420775,202110,283,825,194,619,37,133,74,196,111,329
420780,202110,973,2743,584,1830,107,349,92,259,199,608
420785,202110,207,539,149,420,12,42,72,168,84,210
420790,202110,1038,3035,772,2498,114,433,444,1359,558,1792
420800,202110,681,1677,364,1058,75,244,162,447,237,691
420810,202110,1500,4515,1228,3980,315,1179,492,1367,807,2546
420820,202110,13357,32915,9706,26980,1669,5173,4568,11733,6237,16906
420830,202110,4673,11979,3487,9868,596,1779,1512,4102,2108,5881
420840,202110,490,1457,240,885,59,212,18,73,77,285
420845,202110,2634,6592,1675,4879,316,1107,703,1906,1019,3013
420850,202110,1117,3482,697,2387,113,418,156,469,269,887
420860,202110,374,957,214,669,33,107,56,154,89,261
420870,202110,794,2207,582,1787,154,525,211,577,365,1102
420880,202110,1092,3228,842,2716,167,639,320,927,487,1566
420890,202110,8380,22439,5218,15932,707,2338,1799,4853,2506,7191
420895,202110,182,519,114,344,27,83,36,109,63,192
420900,202110,1578,3835,952,2744,119,422,441,1088,560,1510
420910,202110,33369,86735,21445,63927,3042,10319,8835,23054,11877,33373
420915,202110,515,1816,380,1432,57,211,206,783,263,994
420917,202110,462,1159,208,573,35,95,95,262,130,357
420920,202110,82,214,35,114,2,5,7,23,9,28
420930,202110,17143,43616,12252,35064,2038,6443,5586,15041,7624,21484
420940,202110,3294,7938,1997,5720,427,1379,422,972,849,2351
420945,202110,144,414,110,337,19,65,45,127,64,192
420950,202110,364,1025,211,671,28,105,59,168,87,273
420960,202110,1087,2620,771,2088,118,367,350,842,468,1209
420970,202110,2423,6455,1673,5097,446,1401,478,1468,924,2869
420980,202110,276,909,238,829,108,387,60,213,168,600
420985,202110,330,928,180,612,42,161,47,141,89,302
420990,202110,323,995,183,646,29,108,40,139,69,247
421000,202110,573,1688,419,1354,86,305,98,269,184,574
421003,202110,473,1109,161,465,3,8,18,42,21,50
421005,202110,67,197,51,173,12,42,22,74,34,116
421010,202110,3421,9204,2448,7398,458,1563,696,1824,1154,3387
421020,202110,390,1196,310,1049,44,178,153,485,197,663
421030,202110,837,2396,643,2016,169,590,236,675,405,1265
421040,202110,658,1569,407,1182,30,99,255,722,285,821
421050,202110,1062,2819,703,2040,136,428,275,716,411,1144
421055,202110,178,480,101,305,15,48,59,164,74,212
421060,202110,693,1966,492,1535,89,317,244,691,333,1008
421070,202110,671,1974,418,1343,64,228,169,504,233,732
421080,202110,527,1502,431,1321,48,182,244,718,292,900
421085,202110,385,1069,158,528,15,48,28,74,43,122
421090,202110,274,704,151,420,12,43,51,125,63,168
421100,202110,797,1765,344,1011,75,248,89,206,164,454
421105,202110,1608,4269,1126,3357,170,542,553,1554,723,2096
421110,202110,1182,3044,951,2704,52,176,636,1879,688,2055
421120,202110,1088,3217,762,2495,115,410,213,608,328,1018
421125,202110,299,764,215,613,73,239,76,183,149,422
421130,202110,5074,14438,4175,12676,933,3209,2118,6018,3051,9227
421140,202110,346,929,212,640,39,116,77,211,116,327
421145,202110,444,1191,281,840,63,200,79,202,142,402
421150,202110,667,1818,444,1373,67,244,194,534,261,778
421160,202110,522,1421,391,1166,59,203,238,665,297,868
421165,202110,228,667,140,452,28,90,53,165,81,255
421170,202110,1114,2996,938,2710,141,394,580,1716,721,2110
421175,202110,991,2400,591,1775,109,373,265,769,374,1142
421180,202110,401,1038,222,680,37,138,107,295,144,433
421185,202110,323,815,220,606,26,80,125,330,151,410
421187,202110,277,845,175,590,28,89,58,193,86,282
421189,202110,371,1055,288,892,48,152,116,334,164,486
421190,202110,11985,31838,8268,24754,1400,4492,3200,8748,4600,13240
421200,202110,712,1967,590,1766,86,308,344,970,430,1278
421205,202110,195,507,139,417,23,80,65,181,88,261
421210,202110,1107,2768,623,1930,112,363,227,680,339,1043
421220,202110,1400,4072,1086,3427,230,805,371,1058,601,1863
421223,202110,320,869,197,641,46,145,95,309,141,454
421225,202110,849,2435,720,2223,112,413,441,1328,553,1741
421227,202110,697,1933,449,1416,76,263,205,666,281,929
421230,202110,585,1500,376,1110,73,245,143,413,216,658
421240,202110,300,852,144,490,16,66,29,90,45,156
421250,202110,2180,5393,1544,4372,166,515,935,2540,1101,3055
421260,202110,228,715,51,187,10,44,5,14,15,58
421265,202110,700,1802,614,1679,17,42,532,1447,549,1489
421270,202110,353,933,153,519,30,102,46,145,76,247
421280,202110,2075,5383,1563,4549,211,741,891,2438,1102,3179
421290,202110,1004,2700,508,1533,104,337,105,284,209,621
421300,202110,286,730,136,432,12,47,19,55,31,102
421310,202110,198,571,137,450,29,96,69,221,98,317
421315,202110,240,617,159,452,42,114,42,128,84,242
421320,202110,645,2018,341,1133,33,92,32,57,65,149
421330,202110,618,1797,447,1439,97,351,112,318,209,669
421335,202110,357,1065,289,944,59,212,122,379,181,591
421340,202110,1437,3882,1036,3169,170,603,496,1394,666,1997
421350,202110,1572,4005,1033,3070,197,641,392,1109,589,1750
421360,202110,2313,6054,1379,4175,254,887,520,1360,774,2247
421370,202110,754,2370,468,1616,78,289,144,416,222,705
421380,202110,859,2197,739,2011,92,283,440,1146,532,1429
421390,202110,168,442,65,214,14,41,25,67,39,108
421400,202110,377,1138,277,910,55,206,138,420,193,626
421410,202110,181,493,84,299,19,73,23,74,42,147
421415,202110,184,522,125,372,20,72,40,93,60,165
421420,202110,561,1503,456,1301,50,165,275,767,325,932
421430,202110,100,311,72,240,8,27,16,47,24,74
421440,202110,635,1673,379,1195,67,205,157,471,224,676
421450,202110,482,1385,276,925,27,104,37,125,64,229
421460,202110,357,1074,195,727,15,57,21,60,36,117
421470,202110,314,852,199,618,32,98,67,228,99,326
421480,202110,2821,7441,1884,5549,334,1157,765,2055,1099,3212
421490,202110,117,397,70,265,10,36,12,39,22,75
421500,202110,2193,6300,1468,4772,345,1288,339,969,684,2257
421505,202110,301,815,250,743,31,115,167,472,198,587
421507,202110,440,1208,250,810,50,183,93,269,143,452
421510,202110,380,1059,243,734,39,124,124,348,163,472
421520,202110,500,1312,312,890,30,85,167,431,197,516
421530,202110,293,843,160,544,24,100,31,78,55,178
421535,202110,384,1008,244,759,41,151,138,412,179,563
421540,202110,316,743,173,521,26,87,57,156,83,243
421545,202110,630,1835,468,1547,101,404,224,679,325,1083
421550,202110,2126,5527,1716,4905,329,983,954,2701,1283,3684
421555,202110,171,518,66,235,6,22,8,14,14,36
421560,202110,88,294,60,224,9,39,20,69,29,108
421565,202110,936,2363,629,1889,154,522,198,569,352,1091
421567,202110,441,1346,297,965,87,310,91,260,178,570
421568,202110,338,981,231,731,40,148,90,268,130,416
421569,202110,155,437,74,236,9,28,44,143,53,171
421570,202110,1336,3600,938,2776,196,637,302,810,498,1447
421575,202110,296,846,221,649,30,100,109,292,139,392
421580,202110,4423,11807,2825,8512,391,1359,1072,2742,1463,4101
421590,202110,168,500,124,404,30,110,46,142,76,252
421600,202110,587,1536,392,1129,73,242,141,346,214,588
421605,202110,734,1895,530,1567,101,269,258,813,359,1082
421610,202110,1058,2803,709,2151,115,379,221,653,336,1032
421620,202110,3917,10236,2414,7518,452,1637,783,2278,1235,3915
421625,202110,132,363,66,199,9,26,21,58,30,84
421630,202110,2676,6897,1706,5035,290,1025,629,1540,919,2565
421635,202110,268,705,187,541,14,44,119,314,133,358
421640,202110,682,1821,498,1547,114,394,197,602,311,996
421650,202110,2549,6874,1745,5401,368,1314,568,1550,936,2864
421660,202110,11036,30106,7816,23824,1126,3838,3584,9922,4710,13760
421670,202110,771,2153,551,1645,97,322,254,721,351,1043
421680,202110,1135,2953,876,2520,146,460,543,1449,689,1909
421690,202110,1404,3925,969,3023,171,581,324,1005,495,1586
421700,202110,563,1650,399,1287,82,293,129,391,211,684
421710,202110,203,639,101,334,21,75,26,74,47,149
421715,202110,127,325,96,261,21,57,53,140,74,197
421720,202110,2041,5423,1194,3625,287,926,305,808,592,1734
421725,202110,267,643,149,442,20,60,72,189,92,249
421730,202110,405,1119,237,678,32,95,129,341,161,436
421740,202110,787,2193,520,1625,113,377,162,460,275,837
421750,202110,897,2101,440,1265,90,280,175,465,265,745
421755,202110,168,462,91,276,16,54,37,97,53,151
421760,202110,1034,2678,703,2079,128,404,238,596,366,1000
421770,202110,2412,6265,1734,5098,450,1280,593,1873,1043,3153
421775,202110,212,549,128,388,15,49,55,155,70,204
421780,202110,852,2454,556,1825,106,380,236,705,342,1085
421790,202110,879,2361,501,1636,100,340,210,665,310,1005
421795,202110,175,481,122,354,22,69,38,100,60,169
421800,202110,2703,7122,1961,5768,233,787,1148,3194,1381,3981
421810,202110,644,1749,440,1368,45,166,255,780,300,946
421820,202110,1005,2896,621,1968,107,376,212,559,319,935
421825,202110,1391,3732,1236,3504,104,320,911,2518,1015,2838
421830,202110,2025,5813,1643,5099,335,1109,623,1903,958,3012
421835,202110,239,577,160,450,36,122,61,155,97,277
421840,202110,213,666,148,522,22,85,35,109,57,194
421850,202110,384,1061,222,741,54,210,55,138,109,348
421860,202110,308,843,176,571,24,86,65,190,89,276
421870,202110,4715,11618,3466,9291,472,1505,1888,4472,2360,5977
421875,202110,306,888,125,380,19,55,31,80,50,135
421880,202110,691,1920,476,1453,94,312,140,405,234,717
421885,202110,231,635,147,444,34,106,50,133,84,239
421890,202110,885,2566,654,2105,104,395,370,1126,474,1521
421895,202110,408,1020,351,945,38,106,236,671,274,777
421900,202110,1062,2786,811,2274,101,315,404,1027,505,1342
421910,202110,325,946,205,660,28,112,48,124,76,236
421915,202110,379,1061,224,701,50,153,43,122,93,275
421917,202110,589,1325,334,1002,118,368,79,251,197,619
421920,202110,372,1111,269,911,103,359,81,273,184,632
421930,202110,2679,6659,1450,4344,296,1007,526,1351,822,2358
421935,202110,405,1236,324,1066,62,210,186,600,248,810
421940,202110,382,1101,176,562,27,93,38,94,65,187
421950,202110,3188,7861,1809,5240,348,1095,460,1144,808,2239
421960,202110,182,443,97,284,14,54,30,65,44,119
421970,202110,1933,4879,1212,3407,229,766,502,1218,731,1984
421985,202110,308,842,196,614,25,84,76,222,101,306
422000,202110,1975,4984,1608,4422,146,472,1111,2999,1257,3471
430003,202110,579,1530,382,1178,67,219,172,529,239,748
430005,202110,271,711,173,536,24,81,85,256,109,337
430010,202110,1779,4160,1412,3594,256,638,865,2200,1121,2838
430020,202110,592,1343,443,1144,46,139,296,727,342,866
430030,202110,982,2259,538,1469,129,379,182,455,311,834
430040,202110,10641,24593,6456,17419,1657,4745,1024,2831,2681,7576
430045,202110,482,1188,347,942,28,87,234,617,262,704
430047,202110,242,522,96,256,21,50,26,73,47,123
430050,202110,885,2218,527,1506,101,306,143,385,244,691
430055,202110,281,678,142,390,17,55,74,175,91,230
430057,202110,83,171,29,78,9,28,4,7,13,35
430060,202110,18327,47544,14251,41128,2783,8375,6804,19398,9587,27773
430063,202110,811,2224,661,1922,134,394,355,1035,489,1429
430064,202110,1145,3015,849,2434,199,595,372,1037,571,1632
430066,202110,102,214,73,171,9,24,56,124,65,148
430070,202110,735,1877,127,416,22,86,22,55,44,141
430080,202110,927,2239,558,1518,93,305,296,683,389,988
430085,202110,930,2009,548,1404,91,236,247,618,338,854
430087,202110,849,2006,711,1826,61,163,510,1293,571,1456
430090,202110,510,1330,193,626,19,80,49,142,68,222
430100,202110,922,2183,560,1514,102,312,166,383,268,695
430105,202110,1305,3334,886,2616,121,411,431,1221,552,1632
430107,202110,182,517,101,307,19,58,25,67,44,125
430110,202110,2285,5610,1682,4710,309,894,789,2143,1098,3037
430120,202110,1271,3618,839,2557,140,422,373,1124,513,1546
430130,202110,3591,7956,2633,6626,846,2185,468,1442,1314,3627
430140,202110,1032,2594,729,2051,163,434,372,1027,535,1461
430150,202110,575,1459,313,934,72,222,88,269,160,491
430155,202110,249,627,120,357,19,57,24,59,43,116
430160,202110,21145,47618,16607,41312,1807,4777,10240,25022,12047,29799
430163,202110,3345,7591,2347,6044,76,245,1783,4490,1859,4735
430165,202110,316,775,102,314,11,25,16,45,27,70
430170,202110,981,2546,351,1180,58,200,39,110,97,310
430175,202110,673,1908,569,1693,137,385,271,820,408,1205
430180,202110,685,1640,519,1353,74,177,313,834,387,1011
430185,202110,705,1750,355,1007,101,255,49,139,150,394
430187,202110,794,1668,575,1394,68,180,352,841,420,1021
430190,202110,1449,3650,1157,3202,236,694,538,1417,774,2111
430192,202110,127,336,44,128,6,19,9,21,15,40
430195,202110,431,1241,66,230,8,32,7,14,15,46
430200,202110,1079,3098,855,2694,291,938,225,754,516,1692
430205,202110,454,1145,406,1059,13,46,363,921,376,967
430210,202110,6345,16108,4223,11658,672,1979,1243,2711,1915,4690
430215,202110,319,810,204,587,35,98,80,233,115,331
430220,202110,668,1637,207,675,20,69,51,136,71,205
430222,202110,204,542,146,429,20,63,51,149,71,212
430223,202110,265,674,203,570,15,35,120,331,135,366
430225,202110,16,32,10,23,0,0,7,16,7,16
430230,202110,2031,5339,1672,4791,145,462,1229,3454,1374,3916
430235,202110,383,1051,240,745,38,128,57,150,95,278
430237,202110,519,1171,387,960,16,45,299,723,315,768
430240,202110,1386,3172,782,2135,84,273,409,1013,493,1286
430245,202110,733,1966,573,1668,126,387,300,878,426,1265
430250,202110,955,2250,687,1835,233,667,48,114,281,781
430258,202110,142,380,103,298,7,17,56,158,63,175
430260,202110,716,1821,486,1389,57,184,281,808,338,992
430265,202110,231,652,155,504,28,87,56,190,84,277
430270,202110,3054,7278,2403,6285,361,1025,1501,3793,1862,4818
430280,202110,5289,12022,3692,9356,700,1801,1651,4094,2351,5895
430290,202110,2312,5180,1889,4690,67,192,1589,3852,1656,4044
430300,202110,10725,25922,8107,21503,1230,3571,4357,11101,5587,14672
430310,202110,12860,31055,8772,23611,1103,3296,4394,10992,5497,14288
430320,202110,1058,2600,583,1679,57,164,346,994,403,1158
430330,202110,720,1702,432,1142,80,217,164,398,244,615
430340,202110,620,1431,402,1075,63,159,240,629,303,788
430350,202110,8375,20186,6416,16854,697,2004,4077,10138,4774,12142
430355,202110,310,817,115,365,15,50,15,42,30,92
430360,202110,886,2079,588,1564,108,334,235,568,343,902
430367,202110,352,753,199,500,33,102,111,253,144,355
430370,202110,548,1429,223,655,31,91,57,129,88,220
430380,202110,718,1727,341,1029,76,262,93,269,169,531
430390,202110,3465,8140,2133,5776,411,1256,303,576,714,1832
430400,202110,1044,2201,794,1866,67,177,472,1072,539,1249
430410,202110,553,1275,387,1010,55,142,247,632,302,774
430420,202110,2722,7020,2092,5740,394,1162,1105,2861,1499,4023
430430,202110,575,1430,259,789,58,165,51,165,109,330
430435,202110,1596,3950,1228,3354,214,619,641,1746,855,2365
430440,202110,4011,10594,3178,9203,295,936,2036,5834,2331,6770
430450,202110,7011,16909,5586,14424,1086,3004,2683,6613,3769,9617
430460,202110,36523,89456,27284,74388,4278,12745,14195,37021,18473,49766
430461,202110,230,597,74,224,14,49,28,65,42,114
430462,202110,320,823,164,513,32,104,47,137,79,241
430463,202110,6567,16734,4828,13562,915,2861,2241,5965,3156,8826
430465,202110,458,1141,361,957,62,186,225,570,287,756
430466,202110,4539,11047,3579,9541,740,2043,1758,4433,2498,6476
430467,202110,511,1198,355,959,49,159,198,487,247,646
430468,202110,1333,3187,1063,2797,80,244,759,1942,839,2186
430469,202110,587,1574,84,253,10,28,19,40,29,68
430470,202110,5810,14660,3867,11187,1094,3432,961,2608,2055,6040
430471,202110,564,1559,463,1377,71,216,270,771,341,987
430480,202110,670,1855,428,1329,59,196,99,262,158,458
430485,202110,176,450,68,199,21,58,9,25,30,83
430490,202110,409,1030,224,659,25,91,113,287,138,378
430495,202110,401,1065,264,807,42,134,110,313,152,447
430500,202110,1025,2574,716,2055,227,697,203,532,430,1229
430510,202110,28744,72267,20485,56725,3200,9891,9500,24139,12700,34030
430511,202110,370,1017,140,450,15,51,18,54,33,105
430512,202110,1019,2214,798,1891,172,414,309,732,481,1146
430513,202110,814,1972,378,1067,64,194,176,454,240,648
430515,202110,395,1083,287,868,41,119,152,459,193,578
430517,202110,1243,3568,936,2879,153,464,510,1568,663,2032
430520,202110,1396,3418,748,2065,135,398,170,411,305,809
430530,202110,1015,2486,421,1249,69,210,118,334,187,544
430535,202110,3684,9220,2668,7383,371,1062,1349,3594,1720,4656
430537,202110,406,1234,352,1114,25,71,273,868,298,939
430540,202110,617,1452,340,974,67,195,153,431,220,626
430543,202110,1000,1713,606,1269,65,139,230,566,295,705
430544,202110,777,2127,536,1605,126,385,166,489,292,874
430545,202110,2572,6299,1918,5320,309,863,1079,2988,1388,3851
430550,202110,355,993,258,784,49,154,97,276,146,430
430558,202110,120,281,57,159,7,14,22,63,29,77
430560,202110,288,662,145,422,25,83,50,135,75,218
430570,202110,872,2108,625,1666,109,340,298,707,407,1047
430580,202110,848,2069,606,1701,165,490,244,702,409,1192
430583,202110,202,497,40,123,4,12,11,23,15,35
430585,202110,230,558,121,338,18,54,49,118,67,172
430587,202110,205,538,152,446,21,68,63,171,84,239
430590,202110,1401,3328,1154,2957,77,232,922,2303,999,2535
430593,202110,22,65,14,40,2,4,6,17,8,21
430595,202110,439,1099,125,398,13,45,18,43,31,88
430597,202110,458,1136,239,700,23,69,71,167,94,236
430600,202110,2025,5148,851,2414,127,373,195,513,322,886
430605,202110,1345,3418,978,2751,114,355,480,1295,594,1650
430607,202110,627,1375,470,1141,37,89,327,779,364,868
430610,202110,5912,13451,3952,10535,1041,3189,894,2270,1935,5459
430613,202110,299,690,88,257,11,30,23,55,34,85
430620,202110,671,1608,497,1294,74,221,295,680,369,901
430630,202110,440,1183,124,392,22,70,31,81,53,151
430632,202110,457,1165,201,582,31,86,80,217,111,303
430635,202110,588,1324,444,1080,45,118,332,793,377,911
430637,202110,468,1090,355,920,37,110,240,599,277,709
430640,202110,1139,2991,765,2227,115,333,305,823,420,1156
430642,202110,380,1022,277,800,49,140,133,361,182,501
430645,202110,156,368,62,166,13,38,18,37,31,75
430650,202110,1770,4806,1392,4176,408,1202,554,1828,962,3030
430655,202110,313,756,186,516,28,88,92,225,120,313
430660,202110,5418,13404,4153,11355,867,2476,1871,5044,2738,7520
430670,202110,664,1566,503,1296,49,128,279,730,328,858
430673,202110,558,1242,242,664,40,110,92,227,132,337
430675,202110,251,723,58,209,7,23,11,35,18,58
430676,202110,5410,13012,4326,11382,550,1507,2724,7047,3274,8554
430680,202110,1079,2801,630,1878,166,481,146,420,312,901
430690,202110,2911,7653,2290,6540,772,2333,650,1775,1422,4108
430692,202110,220,665,172,583,13,42,129,450,142,492
430693,202110,974,2498,593,1760,111,378,156,434,267,812
430695,202110,415,1021,255,710,35,89,130,347,165,436
430697,202110,426,1049,325,897,68,168,175,518,243,686
430700,202110,8025,19120,4951,13489,968,2841,1215,2925,2183,5766
430705,202110,405,938,200,564,21,57,80,207,101,264
430710,202110,1763,3626,1227,2924,148,393,740,1712,888,2105
430720,202110,827,1914,401,1165,49,141,195,548,244,689
430730,202110,1031,2739,718,2138,94,277,374,1091,468,1368
430740,202110,683,1814,357,1142,59,190,97,317,156,507
430745,202110,361,964,241,713,56,190,79,196,135,386
430750,202110,1529,3742,1028,2869,331,967,353,951,684,1918
430755,202110,459,1107,294,778,27,82,162,393,189,475
430760,202110,2134,5135,1634,4377,325,963,782,1984,1107,2947
430770,202110,6749,16474,5246,14212,620,1925,3370,8749,3990,10674
430780,202110,1997,4842,1242,3559,191,604,583,1609,774,2213
430781,202110,486,1324,282,852,64,177,84,228,148,405
430783,202110,350,795,208,575,23,68,127,328,150,396
430786,202110,32,113,23,87,4,17,4,16,8,33
430790,202110,4775,11353,3384,8963,361,1123,2058,5043,2419,6166
430800,202110,786,1750,593,1474,44,107,388,956,432,1063
430805,202110,377,945,246,677,13,44,171,449,184,493
430807,202110,546,1337,303,876,32,100,149,391,181,491
430810,202110,773,1821,341,983,41,137,129,317,170,454
430820,202110,1243,3313,748,2331,125,402,222,644,347,1046
430825,202110,269,652,91,246,11,26,32,82,43,108
430830,202110,1788,4865,1444,4207,124,347,996,2865,1120,3212
430840,202110,1113,2614,752,2031,117,290,471,1298,588,1588
430843,202110,181,428,85,228,8,24,33,75,41,99
430845,202110,495,1147,323,872,44,125,162,415,206,540
430850,202110,2336,5946,1596,4545,249,766,584,1719,833,2485
430860,202110,969,2261,462,1283,57,184,210,493,267,677
430865,202110,533,1328,376,1058,98,283,101,280,199,563
430870,202110,591,1549,256,813,41,136,73,198,114,334
430880,202110,1526,3387,1047,2657,167,420,572,1414,739,1834
430885,202110,176,470,95,306,9,31,54,170,63,201
430890,202110,1039,2493,694,1917,48,200,145,375,193,575
430900,202110,3177,6806,2228,5469,166,513,1519,3491,1685,4004
430905,202110,903,2198,589,1608,100,298,252,654,352,952
430910,202110,2211,5848,1677,4768,252,823,790,1944,1042,2767
430912,202110,516,1425,359,1103,38,108,221,692,259,800
430915,202110,513,1506,376,1226,134,419,103,357,237,776
430920,202110,24185,60184,18754,51175,2370,7067,11424,30300,13794,37367
430925,202110,90,202,38,113,4,12,19,55,23,67
430930,202110,11006,25290,7265,19597,1345,3598,3108,8694,4453,12292
430940,202110,999,2527,622,1756,123,364,212,545,335,909
430950,202110,859,1864,554,1357,41,132,369,822,410,954
430955,202110,395,1019,108,299,24,64,34,74,58,138
430957,202110,169,560,153,524,19,65,103,350,122,415
430960,202110,1411,3288,805,2193,157,440,323,835,480,1275
430965,202110,1596,3729,1233,3165,69,177,927,2420,996,2597
430970,202110,379,896,208,568,29,96,108,258,137,354
430975,202110,524,1485,402,1208,75,242,203,578,278,820
430980,202110,401,890,234,612,24,73,114,265,138,338
430990,202110,583,1620,389,1174,56,183,172,509,228,692
430995,202110,567,1421,433,1207,61,175,241,654,302,829
431000,202110,1420,3311,606,1732,114,359,42,101,156,460
431010,202110,2454,6351,1670,4970,325,1029,499,1318,824,2347
431020,202110,8089,17338,4811,12449,910,2706,1768,3987,2678,6693
431030,202110,360,973,176,586,33,127,24,74,57,201
431033,202110,4030,9211,2633,7021,544,1512,989,2626,1533,4138
431036,202110,341,743,71,207,7,24,21,45,28,69
431040,202110,904,2227,578,1667,67,217,288,756,355,973
431041,202110,447,1021,318,822,27,63,183,474,210,537
431043,202110,325,805,192,563,37,122,99,279,136,401
431046,202110,107,278,44,134,6,16,8,22,14,38
431050,202110,1378,3263,973,2606,192,550,433,1189,625,1739
431053,202110,700,1788,395,1171,72,231,127,327,199,558
431055,202110,613,1440,500,1263,62,138,358,905,420,1043
431057,202110,229,653,129,420,27,89,37,111,64,200
431060,202110,5856,14230,3951,11036,867,2659,1187,3160,2054,5819
431065,202110,408,991,297,808,39,115,151,402,190,517
431070,202110,426,1122,256,760,55,181,73,198,128,379
431075,202110,222,625,131,418,31,107,38,124,69,231
431080,202110,604,1607,420,1214,66,220,156,421,222,641
431085,202110,799,2041,507,1389,57,161,270,722,327,883
431087,202110,413,1118,331,954,27,81,221,638,248,719
431090,202110,413,949,163,487,24,77,44,138,68,215
431100,202110,3540,7595,2438,6169,273,700,1387,3513,1660,4213
431110,202110,1448,3274,987,2475,220,577,418,936,638,1513
431112,202110,639,1681,524,1471,39,141,370,978,409,1119
431113,202110,414,1079,344,948,58,170,181,480,239,650
431115,202110,988,2737,777,2348,76,291,505,1428,581,1719
431120,202110,2766,6996,1920,5426,494,1514,505,1333,999,2847
431123,202110,377,1015,249,730,58,150,130,396,188,546
431125,202110,1006,2752,791,2348,271,795,289,904,560,1699
431127,202110,200,539,67,221,8,28,11,33,19,61
431130,202110,3077,7595,2309,6374,327,1000,1294,3466,1621,4466
431140,202110,6082,14140,3697,9697,424,1184,1607,3669,2031,4853
431142,202110,542,1364,404,1137,48,134,248,704,296,838
431150,202110,1062,2754,775,2239,143,449,348,973,491,1422
431160,202110,681,1882,438,1349,87,290,126,374,213,664
431162,202110,546,1331,331,936,37,121,171,429,208,550
431164,202110,183,425,47,148,8,25,9,27,17,52
431170,202110,453,1213,322,947,96,287,88,248,184,535
431171,202110,685,1567,563,1407,145,307,304,809,449,1116
431173,202110,433,1098,321,935,81,275,137,371,218,646
431175,202110,1351,3077,855,2246,133,343,330,831,463,1174
431177,202110,844,2194,659,1903,111,393,429,1168,540,1561
431179,202110,345,738,105,293,14,40,30,80,44,120
431180,202110,2274,5692,1417,4013,325,949,435,1158,760,2107
431190,202110,613,1525,270,774,33,94,82,202,115,296
431198,202110,402,1112,324,965,87,278,112,348,199,626
431200,202110,375,932,91,248,17,49,13,36,30,85
431205,202110,221,593,118,372,36,116,33,113,69,229
431210,202110,648,1514,517,1336,139,370,207,566,346,936
431213,202110,259,673,194,550,9,31,106,291,115,322
431215,202110,645,1509,307,879,27,85,147,388,174,473
431217,202110,158,403,108,308,16,51,55,139,71,190
431220,202110,555,1422,347,1020,31,102,197,543,228,645
431225,202110,1533,3534,1182,2970,124,324,804,2009,928,2333
431230,202110,700,1921,557,1612,89,258,319,899,408,1157
431235,202110,176,465,20,71,2,4,4,19,6,23
431237,202110,355,1092,283,925,53,200,133,399,186,599
431238,202110,34,97,28,84,5,17,12,28,17,45
431240,202110,4929,11646,3936,10107,452,1284,2523,6125,2975,7409
431242,202110,270,678,236,622,40,114,144,363,184,477
431244,202110,368,910,185,523,24,85,72,171,96,256
431245,202110,1352,3077,868,2260,63,175,487,1218,550,1393
431247,202110,288,704,176,481,27,87,81,188,108,275
431250,202110,1809,4385,1339,3754,294,828,671,2037,965,2865
431260,202110,279,742,173,539,24,89,58,178,82,267
431261,202110,266,786,211,688,15,52,118,364,133,416
431262,202110,351,978,182,588,14,43,114,368,128,411
431265,202110,1636,3791,674,1914,80,265,223,541,303,806
431267,202110,247,607,161,429,6,21,118,294,124,315
431270,202110,2902,6375,1551,4084,317,847,499,1373,816,2220
431275,202110,116,320,64,202,21,65,12,39,33,104
431280,202110,239,641,76,242,4,15,14,33,18,48
431290,202110,358,1044,236,746,40,133,34,87,74,220
431295,202110,70,169,21,61,4,12,4,10,8,22
431300,202110,303,786,62,186,7,18,22,56,29,74
431301,202110,296,829,65,208,11,34,6,20,17,54
431303,202110,634,1590,385,1085,22,77,176,440,198,517
431306,202110,2365,5494,1453,3966,190,588,627,1515,817,2103
431308,202110,28,80,25,74,10,34,13,35,23,69
431310,202110,561,1488,397,1143,49,137,186,499,235,636
431320,202110,679,1837,378,1205,67,201,106,300,173,501
431330,202110,1802,4171,923,2583,148,468,371,912,519,1380
431333,202110,223,580,123,359,20,58,47,117,67,175
431335,202110,36,105,19,69,4,10,0,0,4,10
431337,202110,2798,7073,2140,6018,312,1031,1315,3519,1627,4550
431339,202110,434,1081,316,882,90,257,113,308,203,565
431340,202110,19347,46254,13599,36648,1954,5859,6669,16684,8623,22543
431342,202110,429,964,313,778,28,56,240,599,268,655
431344,202110,400,997,240,697,12,34,128,364,140,398
431346,202110,222,538,82,251,13,41,20,50,33,91
431349,202110,744,1836,448,1206,85,222,197,519,282,741
431350,202110,4429,10969,3343,9153,403,1272,1903,4945,2306,6217
431360,202110,582,1351,289,797,89,249,65,178,154,427
431365,202110,2125,4781,1679,4181,116,328,1298,3179,1414,3507
431370,202110,4769,11139,3498,9127,665,1839,1768,4651,2433,6490
431380,202110,860,2243,701,1995,55,158,482,1378,537,1536
431390,202110,2731,6576,1736,4820,159,531,930,2255,1089,2786
431395,202110,1418,3337,1045,2782,193,531,549,1464,742,1995
431400,202110,317,882,181,574,35,108,36,106,71,214
431402,202110,926,2010,692,1661,86,202,471,1117,557,1319
431403,202110,201,550,153,450,27,81,67,189,94,270
431405,202110,5049,12854,3937,11024,624,1940,2037,5334,2661,7274
431406,202110,563,1542,389,1175,76,223,181,562,257,785
431407,202110,503,1319,359,1017,69,212,204,551,273,763
431410,202110,18439,44572,12677,34679,1649,5166,6967,17617,8616,22783
431413,202110,239,647,59,192,6,19,11,36,17,55
431415,202110,726,1713,454,1254,72,243,215,524,287,767
431417,202110,580,1263,384,956,58,167,210,505,268,672
431420,202110,1666,3657,1261,3107,148,380,760,1825,908,2205
431430,202110,586,1473,294,895,45,145,92,242,137,387
431440,202110,31686,71898,22237,57393,3562,9985,9404,22403,12966,32388
431442,202110,140,396,69,233,12,48,10,29,22,77
431445,202110,380,1053,105,331,10,26,13,36,23,62
431446,202110,277,778,207,638,29,107,102,297,131,404
431447,202110,790,2019,438,1274,93,282,129,377,222,659
431449,202110,793,2036,491,1419,90,244,182,543,272,787
431450,202110,2324,4677,1810,3955,71,169,1438,3063,1509,3232
431454,202110,38,124,30,104,5,17,11,35,16,52
431455,202110,606,1398,301,781,33,92,153,359,186,451
431460,202110,2986,6984,2052,5351,533,1445,508,1333,1041,2778
431470,202110,1410,3853,1035,3072,181,547,423,1256,604,1803
431475,202110,246,662,60,199,5,17,10,24,15,41
431477,202110,433,1089,256,741,40,108,99,261,139,369
431478,202110,222,581,50,153,8,21,4,9,12,30
431480,202110,3558,8566,2854,7493,722,1866,1383,3664,2105,5530
431490,202110,112567,258620,85700,217804,5568,16750,63021,153384,68589,170134
431500,202110,503,1262,376,1030,66,190,196,513,262,703
431505,202110,254,606,172,481,12,40,123,340,135,380
431507,202110,332,775,135,395,46,148,33,86,79,234
431510,202110,1691,4183,1141,3123,284,825,373,1019,657,1844
431513,202110,228,489,122,313,13,27,67,167,80,194
431514,202110,119,300,91,250,4,11,62,159,66,170
431515,202110,482,1175,356,959,82,221,200,505,282,726
431517,202110,58,173,46,139,5,15,22,64,27,79
431520,202110,396,980,166,501,15,54,76,198,91,252
431530,202110,5074,10784,3043,7701,598,1476,1068,2726,1666,4202
431531,202110,211,499,130,348,17,39,53,134,70,173
431532,202110,560,1270,342,880,66,189,150,373,216,562
431535,202110,246,645,113,349,22,73,26,69,48,142
431540,202110,1807,5647,1672,5463,58,215,1354,4446,1412,4661
431545,202110,372,938,75,221,7,21,22,60,29,81
431550,202110,2211,5438,1595,4305,259,737,800,2072,1059,2809
431555,202110,685,1539,408,1079,36,104,236,618,272,722
431560,202110,25151,58450,16779,45394,3247,8943,5913,16735,9160,25678
431570,202110,4478,10602,3778,9587,429,1185,2711,6645,3140,7830
431575,202110,307,725,247,641,75,166,109,299,184,465
431580,202110,603,1558,387,1133,46,151,204,566,250,717
431590,202110,627,1692,469,1389,93,276,177,526,270,802
431595,202110,374,1002,244,729,40,117,86,235,126,352
431600,202110,1557,3607,1112,2936,210,601,489,1246,699,1847
431610,202110,1448,3554,988,2731,160,422,492,1391,652,1813
431620,202110,493,1244,235,659,38,110,98,248,136,358
431630,202110,1356,3272,655,1862,94,269,259,699,353,968
431640,202110,6543,14956,5549,13707,507,1320,4133,10234,4640,11554
431642,202110,633,1462,389,1003,42,104,174,419,216,523
431643,202110,386,925,180,509,16,42,53,152,69,194
431645,202110,1891,4101,1487,3570,50,150,1228,2905,1278,3055
431647,202110,313,743,102,298,8,18,26,65,34,83
431650,202110,128,335,89,274,8,27,38,102,46,129
431660,202110,902,2323,427,1325,59,214,110,290,169,504
431670,202110,1214,2830,726,1947,123,347,341,828,464,1175
431673,202110,241,619,89,299,6,23,14,33,20,56
431675,202110,404,1030,106,358,11,38,19,57,30,95
431680,202110,8475,20846,6205,16751,1327,3697,2733,7151,4060,10848
431690,202110,25577,61163,17526,46872,3186,9104,7862,20561,11048,29665
431695,202110,204,484,115,332,22,72,58,147,80,219
431697,202110,479,1100,369,935,48,114,221,569,269,683
431700,202110,1390,3480,1137,3036,195,472,636,1721,831,2193
431710,202110,13995,32094,9945,26357,1447,4134,5417,14277,6864,18411
431720,202110,6936,16583,4177,11462,984,2816,852,2108,1836,4924
431725,202110,27,75,21,65,3,10,9,24,12,34
431730,202110,4124,9482,2587,7109,550,1580,873,2544,1423,4124
431740,202110,5469,12524,3652,9561,897,2730,987,2249,1884,4979
431750,202110,7913,19971,5984,16923,1436,4219,2222,6236,3658,10455
431755,202110,337,896,80,253,11,26,13,36,24,62
431760,202110,5549,12267,3806,9515,426,1185,2352,5577,2778,6762
431770,202110,2019,4513,1537,3881,118,295,1137,2816,1255,3111
431775,202110,203,512,102,315,21,68,16,38,37,106
431780,202110,2256,5365,1466,3946,224,644,602,1574,826,2218
431790,202110,795,2078,523,1531,88,244,229,687,317,931
431795,202110,286,702,140,421,28,84,34,95,62,179
431800,202110,8517,19673,5337,14741,1241,4102,482,1373,1723,5475
431805,202110,289,696,75,261,7,30,7,15,14,45
431810,202110,3412,7736,2139,5481,390,1030,938,2302,1328,3332
431820,202110,2205,5714,1705,4914,465,1447,630,1841,1095,3288
431830,202110,9138,19586,6772,16403,1780,5090,1453,3439,3233,8529
431840,202110,2752,6891,2209,6036,311,872,1430,3892,1741,4764
431842,202110,508,1242,180,537,24,79,75,203,99,282
431843,202110,338,880,245,698,30,91,116,318,146,409
431844,202110,201,536,70,233,15,56,20,74,35,130
431845,202110,513,1326,359,1024,41,114,208,587,249,701
431846,202110,289,719,248,660,13,33,216,576,229,609
431848,202110,156,388,83,237,11,35,20,42,31,77
431849,202110,414,1003,81,239,9,24,14,27,23,51
431850,202110,4287,11189,3307,9329,724,2249,1128,3045,1852,5294
431860,202110,653,1518,355,957,55,159,206,536,261,695
431861,202110,93,258,58,179,9,28,19,60,28,88
431862,202110,475,1471,394,1331,75,278,198,640,273,918
431870,202110,22164,54266,17767,47498,1892,5682,11144,28539,13036,34221
431880,202110,4028,10134,2871,8107,399,1312,1431,3813,1830,5125
431890,202110,4760,11727,2983,8363,812,2455,533,1658,1345,4113
431900,202110,987,2419,635,1793,101,313,318,837,419,1150
431910,202110,788,1817,294,789,41,119,85,185,126,304
431912,202110,501,1310,391,1120,78,240,224,636,302,876
431915,202110,1138,2628,896,2249,34,87,690,1704,724,1791
431920,202110,1273,2873,1048,2585,36,77,889,2185,925,2262
431930,202110,700,1795,481,1386,179,501,161,484,340,985
431935,202110,86,227,60,172,16,46,13,34,29,80
431936,202110,318,876,184,547,35,105,85,236,120,341
431937,202110,144,354,93,254,10,24,41,94,51,118
431940,202110,3127,7171,1868,4918,151,426,1033,2594,1184,3020
431950,202110,2001,5051,1593,4392,351,1012,693,1844,1044,2856
431960,202110,3018,7153,2273,5844,591,1612,666,1688,1257,3300
431970,202110,399,991,173,498,36,112,39,89,75,201
431971,202110,85,210,38,116,4,16,8,17,12,33
431973,202110,497,1565,403,1380,44,138,280,973,324,1111
431975,202110,109,222,22,69,3,13,6,17,9,30
431980,202110,995,2520,774,2161,136,416,412,1080,548,1496
431990,202110,5953,13958,4244,11516,433,1426,2388,6225,2821,7651
432000,202110,12456,28765,9133,23688,1871,5005,4385,11228,6256,16233
432010,202110,2799,6430,1880,4906,344,937,764,1835,1108,2772
432020,202110,1811,4650,1117,3175,241,717,338,924,579,1641
432023,202110,560,1321,278,770,38,109,119,289,157,398
432026,202110,960,2620,708,2131,184,543,211,646,395,1189
432030,202110,379,910,227,610,17,53,132,328,149,381
432032,202110,342,853,235,639,23,67,136,336,159,403
432035,202110,671,1841,588,1704,169,464,256,797,425,1261
432040,202110,1133,2638,434,1312,57,191,181,482,238,673
432045,202110,162,451,103,327,20,63,40,129,60,192
432050,202110,568,1367,423,1121,77,215,195,520,272,735
432055,202110,564,1487,370,1134,126,396,65,185,191,581
432057,202110,182,484,144,388,9,22,75,190,84,212
432060,202110,440,1052,137,426,35,119,32,90,67,209
432065,202110,209,568,152,448,35,111,57,169,92,280
432067,202110,753,2108,641,1864,56,186,476,1331,532,1517
432070,202110,1753,4350,1222,3364,211,653,539,1359,750,2012
432080,202110,5073,11492,3845,9638,592,1721,1828,4338,2420,6059
432085,202110,381,1005,280,847,58,187,131,393,189,580
432090,202110,2358,5714,1389,3869,248,702,617,1625,865,2327
432100,202110,1005,2446,495,1455,105,330,89,220,194,550
432110,202110,2127,5427,1477,4279,342,1100,194,498,536,1598
432120,202110,3285,8521,2618,7438,435,1346,1248,3369,1683,4715
432130,202110,2689,6563,2233,5891,638,1710,962,2583,1600,4293
432132,202110,211,593,111,365,20,68,54,158,74,226
432135,202110,1021,2343,681,1767,67,184,475,1219,542,1403
432140,202110,1762,5028,1354,4217,174,574,841,2579,1015,3153
432143,202110,1471,3780,1121,3245,73,224,725,2078,798,2302
432145,202110,1821,4722,1163,3383,172,524,376,912,548,1436
432146,202110,105,291,78,253,26,93,23,68,49,161
432147,202110,492,1307,290,898,103,319,61,181,164,500
432149,202110,458,1094,235,654,26,71,100,245,126,316
432150,202110,3478,8459,2590,6946,497,1431,1164,3039,1661,4470
432160,202110,5552,13912,4064,11559,887,2832,1346,3687,2233,6519
432162,202110,234,512,37,109,5,18,11,21,16,39
432163,202110,147,342,29,78,0,0,5,6,5,6
432166,202110,670,1801,527,1520,105,352,192,473,297,825
432170,202110,1618,4250,1116,3338,207,674,463,1290,670,1964
432180,202110,3174,7373,1723,4684,288,824,681,1612,969,2436
432183,202110,386,1085,273,839,58,201,93,260,151,461
432185,202110,846,2141,493,1459,49,158,236,654,285,812
432190,202110,2028,4822,1432,3879,132,413,896,2296,1028,2709
432195,202110,879,2188,600,1685,124,322,236,680,360,1002
432200,202110,3620,8752,2634,7231,345,982,1596,4351,1941,5333
432210,202110,412,1073,261,781,51,172,114,293,165,465
432215,202110,619,1772,560,1685,45,111,421,1289,466,1400
432218,202110,264,645,118,331,12,40,53,126,65,166
432220,202110,3765,8636,2666,6844,516,1310,1251,3215,1767,4525
432225,202110,112,300,78,234,12,34,47,139,59,173
432230,202110,768,1772,410,1119,44,121,183,456,227,577
432232,202110,491,1185,312,887,56,160,121,315,177,475
432234,202110,280,700,130,376,23,55,21,58,44,113
432235,202110,44,124,18,56,5,17,4,12,9,29
432237,202110,311,786,275,729,14,26,224,584,238,610
432240,202110,17003,40164,12468,34114,947,2479,8027,22962,8974,25441
432250,202110,5791,15954,4284,12977,1061,3327,1777,5364,2838,8691
432252,202110,452,1077,290,772,33,90,154,381,187,471
432253,202110,889,2594,600,1871,151,504,52,147,203,651
432254,202110,703,1624,204,593,28,75,42,119,70,194
432255,202110,105,266,60,176,4,11,29,79,33,90
432260,202110,5244,13058,3885,10545,1024,2859,1386,3621,2410,6480
432270,202110,2055,5423,1664,4697,475,1449,460,1237,935,2686
432280,202110,1473,3571,771,2220,103,333,273,657,376,990
432285,202110,142,425,22,67,2,6,3,7,5,13
432290,202110,359,962,208,618,65,205,44,98,109,303
432300,202110,27463,66982,20698,56221,2562,7951,12733,32992,15295,40943
432310,202110,871,2251,632,1816,68,201,417,1204,485,1405
432320,202110,201,460,80,240,7,26,28,73,35,99
432330,202110,224,489,70,211,11,27,10,33,21,60
432335,202110,166,459,60,199,8,30,13,39,21,69
432340,202110,329,811,144,464,15,48,42,136,57,184
432345,202110,764,1638,655,1510,16,39,555,1260,571,1299
432350,202110,351,872,185,556,31,90,65,199,96,289
432360,202110,235,694,45,154,4,12,13,43,17,55
432370,202110,314,762,207,582,17,56,140,381,157,437
432375,202110,486,1183,364,950,91,242,154,395,245,637
432377,202110,162,500,34,115,2,7,7,14,9,21
432380,202110,1939,5088,1331,3983,207,657,673,1972,880,2629
500020,202110,3236,7793,2221,6134,226,708,1337,3554,1563,4262
500025,202110,1215,2953,761,2103,80,212,390,1050,470,1262
500060,202110,8369,23105,5744,17658,693,2255,3340,10425,4033,12680
500070,202110,4757,11710,3366,9377,599,1713,1479,4163,2078,5876
500080,202110,1707,4073,1043,2871,198,617,394,946,592,1563
500085,202110,2061,5087,1453,4040,371,1074,629,1658,1000,2732
500090,202110,2207,5656,1498,4439,213,682,488,1561,701,2243
500100,202110,3783,9430,2869,7948,428,1311,1475,3847,1903,5158
500110,202110,8919,22062,5903,17330,1128,3624,1880,6378,3008,10002
500124,202110,2200,6150,1755,5432,317,869,893,2939,1210,3808
500150,202110,1433,3129,935,2430,138,393,428,1055,566,1448
500190,202110,5259,13361,3375,9717,668,1908,916,2524,1584,4432
500200,202110,2738,6252,1883,4828,174,449,1165,2881,1339,3330
500210,202110,4956,11376,3511,9475,1046,2698,1454,4096,2500,6794
500215,202110,1456,3903,1060,3179,100,331,606,1795,706,2126
500220,202110,3054,8122,2099,6390,378,1198,761,2235,1139,3433
500230,202110,2121,4792,1613,4091,199,490,1079,2695,1278,3185
500240,202110,4271,12168,3051,9648,421,1424,1288,4156,1709,5580
500260,202110,3443,7199,2235,5587,279,720,1263,3018,1542,3738
500270,202110,145286,334825,89348,242021,13332,39627,35370,88356,48702,127983
500280,202110,1479,3627,996,2878,190,560,439,1275,629,1835
500290,202110,3880,9258,2324,6519,348,1103,744,1780,1092,2883
500295,202110,3862,9101,2502,6717,423,1265,1027,2390,1450,3655
500310,202110,1038,2080,716,1683,101,216,384,924,485,1140
500315,202110,4055,10716,3249,9543,251,740,2373,7082,2624,7822
500320,202110,20755,53866,14255,43175,3579,11140,4646,15278,8225,26418
500325,202110,5428,11732,3737,9408,430,1071,2311,5835,2741,6906
500330,202110,7006,15480,4575,11995,392,1096,2384,6507,2776,7603
500345,202110,2134,5122,1426,4004,288,849,540,1501,828,2350
500348,202110,2480,6221,1831,5117,230,684,1079,3029,1309,3713
500350,202110,1359,3633,755,2322,95,285,297,892,392,1177
500370,202110,28840,72125,20754,59054,2459,8023,11191,31090,13650,39113
500375,202110,2635,6761,1782,5052,270,850,643,1632,913,2482
500380,202110,3542,8678,2471,6883,718,2138,438,1263,1156,3401
500390,202110,666,1377,413,1059,57,169,243,600,300,769
500400,202110,1641,4084,1081,3007,194,595,364,900,558,1495
500410,202110,2520,5946,1760,4840,180,467,995,2869,1175,3336
500430,202110,2842,6794,1945,5483,273,852,803,2422,1076,3274
500440,202110,1651,3842,891,2574,137,424,298,920,435,1344
500450,202110,1666,4030,999,2867,144,449,279,731,423,1180
500460,202110,3826,9906,2262,6841,367,1241,640,1829,1007,3070
500470,202110,2610,6840,1630,4866,428,1410,355,939,783,2349
500480,202110,2163,6519,1815,5978,169,522,1351,4543,1520,5065
500490,202110,1161,2633,684,1914,119,403,172,478,291,881
500500,202110,4409,11352,2832,8800,769,2820,287,931,1056,3751
500510,202110,737,1815,483,1350,40,111,299,809,339,920
500515,202110,1746,4456,1348,3822,173,532,784,2112,957,2644
500520,202110,3503,9989,2688,8568,682,2139,1079,3766,1761,5905
500525,202110,987,2772,781,2471,64,219,506,1588,570,1807
500540,202110,4867,12387,2827,8692,633,2459,250,682,883,3141
500560,202110,5669,15025,4545,13611,296,873,3673,11217,3969,12090
500568,202110,4661,9995,2855,7303,742,1848,872,2341,1614,4189
500570,202110,8386,19103,5382,14132,830,2427,2369,5715,3199,8142
500580,202110,3274,8368,2380,6802,587,1703,980,2833,1567,4536
500600,202110,3517,8638,2517,7051,550,1601,1021,2929,1571,4530
500620,202110,8404,21434,5662,16299,1022,3075,2387,6536,3409,9611
500625,202110,561,1482,373,1114,65,198,97,272,162,470
500627,202110,802,2039,494,1510,93,299,137,397,230,696
500630,202110,7684,16923,4268,11354,837,2456,1205,3142,2042,5598
500635,202110,3049,9428,2347,8493,163,576,1604,6399,1767,6975
500640,202110,1869,3968,1220,3102,47,136,807,1999,854,2135
500660,202110,19920,48832,13615,39684,3912,12963,3486,10479,7398,23442
500690,202110,2680,6989,1734,5404,454,1603,395,1240,849,2843
500710,202110,3203,8257,2390,6864,609,1862,731,1955,1340,3817
500720,202110,5274,13008,3496,10010,768,2335,1138,3295,1906,5630
500730,202110,1161,2798,630,1826,118,334,143,433,261,767
500740,202110,4874,11334,3228,8796,455,1288,1547,4087,2002,5375
500750,202110,1070,2649,739,2085,91,238,309,818,400,1056
500755,202110,997,2539,577,1754,98,330,129,348,227,678
500769,202110,5518,13321,3124,8851,561,1710,444,1140,1005,2850
500770,202110,1457,3880,982,3079,171,603,311,945,482,1548
500780,202110,1249,2948,796,2209,150,480,214,531,364,1011
500790,202110,7398,19253,5527,15999,1183,3681,2333,6706,3516,10387
500793,202110,2116,5238,1531,4253,353,1042,524,1335,877,2377
500795,202110,2775,6725,2213,6024,131,320,1734,4966,1865,5286
500797,202110,794,1985,516,1486,158,464,142,428,300,892
500800,202110,3583,7925,2200,5858,619,1971,306,880,925,2851
500830,202110,19113,46496,13051,35624,2745,7913,4468,11540,7213,19453
500840,202110,1491,3531,939,2513,132,348,389,984,521,1332
510010,202110,1891,4170,1295,3423,119,260,925,2467,1044,2727
510020,202110,4274,10464,2274,6553,391,1235,620,1558,1011,2793
510025,202110,7068,16635,4369,12395,604,1848,1988,5417,2592,7265
510030,202110,3172,6805,2125,5265,319,777,1084,2569,1403,3346
510035,202110,1268,3232,810,2522,126,411,422,1425,548,1836
510040,202110,2486,5388,1852,4572,198,444,1136,2957,1334,3401
510050,202110,2288,4638,1540,3690,211,521,992,2380,1203,2901
510060,202110,1415,3474,885,2526,133,409,258,690,391,1099
510080,202110,1482,3738,1004,2981,200,637,468,1299,668,1936
510100,202110,699,1593,498,1283,66,171,281,699,347,870
510120,202110,285,508,160,360,10,18,121,274,131,292
510125,202110,2125,5262,1676,4607,152,544,948,2423,1100,2967
510130,202110,1615,3980,1105,3163,230,677,380,1119,610,1796
510140,202110,3170,7900,2111,6573,765,2706,700,2191,1465,4897
510160,202110,1821,4599,1359,4005,139,387,1023,3093,1162,3480
510170,202110,5039,12887,3755,10823,847,2530,1567,4461,2414,6991
510180,202110,15347,33500,10002,25950,2075,5903,3377,9636,5452,15539
510185,202110,1845,4710,1179,3747,473,1541,236,1014,709,2555
510190,202110,2189,6076,1393,4759,362,1376,261,969,623,2345
510250,202110,18387,44951,13573,37710,2434,7056,6808,19486,9242,26542
510260,202110,1846,7812,1540,7292,242,1233,953,4948,1195,6181
510263,202110,3397,9397,2073,6635,342,1214,413,1155,755,2369
510267,202110,5592,15658,3163,10193,520,1794,474,1270,994,3064
510268,202110,1281,3166,965,2660,121,334,561,1508,682,1842
510269,202110,1052,2780,652,2021,145,508,228,648,373,1156
510270,202110,3159,8691,2161,6942,340,1233,857,2730,1197,3963
510279,202110,1858,4695,1094,3360,165,551,379,1062,544,1613
510285,202110,1163,2991,763,2293,208,710,202,544,410,1254
510300,202110,3835,9438,2844,8118,420,1195,1669,5037,2089,6232
510305,202110,1484,4024,923,2965,181,605,213,774,394,1379
510310,202110,991,2363,679,1867,181,515,202,577,383,1092
510320,202110,3814,9228,2646,7279,563,1725,557,1496,1120,3221
510325,202110,4427,12671,3167,10353,866,3042,846,2810,1712,5852
510330,202110,2681,7920,1785,6349,310,1127,621,2597,931,3724
510335,202110,5017,14200,3796,12232,586,1999,1960,6414,2546,8413
510336,202110,459,1268,335,1080,46,144,178,643,224,787
510337,202110,1460,4115,934,3185,333,1258,202,701,535,1959
510340,202110,97961,214275,64450,166469,14289,42675,21504,52600,35793,95275
510343,202110,1162,2948,750,2225,116,400,345,964,461,1364
510345,202110,1300,3633,978,2992,160,482,429,1300,589,1782
510350,202110,3198,7906,2169,6215,480,1386,925,2672,1405,4058
510360,202110,2094,4163,1310,3256,80,126,916,2477,996,2603
510370,202110,1805,5017,1339,4246,184,655,797,2581,981,3236
510380,202110,589,1403,334,982,54,182,139,408,193,590
510385,202110,1248,4076,919,3480,85,369,612,2408,697,2777
510390,202110,1342,3379,903,2854,276,867,271,1049,547,1916
510395,202110,737,1596,501,1255,27,61,323,859,350,920
510410,202110,4981,13240,3593,10892,674,2130,1819,5766,2493,7896
510420,202110,2587,5253,1741,4146,111,263,1178,2811,1289,3074
510450,202110,597,1428,341,977,80,234,56,165,136,399
510452,202110,856,2383,635,1970,76,247,378,1138,454,1385
510454,202110,1021,2739,772,2319,89,256,475,1498,564,1754
510455,202110,1002,2639,688,2052,133,433,249,674,382,1107
510460,202110,1933,4776,1423,4001,162,505,844,2265,1006,2770
510480,202110,5080,11903,3438,8978,590,1703,1399,3457,1989,5160
510490,202110,1766,4433,1319,3873,248,691,790,2379,1038,3070
510500,202110,1604,3862,975,2884,199,620,274,793,473,1413
510510,202110,3846,10582,2743,8699,641,2262,880,2900,1521,5162
510515,202110,5484,13613,3604,10320,740,2412,1136,2855,1876,5267
510517,202110,1458,3608,955,2850,274,951,187,504,461,1455
510520,202110,2364,4664,1299,3341,108,287,599,1692,707,1979
510523,202110,1310,3008,918,2419,162,439,561,1487,723,1926
510525,202110,7950,21240,5859,17167,900,2808,2766,7653,3666,10461
510530,202110,563,1440,415,1223,27,88,275,800,302,888
510550,202110,2400,6885,1746,5781,350,1225,825,2719,1175,3944
510558,202110,2422,6352,1774,5354,248,692,827,2769,1075,3461
510560,202110,1649,4621,1005,3362,185,668,230,835,415,1503
510562,202110,6109,14859,4404,11967,983,2778,1546,4535,2529,7313
510590,202110,3069,7508,2251,6445,149,424,1640,4843,1789,5267
510600,202110,1487,3249,998,2547,156,390,512,1289,668,1679
510610,202110,2690,6327,1813,5187,221,677,1069,3053,1290,3730
510615,202110,2870,6879,1996,5527,290,883,1165,3227,1455,4110
510617,202110,1046,3114,822,2760,82,321,573,1983,655,2304
510618,202110,1267,3294,901,2697,195,639,406,1186,601,1825
510619,202110,818,2035,477,1417,68,190,91,239,159,429
510620,202110,1471,3288,687,2000,173,605,34,69,207,674
510621,202110,1654,4326,999,3097,221,754,276,755,497,1509
510622,202110,5096,13823,3456,10443,1111,3639,465,1312,1576,4951
510623,202110,2822,6911,2051,5702,474,1448,670,1855,1144,3303
510624,202110,1683,4257,835,2682,96,339,177,502,273,841
510625,202110,3201,7570,1794,5120,307,987,436,1248,743,2235
510626,202110,1528,3648,958,2744,234,769,205,599,439,1368
510627,202110,649,1637,354,1072,83,282,88,278,171,560
510628,202110,1524,3437,1007,2770,233,676,391,1063,624,1739
510629,202110,1710,4696,1217,3813,211,719,406,1277,617,1996
510630,202110,3530,9517,2084,6800,458,1596,387,1408,845,3004
510631,202110,590,1380,426,1138,17,37,323,900,340,937
510637,202110,3851,8868,2721,7235,614,1811,851,2317,1465,4128
510642,202110,5641,15531,4299,13522,941,3297,2033,6378,2974,9675
510645,202110,1075,2078,665,1579,189,405,266,681,455,1086
510650,202110,7355,18128,5767,16394,678,1717,3804,12235,4482,13952
510665,202110,1856,3967,1166,2895,254,591,423,1153,677,1744
510670,202110,439,934,252,667,31,87,136,366,167,453
510675,202110,6534,17516,4445,13692,1152,3931,816,2372,1968,6303
510677,202110,2279,5761,1582,4734,213,731,872,2585,1085,3316
510680,202110,715,1785,405,1215,72,248,102,250,174,498
510682,202110,1591,4437,1156,3741,378,1397,296,876,674,2273
510685,202110,499,1396,350,1100,52,169,185,587,237,756
510700,202110,4157,9669,2896,7966,253,752,2197,6026,2450,6778
510704,202110,11400,26474,7614,20104,1771,5013,1835,4697,3606,9710
510706,202110,2266,6515,1559,5347,321,1132,771,2872,1092,4004
510710,202110,2966,7181,1909,5170,420,1157,574,1520,994,2677
510715,202110,638,1355,458,1119,27,66,273,662,300,728
510718,202110,2426,5468,1437,4125,354,983,567,1964,921,2947
510719,202110,475,977,282,720,30,86,164,386,194,472
510720,202110,908,2051,607,1623,121,351,269,695,390,1046
510724,202110,891,2377,622,1874,82,261,329,948,411,1209
510726,202110,1065,1933,583,1349,71,176,289,676,360,852
510729,202110,636,1474,294,842,32,102,80,250,112,352
510730,202110,3045,7174,2068,5701,239,763,1085,2877,1324,3640
510735,202110,1145,3107,893,2763,75,260,676,2077,751,2337
510740,202110,1048,2538,673,1853,111,308,339,901,450,1209
510757,202110,504,1592,390,1411,120,469,136,464,256,933
510760,202110,46041,99277,27760,71677,5612,16405,8713,20557,14325,36962
510770,202110,4392,9683,3010,7955,189,450,2084,5781,2273,6231
510774,202110,359,885,255,730,39,117,137,397,176,514
510775,202110,665,1726,416,1312,94,315,78,236,172,551
510776,202110,580,1388,410,1098,74,211,172,438,246,649
510777,202110,1631,4175,1175,3588,136,450,813,2471,949,2921
510779,202110,815,2108,611,1779,59,150,368,1147,427,1297
510780,202110,3991,10015,2951,8507,684,1915,1264,4135,1948,6050
510785,202110,2066,5268,1200,3732,341,1111,188,687,529,1798
510787,202110,2993,8304,1945,6134,540,1808,149,439,689,2247
510788,202110,598,1358,413,1082,65,171,190,573,255,744
510790,202110,19506,48664,12387,36103,2864,9203,1848,4917,4712,14120
510792,202110,9902,26692,6081,19314,1224,4319,1009,2912,2233,7231
510794,202110,1267,3387,905,2779,304,1030,157,414,461,1444
510795,202110,9330,23592,6242,18149,1305,4212,1742,4828,3047,9040
510800,202110,1642,4118,1088,3195,319,960,131,360,450,1320
510805,202110,1571,4259,1107,3428,228,795,422,1196,650,1991
510810,202110,675,1337,442,1032,128,304,145,369,273,673
510820,202110,807,1487,457,1061,20,56,264,614,284,670
510830,202110,941,2151,704,1856,39,84,543,1504,582,1588
510835,202110,597,1419,393,1124,45,138,244,681,289,819
510840,202110,60496,125431,41435,102195,8173,18810,20042,54529,28215,73339
510850,202110,1948,4657,1196,3499,392,1328,135,328,527,1656
510860,202110,2484,6307,1574,4824,474,1742,202,575,676,2317
510880,202110,787,2127,594,1789,150,485,179,537,329,1022
510885,202110,676,1581,437,1232,88,258,127,379,215,637
510890,202110,776,2164,582,1828,155,525,235,731,390,1256
510895,202110,1347,3388,883,2622,158,566,389,1078,547,1644
520005,202110,3083,7736,2397,6859,708,2035,889,3031,1597,5066
520010,202110,2564,6965,1832,5583,408,1389,602,1652,1010,3041
520013,202110,3402,8309,2208,6188,512,1445,601,1857,1113,3302
520015,202110,531,1283,381,1065,91,255,144,424,235,679
520017,202110,1291,3162,945,2643,228,650,375,1006,603,1656
520020,202110,452,983,346,861,24,74,282,687,306,761
520025,202110,35149,95159,29796,87694,3451,10402,20530,60580,23981,70982
520030,202110,6041,14745,4892,13187,309,852,3658,9836,3967,10688
520050,202110,430,1008,255,690,17,42,159,446,176,488
520055,202110,1971,4620,1245,3237,179,390,614,1602,793,1992
520060,202110,1674,4339,1192,3486,268,916,295,827,563,1743
520080,202110,1906,4843,1454,4232,260,754,691,2238,951,2992
520082,202110,985,2403,736,2001,76,215,374,1058,450,1273
520085,202110,1019,2513,794,2170,149,432,383,1031,532,1463
520090,202110,899,1744,630,1451,84,148,448,1093,532,1241
520110,202110,39219,103180,27097,82855,7473,26085,2676,7470,10149,33555
520120,202110,233,548,130,368,12,40,58,156,70,196
520130,202110,4122,9675,3168,8191,638,1687,1298,3415,1936,5102
520140,202110,43930,114066,30214,90563,10353,33685,3614,11310,13967,44995
520145,202110,628,1406,426,1118,81,231,220,526,301,757
520150,202110,659,1517,491,1310,65,176,258,700,323,876
520160,202110,885,2048,608,1572,102,252,219,620,321,872
520170,202110,4959,9984,3311,8105,199,582,2506,6066,2705,6648
520180,202110,2560,6645,2058,5904,325,1038,1152,3228,1477,4266
520215,202110,1787,4228,1268,3441,274,772,443,1159,717,1931
520235,202110,737,1628,483,1260,48,141,260,675,308,816
520250,202110,1591,3935,1125,3188,326,987,278,898,604,1885
520260,202110,849,1941,536,1452,95,247,207,577,302,824
520280,202110,866,1963,667,1669,127,309,328,859,455,1168
520310,202110,1068,2251,677,1672,163,452,211,562,374,1014
520320,202110,1842,4793,1390,4062,172,511,789,2361,961,2872
520330,202110,4828,12210,3607,10206,530,1717,1829,5026,2359,6743
520340,202110,2570,5504,1574,4145,167,394,948,2607,1115,3001
520350,202110,2935,6883,2072,5595,555,1596,809,2226,1364,3822
520355,202110,1952,5229,1384,4121,427,1322,191,487,618,1809
520357,202110,799,1877,586,1555,45,91,423,1170,468,1261
520360,202110,747,1899,570,1608,136,405,183,524,319,929
520380,202110,1477,3632,903,2604,124,359,374,1022,498,1381
520390,202110,1111,2446,664,1858,197,617,186,555,383,1172
520393,202110,655,1477,420,1109,61,165,167,421,228,586
520396,202110,920,2302,774,2093,45,115,546,1466,591,1581
520400,202110,1656,3960,1268,3439,131,392,910,2454,1041,2846
520410,202110,2195,4679,1434,3553,186,511,775,1791,961,2302
520420,202110,388,868,309,748,20,51,248,572,268,623
520425,202110,1651,3946,890,2487,241,731,125,340,366,1071
520430,202110,2400,5345,1388,3795,245,774,66,166,311,940
520440,202110,3054,7259,1778,4968,411,1242,405,1072,816,2314
520450,202110,12754,29533,8702,23585,2644,7909,1829,5211,4473,13120
520455,202110,731,1968,522,1639,143,455,140,486,283,941
520460,202110,1069,2424,833,2124,79,174,648,1697,727,1871
520465,202110,839,2055,686,1850,59,178,520,1359,579,1537
520470,202110,2191,5378,1666,4688,485,1426,619,1913,1104,3339
520480,202110,903,2424,620,1952,179,577,162,496,341,1073
520485,202110,1599,4537,1294,4093,191,593,803,2509,994,3102
520490,202110,4196,11146,3136,9469,823,2580,1360,4272,2183,6852
520495,202110,1630,3522,1233,2986,65,155,975,2379,1040,2534
520500,202110,1481,3739,1049,2950,190,559,497,1401,687,1960
520505,202110,792,1709,553,1410,60,152,372,954,432,1106
520510,202110,7865,19133,5344,15301,1028,3327,1792,5220,2820,8547
520520,202110,1238,2983,926,2506,212,624,342,913,554,1537
520530,202110,2498,6710,1847,5545,371,1177,869,2698,1240,3875
520540,202110,3101,7948,2019,5863,368,1152,532,1449,900,2601
520545,202110,1169,2885,913,2474,213,514,383,1101,596,1615
520547,202110,1044,2654,813,2271,169,497,412,1134,581,1631
520549,202110,15116,38769,12556,35118,1525,4509,8488,23384,10013,27893
520551,202110,4696,12327,3895,11156,412,1351,2741,7670,3153,9021
520552,202110,841,2110,686,1910,155,410,365,1100,520,1510
520570,202110,560,1249,365,946,89,197,121,358,210,555
520580,202110,2303,5048,1711,4362,187,495,1154,2939,1341,3434
520590,202110,1337,3210,906,2507,256,729,271,751,527,1480
520620,202110,8510,22223,6684,19518,1481,4480,3214,9551,4695,14031
520630,202110,877,2159,626,1745,57,164,290,805,347,969
520640,202110,2493,5931,1877,4893,421,1071,782,2144,1203,3215
520650,202110,1043,2263,738,1841,130,326,369,986,499,1312
520660,202110,577,1388,306,902,50,164,81,242,131,406
520670,202110,969,2587,815,2369,61,193,552,1574,613,1767
520680,202110,820,1942,629,1641,106,267,317,870,423,1137
520690,202110,320,732,213,571,70,178,56,164,126,342
520710,202110,430,1028,304,827,17,47,201,530,218,577
520725,202110,1491,3475,1017,2692,124,394,616,1561,740,1955
520735,202110,857,2029,579,1567,124,305,220,641,344,946
520740,202110,2576,5605,1962,4853,354,807,1035,2837,1389,3644
520750,202110,707,1680,493,1345,79,219,232,617,311,836
520753,202110,1291,3443,969,2833,164,504,400,1095,564,1599
520760,202110,1401,2996,1185,2740,33,65,1080,2529,1113,2594
520780,202110,1566,3622,1127,3003,129,333,593,1587,722,1920
520790,202110,3639,8434,2530,6672,369,968,1316,3617,1685,4585
520800,202110,17449,43703,13597,38039,1846,5216,8161,23513,10007,28729
520810,202110,1351,2774,1025,2406,155,345,654,1682,809,2027
520815,202110,588,1769,433,1434,87,295,111,379,198,674
520830,202110,1948,4091,1383,3434,116,256,1057,2622,1173,2878
520840,202110,2868,7410,2318,6694,840,2722,637,1919,1477,4641
520850,202110,723,1732,537,1460,150,485,173,465,323,950
520860,202110,7458,19508,5489,16190,1325,4169,2072,5962,3397,10131
520870,202110,119555,272916,81303,214915,16456,46670,30412,78366,46868,125036
520880,202110,7778,21797,5948,18426,1257,4067,2161,6629,3418,10696
520890,202110,4489,10250,3062,8061,482,1412,1448,3695,1930,5107
520910,202110,4800,11783,3089,8874,688,2160,793,2173,1481,4333
520915,202110,748,2030,464,1409,93,309,151,422,244,731
520920,202110,4680,10221,3335,8570,524,1329,1603,4445,2127,5774
520929,202110,701,1641,539,1418,56,125,299,841,355,966
520940,202110,1009,2616,780,2284,49,119,598,1757,647,1876
520945,202110,527,1134,382,946,14,34,256,626,270,660
520960,202110,1143,2611,883,2233,288,676,365,1012,653,1688
520970,202110,2786,7360,2165,6370,462,1554,526,1691,988,3245
520980,202110,803,1888,587,1597,96,261,249,658,345,919
520990,202110,3094,7930,2477,7158,333,889,1650,4882,1983,5771
520993,202110,1205,2766,826,2169,139,399,422,1073,561,1472
520995,202110,2465,6094,1836,5218,274,803,724,2168,998,2971
521000,202110,9289,23885,6088,17947,1117,3421,1667,4806,2784,8227
521010,202110,3739,9552,2773,7846,280,781,1569,4424,1849,5205
521015,202110,808,1968,560,1524,38,118,353,920,391,1038
521020,202110,3744,9244,2189,6260,571,1796,204,604,775,2400
521030,202110,562,1219,396,969,44,95,238,607,282,702
521040,202110,8140,19486,6006,16141,1320,3604,2326,6591,3646,10195
521056,202110,951,2434,739,2125,251,701,189,625,440,1326
521060,202110,1023,2679,735,2132,141,430,276,798,417,1228
521080,202110,1152,2422,604,1587,89,250,269,639,358,889
521090,202110,3233,8467,2135,6266,484,1574,230,691,714,2265
521100,202110,1908,4216,1410,3524,241,569,850,2175,1091,2744
521120,202110,4774,11193,3547,9655,235,584,1701,5471,1936,6055
521130,202110,1055,2365,576,1524,18,45,280,795,298,840
521140,202110,1448,3624,1077,2967,105,300,590,1595,695,1895
521150,202110,12831,27636,7987,20739,1434,4239,3573,9507,5007,13746
521160,202110,715,1443,489,1127,80,155,289,671,369,826
521170,202110,1109,2535,815,2094,77,223,483,1196,560,1419
521180,202110,8008,21212,6528,18693,1098,3305,3332,9340,4430,12645
521190,202110,11126,26861,6593,19438,1606,5042,1391,4306,2997,9348
521200,202110,725,1714,509,1378,51,140,319,866,370,1006
521205,202110,656,1577,504,1343,22,58,387,991,409,1049
521210,202110,764,1941,436,1270,74,232,104,228,178,460
521220,202110,3836,9000,2569,7068,383,1162,1137,3146,1520,4308
521225,202110,404,853,293,726,60,136,170,440,230,576
521230,202110,1409,3466,1226,3241,368,975,601,1742,969,2717
521250,202110,32926,83796,25684,73363,9063,26544,7631,23674,16694,50218
521260,202110,560,1272,414,1054,72,177,220,555,292,732
521270,202110,1912,4606,1675,4332,108,237,1280,3359,1388,3596
521280,202110,1827,4806,1369,4056,313,1010,556,1672,869,2682
521290,202110,554,1230,387,1016,49,146,241,606,290,752
521295,202110,1207,2595,952,2322,86,152,791,1995,877,2147
521300,202110,1953,4700,1527,4105,288,721,892,2523,1180,3244
521305,202110,728,1662,526,1382,85,204,301,813,386,1017
521308,202110,5075,12988,3512,10134,331,971,2086,5871,2417,6842
521310,202110,9069,22709,6322,18008,1172,3679,2818,7638,3990,11317
521340,202110,419,946,294,759,23,62,196,508,219,570
521350,202110,2126,5301,1621,4552,150,475,1131,3108,1281,3583
521370,202110,1264,3151,770,2319,222,772,92,299,314,1071
521375,202110,1394,3400,942,2681,198,564,270,879,468,1443
521377,202110,1583,3287,1163,2769,136,221,868,2229,1004,2450
521380,202110,6485,16802,4182,12563,460,1469,1040,3341,1500,4810
521385,202110,714,1663,539,1433,62,149,288,840,350,989
521390,202110,718,1753,496,1406,141,448,147,446,288,894
521400,202110,2961,6659,2369,5959,289,679,1588,4127,1877,4806
521405,202110,1474,3695,1036,2904,142,409,555,1532,697,1941
521410,202110,844,2179,636,1827,102,289,326,978,428,1267
521440,202110,1242,2980,920,2511,285,867,296,798,581,1665
521450,202110,4096,11861,2937,9565,780,2511,622,2249,1402,4760
521460,202110,5802,14657,4088,11687,1153,3446,1161,3371,2314,6817
521470,202110,741,1891,473,1380,69,186,176,519,245,705
521480,202110,441,1066,273,759,60,156,86,235,146,391
521483,202110,2436,5672,1689,4562,328,907,731,2002,1059,2909
521486,202110,1859,4346,1397,3694,96,207,967,2590,1063,2797
521487,202110,418,984,296,821,53,144,154,443,207,587
521490,202110,940,2442,699,2039,36,120,487,1375,523,1495
521500,202110,2261,5452,1709,4655,104,345,1189,3128,1293,3473
521520,202110,774,1757,561,1451,84,190,254,688,338,878
521523,202110,12600,36798,10305,33211,2719,9331,3019,10042,5738,19373
521525,202110,1135,2564,866,2191,71,188,611,1518,682,1706
521530,202110,2402,6038,1476,4207,301,855,383,1074,684,1929
521540,202110,856,2143,595,1722,87,272,269,809,356,1081
521550,202110,1739,4298,933,2681,160,525,230,676,390,1201
521560,202110,4999,12376,3422,10241,788,2314,1427,4756,2215,7070
521565,202110,703,1634,504,1324,93,235,252,656,345,891
521570,202110,3672,9837,2515,7602,477,1727,136,423,613,2150
521580,202110,513,1216,308,860,44,127,110,280,154,407
521590,202110,726,1611,532,1341,92,243,304,752,396,995
521600,202110,455,1167,293,860,27,64,133,389,160,453
521630,202110,1751,3729,1106,2824,236,643,357,901,593,1544
521640,202110,2082,4758,1362,3690,253,716,472,1266,725,1982
521645,202110,573,1456,371,1094,128,355,64,180,192,535
521680,202110,1240,3567,934,3001,236,846,174,579,410,1425
521690,202110,560,1328,465,1208,62,172,290,750,352,922
521710,202110,3411,8220,2198,6241,356,1150,626,1577,982,2727
521720,202110,2415,5330,1589,4125,242,629,851,2231,1093,2860
521730,202110,3806,10178,2926,8719,767,2680,788,1943,1555,4623
521740,202110,4135,10396,3103,8858,791,2457,777,2285,1568,4742
521760,202110,15841,41394,12280,36047,2698,8631,4695,14852,7393,23483
521770,202110,3290,7588,2183,5860,589,1729,511,1431,1100,3160
521800,202110,6899,17783,4986,14677,1120,3354,1989,6420,3109,9774
521805,202110,908,1868,621,1510,162,380,260,689,422,1069
521810,202110,693,1600,502,1345,87,224,286,799,373,1023
521830,202110,5725,15405,4562,13622,299,1041,3315,9719,3614,10760
521839,202110,849,1965,620,1591,87,258,377,878,464,1136
521850,202110,6579,14609,4113,10954,903,2494,705,1958,1608,4452
521860,202110,1623,4241,1107,3298,183,596,361,1004,544,1600
521870,202110,724,1957,515,1559,100,350,128,328,228,678
521878,202110,742,1854,521,1434,55,178,291,737,346,915
521880,202110,19834,47792,13580,38009,3498,10228,4529,12756,8027,22984
521890,202110,3369,8551,2240,6549,585,1814,480,1289,1065,3103
521900,202110,1462,3374,788,2282,217,614,50,142,267,756
521910,202110,1398,2851,960,2336,117,275,526,1370,643,1645
521920,202110,532,1371,382,1124,62,210,185,517,247,727
521925,202110,802,2016,576,1667,91,278,309,889,400,1167
521930,202110,5683,13326,3725,10402,993,2597,1304,4209,2297,6806
521935,202110,1098,2570,746,1968,73,203,420,1056,493,1259
521940,202110,1387,2927,878,2227,189,534,374,915,563,1449
521945,202110,687,1756,520,1469,97,276,271,792,368,1068
521950,202110,790,1864,546,1487,113,310,237,645,350,955
521960,202110,747,1894,506,1447,48,156,275,731,323,887
521970,202110,2866,6572,2180,5754,190,453,1583,4381,1773,4834
521971,202110,786,1824,548,1457,148,356,141,389,289,745
521973,202110,1573,3924,1309,3571,82,171,1055,2911,1137,3082
521975,202110,12504,32045,10168,28818,1887,5425,5979,17101,7866,22526
521980,202110,2611,5968,2002,5167,152,382,1501,3981,1653,4363
521990,202110,1167,3152,941,2769,190,591,397,1160,587,1751
522000,202110,2842,7191,2232,6428,416,1204,1219,3714,1635,4918
522005,202110,353,820,254,669,55,150,114,299,169,449
522010,202110,4386,10502,3146,8507,623,1830,1214,3164,1837,4994
522015,202110,1097,2786,801,2330,257,701,274,850,531,1551
522020,202110,5729,13228,3712,10114,775,2254,1371,3935,2146,6189
522026,202110,840,2193,545,1663,86,289,156,415,242,704
522028,202110,512,1244,351,974,84,250,102,286,186,536
522040,202110,3556,7662,2561,6339,272,754,1771,4282,2043,5036
522045,202110,18484,49649,13678,41380,3104,10017,3827,11287,6931,21304
522050,202110,1244,3136,842,2428,170,556,307,786,477,1342
522060,202110,3056,7817,2154,6353,250,744,1152,3517,1402,4261
522068,202110,1932,4731,1535,4258,104,254,1239,3491,1343,3745
522070,202110,756,1743,619,1552,13,34,533,1308,546,1342
522100,202110,780,1939,532,1531,70,211,274,771,344,982
522108,202110,1142,2638,899,2300,53,127,734,1856,787,1983
522119,202110,1792,4185,1400,3677,196,533,793,2164,989,2697
522130,202110,443,1081,315,908,34,89,211,639,245,728
522140,202110,21617,54841,15173,43418,3539,10780,4380,11867,7919,22647
522145,202110,820,1980,569,1608,162,445,223,645,385,1090
522150,202110,1134,2705,795,2147,203,548,221,614,424,1162
522155,202110,1112,2742,860,2368,178,418,483,1412,661,1830
522157,202110,688,1518,559,1359,22,57,457,1134,479,1191
522160,202110,6243,15697,4032,11689,1037,3242,336,1065,1373,4307
522170,202110,2662,6681,1988,5686,295,852,1133,3305,1428,4157
522180,202110,606,1420,384,1005,63,177,98,271,161,448
522185,202110,20683,49394,14505,40954,5343,16671,3025,9204,8368,25875
522190,202110,798,1821,545,1399,110,284,219,548,329,832
522200,202110,1745,4779,1184,3751,255,866,239,723,494,1589
522205,202110,1792,4138,1344,3521,181,486,757,2003,938,2489
522220,202110,1353,3176,1000,2669,128,326,603,1668,731,1994
522230,202110,1319,3176,1065,2816,186,589,569,1456,755,2045
530010,202110,193978,510993,159596,460194,22345,69658,97228,274471,119573,344129
110001,202109,4163,11346,2784,8778,613,2077,1016,3258,1629,5335
110002,202109,13898,35024,10061,28587,2673,8073,2667,7693,5340,15766
110003,202109,628,1835,469,1506,121,399,135,408,256,807
110004,202109,12825,32300,8579,24965,1716,5381,2581,7482,4297,12863
110005,202109,2611,6636,1816,5354,359,1126,490,1577,849,2703
110006,202109,1767,4842,1094,3436,169,592,229,690,398,1282
110007,202109,1346,3368,848,2529,266,830,206,760,472,1590
110008,202109,3616,9353,2675,8001,320,882,1704,5571,2024,6453
110009,202109,4539,12340,2904,9373,587,2031,1131,3672,1718,5703
110010,202109,8303,25035,6143,20975,1230,4227,2986,11148,4216,15375
110011,202109,7488,19381,5051,15044,1625,5163,691,2145,2316,7308
110012,202109,16545,40453,9968,29142,2155,6852,961,2972,3116,9824
110013,202109,5553,15585,3860,12231,1523,5143,421,1497,1944,6640
110014,202109,4133,10596,2794,8047,506,1561,1263,3533,1769,5094
110015,202109,5989,15034,3653,10632,755,2437,953,2484,1708,4921
110018,202109,3985,9838,2331,6966,407,1413,598,1816,1005,3229
110020,202109,79310,184156,57265,154313,12960,35935,22558,67785,35518,103720
110025,202109,5503,13018,3696,9968,666,1931,1710,4564,2376,6495
110026,202109,546,1340,393,1116,93,298,153,463,246,761
110028,202109,7453,18317,4545,13182,1044,3369,599,1731,1643,5100
110029,202109,1634,3921,956,2747,197,585,360,1074,557,1659
110030,202109,13480,30473,8274,22756,1740,5527,1280,3896,3020,9423
110032,202109,3524,9641,2107,6649,679,2142,361,1254,1040,3396
110033,202109,3781,11434,2824,9660,960,3320,712,2756,1672,6076
110034,202109,3416,7853,2256,6278,695,2203,705,2154,1400,4357
110037,202109,1737,5004,1273,4158,296,966,559,1888,855,2854
110040,202109,3067,8268,2210,6721,562,1854,691,2030,1253,3884
110045,202109,5085,14222,3691,11688,950,3242,1175,3883,2125,7125
110050,202109,1856,4926,1280,3902,393,1331,164,459,557,1790
110060,202109,934,2712,632,2004,166,574,137,415,303,989
110070,202109,1648,4971,1170,3910,333,1184,249,778,582,1962
110080,202109,6823,15403,5143,13409,1002,2474,2993,8478,3995,10952
110090,202109,615,1635,424,1292,81,259,131,401,212,660
110092,202109,1316,3708,919,2960,181,581,426,1485,607,2066
110094,202109,2977,8619,2170,7037,848,2973,236,792,1084,3765
110100,202109,1771,5107,1387,4367,383,1281,542,1755,925,3036
110110,202109,1833,4873,1320,4052,467,1489,250,890,717,2379
110120,202109,1369,3834,1038,3200,227,762,375,1139,602,1901
110130,202109,2974,7236,1718,4868,118,344,165,398,283,742
110140,202109,2251,6420,1568,5047,339,1146,500,1627,839,2773
110143,202109,1393,3740,987,2939,289,874,180,542,469,1416
110145,202109,935,2403,575,1723,134,401,214,681,348,1082
110146,202109,520,1308,365,1063,71,177,180,560,251,737
110147,202109,798,2013,509,1466,61,202,205,509,266,711
110148,202109,942,2546,474,1529,120,448,60,190,180,638
110149,202109,3412,8865,2251,6979,755,2469,470,1575,1225,4044
110150,202109,2887,6962,1832,5399,538,1779,413,1446,951,3225
110155,202109,785,2239,554,1690,116,390,193,532,309,922
110160,202109,1531,4560,1104,3621,295,1003,271,903,566,1906
110170,202109,2212,5560,1405,4081,235,732,741,2070,976,2802
110175,202109,1890,5236,1305,4083,211,674,497,1643,708,2317
110180,202109,1523,4016,1064,3102,139,441,567,1615,706,2056
120001,202109,3483,9889,2830,8913,471,1558,1750,5646,2221,7204
120005,202109,2016,7469,1837,7218,152,620,1458,5877,1610,6497
120010,202109,5541,15893,4710,14685,412,1195,3509,11285,3921,12480
120013,202109,2309,7615,2023,7275,438,1494,1246,4833,1684,6327
120017,202109,2658,8090,2316,7585,372,1206,1426,4983,1798,6189
120020,202109,15938,58643,14659,56237,972,4078,11790,45525,12762,49603
120025,202109,3258,8816,2619,8058,317,965,1876,5940,2193,6905
120030,202109,6598,25564,6113,24676,394,1850,4747,19423,5141,21273
120032,202109,1842,7859,1758,7709,90,550,1509,6505,1599,7055
120033,202109,4333,15431,4061,14946,86,495,3566,12970,3652,13465
120034,202109,2847,9915,2441,9226,94,527,2039,7610,2133,8137
120035,202109,3946,14850,3728,14469,259,1171,3112,12048,3371,13219
120038,202109,2826,8725,2396,8032,487,1672,1352,4613,1839,6285
120039,202109,2100,8824,1965,8562,107,652,1604,6962,1711,7614
120040,202109,47357,142013,40386,130968,5105,17339,25932,84922,31037,102261
120042,202109,3527,12511,3265,12038,132,633,2774,10141,2906,10774
120043,202109,1546,6024,1388,5794,40,240,1269,5295,1309,5535
120045,202109,6290,15934,5419,14950,152,552,4874,13305,5026,13857
120050,202109,9650,33902,8825,32658,360,1753,7418,27585,7778,29338
120060,202109,9719,37619,8883,36403,329,2048,7768,31626,8097,33674
120070,202109,3385,10412,2931,9799,260,827,2139,7428,2399,8255
120080,202109,4548,13904,4041,13162,452,1456,2982,9981,3434,11437
130002,202109,3381,12371,3020,11835,162,519,2642,10627,2804,11146
130006,202109,2593,9231,2155,8483,220,802,1576,6382,1796,7184
130008,202109,2820,9613,2496,9153,58,287,2167,7960,2225,8247
130010,202109,4049,11686,3405,10953,108,294,3050,9982,3158,10276
130014,202109,3586,10065,2773,8791,448,1440,1722,5571,2170,7011
130020,202109,3093,11736,2764,11247,98,561,2344,9532,2442,10093
130030,202109,11153,34027,10166,32889,350,799,9160,30315,9510,31114
130040,202109,4399,12451,3635,11450,347,921,2827,9203,3174,10124
130050,202109,7881,28030,6578,26333,198,855,5938,24120,6136,24975
130060,202109,8065,30867,6911,29378,378,1949,5827,24764,6205,26713
130063,202109,6719,21600,5992,20798,195,841,5468,19054,5663,19895
130068,202109,4013,13359,3368,12480,175,904,2617,9607,2792,10511
130070,202109,7985,21452,6548,19902,326,818,5359,16996,5685,17814
130080,202109,7658,26435,6706,25353,246,1189,5759,22235,6005,23424
130083,202109,2882,9117,2564,8728,158,574,2124,7418,2282,7992
130090,202109,3720,11210,3299,10704,38,152,2983,9883,3021,10035
130100,202109,8246,24502,6971,23174,114,244,6484,22184,6598,22428
130110,202109,8758,24393,7159,22431,1073,2691,5081,17338,6154,20029
130115,202109,5291,16431,4546,15585,102,308,4031,14095,4133,14403
130120,202109,14256,49877,12552,47623,1090,4443,10096,38825,11186,43268
130130,202109,5864,17566,4489,15753,438,1523,3220,11541,3658,13064
130140,202109,7544,25677,6572,24568,201,996,5726,21581,5927,22577
130150,202109,3827,13966,3601,13714,60,369,3337,12763,3397,13132
130160,202109,5568,18814,4774,17804,324,1050,4022,15542,4346,16592
130165,202109,3330,12334,3124,12090,116,490,2822,11044,2938,11534
130170,202109,12201,34308,9820,31572,725,2302,7952,26260,8677,28562
130180,202109,4574,14687,4345,14430,41,195,4195,13919,4236,14114
130185,202109,19528,46744,15972,42938,1234,2040,13052,37856,14286,39896
130190,202109,19812,63398,15927,57727,1589,5426,11527,43609,13116,49035
130195,202109,2571,9089,2074,8412,80,365,1742,7087,1822,7452
130200,202109,2829,7579,2303,6906,81,276,1985,5944,2066,6220
130210,202109,1397,5135,1260,4971,100,558,1033,3964,1133,4522
130220,202109,2485,8040,2091,7558,72,268,1839,6776,1911,7044
130230,202109,5146,19944,4487,19024,189,1119,3938,16676,4127,17795
130240,202109,12970,37700,10531,34551,146,802,9570,31455,9716,32257
130250,202109,27135,79297,23247,74916,1581,4204,18947,63676,20528,67880
130255,202109,4850,15507,4207,14400,133,535,3452,11857,3585,12392
130260,202109,269461,724820,218714,654049,59062,185053,98796,311814,157858,496867
130270,202109,10301,34896,8518,32151,1530,5394,5267,21210,6797,26604
130280,202109,3720,14517,3428,14189,81,402,3213,13430,3294,13832
130290,202109,14363,45621,12545,43358,697,2315,10730,37944,11427,40259
130300,202109,5116,16889,4598,16207,143,742,4019,14175,4162,14917
130310,202109,6750,21540,5833,20387,290,1146,4966,17439,5256,18585
130320,202109,3591,11493,2984,10699,393,1324,2183,8171,2576,9495
130330,202109,4906,15120,3943,13974,210,845,3353,11959,3563,12804
130340,202109,25227,74195,21727,70240,1547,3708,18312,61596,19859,65304
130350,202109,4144,14655,3733,14145,146,706,3299,12481,3445,13187
130353,202109,7837,20511,6263,18525,804,2190,4462,13864,5266,16054
130356,202109,5507,16883,4573,15449,842,2721,2675,9704,3517,12425
130360,202109,3150,10130,2691,9520,76,295,2412,8552,2488,8847
130370,202109,5901,23207,5068,22050,315,1671,4001,17547,4316,19218
130380,202109,7442,30650,6916,29894,386,2126,5896,25335,6282,27461
130390,202109,6349,25615,5660,24499,547,2502,4475,19616,5022,22118
130395,202109,2525,7805,2166,7239,190,612,1692,5740,1882,6352
130400,202109,2931,8764,2511,8220,105,264,2238,7510,2343,7774
130406,202109,11164,37848,9335,35640,1769,6555,6147,24755,7916,31310
130410,202109,4621,15664,3954,14572,1121,4280,1847,7074,2968,11354
130420,202109,14634,49035,12181,45983,948,4136,9433,36077,10381,40213
130423,202109,4637,14031,4067,13381,191,689,3579,11759,3770,12448
130426,202109,2845,11173,2630,10919,58,295,2435,10217,2493,10512
130430,202109,4490,12260,3866,11447,192,601,3360,9922,3552,10523
130440,202109,5327,15980,4474,14960,79,311,4171,14042,4250,14353
140002,202109,2421,6942,2116,6576,102,349,1767,5609,1869,5958
140005,202109,3403,9324,2957,8807,135,339,2514,7742,2649,8081
140010,202109,56374,147789,45152,131245,11035,33982,18680,55838,29715,89820
140015,202109,3987,11483,3385,10758,236,676,2917,9528,3153,10204
140017,202109,5323,13690,4686,12890,348,755,3852,10989,4200,11744
140020,202109,5334,15148,4606,14214,253,964,3790,11642,4043,12606
140023,202109,2635,7597,2162,6926,202,644,1653,5414,1855,6058
140028,202109,2002,5108,1692,4721,77,245,1369,3828,1446,4073
140030,202109,5593,13898,4978,13195,323,577,4400,12050,4723,12627
140040,202109,2710,10273,2506,10006,83,509,2304,9062,2387,9571
140045,202109,2679,9712,2220,9082,388,1330,1396,6379,1784,7709
140047,202109,6531,18110,5445,16547,600,1863,3889,12041,4489,13904
140050,202109,1462,4211,1235,3889,119,342,929,3049,1048,3391
140060,202109,1779,4538,1542,4207,114,284,1266,3534,1380,3818
140070,202109,1947,9958,1884,9836,108,768,1613,8315,1721,9083
150010,202109,46834,115727,42249,109857,1037,2259,37862,98654,38899,100913
150013,202109,2057,5055,1720,4691,148,266,1365,3984,1513,4250
150020,202109,14635,43282,13491,41792,1842,4704,10470,34029,12312,38733
150030,202109,8899,33092,8079,32105,509,1922,6981,28254,7490,30176
150034,202109,4523,10577,3709,9587,262,592,3079,8156,3341,8748
150040,202109,16997,42770,14921,40477,1251,1783,12569,37011,13820,38794
150050,202109,7344,24627,6707,23794,125,506,6201,22231,6326,22737
150060,202109,23098,61116,18620,54505,2661,7899,12233,36534,14894,44433
150070,202109,7344,26334,6435,25256,231,985,5794,23007,6025,23992
150080,202109,96341,212764,78879,188886,20085,53045,19582,58250,39667,111295
150085,202109,8463,23407,7668,22487,130,360,7170,21234,7300,21594
150090,202109,10512,36517,9907,35379,776,2566,8040,29099,8816,31665
150095,202109,6123,16820,5362,15896,265,503,4674,14356,4939,14859
150100,202109,2935,10039,2597,9492,221,661,2031,7686,2252,8347
150110,202109,4460,17929,4148,17579,174,766,3824,16359,3998,17125
150120,202109,8320,25420,7871,24894,287,691,6986,22796,7273,23487
150125,202109,816,2025,596,1732,101,355,363,1031,464,1386
150130,202109,23756,66116,20388,61015,4012,10630,12314,40048,16326,50678
150140,202109,278850,619985,234959,560688,36172,81063,134294,334569,170466,415632
150145,202109,4450,13613,3739,12487,1070,3356,1676,6459,2746,9815
150150,202109,17545,42825,15247,39967,813,2114,12570,33006,13383,35120
150157,202109,3735,9857,2964,8855,324,908,2044,6451,2368,7359
150160,202109,3391,9158,3148,8807,445,1105,2158,6233,2603,7338
150170,202109,26022,80858,22810,75530,4221,12886,13771,49016,17992,61902
150172,202109,5325,14012,4264,12551,311,744,3179,9776,3490,10520
150175,202109,1730,5238,1438,4709,240,815,850,2829,1090,3644
150178,202109,11046,28401,9047,26114,355,668,7919,23528,8274,24196
150180,202109,23638,79595,21375,77034,1413,3507,18554,69480,19967,72987
150190,202109,7096,22570,6582,21950,187,721,5980,19952,6167,20673
150195,202109,5505,16764,5164,16246,199,644,4619,14537,4818,15181
150200,202109,6031,17406,5508,16827,56,134,5211,16037,5267,16171
150210,202109,28247,93163,26455,90894,1499,4428,22193,79017,23692,83445
150215,202109,9053,24746,7841,22910,1351,3851,4610,13944,5961,17795
150220,202109,13308,36093,11607,33695,1154,2988,7979,23910,9133,26898
150230,202109,13282,36471,11759,34435,1304,3315,8031,24723,9335,28038
150240,202109,34585,92459,28712,82671,7021,20817,10734,30927,17755,51744
150250,202109,4395,16242,4086,15899,580,2193,3220,12838,3800,15031
150260,202109,2794,8747,2511,8329,130,385,2050,6915,2180,7300
150270,202109,9433,26004,6651,21038,2042,6830,1523,5182,3565,12012
150275,202109,7115,21969,6466,21064,220,754,5601,18264,5821,19018
150276,202109,2503,6443,2150,6010,268,630,1405,4472,1673,5102
150277,202109,5393,13645,4284,12358,405,1058,3142,9714,3547,10772
150280,202109,7225,28074,6968,27667,384,1419,6076,24464,6460,25883
150285,202109,3367,11630,2945,10964,224,804,2175,8331,2399,9135
150290,202109,10616,28271,9561,27146,377,658,8539,25073,8916,25731
150293,202109,9810,23402,7596,20539,1124,2911,4620,13234,5744,16145
150295,202109,7888,20625,5681,17593,1811,5978,1833,6659,3644,12637
150300,202109,2479,7155,2244,6866,35,112,2072,6378,2107,6490
150304,202109,4423,12567,3645,11382,612,1722,2291,7654,2903,9376
150307,202109,6225,19439,5697,18567,269,845,4591,15101,4860,15946
150309,202109,6750,19117,5417,16891,860,2597,3155,10315,4015,12912
150310,202109,7577,29368,7216,28947,191,960,6452,26176,6643,27136
150320,202109,9451,25450,8616,24246,363,1059,6736,18928,7099,19987
150330,202109,14334,44383,13236,42728,1326,3784,9856,33273,11182,37057
150340,202109,2633,7548,2328,7095,350,975,1592,5036,1942,6011
150345,202109,8904,24575,7980,23372,427,1263,6868,20210,7295,21473
150350,202109,9380,23072,8570,22033,677,1186,7111,18831,7788,20017
150360,202109,24850,66142,19798,59827,2236,4926,13797,45382,16033,50308
150370,202109,11677,33843,9538,30940,1107,2874,6840,24176,7947,27050
150375,202109,3843,15178,3481,14670,209,948,3025,12898,3234,13846
150380,202109,11637,28768,9569,26076,115,400,8519,23184,8634,23584
150390,202109,7900,31001,7061,29710,1099,3854,5017,22633,6116,26487
150400,202109,6869,23870,6578,23342,218,708,5847,20879,6065,21587
150405,202109,9511,24308,8291,22863,523,1006,6710,19205,7233,20211
150410,202109,2043,6140,1739,5629,273,707,1085,3744,1358,4451
150420,202109,41276,110910,31648,96929,8444,26955,11148,39977,19592,66932
150430,202109,8748,24623,7946,23597,917,1850,6195,19443,7112,21293
150440,202109,6013,18134,5439,17357,930,2588,3608,12291,4538,14879
150442,202109,28794,65048,23828,59025,2517,5867,16664,42142,19181,48009
150445,202109,6788,19889,5935,18634,209,613,5154,16288,5363,16901
150450,202109,5381,22166,4973,21627,389,1860,4197,18335,4586,20195
150460,202109,8584,27777,7815,26804,223,807,6729,23915,6952,24722
150470,202109,21567,55587,19236,52944,337,936,18140,49931,18477,50867
150475,202109,5397,16123,4600,14940,665,1860,3237,11049,3902,12909
150480,202109,14315,44078,12817,41900,2312,6299,8581,30389,10893,36688
150490,202109,8580,29386,7824,28442,345,1189,6736,24806,7081,25995
150495,202109,5632,18247,5360,17889,92,421,4932,16382,5024,16803
150497,202109,2911,9020,2334,8029,506,1777,1224,4537,1730,6314
150500,202109,3427,8515,3029,7954,286,684,2301,6037,2587,6721
150503,202109,5191,12947,3568,10844,1011,3248,1125,3953,2136,7201
150506,202109,11250,31958,9396,29440,1941,5378,5782,20183,7723,25561
150510,202109,10143,35638,8783,33206,1365,4688,5672,22825,7037,27513
150520,202109,7972,29182,7650,28787,158,861,7011,26291,7169,27152
150530,202109,12647,42086,10885,39550,1294,3653,7984,30912,9278,34565
150540,202109,5242,13671,4479,12544,284,684,3713,10493,3997,11177
150543,202109,7342,19420,6013,17768,427,1219,4692,14526,5119,15745
150548,202109,10454,31996,9369,30492,226,836,8354,27321,8580,28157
150549,202109,2036,5792,1731,5362,47,156,1448,4529,1495,4685
150550,202109,21734,61806,17979,55724,4674,14548,7173,23965,11847,38513
150553,202109,34522,93707,27253,81198,7637,22869,10683,33227,18320,56096
150555,202109,2063,5321,1613,4620,189,417,1074,3271,1263,3688
150560,202109,2000,5764,1774,5336,315,865,1024,3243,1339,4108
150563,202109,2725,7903,2242,7076,442,1420,1241,3983,1683,5403
150565,202109,4702,14538,4192,13747,95,388,3518,11628,3613,12016
150570,202109,6844,20373,6389,19761,450,1123,5378,17024,5828,18147
150580,202109,10846,41426,9218,39621,559,2765,7289,33116,7848,35881
150590,202109,8516,28707,7277,27232,141,820,6679,24951,6820,25771
150600,202109,9872,31989,9171,31155,210,785,8514,29097,8724,29882
150610,202109,3072,8399,2735,7881,110,326,2321,6676,2431,7002
150611,202109,3467,9202,3093,8697,104,314,2745,7704,2849,8018
150613,202109,14476,38302,10954,32472,1963,6121,5502,16250,7465,22371
150616,202109,3789,10217,2764,8482,586,1829,1190,3679,1776,5508
150618,202109,7304,20288,5948,18225,592,1761,3735,12027,4327,13788
150619,202109,7070,18869,5816,17153,283,639,4859,14641,5142,15280
150620,202109,6956,22672,5980,21041,657,2137,4042,14721,4699,16858
150630,202109,6811,17410,6219,16694,307,719,5432,14669,5739,15388
150635,202109,5231,13872,4373,12492,609,1601,2800,8202,3409,9803
150640,202109,2310,6718,2104,6460,40,108,1963,6100,2003,6208
150650,202109,11944,31890,10315,29336,2882,7778,4509,14139,7391,21917
150655,202109,5809,16439,5254,15625,205,580,4562,13628,4767,14208
150658,202109,4741,13208,3613,11372,706,2312,1829,6069,2535,8381
150660,202109,6006,16539,5309,15577,640,1731,3582,10796,4222,12527
150670,202109,9420,20651,7485,18473,702,1303,6042,15719,6744,17022
150680,202109,73143,206535,56504,180567,13584,41921,24307,89029,37891,130950
150690,202109,2887,6861,2481,6405,104,190,2180,5794,2284,5984
150700,202109,6310,18185,5636,17316,384,876,4450,14216,4834,15092
150710,202109,3844,12589,3482,12021,300,956,2609,9268,2909,10224
150715,202109,5265,14413,4318,12991,292,769,3426,10519,3718,11288
150720,202109,7052,24177,6547,23434,434,1496,5423,19822,5857,21318
150730,202109,13025,37896,11030,34981,1224,3970,8170,26651,9394,30621
150740,202109,4209,11305,3679,10480,325,749,2756,8081,3081,8830
150745,202109,5250,14413,4214,12912,640,2003,2896,9063,3536,11066
150746,202109,1810,5111,1638,4874,77,164,1368,4152,1445,4316
150747,202109,5276,15591,4672,14671,719,1867,3191,10661,3910,12528
150750,202109,3884,11753,3219,10732,219,771,2457,8465,2676,9236
150760,202109,12145,34978,10977,33355,1610,4342,7586,24073,9196,28415
150770,202109,6830,23496,6366,22976,235,536,5764,21608,5999,22144
150775,202109,1057,2771,833,2487,129,413,508,1526,637,1939
150780,202109,4591,13825,4069,13204,153,395,3659,12220,3812,12615
150790,202109,6198,16698,5316,15750,319,769,3856,13270,4175,14039
150795,202109,15211,44483,13177,41433,3019,8905,7530,25228,10549,34133
150796,202109,4062,9492,3520,8872,242,474,2942,7625,3184,8099
150797,202109,4336,12703,3729,11862,190,418,3109,10219,3299,10637
150800,202109,13804,42129,12371,40242,1595,4729,9049,30737,10644,35466
150803,202109,7701,22979,7157,22169,460,1123,6074,19196,6534,20319
150805,202109,3695,10918,3131,10115,271,807,2370,7888,2641,8695
150808,202109,6369,17806,4677,15035,1694,5998,695,2616,2389,8614
150810,202109,21813,54956,16466,48550,3276,9815,8279,27537,11555,37352
150812,202109,5858,15677,5164,14574,437,1294,3911,10829,4348,12123
150815,202109,10164,28619,8488,26658,701,2099,6976,22351,7677,24450
150820,202109,12356,32527,10491,30226,1322,2991,7704,23801,9026,26792
150830,202109,12620,43781,11672,42635,488,1736,9931,37897,10419,39633
150835,202109,2764,8433,2380,7831,345,1131,1534,5075,1879,6206
150840,202109,8094,21814,6528,19383,1038,3363,3712,10855,4750,14218
160005,202109,1245,3283,1096,3100,67,219,926,2636,993,2855
160010,202109,2493,6543,2321,6357,19,93,2249,6098,2268,6191
160015,202109,2947,8217,2608,7810,68,201,2410,7266,2478,7467
160020,202109,2257,6840,1960,6476,169,451,1506,5263,1675,5714
160021,202109,1284,4628,1184,4500,52,260,947,3663,999,3923
160023,202109,1367,4610,1208,4340,175,582,787,3030,962,3612
160025,202109,1854,5533,1742,5407,13,42,1687,5251,1700,5293
160027,202109,8977,24663,7999,23419,723,1947,6310,18934,7033,20881
160030,202109,80839,219412,65613,198981,13938,39143,34274,115761,48212,154904
160040,202109,6026,19799,5491,19130,85,322,5139,18052,5224,18374
160050,202109,5083,14647,3970,13191,1441,4540,1431,6022,2872,10562
160053,202109,4096,12059,3676,11538,303,798,2940,9685,3243,10483
160055,202109,969,2753,936,2717,27,78,863,2526,890,2604
160060,202109,27322,67941,22378,62371,1560,3892,17156,50855,18716,54747
160070,202109,2711,10029,2401,9548,206,767,1867,7761,2073,8528
160080,202109,3444,10562,3035,10105,23,125,2861,9584,2884,9709
170025,202109,682,1717,483,1412,89,241,232,740,321,981
170030,202109,1306,3804,1016,3310,169,497,462,1590,631,2087
170035,202109,1535,3872,1131,3247,76,236,737,2101,813,2337
170040,202109,1994,5377,1585,4794,108,347,1017,3157,1125,3504
170070,202109,1992,4552,1415,3821,94,275,830,2361,924,2636
170100,202109,2515,7045,2077,6328,255,676,1261,4018,1516,4694
170105,202109,743,2088,517,1613,151,424,150,497,301,921
170110,202109,1033,2984,803,2568,106,356,438,1352,544,1708
170130,202109,1355,3880,987,3189,172,587,501,1622,673,2209
170190,202109,1500,4018,1119,3422,294,1010,355,1122,649,2132
170200,202109,2146,4985,1416,3809,217,588,559,1528,776,2116
170210,202109,26694,70333,20168,59584,6051,19448,3085,9879,9136,29327
170215,202109,1383,3611,1109,3234,42,166,889,2583,931,2749
170220,202109,6140,18387,5102,16522,1403,4396,1785,6615,3188,11011
170230,202109,1291,3659,955,3012,280,914,163,561,443,1475
170240,202109,2712,7336,2165,6465,143,455,1563,4590,1706,5045
170255,202109,4111,11477,2976,9495,632,1950,1238,4136,1870,6086
170270,202109,967,2306,657,1859,61,155,374,1065,435,1220
170290,202109,3010,8602,2620,8093,154,409,2045,6564,2199,6973
170300,202109,2116,5486,1709,4885,199,492,1149,3394,1348,3886
170305,202109,694,1824,585,1647,82,227,294,864,376,1091
170307,202109,1006,3241,825,2910,99,346,477,1714,576,2060
170310,202109,1643,4028,1174,3298,167,490,569,1636,736,2126
170320,202109,1094,2792,820,2351,80,234,507,1495,587,1729
170330,202109,937,2790,845,2658,42,173,702,2152,744,2325
170360,202109,574,1479,408,1213,22,77,276,773,298,850
170370,202109,1312,3390,942,2772,244,691,296,945,540,1636
170380,202109,1927,5317,1462,4600,85,273,851,2807,936,3080
170382,202109,565,1631,471,1475,27,116,355,1068,382,1184
170384,202109,1703,5709,1394,5130,291,1026,690,2700,981,3726
170386,202109,1032,2753,646,2020,73,261,236,699,309,960
170388,202109,657,1772,463,1450,65,219,214,677,279,896
170389,202109,1080,3246,881,2912,54,196,633,2142,687,2338
170390,202109,1860,4064,1399,3520,33,74,1180,3042,1213,3116
170410,202109,636,1719,455,1406,20,79,303,907,323,986
170460,202109,399,1033,329,928,42,118,218,625,260,743
170510,202109,974,2645,709,2192,40,145,453,1298,493,1443
170550,202109,6846,17681,5051,14853,1365,4292,1062,3377,2427,7669
170555,202109,1454,3798,1141,3315,108,281,528,1651,636,1932
170560,202109,1078,2924,825,2570,79,221,505,1691,584,1912
170600,202109,1359,3568,1095,3194,291,721,500,1655,791,2376
170610,202109,1660,4241,1206,3562,85,261,752,2203,837,2464
170625,202109,454,1175,305,888,40,106,118,334,158,440
170650,202109,1276,3674,1010,3237,117,386,621,2028,738,2414
170700,202109,3554,10253,2683,8584,522,1681,1154,3740,1676,5421
170710,202109,1543,3890,1204,3366,174,477,719,2056,893,2533
170720,202109,1822,4444,1393,3766,304,802,676,1898,980,2700
170730,202109,1130,2950,850,2494,133,311,459,1444,592,1755
170740,202109,2172,6932,1871,6386,166,617,1344,4575,1510,5192
170755,202109,922,2436,651,1994,94,303,262,800,356,1103
170765,202109,1173,2977,828,2436,153,439,347,1073,500,1512
170770,202109,1934,5346,1568,4795,145,458,1069,3297,1214,3755
170820,202109,3622,10486,2805,9033,556,1802,1253,4244,1809,6046
170825,202109,1055,2387,866,2146,103,229,625,1572,728,1801
170830,202109,1421,3707,1157,3297,249,654,667,1992,916,2646
170900,202109,2855,8683,2408,8040,223,629,1875,6459,2098,7088
170930,202109,3911,10479,2971,8731,687,2136,888,2647,1575,4783
170950,202109,11648,31477,8108,25136,2118,7506,862,2932,2980,10438
170980,202109,494,1263,378,1078,35,99,240,673,275,772
171050,202109,1701,5208,1480,4835,50,216,1227,3994,1277,4210
171070,202109,1401,3861,1201,3568,322,871,516,1852,838,2723
171090,202109,1105,2715,865,2380,96,269,535,1458,631,1727
171110,202109,599,1571,418,1244,84,235,177,494,261,729
171150,202109,1116,2680,703,1992,75,234,428,1196,503,1430
171180,202109,802,2120,530,1611,101,283,222,687,323,970
171190,202109,1981,6279,1724,5842,263,923,1069,3732,1332,4655
171195,202109,827,2548,659,2228,75,291,409,1360,484,1651
171200,202109,633,1715,474,1456,117,394,167,498,284,892
171215,202109,405,1098,333,981,32,103,216,610,248,713
171240,202109,817,2590,648,2286,27,148,442,1527,469,1675
171245,202109,764,2143,600,1833,54,180,380,1118,434,1298
171250,202109,1020,2690,746,2278,134,436,346,1069,480,1505
171270,202109,506,1728,396,1493,89,338,160,654,249,992
171280,202109,917,2660,738,2341,72,232,447,1461,519,1693
171320,202109,4167,11385,3260,9809,667,1868,1214,3932,1881,5800
171330,202109,2867,7737,2204,6566,518,1536,928,2895,1446,4431
171360,202109,1510,4176,1193,3713,98,281,828,2730,926,3011
171370,202109,737,1806,564,1566,49,130,394,1108,443,1238
171380,202109,1527,4001,1278,3666,154,414,849,2581,1003,2995
171395,202109,1058,2743,734,2166,68,203,468,1342,536,1545
171420,202109,2060,5800,1506,4720,268,818,667,2163,935,2981
171430,202109,1101,3122,929,2806,55,171,644,1874,699,2045
171488,202109,2466,6960,1959,6144,326,1031,1025,3263,1351,4294
171500,202109,994,2450,741,2063,69,173,493,1383,562,1556
171510,202109,846,2649,732,2437,43,167,535,1767,578,1934
171515,202109,502,1235,378,1057,43,128,227,605,270,733
171525,202109,759,2026,574,1741,36,122,364,1070,400,1192
171550,202109,356,995,275,871,38,142,146,436,184,578
171570,202109,1160,3397,979,3079,133,401,571,1885,704,2286
171575,202109,1808,4782,1168,3653,130,417,514,1613,644,2030
171610,202109,6000,16280,4433,13616,893,3112,1097,3690,1990,6802
171620,202109,2697,7403,2285,6813,101,392,1886,5593,1987,5985
171630,202109,1071,2655,826,2328,87,238,577,1680,664,1918
171650,202109,2155,5937,1673,5143,394,1300,482,1676,876,2976
171660,202109,2446,6006,1693,4776,213,534,978,2801,1191,3335
171665,202109,1281,3534,1016,3106,187,615,480,1489,667,2104
171670,202109,1991,5186,1505,4380,230,692,732,2170,962,2862
171700,202109,1244,3410,907,2799,109,311,493,1542,602,1853
171720,202109,811,2048,638,1784,58,168,459,1274,517,1442
171750,202109,1376,3782,935,2950,213,705,133,517,346,1222
171780,202109,1271,3137,942,2663,79,241,662,1856,741,2097
171790,202109,1453,4562,1180,3999,182,592,564,1950,746,2542
171800,202109,760,1990,582,1733,70,238,334,973,404,1211
171820,202109,11958,32642,8828,27306,2121,6822,2330,7906,4451,14728
171830,202109,1616,4992,1382,4595,128,481,877,2943,1005,3424
171840,202109,794,2052,613,1774,21,62,397,1152,418,1214
171845,202109,673,1601,511,1365,46,164,335,854,381,1018
171850,202109,976,3086,816,2735,73,275,558,1839,631,2114
171855,202109,1090,3236,929,2942,59,172,602,1874,661,2046
171865,202109,453,1318,383,1210,58,188,208,627,266,815
171870,202109,865,2302,604,1835,74,210,313,970,387,1180
171875,202109,1354,3770,1092,3366,36,154,835,2540,871,2694
171880,202109,1278,3675,1116,3461,45,119,879,2816,924,2935
171884,202109,973,2687,726,2250,147,478,263,858,410,1336
171886,202109,1521,3952,1091,3288,283,980,230,711,513,1691
171888,202109,726,2002,510,1604,27,108,317,959,344,1067
171889,202109,414,1210,300,998,70,256,109,348,179,604
171890,202109,1221,3367,888,2833,157,467,500,1614,657,2081
171900,202109,573,1909,439,1600,78,251,178,686,256,937
172000,202109,610,1744,512,1576,68,198,271,835,339,1033
172010,202109,1049,3464,905,3196,80,288,567,2021,647,2309
172015,202109,384,1284,287,1091,49,176,123,486,172,662
172020,202109,2908,7847,2545,7380,161,463,1870,5693,2031,6156
172025,202109,721,1951,537,1659,43,142,380,1175,423,1317
172030,202109,1291,3730,1084,3395,68,207,809,2541,877,2748
172049,202109,1365,3200,911,2581,176,437,441,1396,617,1833
172065,202109,1481,3690,1171,3299,100,213,923,2788,1023,3001
172080,202109,2414,6980,1961,6190,125,391,1292,4099,1417,4490
172085,202109,488,1303,315,943,60,174,111,309,171,483
172090,202109,4178,10190,3254,8978,145,369,2481,6969,2626,7338
172093,202109,482,1401,343,1155,20,96,202,650,222,746
172097,202109,700,1777,482,1402,63,187,212,603,275,790
172100,202109,51827,124694,37403,102359,6261,18463,14128,39516,20389,57979
172110,202109,1669,5842,1437,5484,110,438,1085,4269,1195,4707
172120,202109,5259,15058,4125,13212,518,1694,2294,7569,2812,9263
172125,202109,408,1076,312,927,24,80,188,531,212,611
172130,202109,642,1560,503,1333,20,75,358,875,378,950
172208,202109,2670,6300,2135,5613,239,467,1498,4126,1737,4593
172210,202109,2780,6832,2130,6012,295,887,1236,3701,1531,4588
210005,202109,19576,54279,14672,46301,4073,13310,5593,18507,9666,31817
210010,202109,1958,5970,1772,5748,73,280,1555,5074,1628,5354
210015,202109,3458,10097,3011,9492,151,451,2491,7936,2642,8387
210020,202109,7463,17478,6367,16205,97,275,5850,14964,5947,15239
210030,202109,4762,15418,4378,14840,404,1323,3500,12110,3904,13433
210040,202109,1980,4485,1741,4199,79,196,1453,3410,1532,3606
210043,202109,6130,17279,5211,15991,387,1157,4099,12772,4486,13929
210047,202109,6758,20557,5506,18882,141,654,4741,16321,4882,16975
210050,202109,2252,7395,1797,6559,194,724,1216,4528,1410,5252
210055,202109,1992,6159,1806,5879,51,173,1569,5138,1620,5311
210060,202109,7647,27332,6804,25846,776,2848,4582,18076,5358,20924
210070,202109,7270,20051,6751,19361,41,153,6398,18311,6439,18464
210080,202109,4320,14346,4102,14109,36,206,3794,13139,3830,13345
210083,202109,5784,16134,4799,15070,131,369,4428,14096,4559,14465
210087,202109,3040,8232,2601,7642,133,346,2118,6290,2251,6636
210090,202109,9320,28475,8698,27404,744,1714,7105,22994,7849,24708
210095,202109,6755,21289,6161,20534,321,1121,5117,17569,5438,18690
210100,202109,6833,20769,6045,19461,557,1734,4439,14517,4996,16251
210110,202109,2951,9264,2718,8982,54,275,2438,8038,2492,8313
210120,202109,24058,63392,19884,58061,2021,4451,13462,42387,15483,46838
210125,202109,4517,12023,3919,11322,803,1861,2631,8251,3434,10112
210130,202109,4410,11218,3638,10258,161,331,3084,8812,3245,9143
210135,202109,1642,4456,1368,4040,91,190,1111,3386,1202,3576
210140,202109,20334,51693,15686,45727,3145,8404,8497,26683,11642,35087
210150,202109,4592,10624,4075,9925,213,379,3425,8354,3638,8733
210160,202109,18026,49742,15354,46435,1393,4034,10812,34458,12205,38492
210170,202109,15959,47610,14811,46152,924,2173,12816,40792,13740,42965
210173,202109,2325,8806,2174,8548,96,536,1879,7323,1975,7859
210177,202109,3528,9584,3055,8993,306,747,2435,7507,2741,8254
210180,202109,1447,3826,1258,3595,24,62,1140,3269,1164,3331
210190,202109,5546,14438,4671,13261,85,268,4031,11352,4116,11620
210193,202109,1389,3944,1216,3669,39,114,894,2763,933,2877
210197,202109,2160,6527,1986,6291,162,460,1626,5284,1788,5744
210200,202109,7981,25035,7085,23580,423,1448,5604,18722,6027,20170
210203,202109,7290,21077,6176,19597,365,1142,4941,16059,5306,17201
210207,202109,4012,9588,3104,8593,163,344,2562,7276,2725,7620
210210,202109,8071,25664,7348,24645,139,767,6299,20983,6438,21750
210215,202109,2546,7930,2183,7391,112,536,1639,5485,1751,6021
210220,202109,6342,21446,5965,20896,138,910,5280,18148,5418,19058
210230,202109,5436,15821,4927,15065,456,1087,4065,12789,4521,13876
210232,202109,11706,35463,9579,32219,1831,5925,5606,20453,7437,26378
210235,202109,3421,10280,3022,9698,156,562,2523,8130,2679,8692
210237,202109,3117,9606,2677,9082,25,114,2495,8477,2520,8591
210240,202109,2645,8108,2433,7759,68,218,2035,6410,2103,6628
210250,202109,6000,17689,5462,17015,60,320,4991,15500,5051,15820
210255,202109,2673,7942,2278,7262,282,893,1478,4710,1760,5603
210260,202109,5558,16349,4886,15371,290,876,4093,12991,4383,13867
210270,202109,5151,13840,4591,13133,81,335,4130,11723,4211,12058
210275,202109,3499,8840,3034,8262,98,256,2506,6834,2604,7090
210280,202109,5840,16049,4687,14311,244,858,3550,10723,3794,11581
210290,202109,7696,19626,6888,18629,116,315,6437,17447,6553,17762
210300,202109,33076,89481,26967,80671,2963,9145,17211,54243,20174,63388
210310,202109,3184,7924,2802,7370,115,233,2457,6534,2572,6767
210312,202109,2867,6934,2561,6607,20,76,2444,6272,2464,6348
210315,202109,3117,8436,2683,7952,100,252,2346,7156,2446,7408
210317,202109,4262,13202,3846,12714,90,442,3466,11411,3556,11853
210320,202109,19624,57117,17928,54916,330,1339,16011,48922,16341,50261
210325,202109,3726,10376,3177,9667,123,341,2728,8552,2851,8893
210330,202109,25068,68035,20079,61758,5027,13637,10649,37391,15676,51028
210340,202109,10493,29686,9334,28152,678,1902,7285,22552,7963,24454
210350,202109,9188,26136,8066,24769,128,427,7226,22318,7354,22745
210355,202109,4291,14007,3790,13222,96,439,3215,11284,3311,11723
210360,202109,14115,42839,12517,40426,510,2078,9497,30144,10007,32222
210370,202109,11300,24812,8682,22051,255,409,7910,20594,8165,21003
210375,202109,3354,8827,2532,7659,775,2499,814,2729,1589,5228
210380,202109,5530,13927,4754,13007,267,630,3993,11056,4260,11686
210390,202109,2833,9153,2624,8799,104,416,2273,7585,2377,8001
210400,202109,4579,13645,4041,13005,129,366,3589,11779,3718,12145
210405,202109,7140,18615,5775,16711,1155,2976,3184,10005,4339,12981
210407,202109,2085,6601,1759,6039,75,280,1393,4749,1468,5029
210408,202109,2700,9697,2512,9427,149,640,1994,7554,2143,8194
210409,202109,3997,13245,3621,12737,100,489,3019,10786,3119,11275
210410,202109,3614,10513,3066,9605,128,456,2448,7591,2576,8047
210420,202109,3942,12281,3522,11525,219,592,2920,9738,3139,10330
210430,202109,2295,6639,2030,6297,115,303,1696,5380,1811,5683
210440,202109,4505,11808,3901,11055,84,232,3544,10023,3628,10255
210450,202109,2397,6988,2060,6503,111,330,1672,5310,1783,5640
210455,202109,4605,11726,3495,10317,927,2752,1652,5197,2579,7949
210460,202109,3820,10728,3233,9967,60,211,2824,8694,2884,8905
210462,202109,1749,5123,1474,4681,45,152,1175,3767,1220,3919
210465,202109,2778,7951,2414,7442,78,335,1951,5887,2029,6222
210467,202109,6089,18742,5292,17708,292,997,4395,14970,4687,15967
210470,202109,2013,5297,1501,4568,115,258,1115,3566,1230,3824
210480,202109,17089,48683,14156,45090,1333,3436,10136,35531,11469,38967
210490,202109,3723,9170,3017,8214,71,173,2571,6992,2642,7165
210500,202109,6486,24282,5962,23400,402,1744,4876,19138,5278,20882
210510,202109,5972,19488,5200,18654,102,465,4685,17032,4787,17497
210515,202109,3787,11019,3275,10421,196,641,2654,8695,2850,9336
210520,202109,2571,7356,2299,6989,60,212,1971,5936,2031,6148
210530,202109,53301,129515,41053,111570,6795,21694,12347,40954,19142,62648
210535,202109,3473,11002,3174,10572,134,456,2692,9046,2826,9502
210540,202109,15383,42924,12766,39279,1672,4462,8686,28380,10358,32842
210542,202109,6855,15577,5412,13987,554,1130,4133,11391,4687,12521
210545,202109,2270,6904,2126,6675,35,136,1896,5897,1931,6033
210547,202109,3702,12883,3290,12127,254,894,2529,9538,2783,10432
210550,202109,6130,18278,4800,16137,328,1226,3370,11679,3698,12905
210560,202109,3836,11338,3390,10632,138,386,2827,8853,2965,9239
210565,202109,1497,4698,1250,4345,57,293,966,3371,1023,3664
210570,202109,10805,28985,9577,27487,286,719,8378,24577,8664,25296
210580,202109,3109,8100,2454,7257,144,352,1685,5283,1829,5635
210590,202109,4370,12818,3800,12096,58,298,3402,10788,3460,11086
210592,202109,2687,7785,2452,7411,21,96,2110,6323,2131,6419
210594,202109,2577,6829,1981,5902,111,308,1459,4517,1570,4825
210596,202109,2750,9348,2455,8815,186,589,1928,7098,2114,7687
210598,202109,1888,5279,1743,5063,56,162,1538,4455,1594,4617
210600,202109,3101,8215,2545,7424,151,388,1868,5548,2019,5936
210610,202109,2873,7694,2450,7184,53,206,2115,6203,2168,6409
210620,202109,2921,7467,2398,6825,70,181,2133,6100,2203,6281
210630,202109,3146,10193,2861,9711,108,464,2358,7937,2466,8401
210632,202109,4645,14155,4121,13422,216,840,3310,10724,3526,11564
210635,202109,1772,6202,1667,6009,107,358,1346,4964,1453,5322
210637,202109,2607,8409,2236,7878,131,561,1671,6013,1802,6574
210640,202109,4701,16376,4389,16015,54,246,4044,14798,4098,15044
210650,202109,7546,21218,6830,20288,139,399,6108,18239,6247,18638
210660,202109,8265,24012,7372,22566,243,974,6271,18849,6514,19823
210663,202109,2795,7676,2539,7378,183,360,2060,6312,2243,6672
210667,202109,2034,6434,1823,6125,63,194,1594,5459,1657,5653
210670,202109,5027,16011,4557,15279,106,444,4022,13464,4128,13908
210675,202109,5226,13810,4460,12842,355,807,3515,10591,3870,11398
210680,202109,4780,11289,4027,10411,96,154,3660,9583,3756,9737
210690,202109,7768,23462,6450,21985,251,963,5617,19464,5868,20427
210700,202109,2821,7746,2224,6881,163,435,1581,5121,1744,5556
210710,202109,5126,15394,4519,14551,95,460,4017,12804,4112,13264
210720,202109,3138,9877,2778,9427,56,303,2470,8321,2526,8624
210725,202109,1341,4348,1159,4065,49,166,790,2928,839,3094
210730,202109,1242,3122,1049,2853,49,123,901,2446,950,2569
210735,202109,4870,13721,4141,12791,222,547,3504,11207,3726,11754
210740,202109,5322,13760,4574,12892,91,224,3912,11082,4003,11306
210745,202109,4548,12144,4208,11715,111,266,3803,10580,3914,10846
210750,202109,24110,61190,20863,57059,2517,5919,13826,40473,16343,46392
210760,202109,6028,15562,5066,14543,80,165,4758,13858,4838,14023
210770,202109,6278,15832,5419,14842,51,196,5108,13940,5159,14136
210780,202109,7737,23524,6725,21854,648,1754,5104,16999,5752,18753
210790,202109,4409,13595,3969,13021,205,425,3255,11248,3460,11673
210800,202109,4935,13111,4211,12146,90,339,3735,10680,3825,11019
210805,202109,4076,14373,3876,14070,134,582,3383,12297,3517,12879
210810,202109,4950,14187,4514,13623,346,801,3653,11444,3999,12245
210820,202109,7135,19985,5956,18116,724,2183,3506,11083,4230,13266
210825,202109,7045,21109,6318,20150,330,845,5326,17437,5656,18282
210830,202109,8070,22073,7316,21174,393,906,6324,18767,6717,19673
210840,202109,3268,8423,2941,7990,39,117,2647,7109,2686,7226
210845,202109,6585,17419,5853,16617,49,154,5569,15937,5618,16091
210850,202109,6047,19762,4953,18119,238,1048,3898,14351,4136,15399
210860,202109,21879,54030,18156,49465,1187,2734,14211,40958,15398,43692
210870,202109,7647,19194,6099,17434,219,488,5371,15538,5590,16026
210880,202109,4305,12933,3852,12373,211,695,3025,9778,3236,10473
210890,202109,4024,11364,3628,10903,387,939,2789,8748,3176,9687
210900,202109,4810,13561,3731,11603,1474,4934,524,1915,1998,6849
210905,202109,2074,5501,1734,5072,56,101,1568,4708,1624,4809
210910,202109,7280,21699,6017,19667,720,2358,3955,13061,4675,15419
210920,202109,3208,10432,2785,9872,63,355,2496,8761,2559,9116
210923,202109,1659,4689,1404,4293,88,241,1037,3195,1125,3436
210927,202109,5169,16363,4514,15577,488,1580,3306,11926,3794,13506
210930,202109,2547,8323,2225,7709,147,480,1701,5910,1848,6390
210940,202109,4099,11396,3813,11067,115,412,3484,10015,3599,10427
210945,202109,7007,19376,6267,18510,256,660,5253,15981,5509,16641
210950,202109,5326,14477,4086,12759,590,1376,2670,9205,3260,10581
210955,202109,1594,4806,1372,4445,359,1097,694,2420,1053,3517
210960,202109,9261,26729,8021,24862,1600,4556,4879,16099,6479,20655
210970,202109,1405,4124,1129,3659,90,263,852,2744,942,3007
210975,202109,1831,5481,1644,5190,98,310,1304,4149,1402,4459
210980,202109,10050,23288,8806,22001,113,249,8287,20844,8400,21093
210990,202109,17190,46482,13253,41395,760,2341,9670,31631,10430,33972
211000,202109,15043,42455,12503,39305,1201,3335,9167,30538,10368,33873
211003,202109,5864,16845,4901,15685,119,450,4228,13869,4347,14319
211010,202109,6490,22536,5791,21640,111,510,5161,19585,5272,20095
211020,202109,8333,23601,7211,22327,238,777,6117,19581,6355,20358
211023,202109,2059,6504,1910,6313,97,300,1605,5315,1702,5615
211027,202109,3260,9899,3091,9639,235,591,2607,8310,2842,8901
211030,202109,3893,10535,3476,10017,284,694,2708,8075,2992,8769
211040,202109,4840,16767,4469,16149,97,563,4025,14441,4122,15004
211050,202109,9184,23472,8349,22392,85,293,7667,20552,7752,20845
211060,202109,7006,20949,6350,20056,168,651,5597,17671,5765,18322
211065,202109,2355,6236,1958,5743,92,234,1615,4851,1707,5085
211070,202109,8350,24994,7140,23207,511,1513,5695,18773,6206,20286
211080,202109,1345,3632,1081,3220,29,146,860,2443,889,2589
211085,202109,2157,5822,1823,5375,98,202,1514,4704,1612,4906
211090,202109,3197,8725,2870,8356,30,138,2662,7723,2692,7861
211100,202109,6876,17135,6349,16506,37,120,5919,15483,5956,15603
211102,202109,3276,10589,2990,10166,233,897,2433,8208,2666,9105
211105,202109,2438,7445,2032,6724,148,496,1477,4854,1625,5350
211107,202109,4966,15205,4212,14097,155,597,3277,11496,3432,12093
211110,202109,6217,16360,4871,14326,367,994,3630,10859,3997,11853
211120,202109,45949,110177,37640,100461,6102,14756,23239,66643,29341,81399
211125,202109,2109,6221,1776,5705,50,158,1494,4834,1544,4992
211130,202109,182005,426490,155205,391901,24409,56077,78711,223023,103120,279100
211140,202109,5137,14733,4490,13912,246,602,3729,11751,3975,12353
211150,202109,9718,25598,8155,23595,385,939,6786,19921,7171,20860
211153,202109,2485,7120,1978,6495,331,1047,1223,4278,1554,5325
211157,202109,1189,3650,996,3301,32,132,724,2398,756,2530
211160,202109,4437,11957,3497,10635,135,431,2672,8046,2807,8477
211163,202109,1606,5108,1453,4884,41,170,1277,4322,1318,4492
211167,202109,1627,4921,1511,4752,28,93,1390,4372,1418,4465
211170,202109,6596,15929,6109,15367,71,136,5782,14529,5853,14665
211172,202109,2646,7038,2272,6483,98,286,1820,5082,1918,5368
211174,202109,2909,8271,2631,7959,29,146,2476,7458,2505,7604
211176,202109,4357,12085,3396,10674,152,596,2740,8602,2892,9198
211178,202109,5169,11279,4428,10494,18,72,4277,10059,4295,10131
211180,202109,4186,13487,3840,12992,208,702,3146,10728,3354,11430
211190,202109,3128,9048,2652,8348,32,172,2373,7414,2405,7586
211195,202109,1449,3962,1234,3639,133,259,957,2982,1090,3241
211200,202109,2200,6196,1761,5576,205,581,1204,3896,1409,4477
211210,202109,6347,19214,5717,18374,340,1203,4692,15071,5032,16274
211220,202109,39137,95869,32242,87463,3613,8752,23242,65077,26855,73829
211223,202109,5418,14010,4450,12719,421,1137,3155,9118,3576,10255
211227,202109,1797,5724,1597,5443,60,255,1243,4298,1303,4553
211230,202109,8058,22288,7062,20795,389,862,5777,17454,6166,18316
211240,202109,8086,25190,7646,24623,229,868,6985,22398,7214,23266
211245,202109,7251,17792,6410,16905,85,208,6150,16197,6235,16405
211250,202109,13447,41570,12156,39751,930,3057,9541,31410,10471,34467
211260,202109,8253,26118,7328,24905,228,871,6497,22299,6725,23170
211270,202109,10381,32574,8847,30520,354,1561,7144,24942,7498,26503
211280,202109,12786,34326,11497,32701,829,1871,9549,28141,10378,30012
211285,202109,1927,6043,1722,5767,132,454,1303,4489,1435,4943
211290,202109,7643,22480,6896,21489,231,759,5877,18405,6108,19164
211300,202109,7863,22330,6885,20748,281,861,5594,16687,5875,17548
211400,202109,12010,32856,9800,29821,1078,3135,6466,20872,7544,24007
220005,202109,1933,4814,1750,4560,35,102,1492,3825,1527,3927
220010,202109,1510,4226,1239,3747,20,78,958,2882,978,2960
220020,202109,3939,10322,3364,9533,129,407,2797,7890,2926,8297
220025,202109,2274,5073,1952,4612,26,56,1627,3741,1653,3797
220027,202109,1327,3243,1132,2982,20,62,979,2540,999,2602
220030,202109,3468,8498,3238,8195,97,232,2821,7075,2918,7307
220040,202109,7524,22209,6569,20415,1589,4514,3250,10794,4839,15308
220045,202109,1536,4533,1263,4080,22,110,1054,3351,1076,3461
220050,202109,4791,12810,4069,11883,57,260,3744,10818,3801,11078
220060,202109,2481,5084,2121,4670,27,62,2009,4414,2036,4476
220070,202109,2484,6118,2110,5578,75,133,1756,4663,1831,4796
220080,202109,758,2110,654,1962,19,58,559,1673,578,1731
220090,202109,1793,4227,1504,3816,13,39,1241,3265,1254,3304
220095,202109,676,1616,635,1574,43,70,550,1409,593,1479
220100,202109,1468,3871,1182,3427,38,124,962,2705,1000,2829
220105,202109,2122,6312,1862,5826,119,373,1406,4407,1525,4780
220110,202109,3465,9483,3147,8948,34,165,2818,7910,2852,8075
220115,202109,2816,7912,2600,7635,85,239,2347,6894,2432,7133
220117,202109,1467,3398,1161,2979,5,20,977,2455,982,2475
220120,202109,13528,35029,12342,33568,78,251,11584,31461,11662,31712
220130,202109,1184,3024,1000,2773,8,44,907,2466,915,2510
220140,202109,2208,4478,1865,4078,96,222,1634,3557,1730,3779
220150,202109,6620,18957,6035,17961,121,469,5127,15036,5248,15505
220155,202109,1230,3425,982,2983,36,102,703,2099,739,2201
220157,202109,1094,2606,924,2349,24,72,735,1819,759,1891
220160,202109,2926,7944,2513,7199,31,120,2053,5772,2084,5892
220170,202109,1671,4266,1424,3906,17,72,1264,3428,1281,3500
220173,202109,2285,6113,1765,5172,47,133,1432,4090,1479,4223
220177,202109,2086,5746,1981,5630,8,27,1957,5557,1965,5584
220180,202109,1160,2719,941,2360,5,19,750,1766,755,1785
220190,202109,7299,17617,6207,16137,355,910,4762,12685,5117,13595
220191,202109,1646,4754,1491,4496,78,248,1050,3136,1128,3384
220192,202109,2119,5492,1559,4518,28,80,1257,3599,1285,3679
220194,202109,1765,4922,1568,4607,50,183,1294,3765,1344,3948
220196,202109,2109,5317,1917,5032,32,119,1669,4309,1701,4428
220198,202109,1309,3502,1114,3251,6,15,1031,3041,1037,3056
220200,202109,5344,15156,4664,14267,74,290,4021,12315,4095,12605
220202,202109,2227,6150,1909,5639,24,115,1638,4756,1662,4871
220205,202109,2564,7238,2287,6732,56,205,1926,5594,1982,5799
220207,202109,795,2360,664,2136,54,184,440,1429,494,1613
220208,202109,1771,5229,1477,4690,174,575,900,2835,1074,3410
220209,202109,1623,4558,1408,4177,29,105,1158,3399,1187,3504
220210,202109,1839,4313,1595,3941,13,45,1396,3357,1409,3402
220211,202109,1682,4132,1542,3943,18,65,1344,3440,1362,3505
220213,202109,1862,4797,1608,4367,19,60,1315,3474,1334,3534
220217,202109,2335,6575,2189,6408,48,84,2028,6060,2076,6144
220220,202109,11060,27770,9237,25060,686,1508,6245,17966,6931,19474
220225,202109,1012,2647,830,2412,4,27,782,2247,786,2274
220230,202109,5712,14128,4884,12986,152,334,4205,11287,4357,11621
220240,202109,3160,8895,2840,8364,106,354,2343,6856,2449,7210
220245,202109,1852,4128,1402,3585,13,50,1274,3287,1287,3337
220250,202109,3052,8336,2676,7862,13,63,2507,7335,2520,7398
220253,202109,1636,4310,1467,4031,55,162,1245,3359,1300,3521
220255,202109,2019,4585,1739,4201,31,124,1521,3556,1552,3680
220260,202109,4613,13503,4022,12447,177,565,3159,9784,3336,10349
220265,202109,1415,4298,1278,4126,36,166,1075,3409,1111,3575
220270,202109,6074,19394,5730,18782,184,863,4797,15255,4981,16118
220271,202109,1523,3853,1332,3583,22,69,1167,3123,1189,3192
220272,202109,1802,5081,1603,4721,50,139,1206,3466,1256,3605
220273,202109,1292,3600,1082,3221,49,171,827,2422,876,2593
220275,202109,2428,5451,1939,4788,34,52,1722,4280,1756,4332
220277,202109,2267,5502,1932,5032,49,108,1611,4147,1660,4255
220280,202109,1737,3912,1441,3533,17,49,1236,3014,1253,3063
220285,202109,1494,3665,1273,3405,7,23,1186,3150,1193,3173
220290,202109,6927,18602,5491,16602,333,1015,4025,12566,4358,13581
220300,202109,2073,5786,1670,5259,32,157,1400,4372,1432,4529
220310,202109,3125,8154,2466,7393,38,154,2105,6283,2143,6437
220320,202109,3168,8978,2447,7672,53,238,1916,5852,1969,6090
220323,202109,1698,4774,1324,4187,55,166,1079,3369,1134,3535
220325,202109,1266,3686,1089,3395,25,112,907,2776,932,2888
220327,202109,1642,4427,1436,4104,34,131,1187,3298,1221,3429
220330,202109,4739,10929,4035,10087,57,169,3654,9090,3711,9259
220335,202109,1700,5068,1533,4844,31,90,1363,4335,1394,4425
220340,202109,1958,5019,1507,4268,56,151,1018,2817,1074,2968
220342,202109,1215,3452,1087,3258,53,155,855,2561,908,2716
220345,202109,3187,7052,2446,6015,19,53,2213,5426,2232,5479
220350,202109,3422,8483,2736,7478,140,355,1942,5388,2082,5743
220360,202109,1258,3185,996,2752,16,43,791,2181,807,2224
220370,202109,8853,25130,8044,23839,175,580,6943,20448,7118,21028
220375,202109,1669,4622,1484,4397,2,7,1417,4222,1419,4229
220380,202109,1538,3551,1271,3182,17,36,1118,2791,1135,2827
220385,202109,866,2012,714,1752,6,15,624,1516,630,1531
220390,202109,10958,27335,8454,23548,2047,5509,3060,9512,5107,15021
220400,202109,1567,3619,1202,3060,22,68,931,2285,953,2353
220410,202109,1206,3245,982,2862,46,124,797,2305,843,2429
220415,202109,850,2133,716,1919,25,60,573,1520,598,1580
220420,202109,2065,5644,1663,4886,59,163,1259,3651,1318,3814
220430,202109,2690,6794,2457,6466,54,169,2161,5602,2215,5771
220435,202109,1828,4606,1563,4214,40,125,1307,3450,1347,3575
220440,202109,2431,7338,2050,6769,71,312,1759,5690,1830,6002
220450,202109,2573,6574,2085,5971,49,151,1793,5155,1842,5306
220455,202109,1318,4021,1257,3935,6,35,1136,3552,1142,3587
220460,202109,1042,2481,967,2389,28,55,839,2060,867,2115
220465,202109,2474,7328,2176,6870,200,563,1605,5226,1805,5789
220470,202109,3736,9958,3356,9347,155,344,2675,7425,2830,7769
220480,202109,2920,7275,2358,6397,250,495,1509,4227,1759,4722
220490,202109,2537,6210,2192,5783,25,114,1903,4953,1928,5067
220500,202109,3157,7622,2719,6954,107,230,2118,5370,2225,5600
220510,202109,2676,7226,2151,6300,86,209,1699,5041,1785,5250
220515,202109,1722,4041,1596,3866,40,62,1382,3344,1422,3406
220520,202109,5119,12989,4632,12306,92,242,4040,10695,4132,10937
220525,202109,1489,3539,1271,3272,8,35,1167,2992,1175,3027
220527,202109,1351,3640,1168,3379,17,64,1002,2935,1019,2999
220530,202109,1470,3574,1277,3328,32,91,1164,3020,1196,3111
220535,202109,812,2179,760,2109,30,75,612,1702,642,1777
220540,202109,3300,10260,3071,9822,141,455,2566,8197,2707,8652
220545,202109,1492,4310,1386,4143,56,209,1177,3476,1233,3685
220550,202109,8866,26707,7897,25014,453,1483,6006,18860,6459,20343
220551,202109,1448,3956,1280,3691,28,99,1047,2964,1075,3063
220552,202109,1695,4755,1384,4205,21,107,1115,3281,1136,3388
220553,202109,1834,4555,1505,4124,54,85,1241,3527,1295,3612
220554,202109,948,2362,701,1970,55,125,474,1321,529,1446
220555,202109,2584,7078,2241,6651,32,111,1875,5732,1907,5843
220556,202109,1246,3507,1089,3209,39,153,818,2323,857,2476
220557,202109,1774,5192,1463,4506,111,361,1034,3111,1145,3472
220558,202109,1444,3694,1134,3260,17,66,975,2771,992,2837
220559,202109,1863,4456,1584,4028,19,40,1292,3334,1311,3374
220560,202109,1806,3993,1485,3593,49,87,1329,3262,1378,3349
220570,202109,7649,21888,6976,20936,500,1289,5538,16916,6038,18205
220580,202109,7108,18776,6471,17769,108,274,5824,15982,5932,16256
220585,202109,2146,6525,1761,5833,36,92,1459,4874,1495,4966
220590,202109,1437,3770,1190,3409,92,205,854,2518,946,2723
220595,202109,2700,7145,2444,6803,17,70,2192,6056,2209,6126
220600,202109,1489,3187,1263,2920,71,86,1082,2567,1153,2653
220605,202109,1640,4702,1407,4286,18,94,1154,3419,1172,3513
220610,202109,2869,8161,2686,7888,25,122,2519,7353,2544,7475
220620,202109,8234,24456,7537,23517,138,694,6876,21244,7014,21938
220630,202109,390,1123,304,969,22,75,203,632,225,707
220635,202109,1845,5392,1649,4990,41,179,1304,3832,1345,4011
220640,202109,2452,6731,2085,6210,64,247,1704,5032,1768,5279
220650,202109,2192,5813,1883,5347,30,91,1539,4355,1569,4446
220660,202109,2608,8069,2219,7432,69,329,1857,6128,1926,6457
220665,202109,1291,3790,1090,3456,27,134,919,2851,946,2985
220667,202109,1689,5029,1523,4730,64,223,1235,3814,1299,4037
220669,202109,1723,4958,1653,4853,51,177,1475,4261,1526,4438
220670,202109,2261,5707,1804,5078,19,73,1563,4396,1582,4469
220672,202109,3324,7974,2691,7208,82,272,2400,6343,2482,6615
220675,202109,1348,3560,1202,3298,36,89,979,2681,1015,2770
220680,202109,2819,7410,2687,7230,119,212,2429,6666,2548,6878
220690,202109,1637,4225,1442,3930,64,184,1127,3066,1191,3250
220695,202109,934,2534,868,2416,21,60,756,2096,777,2156
220700,202109,10657,25058,8637,22341,350,837,6603,16996,6953,17833
220710,202109,941,2486,693,2031,30,82,528,1507,558,1589
220720,202109,2163,5049,1946,4765,15,54,1707,4133,1722,4187
220730,202109,1362,3681,1158,3349,16,66,987,2796,1003,2862
220735,202109,1025,2288,804,1954,28,75,658,1553,686,1628
220740,202109,1401,3541,1122,3173,32,73,939,2705,971,2778
220750,202109,3990,9798,3506,9112,164,360,3098,8077,3262,8437
220755,202109,1431,3331,1194,2982,21,61,995,2432,1016,2493
220760,202109,3182,8450,2794,7935,60,172,2549,7286,2609,7458
220770,202109,24855,71321,21090,65007,6146,19885,7345,23820,13491,43705
220775,202109,1220,2963,1085,2793,8,27,1046,2676,1054,2703
220777,202109,1646,4101,1268,3530,37,89,964,2709,1001,2798
220779,202109,1297,3305,1122,3045,24,66,974,2617,998,2683
220780,202109,6016,14462,5170,13214,219,602,4107,10353,4326,10955
220785,202109,1503,3304,1318,3068,6,14,1262,2920,1268,2934
220790,202109,10524,29031,9481,27541,159,648,8005,23052,8164,23700
220793,202109,956,2470,768,2148,8,11,638,1813,646,1824
220795,202109,1453,3642,1277,3408,28,77,1115,2978,1143,3055
220800,202109,18978,40845,16139,37148,592,1242,12624,29045,13216,30287
220810,202109,3153,8510,2654,7651,43,116,2206,6294,2249,6410
220820,202109,5246,13235,4567,12237,242,496,3553,9584,3795,10080
220830,202109,7483,19263,6700,18167,266,734,5515,14773,5781,15507
220840,202109,12603,37042,10540,32922,2378,6994,4894,16049,7272,23043
220850,202109,3243,9723,2920,9322,41,209,2607,8346,2648,8555
220855,202109,719,1767,629,1648,21,58,567,1479,588,1537
220860,202109,1081,2619,943,2405,13,54,865,2176,878,2230
220865,202109,2499,6472,1928,5462,61,228,1427,3914,1488,4142
220870,202109,3180,8425,2639,7723,26,123,2430,7098,2456,7221
220880,202109,5447,12614,4690,11678,69,242,4314,10633,4383,10875
220885,202109,1451,4208,1203,3802,63,190,935,3019,998,3209
220887,202109,1615,3384,1353,3052,13,28,1254,2817,1267,2845
220890,202109,1447,4263,1258,3990,46,149,1047,3377,1093,3526
220900,202109,2050,4808,1713,4378,32,76,1497,3812,1529,3888
220910,202109,1585,4192,1333,3820,65,164,1083,3146,1148,3310
220915,202109,1006,2624,809,2270,16,52,625,1678,641,1730
220920,202109,1479,4475,1285,4221,61,223,1059,3513,1120,3736
220930,202109,1839,4783,1543,4364,21,62,1438,4060,1459,4122
220935,202109,1124,3168,907,2705,23,99,585,1644,608,1743
220937,202109,1553,3974,1332,3626,24,83,1074,2873,1098,2956
220940,202109,1625,4370,1299,3803,29,89,1017,2945,1046,3034
220945,202109,493,1619,408,1453,16,85,303,1057,319,1142
220950,202109,1450,3279,962,2537,20,56,763,1943,783,1999
220955,202109,1662,4140,1379,3658,26,65,1185,3110,1211,3175
220960,202109,830,2064,619,1712,31,89,435,1149,466,1238
220965,202109,1842,4910,1597,4553,15,92,1379,3860,1394,3952
220970,202109,2047,4711,1508,3924,24,57,1274,3282,1298,3339
220975,202109,700,1927,600,1802,9,50,539,1577,548,1627
220980,202109,1179,3253,1044,3071,33,116,873,2550,906,2666
220985,202109,1342,3336,1164,3077,61,133,944,2460,1005,2593
220987,202109,1508,4356,1333,4053,56,189,1079,3256,1135,3445
220990,202109,1731,4697,1523,4387,14,80,1305,3710,1319,3790
220995,202109,1180,3378,980,3012,30,89,736,2269,766,2358
220997,202109,2417,7191,2231,6891,44,168,1981,6058,2025,6226
221000,202109,4588,12301,4037,11500,83,332,3475,9819,3558,10151
221005,202109,1522,3871,1388,3646,14,68,1209,3082,1223,3150
221010,202109,1289,2810,1013,2474,18,51,881,2117,899,2168
221020,202109,1603,4743,1451,4488,19,70,1118,3433,1137,3503
221030,202109,1720,4069,1467,3762,19,52,1276,3328,1295,3380
221035,202109,1573,3941,1370,3672,22,27,1224,3358,1246,3385
221037,202109,743,1950,615,1731,9,25,450,1203,459,1228
221038,202109,543,1479,421,1267,13,41,285,849,298,890
221039,202109,894,2403,759,2180,25,106,611,1696,636,1802
221040,202109,4387,12395,3826,11407,198,526,3050,9168,3248,9694
221050,202109,4003,10216,3544,9638,67,199,3198,8698,3265,8897
221060,202109,9004,24611,7460,22090,348,799,5933,17835,6281,18634
221062,202109,1162,3641,998,3370,35,145,806,2705,841,2850
221063,202109,1124,2988,968,2763,55,157,767,2171,822,2328
221065,202109,2713,6819,2376,6240,15,49,2093,5424,2108,5473
221070,202109,3527,10566,2848,9150,327,986,1717,5665,2044,6651
221080,202109,3582,8609,2939,7658,56,180,2421,6211,2477,6391
221090,202109,1453,3620,1194,3217,9,29,1020,2702,1029,2731
221093,202109,1442,3901,1315,3658,136,347,909,2492,1045,2839
221095,202109,889,2298,755,2094,8,21,642,1755,650,1776
221097,202109,887,2219,668,1831,21,53,501,1305,522,1358
221100,202109,123452,319962,102866,285415,10143,29792,67008,180601,77151,210393
221110,202109,10034,29400,9190,28291,125,595,8269,25273,8394,25868
221120,202109,4908,13334,4373,12506,157,440,3787,10883,3944,11323
221130,202109,5738,14175,4366,11602,813,2000,2234,5964,3047,7964
221135,202109,1830,4512,1630,4247,42,93,1456,3814,1498,3907
221140,202109,1381,3154,1161,2878,10,33,1053,2574,1063,2607
221150,202109,1121,2770,877,2354,20,87,678,1705,698,1792
221160,202109,756,1833,668,1721,27,35,538,1408,565,1443
221170,202109,1023,2866,938,2714,8,29,823,2343,831,2372
230010,202109,3149,8069,2592,7138,33,100,2137,5770,2170,5870
230015,202109,3186,9992,2817,9252,152,528,1987,6547,2139,7075
230020,202109,13270,41164,12414,39888,368,1376,10623,34075,10991,35451
230030,202109,13288,32412,11149,29639,252,634,9671,25791,9923,26425
230040,202109,4623,11622,3824,10333,39,182,3218,8569,3257,8751
230050,202109,2796,8496,2136,6992,332,1033,948,3045,1280,4078
230060,202109,2440,6517,1954,5657,30,110,1547,4401,1577,4511
230070,202109,4311,10804,3454,9238,222,606,2431,6438,2653,7044
230075,202109,9179,28959,8399,27609,653,2178,6426,21164,7079,23342
230080,202109,3118,6477,2374,5574,4,9,2174,5124,2178,5133
230090,202109,4565,10862,3861,9761,194,448,3095,7794,3289,8242
230100,202109,19171,47578,16776,44453,1445,3532,11904,31930,13349,35462
230110,202109,13061,37861,10926,33737,1727,5208,5658,17677,7385,22885
230120,202109,8089,20838,7083,19239,533,1221,5215,14385,5748,15606
230125,202109,3255,8432,2641,7470,96,291,2035,5672,2131,5963
230130,202109,5801,17400,4720,15071,410,1328,3049,9655,3459,10983
230140,202109,3498,10309,2968,9230,82,337,2265,6881,2347,7218
230150,202109,1672,4883,1375,4237,224,603,784,2507,1008,3110
230160,202109,6684,16831,5767,15454,118,360,4847,12802,4965,13162
230170,202109,6709,18400,5490,15964,380,968,3855,11148,4235,12116
230180,202109,1693,4614,1429,4102,18,78,1166,3247,1184,3325
230185,202109,4610,12633,3906,11472,302,884,2843,8405,3145,9289
230190,202109,14459,40942,12125,36658,1349,4070,7166,21547,8515,25617
230195,202109,5594,15861,5065,14893,402,1144,3779,11124,4181,12268
230200,202109,5162,13912,4321,12373,158,439,3321,9354,3479,9793
230205,202109,4480,12389,3916,11566,235,652,2962,8722,3197,9374
230210,202109,10554,24567,8918,22410,400,1073,6977,17315,7377,18388
230220,202109,14452,35603,12681,33087,625,1589,10431,26962,11056,28551
230230,202109,7188,20472,6423,18956,459,1251,4733,13985,5192,15236
230240,202109,13156,34671,11334,31570,271,1126,9367,25463,9638,26589
230250,202109,9148,24801,8471,23764,222,704,6860,18669,7082,19373
230260,202109,15230,43531,13165,39943,2283,6414,6942,21846,9225,28260
230270,202109,7941,20638,6099,17258,585,1559,3849,11072,4434,12631
230280,202109,20844,54409,17084,48173,419,1583,13495,36706,13914,38289
230290,202109,5110,13744,4210,12069,235,547,3204,9180,3439,9727
230300,202109,5005,12959,4527,12317,84,221,3998,10871,4082,11092
230310,202109,4864,13509,4115,12171,126,466,2958,8561,3084,9027
230320,202109,8092,22778,6789,20442,194,762,5254,15488,5448,16250
230330,202109,4907,12958,3902,11075,113,348,2962,8194,3075,8542
230340,202109,3969,11869,3403,10716,214,708,2410,7464,2624,8172
230350,202109,18551,49488,16165,46014,823,2557,10995,31481,11818,34038
230360,202109,3087,7899,2453,6799,123,324,1725,4715,1848,5039
230365,202109,3173,7640,2618,6830,57,230,2229,5737,2286,5967
230370,202109,62402,165944,53304,152768,6905,19900,33541,96543,40446,116443
230380,202109,6505,17503,5144,15044,115,403,3840,10962,3955,11365
230390,202109,3576,10167,3080,9372,77,297,2409,7242,2486,7539
230393,202109,3522,9927,2801,8469,66,329,2184,6333,2250,6662
230395,202109,5940,15867,5130,14529,425,1114,3507,10004,3932,11118
230400,202109,5610,15032,4971,14012,63,304,4055,11135,4118,11439
230410,202109,14024,40770,11594,36393,944,3101,7861,24787,8805,27888
230420,202109,30441,80840,24802,71293,2857,8321,14208,40425,17065,48746
230423,202109,4959,14282,4342,13085,165,546,3401,10131,3566,10677
230425,202109,5952,17703,5430,16654,491,1490,3824,11683,4315,13173
230426,202109,2946,7468,2172,6004,28,89,1643,4443,1671,4532
230427,202109,1942,5266,1387,4143,82,244,887,2542,969,2786
230428,202109,10240,26499,8782,24341,1427,3733,4883,13626,6310,17359
230430,202109,5128,14008,4050,12154,161,499,3043,9023,3204,9522
230435,202109,6374,15970,5303,14114,735,1784,3105,8372,3840,10156
230440,202109,442576,1059738,369639,954677,32797,88749,247644,628826,280441,717575
230445,202109,4379,11399,3510,9874,205,548,2393,6575,2598,7123
230450,202109,3716,10349,3234,9649,224,788,2375,6888,2599,7676
230460,202109,2195,5966,1902,5509,45,181,1611,4619,1656,4800
230465,202109,4384,11814,3699,10530,121,385,2801,7695,2922,8080
230470,202109,11651,37492,10447,35299,874,3174,7318,24494,8192,27668
230480,202109,1518,4295,1266,3847,61,236,935,2740,996,2976
230490,202109,2713,7360,2302,6597,168,522,1452,3925,1620,4447
230495,202109,5954,17007,5242,15745,560,1692,3264,9860,3824,11552
230500,202109,9599,29993,8500,28015,246,963,6925,22857,7171,23820
230510,202109,1731,4846,1356,4071,156,484,749,2206,905,2690
230520,202109,4900,13135,4229,11979,365,897,2905,8309,3270,9206
230523,202109,16023,46057,12768,39280,2813,8511,3116,10294,5929,18805
230526,202109,3908,10716,3330,9764,198,476,2426,7234,2624,7710
230530,202109,5662,17304,4764,15575,428,1425,3306,10723,3734,12148
230533,202109,4763,10829,3889,9483,120,272,3228,7768,3348,8040
230535,202109,5375,14679,4552,13298,334,956,3004,8861,3338,9817
230540,202109,16388,43780,14038,40305,291,989,11632,33196,11923,34185
230550,202109,22241,56658,17904,49451,1498,4108,11674,32012,13172,36120
230560,202109,8153,19729,6616,17324,63,237,5694,14781,5757,15018
230565,202109,3211,8664,2691,7723,121,417,2069,5822,2190,6239
230570,202109,3515,8806,2993,8087,86,203,2443,6596,2529,6799
230580,202109,11732,29126,10069,26776,421,1003,8248,21971,8669,22974
230590,202109,9535,26176,7968,23362,487,1482,5859,16723,6346,18205
230600,202109,3923,9631,3108,8252,94,227,2109,5665,2203,5892
230610,202109,6879,18555,6096,17259,461,1213,4792,13544,5253,14757
230620,202109,2190,5733,1703,4815,102,308,1065,2903,1167,3211
230625,202109,8747,23563,7384,21142,1911,5696,2440,7184,4351,12880
230630,202109,11639,32513,10184,29780,1342,3590,6304,18784,7646,22374
230640,202109,28001,83136,25336,78925,1126,4186,20338,62561,21464,66747
230650,202109,5538,14345,4690,12917,117,403,3847,10329,3964,10732
230655,202109,9454,31305,8883,30342,631,2082,7111,24587,7742,26669
230660,202109,6224,18095,5066,16076,127,659,4094,12727,4221,13386
230670,202109,6448,14856,4675,12075,143,393,3709,9344,3852,9737
230680,202109,2783,7373,2336,6592,115,265,1670,4753,1785,5018
230690,202109,7460,21378,6402,19319,395,1342,4124,12243,4519,13585
230700,202109,10817,26618,8761,22922,419,911,6448,16653,6867,17564
230710,202109,7084,21760,6204,19907,722,2142,4030,13033,4752,15175
230720,202109,1972,5626,1619,4960,103,277,1142,3428,1245,3705
230725,202109,4425,12535,3970,11750,395,1240,2471,7233,2866,8473
230730,202109,61074,157547,48006,138272,10791,32737,14572,45480,25363,78217
230740,202109,6318,17156,5358,15626,140,398,4263,12444,4403,12842
230750,202109,8728,22667,7260,20239,165,495,5786,15746,5951,16241
230760,202109,11466,29400,9935,27106,489,1529,7513,19975,8002,21504
230763,202109,5185,13562,4326,12062,106,459,3496,9420,3602,9879
230765,202109,42944,112526,35638,100924,5207,15170,18767,52297,23974,67467
230770,202109,26482,62980,22181,57431,2197,5561,14994,38951,17191,44512
230780,202109,6709,22753,6042,21187,921,2996,3389,12361,4310,15357
230790,202109,3196,8768,2867,8244,103,399,2215,6170,2318,6569
230800,202109,8665,26449,7607,24345,1093,3454,4285,13649,5378,17103
230810,202109,11356,33591,10192,31716,366,1254,7978,24487,8344,25741
230820,202109,3662,11426,3026,10062,250,944,1863,5882,2113,6826
230830,202109,7814,20764,6652,18867,121,468,5491,15171,5612,15639
230835,202109,4370,10144,3382,8621,92,247,2724,6857,2816,7104
230837,202109,3282,9571,2929,8969,116,409,2350,7078,2466,7487
230840,202109,9730,27510,8350,25142,1046,2824,5696,17417,6742,20241
230850,202109,10150,28288,8535,25191,364,1095,6254,18249,6618,19344
230860,202109,5681,13782,4704,12397,58,181,4157,10864,4215,11045
230870,202109,16601,39796,14293,36000,413,1101,11674,28875,12087,29976
230880,202109,2199,6424,2015,6128,42,212,1606,4751,1648,4963
230890,202109,4622,14455,4216,13677,311,1063,3106,9964,3417,11027
230900,202109,3178,8784,2751,7999,159,527,1919,5410,2078,5937
230910,202109,3312,8604,2645,7595,59,256,2131,6117,2190,6373
230920,202109,4945,13400,4147,12143,98,348,3306,9486,3404,9834
230930,202109,7023,18897,5868,16870,284,765,4089,11713,4373,12478
230940,202109,8512,20903,7399,19240,209,466,6208,16101,6417,16567
230945,202109,6783,18840,5793,16996,298,978,4116,11811,4414,12789
230950,202109,6382,15699,5636,14687,121,262,4830,12678,4951,12940
230960,202109,14192,39358,12436,36120,2270,6399,5880,17129,8150,23528
230970,202109,14631,37450,12242,33772,1639,4258,7296,20271,8935,24529
230980,202109,2816,7907,2477,7318,338,928,1581,4827,1919,5755
230990,202109,1727,4711,1424,4125,62,226,1015,2814,1077,3040
231000,202109,2678,6960,2160,5959,93,209,1594,4309,1687,4518
231010,202109,3808,8612,2990,7243,26,93,2620,6169,2646,6262
231020,202109,8560,25243,7637,23525,1291,3556,4477,14319,5768,17875
231025,202109,7944,20851,6912,19182,768,1970,4850,13661,5618,15631
231030,202109,7648,22074,6010,18692,1047,2988,3028,9633,4075,12621
231040,202109,3021,8374,2624,7658,120,328,2060,5934,2180,6262
231050,202109,12242,30243,9996,26353,644,1556,7498,19403,8142,20959
231060,202109,2989,8234,2629,7667,59,164,2189,6402,2248,6566
231070,202109,8337,23398,7172,21361,644,1905,4833,14237,5477,16142
231080,202109,4058,11173,3429,10154,139,520,2597,7524,2736,8044
231085,202109,7168,16650,5708,14960,229,492,4471,11821,4700,12313
231090,202109,4653,11810,3431,9506,105,385,2336,6203,2441,6588
231095,202109,2327,6772,1845,5758,171,523,1204,3756,1375,4279
231100,202109,3369,9393,2742,8204,139,440,2062,6116,2201,6556
231110,202109,3808,10750,3489,10170,134,451,2623,7505,2757,7956
231120,202109,2448,6853,2038,6148,78,255,1485,4434,1563,4689
231123,202109,1993,5030,1669,4479,93,206,1198,3233,1291,3439
231126,202109,5692,15187,4660,13265,296,765,3345,9449,3641,10214
231130,202109,22596,55322,18735,50551,1105,3138,13910,37145,15015,40283
231135,202109,4297,11834,3559,10425,180,536,2515,7297,2695,7833
231140,202109,17147,47043,13845,41432,641,2230,9890,28943,10531,31173
231150,202109,6191,16303,4612,13303,629,1839,1968,5844,2597,7683
231160,202109,6492,19392,5778,18103,790,2308,3292,10675,4082,12983
231170,202109,4711,13030,3920,11555,254,758,2746,7858,3000,8616
231180,202109,15116,41403,12312,35673,2826,7946,4837,14289,7663,22235
231190,202109,4136,11278,3390,9944,75,253,2615,7547,2690,7800
231195,202109,5358,15355,4453,13557,266,843,3228,9777,3494,10620
231200,202109,8025,24130,6996,22090,168,796,5594,17139,5762,17935
231210,202109,5081,14376,4321,13116,149,495,3341,9935,3490,10430
231220,202109,13086,32375,10299,27291,515,1331,7559,19429,8074,20760
231230,202109,9384,29399,8278,27359,582,2060,5991,19926,6573,21986
231240,202109,12017,34081,10579,31410,1744,4899,6203,18773,7947,23672
231250,202109,2205,5466,1452,3850,114,316,865,2211,979,2527
231260,202109,3388,9170,2953,8482,275,718,1987,5900,2262,6618
231270,202109,6528,16709,5229,14571,155,560,3966,10750,4121,11310
231280,202109,1809,5457,1650,5178,91,263,1236,3870,1327,4133
231290,202109,38995,113278,32456,100409,5489,16676,14836,45566,20325,62242
231300,202109,4273,11423,3361,9646,154,491,2317,6476,2471,6967
231310,202109,7860,19470,6233,16517,554,1444,4229,10917,4783,12361
231320,202109,7897,21239,6116,18123,93,369,4872,14224,4965,14593
231325,202109,2588,6438,2128,5769,181,329,1486,4175,1667,4504
231330,202109,10140,28914,8422,25553,1622,4503,4438,14232,6060,18735
231335,202109,5815,15106,4932,13716,70,291,4337,11937,4407,12228
231340,202109,18943,55725,17063,52448,1198,3549,12848,39866,14046,43415
231350,202109,16221,43605,14801,41572,239,806,13331,37141,13570,37947
231355,202109,4550,13107,4103,12286,240,712,3210,9525,3450,10237
231360,202109,7985,23255,6912,21413,298,968,5468,16895,5766,17863
231370,202109,2242,6019,1792,5218,37,109,1366,3956,1403,4065
231375,202109,4386,13377,4007,12760,113,475,3368,10608,3481,11083
231380,202109,6222,16449,5615,15622,192,439,4597,12942,4789,13381
231390,202109,3553,10020,3191,9408,107,383,2380,6829,2487,7212
231395,202109,4327,12124,3600,10969,299,910,2351,7145,2650,8055
231400,202109,9987,28152,8351,25181,250,1050,6330,18678,6580,19728
231410,202109,15234,45971,13905,43806,685,2087,11196,35289,11881,37376
240010,202109,2655,6777,2066,5739,223,601,1199,3298,1422,3899
240020,202109,13146,35677,10980,31864,649,2167,7208,20685,7857,22852
240030,202109,3130,7250,2790,6749,111,297,2415,5780,2526,6077
240040,202109,858,2413,720,2155,30,110,496,1422,526,1532
240050,202109,3471,9053,2789,7835,49,130,2129,5868,2178,5998
240060,202109,1465,3807,1186,3300,22,71,959,2613,981,2684
240070,202109,2294,6375,2049,5850,206,582,1466,4092,1672,4674
240080,202109,3026,7966,2442,6944,72,243,1833,5147,1905,5390
240090,202109,2326,5654,1895,4937,16,41,1581,4068,1597,4109
240100,202109,10686,25522,8509,21723,194,548,6704,16530,6898,17078
240110,202109,4660,12947,3881,11517,180,636,2844,8251,3024,8887
240120,202109,3498,9467,2848,8664,195,589,2029,6322,2224,6911
240130,202109,3860,7739,3178,6859,30,66,2896,6188,2926,6254
240140,202109,1837,5437,1576,4930,174,572,1044,3249,1218,3821
240145,202109,6838,18547,5556,16351,861,2574,3151,9378,4012,11952
240150,202109,996,2791,877,2553,50,148,679,1933,729,2081
240160,202109,1492,4389,1247,3934,35,132,941,2980,976,3112
240165,202109,1006,2675,836,2352,23,89,701,1927,724,2016
240170,202109,2767,7148,2327,6379,234,637,1518,4121,1752,4758
240180,202109,3096,9020,2464,7741,579,1747,1040,3487,1619,5234
240185,202109,1292,3909,1193,3739,56,189,998,3113,1054,3302
240190,202109,1104,3132,948,2877,20,77,795,2432,815,2509
240200,202109,11444,28220,9103,24281,918,2539,5180,13557,6098,16096
240210,202109,3404,8187,2764,7158,22,109,2332,5837,2354,5946
240220,202109,7520,22235,6759,21062,322,1317,5383,16561,5705,17878
240230,202109,5991,14906,4785,12930,233,555,3726,10143,3959,10698
240240,202109,1861,5241,1213,3773,115,363,414,1158,529,1521
240250,202109,3115,7882,2706,7316,68,199,2326,6229,2394,6428
240260,202109,14110,41225,12176,37998,1747,5066,7339,24250,9086,29316
240270,202109,2474,7082,2142,6533,116,341,1569,4927,1685,5268
240280,202109,1773,4396,1477,3915,62,146,1156,3042,1218,3188
240290,202109,1203,3456,979,2966,27,111,691,1978,718,2089
240300,202109,2388,5946,1718,4736,78,209,1059,2870,1137,3079
240310,202109,8698,22694,6842,19392,893,2659,3457,9631,4350,12290
240320,202109,2141,5657,1551,4519,30,124,1171,3258,1201,3382
240325,202109,33152,85810,26483,74441,4338,12452,12307,34306,16645,46758
240330,202109,1852,4932,1421,4123,57,189,978,2710,1035,2899
240340,202109,2030,4583,1650,4024,54,123,1354,3241,1408,3364
240350,202109,2323,5687,2064,5396,38,93,1869,4910,1907,5003
240360,202109,10098,26860,8924,25035,1014,2737,5979,17087,6993,19824
240370,202109,2099,5233,1619,4286,66,176,1147,2948,1213,3124
240375,202109,962,2366,803,2094,26,87,632,1587,658,1674
240380,202109,2284,6385,1706,5123,146,402,950,2841,1096,3243
240390,202109,1080,2535,774,1973,23,42,495,1178,518,1220
240400,202109,1559,3705,1193,3090,35,121,839,2028,874,2149
240410,202109,606,1737,495,1524,45,153,311,909,356,1062
240420,202109,4811,16180,4254,14995,462,1836,2586,8949,3048,10785
240430,202109,3601,8951,2977,7878,173,517,2224,5707,2397,6224
240440,202109,2606,5659,2210,5100,147,283,1752,4072,1899,4355
240450,202109,4709,12452,3686,10570,369,1042,2118,5875,2487,6917
240460,202109,3187,8566,2832,7997,241,703,2231,6290,2472,6993
240470,202109,3674,10952,2766,9058,659,1995,1149,4044,1808,6039
240480,202109,619,1630,417,1190,33,83,195,539,228,622
240485,202109,2277,6147,1836,5377,121,336,1251,3688,1372,4024
240490,202109,1673,4172,1309,3517,82,170,937,2539,1019,2709
240500,202109,2215,5885,1909,5353,109,288,1517,4276,1626,4564
240510,202109,1745,4545,1506,4180,90,266,1187,3267,1277,3533
240520,202109,1591,3688,1217,3187,85,189,880,2401,965,2590
240530,202109,2404,6357,2151,5961,94,265,1784,4872,1878,5137
240540,202109,2407,5822,2121,5383,65,116,1824,4662,1889,4778
240550,202109,747,1990,672,1846,15,62,576,1532,591,1594
240560,202109,3340,8453,2816,7760,281,664,2025,5754,2306,6418
240570,202109,2910,7425,1955,5383,302,804,675,1769,977,2573
240580,202109,8159,23722,7165,21908,638,1792,5571,17276,6209,19068
240590,202109,822,1958,722,1802,8,24,581,1411,589,1435
240600,202109,1880,4955,1384,3957,44,123,925,2546,969,2669
240610,202109,4383,11373,3753,10266,119,344,2900,7783,3019,8127
240615,202109,1300,3282,1049,2844,116,295,707,1891,823,2186
240620,202109,1896,5131,1628,4684,117,284,1278,3713,1395,3997
240630,202109,2134,5782,1922,5426,143,290,1351,3997,1494,4287
240640,202109,987,2569,785,2240,27,93,578,1617,605,1710
240650,202109,4195,11522,3576,10277,240,627,2629,7520,2869,8147
240660,202109,3148,7862,2795,7415,69,182,2521,6711,2590,6893
240670,202109,2581,6991,2065,5962,144,422,1345,3794,1489,4216
240680,202109,1671,4319,1353,3787,74,191,992,2720,1066,2911
240690,202109,1085,2609,850,2220,15,61,686,1720,701,1781
240700,202109,2566,7242,2093,6372,83,261,1584,4767,1667,5028
240710,202109,16995,42458,14287,37940,1667,4310,9206,24275,10873,28585
240720,202109,5426,12988,4655,11903,495,1212,3329,8498,3824,9710
240725,202109,1184,3264,902,2734,38,113,610,1789,648,1902
240730,202109,2362,6390,1881,5449,51,163,1435,4095,1486,4258
240740,202109,1948,5148,1568,4401,51,178,1147,3061,1198,3239
240750,202109,2207,7065,1867,6347,237,830,1048,3616,1285,4446
240760,202109,1751,3872,1262,3145,76,98,973,2488,1049,2586
240770,202109,3302,8988,2788,8255,129,438,2261,6640,2390,7078
240780,202109,4741,13038,3914,11660,558,1604,2365,7264,2923,8868
240790,202109,916,2502,759,2214,15,62,574,1619,589,1681
240800,202109,51778,120222,40309,103113,5147,13063,21305,54425,26452,67488
240810,202109,95509,238937,81162,215795,8600,23503,53793,140266,62393,163769
240820,202109,6063,17447,5241,15977,709,2081,3232,10050,3941,12131
240830,202109,8903,24906,7874,23389,254,948,6484,19092,6738,20040
240840,202109,1122,2730,896,2374,25,63,646,1654,671,1717
240850,202109,1479,3917,1040,2993,66,187,576,1606,642,1793
240860,202109,1400,3614,1055,3006,13,56,814,2214,827,2270
240870,202109,1118,2766,842,2305,150,423,443,1246,593,1669
240880,202109,1327,4109,1165,3793,73,292,870,2767,943,3059
240890,202109,4611,12328,3532,10318,466,1461,1806,5042,2272,6503
240895,202109,2988,8894,2740,8499,230,662,2193,6951,2423,7613
240910,202109,3643,9500,3078,8516,49,164,2520,6824,2569,6988
240920,202109,1045,2628,836,2305,99,197,460,1363,559,1560
240930,202109,3791,8396,3118,7572,240,347,2254,5882,2494,6229
240933,202109,1716,4170,1450,3793,34,124,1266,3255,1300,3379
240940,202109,6288,15233,4895,12849,603,1532,2757,7127,3360,8659
240950,202109,1139,3267,985,2987,32,122,795,2349,827,2471
240960,202109,695,2098,623,1954,21,63,487,1504,508,1567
240970,202109,1921,4853,1541,4207,61,215,1261,3354,1322,3569
240980,202109,3410,9891,3008,9186,102,445,2447,7321,2549,7766
240990,202109,2731,7373,2409,6783,237,735,1718,4656,1955,5391
241000,202109,973,2485,767,2118,28,68,575,1555,603,1623
241010,202109,2920,8987,2648,8422,175,603,1946,6136,2121,6739
241020,202109,2240,5769,1696,4714,92,257,1158,3102,1250,3359
241025,202109,1843,5129,1475,4471,37,151,1080,3203,1117,3354
241030,202109,2518,7781,2024,6735,239,779,1273,4276,1512,5055
241040,202109,2322,7133,2024,6613,78,364,1588,5144,1666,5508
241050,202109,1441,3923,1167,3432,32,112,850,2429,882,2541
241060,202109,806,2187,701,1974,37,100,488,1338,525,1438
241070,202109,706,1842,601,1671,15,39,464,1250,479,1289
241080,202109,1142,3195,875,2653,32,103,621,1858,653,1961
241090,202109,2034,5827,1663,5196,53,233,1298,4002,1351,4235
241100,202109,1249,3352,949,2752,67,179,606,1717,673,1896
241105,202109,973,2880,793,2550,243,774,262,865,505,1639
241110,202109,1028,2791,772,2264,38,105,507,1436,545,1541
241120,202109,7835,21789,6602,19650,878,2513,3952,12155,4830,14668
241140,202109,3492,9012,2683,7421,143,394,1935,5235,2078,5629
241142,202109,814,2145,601,1750,29,89,357,993,386,1082
241150,202109,6210,15529,5489,14395,182,431,4416,11490,4598,11921
241160,202109,1256,3336,991,2853,153,461,569,1572,722,2033
241170,202109,1431,3527,1207,3142,37,114,988,2475,1025,2589
241180,202109,1097,2754,819,2226,98,266,392,1069,490,1335
241190,202109,1210,3085,1013,2698,14,61,746,1907,760,1968
241200,202109,20880,52642,18051,48066,2735,7209,10566,28031,13301,35240
241210,202109,1512,3902,1084,3074,108,329,622,1720,730,2049
241220,202109,9583,26773,8402,24828,1733,5081,4090,12503,5823,17584
241230,202109,2992,7771,2640,7226,117,322,2176,5913,2293,6235
241240,202109,1298,3540,828,2530,83,260,314,962,397,1222
241250,202109,5823,16169,4670,14058,168,654,3451,10027,3619,10681
241255,202109,2432,7248,2151,6696,133,444,1610,4933,1743,5377
241260,202109,5164,13041,4117,11339,104,348,3280,8852,3384,9200
241270,202109,1703,4864,1416,4323,110,332,999,3064,1109,3396
241280,202109,2280,5548,1956,4972,73,166,1655,4151,1728,4317
241290,202109,3423,8240,2520,6799,75,219,1962,5174,2037,5393
241300,202109,1578,4107,1276,3588,29,85,867,2380,896,2465
241310,202109,2254,5404,1942,4968,26,64,1685,4358,1711,4422
241320,202109,974,3087,835,2826,83,332,533,1795,616,2127
241330,202109,1824,4561,1435,4043,15,82,1263,3534,1278,3616
241335,202109,3552,9563,3102,8758,120,362,2531,7048,2651,7410
241340,202109,1619,4433,1269,3733,232,741,561,1573,793,2314
241350,202109,2242,6004,1955,5491,121,311,1503,4211,1624,4522
241355,202109,1382,3653,1122,3155,12,30,850,2356,862,2386
241360,202109,2122,5365,1592,4317,43,107,1179,3123,1222,3230
241370,202109,1439,3798,1116,3143,59,164,792,2163,851,2327
241380,202109,724,1902,560,1597,88,233,270,783,358,1016
241390,202109,2811,8001,2494,7532,203,516,1879,5823,2082,6339
241400,202109,3725,10098,3298,9459,162,514,2622,7477,2784,7991
241410,202109,2545,7349,2063,6369,314,994,1117,3469,1431,4463
241415,202109,1762,4957,1468,4396,49,163,1093,3217,1142,3380
241420,202109,2541,7555,2200,6983,447,1520,1208,3836,1655,5356
241430,202109,639,1673,447,1270,17,45,289,787,306,832
241440,202109,8120,24009,7256,22502,335,1105,5764,17874,6099,18979
241445,202109,1277,3060,1103,2830,40,75,941,2516,981,2591
241450,202109,2942,6898,2462,6150,368,770,1650,4268,2018,5038
241460,202109,4068,10675,3274,9067,218,536,2212,6020,2430,6556
241470,202109,1442,3757,1183,3370,25,82,975,2773,1000,2855
241475,202109,1304,3509,1032,2999,20,88,777,2148,797,2236
241480,202109,3138,9462,2574,8245,782,2502,804,2883,1586,5385
241490,202109,696,1597,540,1380,18,40,415,1044,433,1084
241500,202109,813,2227,733,2126,3,10,693,2025,696,2035
250010,202109,2719,7879,2278,6978,54,197,1678,5028,1732,5225
250020,202109,1723,4434,1257,3558,58,98,883,2519,941,2617
250030,202109,7132,19107,6284,17795,576,1581,4621,13028,5197,14609
250040,202109,4318,12494,3745,11465,355,1034,2649,8018,3004,9052
250050,202109,3716,9695,3357,9235,89,311,2835,7780,2924,8091
250053,202109,1285,3459,1176,3292,89,218,868,2444,957,2662
250057,202109,710,2352,654,2269,9,37,599,2104,608,2141
250060,202109,5811,14605,5234,13888,298,735,4339,11611,4637,12346
250070,202109,4216,11366,3539,10216,22,84,2865,8084,2887,8168
250073,202109,799,2055,648,1819,12,24,518,1436,530,1460
250077,202109,2422,6108,1839,5183,55,174,1434,3992,1489,4166
250080,202109,5362,12688,4512,11630,58,197,4001,10173,4059,10370
250090,202109,3550,8270,3091,7669,59,147,2669,6518,2728,6665
250100,202109,3721,10958,3338,10274,158,496,2612,7907,2770,8403
250110,202109,4971,13648,4481,12957,271,903,3463,9888,3734,10791
250115,202109,758,1848,560,1547,12,49,426,1148,438,1197
250120,202109,1918,5428,1605,4915,24,117,1281,3886,1305,4003
250130,202109,5763,15259,4857,13979,61,311,4156,11802,4217,12113
250135,202109,1253,3372,1089,3097,16,57,957,2718,973,2775
250140,202109,2370,6677,2199,6466,105,370,1903,5600,2008,5970
250150,202109,4836,14682,4328,13822,132,511,3473,10928,3605,11439
250153,202109,1405,3650,1159,3288,39,94,910,2576,949,2670
250157,202109,1930,5387,1736,5045,58,190,1397,3999,1455,4189
250160,202109,4043,9730,3220,8625,42,120,2798,7505,2840,7625
250170,202109,1922,4891,1728,4620,24,86,1499,3950,1523,4036
250180,202109,21656,50247,18502,46248,706,1995,14783,36071,15489,38066
250190,202109,4245,10996,3570,10014,312,897,2537,6995,2849,7892
250200,202109,2114,5329,1800,4916,74,175,1490,4108,1564,4283
250205,202109,892,2690,771,2506,10,45,627,2024,637,2069
250210,202109,1586,4666,1430,4428,43,169,1143,3484,1186,3653
250215,202109,1675,4401,1404,4023,79,232,812,2376,891,2608
250220,202109,680,1851,539,1634,23,81,362,1081,385,1162
250230,202109,1751,3855,1233,3094,22,60,988,2431,1010,2491
250240,202109,2518,7255,2213,6724,32,136,1899,5693,1931,5829
250250,202109,4731,12810,4136,11960,95,276,3520,10253,3615,10529
250260,202109,1718,4702,1453,4244,54,124,1141,3335,1195,3459
250270,202109,1228,3657,1118,3519,56,193,846,2745,902,2938
250280,202109,3640,9467,3241,8900,158,349,2540,7051,2698,7400
250290,202109,1567,4088,1341,3755,17,51,1074,2984,1091,3035
250300,202109,5627,14608,5049,13926,152,646,4286,11451,4438,12097
250310,202109,1223,3334,1019,2991,37,118,769,2244,806,2362
250320,202109,12873,27981,11110,25983,253,655,10024,23156,10277,23811
250330,202109,2481,6623,2075,6063,203,455,1586,4759,1789,5214
250340,202109,1195,2937,1057,2761,13,34,966,2513,979,2547
250350,202109,4300,11774,3775,10872,221,463,2957,8817,3178,9280
250355,202109,2109,6117,1890,5826,25,130,1708,5253,1733,5383
250360,202109,1847,4918,1654,4661,38,130,1406,3916,1444,4046
250370,202109,14353,35435,11926,31812,229,752,10121,26564,10350,27316
250375,202109,1235,3106,994,2819,4,17,936,2671,940,2688
250380,202109,1683,4197,1545,4025,34,119,1367,3466,1401,3585
250390,202109,1917,4783,1613,4314,73,191,1300,3451,1373,3642
250400,202109,71707,173015,53056,144527,14519,43023,13869,40327,28388,83350
250403,202109,1862,5022,1665,4797,59,297,1317,3616,1376,3913
250407,202109,1395,3262,1081,2811,106,216,672,1913,778,2129
250410,202109,690,1792,591,1631,7,15,481,1291,488,1306
250415,202109,1943,5271,1697,4892,29,120,1457,4179,1486,4299
250420,202109,1237,3325,1107,3148,24,81,1003,2836,1027,2917
250430,202109,6412,15532,5437,14257,153,417,4448,11455,4601,11872
250435,202109,1608,4447,1288,3908,11,43,980,2926,991,2969
250440,202109,4773,12357,4137,11556,83,176,3649,10201,3732,10377
250450,202109,1856,4833,1527,4384,34,112,1250,3614,1284,3726
250460,202109,7562,19968,6724,18757,434,1209,5315,14826,5749,16035
250470,202109,1587,4048,1300,3599,52,162,1023,2778,1075,2940
250480,202109,4066,10871,3441,10113,37,121,3043,9027,3080,9148
250485,202109,759,1658,566,1390,49,80,394,954,443,1034
250490,202109,5314,12323,4727,11650,152,408,4207,10208,4359,10616
250500,202109,2072,5604,1848,5223,59,146,1498,4235,1557,4381
250510,202109,5605,13747,4824,12705,79,157,4208,11194,4287,11351
250520,202109,1959,5078,1668,4683,114,323,1223,3414,1337,3737
250523,202109,2229,5449,1955,5090,72,278,1637,4114,1709,4392
250527,202109,1700,4264,1531,4077,24,63,1356,3632,1380,3695
250530,202109,665,1673,571,1530,15,39,501,1345,516,1384
250535,202109,1438,4046,1291,3781,20,77,1037,2950,1057,3027
250540,202109,3167,6979,2640,6394,79,142,2322,5743,2401,5885
250550,202109,802,2519,706,2332,20,66,518,1700,538,1766
250560,202109,1809,4889,1583,4571,41,132,1336,3782,1377,3914
250570,202109,2828,8103,2427,7388,81,254,1898,5712,1979,5966
250580,202109,1087,2795,956,2613,46,160,806,2151,852,2311
250590,202109,902,2350,799,2204,19,55,672,1836,691,1891
250600,202109,8294,21251,6895,19400,249,740,5507,15405,5756,16145
250610,202109,3012,8395,2690,7929,100,357,2234,6526,2334,6883
250620,202109,872,2207,748,2001,17,44,533,1414,550,1458
250625,202109,2474,7028,2209,6594,40,190,1890,5511,1930,5701
250630,202109,10878,28898,8919,25579,938,2689,5762,16182,6700,18871
250640,202109,3685,9672,3299,9167,81,309,2885,7911,2966,8220
250650,202109,1032,2409,863,2182,15,41,753,1871,768,1912
250660,202109,1694,4117,1354,3652,48,110,1100,2896,1148,3006
250670,202109,2426,7362,2206,6983,38,155,1923,5979,1961,6134
250680,202109,6059,13768,5421,13053,49,187,5065,12020,5114,12207
250690,202109,6924,15389,5812,14021,108,229,5115,12294,5223,12523
250700,202109,4505,12409,3913,11516,602,1712,2450,7323,3052,9035
250710,202109,4478,12674,3903,11855,272,810,2845,8695,3117,9505
250720,202109,2901,7588,2596,7159,28,140,2331,6362,2359,6502
250730,202109,4323,11221,3784,10502,119,434,3157,8532,3276,8966
250740,202109,2037,4917,1682,4452,100,222,1309,3499,1409,3721
250750,202109,112744,269167,95867,245596,7735,20460,69781,175881,77516,196341
250760,202109,2451,6073,2142,5573,68,178,1759,4467,1827,4645
250770,202109,4200,12253,3760,11665,483,1339,2593,8335,3076,9674
250780,202109,1827,4784,1538,4276,66,197,1196,3259,1262,3456
250790,202109,2611,7457,2263,6941,85,340,1671,5006,1756,5346
250800,202109,2514,6507,2208,6022,105,203,1776,4927,1881,5130
250810,202109,1337,3411,1120,3108,42,76,928,2634,970,2710
250820,202109,2017,5515,1852,5333,28,114,1679,4804,1707,4918
250830,202109,6162,18024,5040,15755,261,920,3360,10189,3621,11109
250840,202109,780,2440,675,2236,18,63,508,1699,526,1762
250850,202109,1846,5308,1649,4964,31,118,1370,4032,1401,4150
250855,202109,1069,2945,923,2715,55,174,716,2098,771,2272
250860,202109,3445,9832,2841,8822,492,1463,1536,4905,2028,6368
250870,202109,1072,2863,910,2603,44,132,725,2059,769,2191
250880,202109,1670,4215,1388,3793,89,255,1054,2875,1143,3130
250890,202109,10766,26590,9488,24914,414,1351,7664,19335,8078,20686
250900,202109,3106,8080,2687,7354,101,221,2255,6137,2356,6358
250905,202109,2624,7027,2422,6751,42,129,2224,6200,2266,6329
250910,202109,6391,15268,5292,14034,62,174,4648,12390,4710,12564
250915,202109,2212,5025,1551,4313,28,56,1357,3868,1385,3924
250920,202109,3668,9097,3230,8435,272,606,2488,6502,2760,7108
250930,202109,2381,6279,2146,5976,46,198,1859,5049,1905,5247
250933,202109,1242,3580,1103,3331,25,103,876,2594,901,2697
250937,202109,748,1992,627,1797,22,74,491,1428,513,1502
250939,202109,1927,4880,1687,4578,58,133,1326,3609,1384,3742
250940,202109,4119,10735,3612,10073,23,74,3240,9042,3263,9116
250950,202109,1800,4540,1451,4083,30,113,1180,3268,1210,3381
250960,202109,1144,3311,1006,3092,26,119,818,2443,844,2562
250970,202109,8459,21345,7411,19652,207,611,6092,15841,6299,16452
250980,202109,2443,6380,2208,6044,24,109,1936,5170,1960,5279
250990,202109,2122,6255,1775,5663,57,219,1330,4198,1387,4417
251000,202109,2097,5817,1696,5132,34,134,1380,4157,1414,4291
251010,202109,2767,7509,2508,7109,24,87,2248,6382,2272,6469
251020,202109,1677,4505,1500,4226,30,126,1301,3599,1331,3725
251030,202109,1073,2785,878,2449,49,121,586,1636,635,1757
251040,202109,1915,5176,1617,4680,27,121,1347,3868,1374,3989
251050,202109,1074,2902,904,2580,44,141,647,1775,691,1916
251060,202109,1110,2322,842,1986,13,36,639,1495,652,1531
251065,202109,502,1335,382,1113,8,23,265,741,273,764
251070,202109,772,1934,642,1748,8,31,554,1466,562,1497
251080,202109,19597,48381,15857,42776,2314,6360,9371,25733,11685,32093
251090,202109,2918,8203,2463,7408,58,174,1941,5815,1999,5989
251100,202109,837,2610,738,2416,22,76,581,1835,603,1911
251110,202109,1817,4688,1538,4204,74,157,1162,3194,1236,3351
251120,202109,8023,21353,6751,19805,340,1062,5213,15450,5553,16512
251130,202109,4028,8730,3539,8180,50,129,3232,7428,3282,7557
251140,202109,4475,12173,3983,11484,66,250,3303,9429,3369,9679
251150,202109,2709,7666,2471,7280,67,291,2116,6085,2183,6376
251160,202109,2282,6476,1974,6022,31,143,1699,5083,1730,5226
251170,202109,1674,4381,1467,4117,19,61,1320,3677,1339,3738
251180,202109,2710,7076,2221,6390,152,421,1560,4509,1712,4930
251190,202109,4559,11670,4113,11165,35,179,3742,9973,3777,10152
251200,202109,4521,12867,3983,12187,66,253,3503,10751,3569,11004
251203,202109,1023,3198,933,2988,24,89,700,2178,724,2267
251207,202109,1155,3055,873,2600,16,69,604,1757,620,1826
251210,202109,8119,19802,6633,17793,348,708,4939,13614,5287,14322
251220,202109,1311,3026,979,2592,73,143,719,1982,792,2125
251230,202109,4883,13269,4209,12066,113,343,3322,9308,3435,9651
251240,202109,3748,10205,3143,9176,183,458,2314,6743,2497,7201
251250,202109,11137,29014,9752,26665,678,1858,7289,19402,7967,21260
251260,202109,521,1410,471,1328,13,53,377,1029,390,1082
251270,202109,4386,13398,3929,12774,111,423,3200,10615,3311,11038
251272,202109,1343,3632,1227,3479,66,206,1014,2834,1080,3040
251274,202109,933,2534,744,2189,59,183,488,1379,547,1562
251275,202109,1267,3502,1072,3183,28,108,839,2425,867,2533
251276,202109,1351,3635,1171,3391,22,113,958,2688,980,2801
251278,202109,626,1666,564,1574,40,106,436,1227,476,1333
251280,202109,2316,6129,2110,5827,57,148,1770,4864,1827,5012
251290,202109,6497,14429,5914,13729,184,497,5233,11847,5417,12344
251300,202109,905,2602,816,2465,9,46,694,2083,703,2129
251310,202109,2918,7945,2542,7379,36,173,2111,5995,2147,6168
251315,202109,1825,5520,1651,5180,123,330,1235,3875,1358,4205
251320,202109,1668,4358,1223,3586,29,96,918,2647,947,2743
251330,202109,2167,4981,1784,4528,25,73,1588,4064,1613,4137
251335,202109,1139,3143,1019,2963,22,95,899,2563,921,2658
251340,202109,3849,8990,3069,7966,129,328,2346,6113,2475,6441
251350,202109,1094,3040,998,2882,30,91,818,2340,848,2431
251360,202109,1916,5218,1542,4685,11,63,1268,3851,1279,3914
251365,202109,781,2039,613,1718,6,20,492,1358,498,1378
251370,202109,25815,66218,22057,60907,3441,9243,12374,35563,15815,44806
251380,202109,1319,3552,1120,3220,14,83,962,2700,976,2783
251385,202109,792,1986,612,1664,22,58,454,1195,476,1253
251390,202109,6666,18833,5876,17615,555,1613,3877,11782,4432,13395
251392,202109,1024,2735,865,2493,27,106,679,1927,706,2033
251394,202109,653,1827,525,1607,37,106,369,1127,406,1233
251396,202109,681,1819,578,1639,18,46,396,1107,414,1153
251398,202109,1057,2612,748,2074,17,51,556,1505,573,1556
251400,202109,1351,3103,1061,2713,22,79,864,2139,886,2218
251410,202109,1605,3688,1291,3246,21,79,1093,2644,1114,2723
251420,202109,2056,5218,1684,4775,34,110,1345,3772,1379,3882
251430,202109,1598,4730,1436,4449,31,140,1236,3809,1267,3949
251440,202109,1124,3078,908,2680,46,103,698,2114,744,2217
251445,202109,1598,4374,1471,4194,28,81,1265,3568,1293,3649
251450,202109,4457,12992,3984,12266,77,285,3329,10178,3406,10463
251455,202109,897,2649,821,2510,17,64,662,1980,679,2044
251460,202109,996,2744,839,2503,14,42,694,2081,708,2123
251465,202109,482,1363,411,1224,6,26,310,894,316,920
251470,202109,1224,3297,921,2690,76,227,529,1489,605,1716
251480,202109,1059,2699,864,2363,13,47,667,1749,680,1796
251490,202109,2000,5133,1600,4576,76,203,1184,3423,1260,3626
251500,202109,2042,5582,1873,5370,40,139,1686,4827,1726,4966
251510,202109,2767,8045,2307,7139,120,382,1574,4752,1694,5134
251520,202109,1082,2702,837,2270,71,170,541,1442,612,1612
251530,202109,15155,35513,12223,31882,89,464,10860,27857,10949,28321
251540,202109,3161,8722,2840,8156,70,247,2410,6824,2480,7071
251550,202109,4020,9092,3215,8125,139,217,2644,6799,2783,7016
251560,202109,570,1716,508,1621,53,182,354,1092,407,1274
251570,202109,973,2693,797,2345,21,93,638,1830,659,1923
251580,202109,2030,4784,1828,4498,32,112,1577,3747,1609,3859
251590,202109,1661,3972,1402,3665,70,160,1163,3013,1233,3173
251593,202109,963,2761,867,2597,89,259,560,1674,649,1933
251597,202109,2154,5954,1931,5659,17,84,1734,5025,1751,5109
251600,202109,6531,17240,5685,15944,209,567,4642,12904,4851,13471
251610,202109,3207,9022,2773,8225,262,688,1873,5688,2135,6376
251615,202109,1363,3280,1093,2874,22,63,887,2261,909,2324
251620,202109,19882,44232,15236,38559,78,261,13188,33662,13266,33923
251630,202109,5092,11535,4058,10103,220,513,3011,7467,3231,7980
251640,202109,2317,6058,2069,5683,20,93,1855,4992,1875,5085
251650,202109,4086,10734,3545,10033,130,370,2985,8464,3115,8834
251660,202109,3685,10701,3256,9967,56,228,2714,8199,2770,8427
251670,202109,4245,11606,3749,10909,38,180,3369,9736,3407,9916
251675,202109,726,1910,655,1825,97,238,446,1275,543,1513
251680,202109,2695,6825,2254,6257,44,134,1863,5202,1907,5336
251690,202109,3226,8871,2749,8059,76,213,2092,6113,2168,6326
251700,202109,2293,6209,1909,5730,38,145,1614,4755,1652,4900
251710,202109,811,2043,573,1568,37,115,334,853,371,968
251720,202109,1364,3782,1100,3331,15,62,854,2505,869,2567
251740,202109,616,1699,489,1462,41,147,326,937,367,1084
260005,202109,30783,64012,25363,57072,1941,4175,19198,42469,21139,46644
260010,202109,10727,27351,8856,24363,485,1335,5241,14543,5726,15878
260020,202109,7117,16197,5938,14526,68,286,5078,12173,5146,12459
260030,202109,7151,17741,5997,16080,126,373,4912,13069,5038,13442
260040,202109,7982,19580,6731,17823,444,1132,4898,13193,5342,14325
260050,202109,14410,36597,11984,33916,243,669,10987,31322,11230,31991
260060,202109,4350,10312,3733,9342,302,597,2796,7196,3098,7793
260070,202109,11135,27103,9555,24853,340,1079,7739,19649,8079,20728
260080,202109,6667,15004,5792,13849,110,314,4862,11452,4972,11766
260090,202109,4840,12127,4315,11413,383,995,3247,8636,3630,9631
260100,202109,3071,8136,2579,7404,30,158,2176,6156,2206,6314
260105,202109,5118,13784,4590,13075,131,408,3890,10953,4021,11361
260110,202109,22812,62237,20299,58606,850,2764,16835,47987,17685,50751
260120,202109,15019,38535,12668,35123,1479,3899,8163,23009,9642,26908
260130,202109,3288,8055,2910,7515,221,509,2185,5590,2406,6099
260140,202109,13359,29318,11505,27137,512,1284,9758,22710,10270,23994
260150,202109,3638,8314,3148,7713,94,217,2768,6761,2862,6978
260160,202109,6721,17084,5695,15840,95,304,5173,14498,5268,14802
260170,202109,21503,49112,18269,44742,951,2238,14586,35393,15537,37631
260180,202109,3661,9411,3163,8740,72,239,2733,7448,2805,7687
260190,202109,18873,37116,15941,33690,202,460,14175,29445,14377,29905
260200,202109,11520,26883,9923,24856,524,1026,8309,21216,8833,22242
260210,202109,11838,32758,10065,29898,280,947,8029,23756,8309,24703
260220,202109,11157,25491,10288,24401,179,450,9169,21475,9348,21925
260230,202109,11148,26486,9664,24530,207,515,8165,20489,8372,21004
260240,202109,2873,8381,2506,7678,90,307,1937,5855,2027,6162
260250,202109,2345,5823,2039,5354,115,210,1608,4256,1723,4466
260260,202109,13211,33231,11746,31044,383,1133,9432,24534,9815,25667
260270,202109,4498,10541,3940,9892,101,356,3352,8288,3453,8644
260280,202109,13030,38301,11745,36472,407,1632,10044,30748,10451,32380
260290,202109,42918,105356,36878,96742,3907,10356,25144,65722,29051,76078
260300,202109,9906,26147,8609,24385,193,682,7304,20659,7497,21341
260310,202109,5680,13847,4999,13004,375,789,3829,10220,4204,11009
260320,202109,8056,22639,6836,20585,218,615,5586,16869,5804,17484
260330,202109,2665,7989,2325,7292,58,187,1861,5702,1919,5889
260340,202109,2129,5554,1846,5145,21,84,1624,4432,1645,4516
260345,202109,26993,67182,22554,60829,3385,9594,12003,31675,15388,41269
260350,202109,5857,13219,5055,12308,46,126,4556,11028,4602,11154
260360,202109,2668,6679,2400,6209,41,126,1749,4437,1790,4563
260370,202109,5737,15938,4939,14626,199,572,3837,11306,4036,11878
260380,202109,5202,14837,4452,13614,163,467,3395,10300,3558,10767
260390,202109,4885,14166,4021,12414,222,613,2701,8240,2923,8853
260392,202109,3601,11012,3250,10566,87,510,2711,8794,2798,9304
260400,202109,19712,43892,16999,40377,469,1162,13605,31169,14074,32331
260410,202109,77899,183007,60935,159616,10941,29693,26831,72765,37772,102458
260415,202109,4575,11790,3942,10789,41,160,3311,8898,3352,9058
260420,202109,12817,26391,10891,24267,85,244,10154,22439,10239,22683
260430,202109,2893,8678,2460,7836,141,454,1680,5309,1821,5763
260440,202109,3877,9637,3448,9024,66,206,2960,7630,3026,7836
260450,202109,5912,14499,5273,13667,285,536,4393,11605,4678,12141
260460,202109,5495,15650,4681,14244,475,1568,2857,8569,3332,10137
260470,202109,5000,12917,4214,12016,81,170,3859,11160,3940,11330
260480,202109,4252,10699,3588,9775,312,831,2435,6777,2747,7608
260490,202109,5478,12424,4844,11523,27,120,4435,10380,4462,10500
260500,202109,6288,15180,5370,13905,403,876,3809,10021,4212,10897
260510,202109,10301,24653,8634,22326,88,315,7620,19506,7708,19821
260515,202109,4632,11925,3641,10121,149,348,2526,6824,2675,7172
260520,202109,17234,38935,15017,36147,717,1646,12378,29467,13095,31113
260530,202109,10125,28442,8603,26115,109,497,7458,22374,7567,22871
260540,202109,7414,15935,6550,14852,129,277,5923,13355,6052,13632
260545,202109,73,222,49,164,3,12,21,67,24,79
260550,202109,3279,8674,2651,7656,140,429,1828,5172,1968,5601
260560,202109,6205,15512,5194,14044,110,380,4383,11664,4493,12044
260570,202109,8148,21121,7191,19841,340,961,5854,16184,6194,17145
260580,202109,4610,10752,4144,10141,24,72,3798,9245,3822,9317
260590,202109,7332,15799,6199,14557,217,443,5328,12614,5545,13057
260600,202109,32851,82143,26889,73228,1069,3028,20585,54940,21654,57968
260610,202109,7816,19547,6950,18409,437,1113,5196,13829,5633,14942
260620,202109,17764,43893,15578,40813,1277,3647,11503,29526,12780,33173
260630,202109,2471,6520,2018,5825,42,128,1637,4650,1679,4778
260640,202109,23161,50369,19540,46242,805,1869,16069,37770,16874,39639
260650,202109,6513,16299,5228,14739,517,871,4151,12260,4668,13131
260660,202109,7393,18541,6438,17302,246,746,5522,14630,5768,15376
260670,202109,2359,6026,1930,5342,82,216,1357,3659,1439,3875
260680,202109,30331,70506,25574,63855,1994,4990,17807,43814,19801,48804
260690,202109,3656,9286,3045,8343,69,245,2409,6556,2478,6801
260700,202109,6537,17622,6028,17047,20,69,5849,16612,5869,16681
260710,202109,1429,3614,1206,3285,34,121,951,2583,985,2704
260720,202109,27305,63050,23141,57850,2278,5355,16618,42287,18896,47642
260730,202109,8277,22814,7228,21364,234,720,6097,17835,6331,18555
260740,202109,1367,3834,1144,3470,14,67,904,2802,918,2869
260750,202109,7589,19989,6164,18243,249,496,5361,16413,5610,16909
260760,202109,6181,13798,5318,12798,157,359,4523,10900,4680,11259
260765,202109,8632,23768,7525,22247,371,1326,5407,15652,5778,16978
260770,202109,4070,10041,3364,8883,115,339,2664,6931,2779,7270
260775,202109,5520,14183,4830,13163,175,576,3836,10124,4011,10700
260780,202109,3854,11055,3442,10399,417,1282,2114,6292,2531,7574
260790,202109,127362,277876,105468,249883,15993,36408,65177,155111,81170,191519
260795,202109,3115,7663,2665,7092,91,262,2131,5731,2222,5993
260800,202109,5644,12613,5091,11870,188,479,4440,10050,4628,10529
260805,202109,3797,10356,3222,9377,204,618,2336,6741,2540,7359
260810,202109,6830,17780,6015,16264,444,1062,4480,11952,4924,13014
260820,202109,4702,10551,4177,9951,91,250,3495,8230,3586,8480
260825,202109,3094,8867,2722,8227,112,343,2052,6159,2164,6502
260830,202109,4353,12317,3603,11000,493,1277,2237,7129,2730,8406
260840,202109,4372,10978,3911,10358,235,523,3274,8733,3509,9256
260845,202109,4728,11971,4172,11045,259,710,3129,8101,3388,8811
260850,202109,5388,14141,4497,12504,346,1006,2903,7804,3249,8810
260860,202109,3508,9746,3006,8889,97,298,2426,7016,2523,7314
260870,202109,4614,10814,3960,10017,60,215,3548,8862,3608,9077
260875,202109,7781,18134,6321,16035,541,1264,4392,11309,4933,12573
260880,202109,9931,27311,8645,25162,422,1217,6818,19822,7240,21039
260890,202109,13519,33478,11695,30753,710,1864,8425,21684,9135,23548
260900,202109,5744,15321,4743,13928,288,850,3244,9497,3532,10347
260910,202109,3378,8926,2939,8270,103,279,2314,6481,2417,6760
260915,202109,5167,14915,4510,14145,46,202,4146,13024,4192,13226
260920,202109,3626,8309,3084,7723,123,224,2624,6683,2747,6907
260930,202109,4197,12204,3613,11181,165,555,2792,8424,2957,8979
260940,202109,15558,35927,13521,33114,1187,2850,10013,24214,11200,27064
260950,202109,7565,19428,6106,16977,358,1161,4040,10646,4398,11807
260960,202109,75561,162571,61134,144387,6269,14844,39980,93323,46249,108167
260970,202109,6048,15081,5371,14180,293,578,3973,10810,4266,11388
260980,202109,4751,13424,4167,12703,48,148,3812,11736,3860,11884
260990,202109,19062,49773,16131,45768,841,2275,12643,35612,13484,37887
261000,202109,17330,39024,14631,35661,417,1138,11890,28364,12307,29502
261010,202109,2425,6184,2127,5793,102,226,1819,4997,1921,5223
261020,202109,6834,17157,5948,15744,320,775,4859,12627,5179,13402
261030,202109,4199,11900,3693,11015,120,446,2931,8507,3051,8953
261040,202109,5652,15687,4615,13775,148,491,3554,10329,3702,10820
261050,202109,8437,20646,7650,19506,382,652,6091,15630,6473,16282
261060,202109,14887,36162,12972,33869,259,769,10925,28214,11184,28983
261070,202109,69461,147250,57639,131856,3447,7379,43686,98072,47133,105451
261080,202109,7063,16330,6411,15540,153,313,5925,14374,6078,14687
261090,202109,20404,46569,18127,43618,359,1006,15915,37696,16274,38702
261100,202109,9029,23519,7873,21828,527,1430,5894,16344,6421,17774
261110,202109,71711,193415,60204,172796,8006,23932,35898,101651,43904,125583
261120,202109,3776,9238,3271,8535,70,151,2835,7386,2905,7537
261130,202109,7617,18039,6678,16796,123,349,5901,14702,6024,15051
261140,202109,3877,8707,3459,8160,202,480,2719,6340,2921,6820
261150,202109,5421,13862,4779,12909,86,285,4133,11056,4219,11341
261153,202109,1996,5854,1671,5219,57,175,1125,3540,1182,3715
261160,202109,228052,511150,185895,454147,44313,111098,78075,194801,122388,305899
261170,202109,6787,15716,5974,14613,247,508,4993,12127,5240,12635
261180,202109,9808,23800,8553,22184,506,1160,6223,16385,6729,17545
261190,202109,4793,13478,4307,12703,136,595,3484,9971,3620,10566
261200,202109,3545,7866,3137,7329,198,464,2580,5947,2778,6411
261210,202109,1993,4731,1712,4335,78,189,1413,3529,1491,3718
261220,202109,14684,39450,12359,35346,1423,4232,7408,20788,8831,25020
261230,202109,4208,11646,3519,10730,37,126,2963,9139,3000,9265
261240,202109,5808,13778,5093,12678,341,700,4083,10174,4424,10874
261245,202109,3933,10595,3281,9462,68,294,2640,7337,2708,7631
261247,202109,3143,8984,2613,8047,146,440,1847,5639,1993,6079
261250,202109,24261,53293,21077,49617,2891,6110,14507,35633,17398,41743
261255,202109,4319,12215,3536,10710,132,491,2729,8074,2861,8565
261260,202109,13330,34653,11616,32447,301,1042,10160,28108,10461,29150
261270,202109,4727,11074,4125,10334,198,439,3405,8533,3603,8972
261280,202109,2610,7107,2290,6573,66,219,1820,5078,1886,5297
261290,202109,3025,7619,2519,7049,62,208,2052,5806,2114,6014
261300,202109,13291,35458,11384,32319,457,1568,8657,23925,9114,25493
261310,202109,9565,23191,8217,21380,607,1638,6129,15624,6736,17262
261320,202109,6309,17102,5467,15750,70,273,4683,13332,4753,13605
261330,202109,5888,14141,5310,13396,118,402,4630,11441,4748,11843
261340,202109,4445,11944,3870,11216,123,431,3257,9328,3380,9759
261350,202109,8988,25953,7929,24147,115,452,6455,19465,6570,19917
261360,202109,8514,19768,7174,17876,261,658,5756,13988,6017,14646
261370,202109,25245,61036,21166,55518,2451,5927,13571,36205,16022,42132
261380,202109,4321,12433,3818,11584,423,1354,2569,7717,2992,9071
261390,202109,17562,48305,14813,43947,1167,3683,9925,29152,11092,32835
261400,202109,4828,14709,4224,13431,224,774,3129,9764,3353,10538
261410,202109,10087,24333,8290,21622,350,996,6706,17046,7056,18042
261420,202109,7728,22163,6976,21250,651,2206,5123,15573,5774,17779
261430,202109,3686,9910,3138,9062,49,197,2650,7502,2699,7699
261440,202109,1517,4398,1267,3937,48,197,909,2718,957,2915
261450,202109,15130,39985,13346,37309,167,566,11017,30944,11184,31510
261460,202109,8026,21142,7025,19604,290,818,5633,15709,5923,16527
261470,202109,4281,10383,3695,9580,34,126,3184,8214,3218,8340
261480,202109,5443,15986,4675,14701,215,740,3637,11279,3852,12019
261485,202109,5260,14348,4575,13310,365,1120,3378,9726,3743,10846
261500,202109,6358,15629,5536,14523,418,905,3802,10451,4220,11356
261510,202109,1952,5656,1697,5243,58,206,1294,4023,1352,4229
261520,202109,2406,7197,2167,6720,61,192,1606,4960,1667,5152
261530,202109,12736,35608,10347,31410,825,2836,5570,16157,6395,18993
261540,202109,8900,24253,8056,23077,1294,3443,4460,13678,5754,17121
261550,202109,3848,9944,3334,9155,260,723,2387,6435,2647,7158
261560,202109,8365,23551,7274,21946,306,981,5716,17232,6022,18213
261570,202109,3612,9554,2870,8343,172,558,1983,5696,2155,6254
261580,202109,7063,18097,6100,16779,91,405,5512,14970,5603,15375
261590,202109,2833,6995,2306,6256,77,232,1746,4689,1823,4921
261600,202109,5596,13339,4759,12141,292,581,3423,8895,3715,9476
261610,202109,2201,6231,1768,5435,128,438,1150,3523,1278,3961
261618,202109,2640,6347,2309,5879,82,188,1865,4714,1947,4902
261620,202109,4317,11899,3925,11320,778,1978,2530,7642,3308,9620
261630,202109,6303,17439,5347,15652,377,1226,3530,9962,3907,11188
261640,202109,39217,85091,33448,78087,2018,3498,25244,61085,27262,64583
261650,202109,4390,10410,3731,9582,188,444,2827,7271,3015,7715
270010,202109,4561,14819,3946,13778,121,666,3196,10863,3317,11529
270020,202109,4079,9915,3582,9293,128,385,3076,7795,3204,8180
270030,202109,35573,94306,29725,84991,3267,9209,20510,58397,23777,67606
270040,202109,11339,28934,9763,27061,386,1132,8225,22702,8611,23834
270050,202109,5703,12929,4851,11966,397,722,4064,10321,4461,11043
270060,202109,2337,5798,1960,5354,174,407,1514,4218,1688,4625
270070,202109,4837,13264,4202,12390,104,367,3541,10255,3645,10622
270080,202109,1506,4015,1271,3622,49,137,984,2724,1033,2861
270090,202109,1838,5462,1652,5107,44,166,1390,4209,1434,4375
270100,202109,5910,14571,5115,13430,204,574,4297,11086,4501,11660
270110,202109,3415,7631,2777,6905,154,293,2202,5775,2356,6068
270120,202109,2711,7346,2353,6859,68,264,1976,5660,2044,5924
270130,202109,5291,13306,4589,12451,169,494,3904,10609,4073,11103
270135,202109,2080,4911,1760,4556,29,96,1625,4172,1654,4268
270140,202109,9942,22864,7998,20189,375,1045,6214,15016,6589,16061
270150,202109,2705,8096,2462,7749,3,15,2320,7290,2323,7305
270160,202109,6227,16586,5320,15549,118,409,4873,14286,4991,14695
270170,202109,3466,9905,2912,9141,166,705,2203,6651,2369,7356
270180,202109,2346,7105,2149,6862,38,183,1950,6160,1988,6343
270190,202109,1814,5083,1609,4835,23,102,1461,4364,1484,4466
270200,202109,2587,7613,2244,7127,104,314,1671,5326,1775,5640
270210,202109,5939,13628,5053,12621,59,201,4667,11510,4726,11711
270220,202109,1716,4303,1368,3803,181,502,866,2373,1047,2875
270230,202109,9930,26234,8297,23736,860,2426,5835,16772,6695,19198
270235,202109,6150,18354,5321,17035,146,464,4459,14192,4605,14656
270240,202109,11652,30529,9609,27741,945,2736,6865,20046,7810,22782
270250,202109,2983,7141,2633,6650,188,418,2128,5396,2316,5814
270255,202109,4660,12968,3694,11253,112,419,2853,8532,2965,8951
270260,202109,5650,16487,5111,15600,94,431,4476,13391,4570,13822
270270,202109,1111,2777,924,2546,107,271,682,1906,789,2177
270280,202109,3983,9404,3188,8422,529,771,2202,6354,2731,7125
270290,202109,7976,24451,7187,23184,115,553,6369,20321,6484,20874
270300,202109,4428,11205,3455,10146,202,458,2680,8130,2882,8588
270310,202109,7250,19709,6230,18158,75,377,5424,15472,5499,15849
270320,202109,5707,16469,4935,14988,308,939,3637,10746,3945,11685
270330,202109,4199,13129,3721,12405,234,916,2947,9782,3181,10698
270340,202109,1672,4302,1441,3992,42,102,1239,3402,1281,3504
270350,202109,1957,4461,1588,4035,129,345,1146,2944,1275,3289
270360,202109,2763,6706,2473,6383,89,178,2281,5937,2370,6115
270370,202109,1458,4367,1329,4135,31,138,1145,3512,1176,3650
270375,202109,3191,7335,2667,6761,22,58,2505,6364,2527,6422
270380,202109,5763,15518,4863,14378,542,1431,3421,10501,3963,11932
270390,202109,1278,3141,1032,2855,11,42,875,2432,886,2474
270400,202109,6830,17112,5753,15537,239,539,4661,12539,4900,13078
270410,202109,4872,13640,4230,12679,135,457,3570,10664,3705,11121
270420,202109,5939,16950,5339,16080,106,447,4672,13819,4778,14266
270430,202109,145066,333712,113888,293874,21181,56028,55084,144754,76265,200782
270440,202109,4903,12841,4262,12058,76,289,3785,10612,3861,10901
270450,202109,7448,19279,6528,18165,288,782,5429,15425,5717,16207
270460,202109,3842,8410,3281,7742,159,297,2952,7005,3111,7302
270470,202109,11529,31137,10053,29071,618,1881,7872,22809,8490,24690
270480,202109,3061,7880,2580,7198,90,297,2114,5795,2204,6092
270490,202109,973,2623,848,2470,51,146,684,1994,735,2140
270500,202109,5072,15024,4506,14077,243,791,3596,11125,3839,11916
270510,202109,5918,15076,4985,13898,383,1206,3719,10068,4102,11274
270520,202109,4320,11787,3440,10339,726,2191,1391,4421,2117,6612
270530,202109,1368,3820,1155,3487,59,157,809,2484,868,2641
270540,202109,2368,6421,2017,5975,59,187,1752,5154,1811,5341
270550,202109,7085,17725,5646,16134,745,1703,4000,12023,4745,13726
270560,202109,3135,7835,2660,7192,177,484,2110,5677,2287,6161
270570,202109,4404,11810,3752,10850,263,655,2964,8636,3227,9291
270580,202109,2355,6515,2127,6193,121,342,1810,5255,1931,5597
270590,202109,1617,4822,1488,4645,16,83,1407,4378,1423,4461
270600,202109,2842,8569,2571,8158,40,192,2295,7197,2335,7389
270610,202109,3729,9571,3230,8907,85,225,2871,7886,2956,8111
270620,202109,1305,3810,1202,3615,24,83,1046,3069,1070,3152
270630,202109,18204,43468,15702,40065,698,1928,13111,32864,13809,34792
270640,202109,5643,15651,4939,14538,166,597,4109,11910,4275,12507
270642,202109,2594,8211,2299,7758,155,618,1745,5800,1900,6418
270644,202109,3828,9320,3162,8461,413,944,2235,6233,2648,7177
270650,202109,3353,9467,2931,8896,310,977,2215,6730,2525,7707
270660,202109,2038,5110,1746,4703,79,248,1337,3545,1416,3793
270670,202109,17402,38705,14551,35231,389,1006,12550,29725,12939,30731
270680,202109,5780,13372,5175,12716,124,181,4846,12068,4970,12249
270690,202109,9751,23455,8178,21464,360,959,6635,17265,6995,18224
270700,202109,547,1598,479,1481,43,124,342,1051,385,1175
270710,202109,5815,16813,5148,15781,289,913,4094,12489,4383,13402
270720,202109,3744,10619,3338,9950,59,278,2966,8681,3025,8959
270730,202109,8484,18132,7419,17000,347,548,5779,14756,6126,15304
270740,202109,2432,6272,2141,5933,89,283,1787,4906,1876,5189
270750,202109,5882,15027,5144,14114,62,244,4588,12498,4650,12742
270760,202109,3490,9487,2953,8760,53,212,2466,7284,2519,7496
270770,202109,21802,52516,17510,47162,2997,7106,10421,29851,13418,36957
270780,202109,1911,4984,1766,4783,55,175,1578,4231,1633,4406
270790,202109,1750,4570,1469,4182,118,335,1100,3118,1218,3453
270800,202109,11411,30242,10299,28664,368,1177,8820,24298,9188,25475
270810,202109,3481,9572,2755,8393,177,590,1936,5814,2113,6404
270820,202109,1676,4861,1427,4466,44,188,1144,3518,1188,3706
270830,202109,5294,12424,4268,11158,159,500,3494,8971,3653,9471
270840,202109,8679,25229,7703,23825,146,686,6730,20405,6876,21091
270850,202109,9184,21295,8101,20026,759,1883,6599,16244,7358,18127
270860,202109,15076,32454,11986,28995,586,1206,9746,23601,10332,24807
270870,202109,2341,6358,1914,5664,277,721,1191,3729,1468,4450
270880,202109,8207,24156,7321,22819,186,739,6129,18812,6315,19551
270890,202109,3216,8473,2710,7758,223,634,1838,5256,2061,5890
270895,202109,3287,9730,2959,9308,63,342,2639,8150,2702,8492
270900,202109,1809,4554,1379,3878,25,59,1090,3047,1115,3106
270910,202109,4195,11719,3638,10858,95,269,3054,9002,3149,9271
270915,202109,10101,27750,8187,24682,652,2158,5634,16597,6286,18755
270920,202109,5894,16770,5348,15909,79,349,4646,13476,4725,13825
270930,202109,18040,40537,13985,35838,1756,3899,9393,25567,11149,29466
270940,202109,6760,17238,5705,15969,181,663,4558,12409,4739,13072
280010,202109,700,1915,564,1639,15,53,403,1077,418,1130
280020,202109,5126,12632,4313,11369,387,970,3021,7984,3408,8954
280030,202109,81101,184513,64803,161785,12673,31394,30967,79738,43640,111132
280040,202109,3043,8108,2654,7527,264,699,1840,5257,2104,5956
280050,202109,4183,11574,3567,10624,689,1996,1912,5748,2601,7744
280060,202109,6801,16719,5374,14581,947,2672,2599,7312,3546,9984
280067,202109,7305,17356,6197,15664,295,713,4586,11457,4881,12170
280070,202109,1909,5601,1772,5381,113,339,1460,4418,1573,4757
280100,202109,4181,10689,3510,9646,356,969,2353,6503,2709,7472
280110,202109,1534,3877,1340,3593,13,49,1210,3175,1223,3224
280120,202109,7783,21740,6906,20346,836,2221,4882,14797,5718,17018
280130,202109,9247,21259,8050,19611,423,1070,6489,15709,6912,16779
280140,202109,5714,13214,5026,12280,273,673,4143,10113,4416,10786
280150,202109,4350,10652,3783,9889,498,1119,2720,7303,3218,8422
280160,202109,1225,3448,1038,3140,92,325,718,2114,810,2439
280170,202109,5361,13672,4812,12983,269,634,3864,10498,4133,11132
280190,202109,1365,2903,1217,2708,50,115,1030,2247,1080,2362
280200,202109,1314,3332,1091,3020,61,195,834,2273,895,2468
280210,202109,17918,42441,15584,39180,1741,4179,10013,25335,11754,29514
280220,202109,1768,4656,1512,4321,45,178,1252,3552,1297,3730
280230,202109,4565,11071,3779,9903,335,663,2603,6980,2938,7643
280240,202109,3431,8930,3048,8358,33,167,2650,7078,2683,7245
280250,202109,963,2216,801,1975,82,203,561,1352,643,1555
280260,202109,2316,5422,2031,5061,40,93,1845,4640,1885,4733
280270,202109,2544,6681,2254,6252,169,413,1799,5024,1968,5437
280280,202109,4240,12245,3768,11545,562,1461,2540,8229,3102,9690
280290,202109,19266,48723,16542,44911,1381,3766,11091,30369,12472,34135
280300,202109,12804,29153,11217,27454,384,784,8142,22128,8526,22912
280310,202109,1434,3619,1199,3238,42,124,903,2389,945,2513
280320,202109,9060,23610,7850,21814,1005,2578,5196,14456,6201,17034
280330,202109,4869,11718,4132,10711,251,677,3035,7886,3286,8563
280340,202109,5701,11750,4726,10681,274,421,4029,9356,4303,9777
280350,202109,27207,61854,23901,57510,1111,2638,19025,45116,20136,47754
280360,202109,5826,15761,5105,14597,674,1922,3070,8969,3744,10891
280370,202109,2287,5374,1901,4746,61,123,1531,3755,1592,3878
280380,202109,1067,2710,898,2491,77,191,609,1729,686,1920
280390,202109,3844,9075,3253,8175,206,403,2537,6444,2743,6847
280400,202109,4037,9782,3511,9075,534,1192,2212,6018,2746,7210
280410,202109,2521,6614,2072,5918,164,461,1304,3657,1468,4118
280420,202109,4438,11497,4089,11055,69,251,3766,10125,3835,10376
280430,202109,2185,5152,1916,4791,68,194,1570,3821,1638,4015
280440,202109,4465,11362,3941,10586,135,434,3359,8798,3494,9232
280445,202109,2443,6074,2190,5652,50,126,1692,4220,1742,4346
280450,202109,10477,24134,9061,22231,1230,2604,5603,14539,6833,17143
280460,202109,7164,16361,6476,15431,440,912,5392,12827,5832,13739
280470,202109,1752,4795,1483,4298,102,302,1069,3047,1171,3349
280480,202109,46305,108532,39985,99667,3422,8689,28155,68816,31577,77505
280490,202109,3902,10863,3305,9831,107,393,2507,7202,2614,7595
280500,202109,1044,2412,899,2220,26,56,766,1872,792,1928
280510,202109,2752,6550,2384,6047,64,209,1897,4682,1961,4891
280520,202109,1800,4310,1580,4009,93,196,1244,3150,1337,3346
280530,202109,2501,6131,2179,5682,209,444,1616,4295,1825,4739
280540,202109,9005,23693,8177,22502,255,784,7157,19515,7412,20299
280550,202109,6744,15360,5585,13745,155,521,4652,11068,4807,11589
280560,202109,7621,20307,7145,19603,112,393,6368,17236,6480,17629
280570,202109,6703,15837,5413,14237,252,690,3947,10530,4199,11220
280580,202109,5955,15093,5191,13987,546,1245,3754,10293,4300,11538
280590,202109,2981,6664,2558,6159,127,426,2009,4618,2136,5044
280600,202109,3913,9780,3489,9194,293,674,2463,6562,2756,7236
280610,202109,2616,6197,2343,5813,136,324,1925,4724,2061,5048
280620,202109,5761,13543,4955,12493,431,902,3513,9223,3944,10125
280630,202109,4091,10829,3762,10392,205,569,3052,8461,3257,9030
280640,202109,2441,6359,2155,6039,52,134,1932,5452,1984,5586
280650,202109,1245,3217,1018,2879,86,278,728,1964,814,2242
280660,202109,3865,8189,3316,7556,299,466,2681,6329,2980,6795
280670,202109,20511,45826,17690,42204,1490,3428,13336,31805,14826,35233
280680,202109,2871,6702,2469,6134,237,432,1749,4464,1986,4896
280690,202109,1008,2371,856,2179,54,127,684,1711,738,1838
280700,202109,1221,2965,1055,2723,21,52,838,2130,859,2182
280710,202109,15868,34730,13458,31991,659,1078,11272,27616,11931,28694
280720,202109,2778,6209,2300,5636,40,132,1724,4379,1764,4511
280730,202109,1116,2806,983,2599,62,168,726,1848,788,2016
280740,202109,15008,35084,12888,31902,949,2301,9304,22604,10253,24905
280750,202109,3770,10188,3263,9316,197,561,2368,6670,2565,7231
280760,202109,6835,17337,5943,15995,666,1573,3817,10697,4483,12270
290010,202109,3254,6713,2121,4976,4,11,1760,3963,1764,3974
290020,202109,5513,14338,5014,13712,349,630,4212,11949,4561,12579
290030,202109,4822,10668,3888,9653,184,399,3260,8238,3444,8637
290035,202109,5402,11399,4462,10195,349,509,3554,8429,3903,8938
290040,202109,4514,10488,3826,9661,151,325,2910,7897,3061,8222
290050,202109,2124,6654,1785,5933,103,396,1250,4064,1353,4460
290060,202109,1426,3215,1048,2648,148,336,642,1643,790,1979
290070,202109,38708,82559,33298,75891,1877,4348,25978,58515,27855,62863
290080,202109,5438,15538,4715,14470,496,1530,3220,10071,3716,11601
290090,202109,2232,4213,1567,3503,18,47,1422,3169,1440,3216
290100,202109,10051,25646,8115,22819,1405,3638,4221,12556,5626,16194
290110,202109,5482,13929,4842,12941,508,1276,3239,8696,3747,9972
290115,202109,4188,11971,3549,10846,285,814,2677,8245,2962,9059
290120,202109,6773,16278,5675,14751,143,427,4848,12398,4991,12825
290130,202109,4938,11624,3844,10186,173,391,2944,7899,3117,8290
290135,202109,4473,10290,3664,8984,154,382,2914,6912,3068,7294
290140,202109,4612,11783,3567,10417,82,295,3044,8869,3126,9164
290150,202109,2665,6521,2273,6053,146,347,1732,4709,1878,5056
290160,202109,3668,7946,3264,7397,241,436,2658,6055,2899,6491
290170,202109,3469,8619,3058,8172,105,231,2722,7402,2827,7633
290180,202109,3102,8256,2566,7386,74,238,2114,6044,2188,6282
290190,202109,4453,11975,3929,11277,96,343,3300,9321,3396,9664
290195,202109,2443,5879,1957,5243,30,107,1676,4465,1706,4572
290200,202109,4334,11696,3489,10265,157,474,2621,7634,2778,8108
290205,202109,3653,9055,3247,8468,191,521,2540,6511,2731,7032
290210,202109,13435,35912,11877,33537,883,2190,9214,26407,10097,28597
290220,202109,3043,7204,2664,6720,113,274,2193,5523,2306,5797
290225,202109,3328,6918,2532,6082,126,213,2171,5296,2297,5509
290230,202109,2652,6719,2425,6444,42,105,2189,5839,2231,5944
290240,202109,3842,9406,3039,8422,67,217,2563,7093,2630,7310
290250,202109,4037,11541,3353,10524,99,289,2748,8815,2847,9104
290260,202109,5600,13379,4721,12118,193,575,3918,9867,4111,10442
290265,202109,3675,10372,2992,9101,229,644,2067,6313,2296,6957
290270,202109,10849,36810,10111,35563,508,2163,8158,28539,8666,30702
290280,202109,6345,18533,5462,16770,285,997,3947,11945,4232,12942
290290,202109,10346,29241,8450,25831,761,2432,5718,17269,6479,19701
290300,202109,4301,11560,3180,9445,169,505,2257,6716,2426,7221
290310,202109,1753,4018,1411,3611,31,131,1193,2979,1224,3110
290320,202109,25808,65421,20615,57664,4344,11730,10010,29692,14354,41422
290323,202109,3848,10368,3338,9578,116,326,2578,7494,2694,7820
290327,202109,4287,12023,3662,10837,288,796,2609,7697,2897,8493
290330,202109,2451,4856,1930,4301,56,71,1685,3869,1741,3940
290340,202109,6016,14446,4572,12706,436,1148,3308,9388,3744,10536
290350,202109,4939,13442,4115,12037,269,723,2902,8553,3171,9276
290360,202109,5126,13096,4484,12269,133,299,3857,10656,3990,10955
290370,202109,5413,12764,3969,10870,205,467,2786,7753,2991,8220
290380,202109,5873,15112,4859,13735,113,238,4149,11923,4262,12161
290390,202109,15101,42023,12520,37901,1405,4045,8015,24708,9420,28753
290395,202109,3088,8478,2478,7443,60,235,1892,5625,1952,5860
290400,202109,3902,10260,3176,9078,113,374,2453,6891,2566,7265
290405,202109,4826,13585,4100,12352,318,946,2770,8536,3088,9482
290410,202109,5875,15492,4506,13332,105,416,3422,9918,3527,10334
290420,202109,3250,8561,2704,7725,94,272,2150,6095,2244,6367
290430,202109,3436,8912,2819,7954,215,636,1986,5475,2201,6111
290440,202109,3013,7188,2189,5912,102,218,1529,4248,1631,4466
290450,202109,3727,8981,2955,7841,118,251,2260,6010,2378,6261
290460,202109,12678,34789,10632,31009,2286,6717,4315,12703,6601,19420
290470,202109,4850,11292,3566,9543,463,1235,1955,5373,2418,6608
290475,202109,6784,19248,5734,17439,65,345,4774,14250,4839,14595
290480,202109,1866,4578,1521,4088,68,218,1091,2793,1159,3011
290485,202109,4792,13480,4211,12674,100,436,3610,10728,3710,11164
290490,202109,9364,21509,8407,20213,467,962,6682,16291,7149,17253
290500,202109,4288,12352,3352,10401,542,1736,1471,4455,2013,6191
290510,202109,3691,8851,3081,8066,59,188,2727,7090,2786,7278
290515,202109,3748,10276,3253,9584,43,141,2942,8800,2985,8941
290520,202109,12143,33607,9451,28497,667,2026,5686,17034,6353,19060
290530,202109,5148,14446,4335,13136,112,449,3670,11031,3782,11480
290540,202109,3480,8919,3133,8542,40,121,2923,7967,2963,8088
290550,202109,4358,11277,3807,10626,14,67,3509,9910,3523,9977
290560,202109,6418,16283,4870,14050,366,1290,3227,8993,3593,10283
290570,202109,45817,110360,40593,103771,2271,5753,32872,83521,35143,89274
290580,202109,8399,23283,7238,21630,685,1822,5225,16197,5910,18019
290590,202109,7168,21649,6028,19636,150,508,4839,15905,4989,16413
290600,202109,19773,53586,17253,49537,826,2191,13689,39439,14515,41630
290610,202109,2672,8033,2099,6859,82,291,1482,4810,1564,5101
290620,202109,6271,17520,5421,16126,212,581,4543,13542,4755,14123
290630,202109,9815,22718,7832,20195,712,1707,5845,15355,6557,17062
290640,202109,2904,7166,2234,6212,116,292,1572,4560,1688,4852
290650,202109,13269,32047,11716,30307,2367,5857,7550,20359,9917,26216
290660,202109,3796,9582,3124,8543,64,172,2352,6603,2416,6775
290670,202109,6989,18579,5925,16895,380,1013,4545,13189,4925,14202
290680,202109,11311,30492,9472,27794,189,913,7856,22693,8045,23606
290682,202109,4893,12347,4247,11484,142,288,3571,9787,3713,10075
290685,202109,3577,7944,2578,6523,231,522,1521,4161,1752,4683
290687,202109,6909,17859,5645,15792,722,1888,3592,10318,4314,12206
290689,202109,2977,8007,2258,6700,196,608,1505,4496,1701,5104
290690,202109,5392,13857,4341,12395,273,831,3170,8918,3443,9749
290700,202109,2827,7209,2507,6807,44,156,2208,5969,2252,6125
290710,202109,8546,23396,7336,21733,239,655,6137,18310,6376,18965
290720,202109,19064,51115,17286,48390,932,2732,13920,38602,14852,41334
290730,202109,7235,16890,6171,15664,321,630,4816,12473,5137,13103
290740,202109,1086,2827,861,2471,25,75,734,2101,759,2176
290750,202109,11948,28533,10354,26013,728,1800,7702,18866,8430,20666
290755,202109,2080,5754,1678,5041,99,274,1153,3508,1252,3782
290760,202109,3873,10999,3184,9733,158,420,2180,6847,2338,7267
290770,202109,2749,8415,2509,8118,45,190,2115,6975,2160,7165
290780,202109,8355,20405,7194,18885,268,515,5559,15029,5827,15544
290790,202109,4964,13212,4314,12269,188,453,3534,10218,3722,10671
290800,202109,7196,14450,5018,11933,285,560,3757,9074,4042,9634
290810,202109,5374,13830,4355,12361,111,320,3318,9647,3429,9967
290820,202109,5114,13287,4603,12571,223,570,3430,9531,3653,10101
290830,202109,4617,10525,4074,9798,31,104,3515,8235,3546,8339
290840,202109,18117,46410,15467,42319,2060,4617,9831,28685,11891,33302
290850,202109,7452,16754,6595,15831,258,494,5719,13868,5977,14362
290860,202109,6283,17514,5443,16554,214,617,4576,14262,4790,14879
290870,202109,4883,13157,3704,10920,218,588,2515,7457,2733,8045
290880,202109,1467,3519,1182,3154,110,260,744,2128,854,2388
290890,202109,9658,19085,8647,17965,151,319,8069,16672,8220,16991
290900,202109,2544,6455,1980,5485,133,293,1204,3352,1337,3645
290910,202109,5379,12482,4081,10547,40,100,3493,8941,3533,9041
290920,202109,5294,13042,4744,12400,112,158,4412,11771,4524,11929
290930,202109,7746,21143,6281,18622,202,751,4870,14081,5072,14832
290940,202109,3722,10291,3146,9463,173,536,2508,7557,2681,8093
290950,202109,1492,3720,1217,3309,73,184,841,2310,914,2494
290960,202109,5910,14621,5261,13812,233,501,4381,11574,4614,12075
290970,202109,3282,9613,2686,8520,97,359,2081,6612,2178,6971
290980,202109,13120,30365,11039,27261,713,1876,7173,17177,7886,19053
290990,202109,9901,25932,8788,24169,278,1026,7376,19678,7654,20704
291000,202109,3488,8752,2701,7755,118,317,2192,6387,2310,6704
291005,202109,15993,38566,14108,36145,1538,3481,10672,27741,12210,31222
291010,202109,3156,9385,2568,8118,145,492,1650,5075,1795,5567
291020,202109,1309,3133,1062,2710,28,84,775,1868,803,1952
291030,202109,2633,6206,1874,4932,122,281,1155,2993,1277,3274
291040,202109,5667,15016,4666,13597,157,511,3672,10702,3829,11213
291050,202109,8489,20802,7289,19184,801,2098,5203,13593,6004,15691
291060,202109,6702,18978,5704,17649,306,1144,4414,13539,4720,14683
291070,202109,16848,43984,14066,39579,385,1219,11472,32034,11857,33253
291072,202109,26634,64837,19439,52966,3208,8902,8987,24396,12195,33298
291075,202109,5652,13551,5103,12732,105,245,4294,10503,4399,10748
291077,202109,1753,4495,1369,3819,78,141,942,2676,1020,2817
291080,202109,121474,287270,96182,252483,25877,68368,29464,84297,55341,152665
291085,202109,5889,14390,4837,12825,172,486,4042,10672,4214,11158
291090,202109,2153,3929,1599,3315,44,73,1341,2749,1385,2822
291100,202109,3317,7071,2280,5851,92,240,1753,4469,1845,4709
291110,202109,6362,18256,5408,16679,289,996,4222,12642,4511,13638
291120,202109,8037,18972,6790,17403,317,801,5230,13408,5547,14209
291125,202109,2344,4032,1766,3383,87,129,1439,2794,1526,2923
291130,202109,3388,9420,2502,7693,55,259,1892,5599,1947,5858
291140,202109,5039,13156,3640,10631,519,1326,2152,6323,2671,7649
291150,202109,2603,5525,2016,4868,4,16,1924,4652,1928,4668
291160,202109,5214,14027,4329,12768,392,1162,2898,8533,3290,9695
291165,202109,2258,6043,1667,4875,27,109,1202,3386,1229,3495
291170,202109,21656,53695,18006,47639,989,2795,11949,30916,12938,33711
291180,202109,6681,14832,4913,12514,230,541,3886,9904,4116,10445
291185,202109,3188,8196,2805,7601,125,308,2196,6009,2321,6317
291190,202109,8106,19170,6716,17413,263,680,5442,14155,5705,14835
291200,202109,2918,7795,2150,6343,71,217,1383,3906,1454,4123
291210,202109,7474,15498,5530,13287,135,392,4096,9913,4231,10305
291220,202109,4498,12132,4064,11503,266,756,3140,8870,3406,9626
291230,202109,4709,9763,3577,8531,40,92,3256,7816,3296,7908
291240,202109,4226,10705,3562,9599,59,199,3053,8129,3112,8328
291250,202109,3491,10013,2729,8619,147,428,1754,5586,1901,6014
291260,202109,1493,3449,1229,3107,28,85,1001,2554,1029,2639
291270,202109,5866,14309,4592,12506,293,772,3420,9380,3713,10152
291280,202109,2793,6516,2066,5490,197,474,1308,3465,1505,3939
291290,202109,5889,15147,4503,13023,363,1077,3049,8790,3412,9867
291300,202109,3985,10487,3147,9108,108,333,2405,6841,2513,7174
291310,202109,5197,13687,4456,12366,180,488,3702,10223,3882,10711
291320,202109,6430,17186,5020,14629,1121,3050,2444,7558,3565,10608
291330,202109,1940,4787,1620,4268,69,179,1236,3168,1305,3347
291340,202109,4482,11239,3600,9749,113,298,2695,7228,2808,7526
291345,202109,3021,8731,2730,8291,101,320,2284,6964,2385,7284
291350,202109,7133,16976,5542,15089,59,170,4827,13323,4886,13493
291360,202109,38047,85002,29907,75359,3057,7086,19497,50907,22554,57993
291370,202109,8459,22396,7447,20801,593,1660,5505,15130,6098,16790
291380,202109,3645,9576,3191,8968,96,345,2694,7508,2790,7853
291390,202109,13596,28508,10475,25078,468,1007,8647,20736,9115,21743
291400,202109,14844,35843,12303,32142,1324,3062,7858,21566,9182,24628
291410,202109,3120,8019,2443,6849,33,122,1801,4975,1834,5097
291420,202109,2032,4830,1579,4272,18,70,1409,3797,1427,3867
291430,202109,2810,7691,2416,7042,101,333,1900,5393,2001,5726
291440,202109,6700,18637,5813,17197,321,933,4500,13424,4821,14357
291450,202109,10307,23426,8477,21330,80,135,7530,19412,7610,19547
291460,202109,16436,42183,14390,39182,711,2033,10888,29364,11599,31397
291465,202109,9372,22501,7336,20177,123,528,6355,17334,6478,17862
291470,202109,18445,39658,15363,36119,867,1719,11380,27506,12247,29225
291480,202109,45342,97127,33996,81971,3560,8796,19005,45385,22565,54181
291490,202109,5763,14069,4968,13174,136,409,4490,11863,4626,12272
291500,202109,5261,12428,4419,11322,61,210,4047,10383,4108,10593
291510,202109,4590,10887,3391,9363,42,218,2859,7788,2901,8006
291520,202109,4688,10322,3534,8815,187,490,2737,6766,2924,7256
291530,202109,2425,5318,1734,4439,291,665,998,2780,1289,3445
291535,202109,3569,10222,3090,9353,167,447,2358,7388,2525,7835
291540,202109,2318,5047,1602,4193,84,225,1304,3414,1388,3639
291550,202109,5868,13040,4535,11375,463,919,3014,7832,3477,8751
291560,202109,19064,44223,13913,37467,1634,4088,7865,22352,9499,26440
291570,202109,2436,5635,1906,4989,60,145,1581,4287,1641,4432
291580,202109,6669,16676,5243,14784,272,712,3791,10715,4063,11427
291590,202109,2328,5407,2045,5086,77,238,1837,4484,1914,4722
291600,202109,5579,12635,4312,10725,375,962,2957,7146,3332,8108
291610,202109,5734,14627,5132,13962,59,214,4724,12828,4783,13042
291620,202109,3230,7106,2424,6224,124,286,1867,4910,1991,5196
291630,202109,3574,7609,2677,6471,231,592,2002,4820,2233,5412
291640,202109,17351,40687,13153,34742,1875,4523,6320,17168,8195,21691
291650,202109,9474,23209,8367,21907,562,976,7005,18911,7567,19887
291660,202109,2129,5093,1563,4238,128,376,1016,2593,1144,2969
291670,202109,2103,5423,1762,4927,110,260,1297,3704,1407,3964
291680,202109,4169,9922,3359,8778,335,853,2304,6090,2639,6943
291685,202109,5039,11851,4046,10526,221,437,3092,8282,3313,8719
291690,202109,4284,9231,3004,7391,337,667,2182,5476,2519,6143
291700,202109,9074,25339,7998,23509,334,1060,6537,18895,6871,19955
291710,202109,5477,12515,4105,10630,354,850,2861,7421,3215,8271
291720,202109,4610,13467,3854,11979,717,2241,2092,6474,2809,8715
291730,202109,6574,16138,5662,14938,252,713,4753,12478,5005,13191
291733,202109,2830,7187,2405,6636,59,154,1756,5128,1815,5282
291735,202109,3039,7891,2422,6819,77,159,1860,5234,1937,5393
291740,202109,4135,10457,3026,8382,101,205,2092,5798,2193,6003
291750,202109,20998,48327,17082,42603,1935,4496,11004,28171,12939,32667
291760,202109,10903,30214,8534,26464,2500,8765,2265,7021,4765,15786
291770,202109,7572,19605,6331,17495,285,871,4847,12993,5132,13864
291780,202109,5310,13726,4779,12994,91,286,4182,11272,4273,11558
291790,202109,2800,7487,2538,7152,238,541,1910,5570,2148,6111
291800,202109,31801,76721,23985,65369,4276,10936,11029,31688,15305,42624
291810,202109,10831,25030,9136,22967,375,851,7601,19417,7976,20268
291820,202109,4048,10216,3523,9538,91,255,2855,7749,2946,8004
291830,202109,4745,10723,3872,9548,231,407,3035,7585,3266,7992
291835,202109,6819,19864,5409,17220,464,1496,3578,11562,4042,13058
291840,202109,49137,131713,42778,121923,3996,12071,30612,86620,34608,98691
291845,202109,2759,6806,2195,6121,100,269,1851,5226,1951,5495
291850,202109,4311,11606,3605,10465,141,379,2874,8440,3015,8819
291855,202109,2318,4389,1803,3821,28,66,1648,3486,1676,3552
291860,202109,2353,6013,1638,4657,35,74,1094,3020,1129,3094
291870,202109,1344,3303,907,2546,38,93,623,1732,661,1825
291875,202109,3038,8964,2614,8098,51,206,1941,5833,1992,6039
291880,202109,5841,16083,4984,14669,279,723,3639,10903,3918,11626
291890,202109,1666,3365,1086,2695,160,344,684,1743,844,2087
291900,202109,1411,3181,1078,2693,20,64,863,2097,883,2161
291905,202109,2494,6248,2051,5569,78,263,1601,4187,1679,4450
291910,202109,3151,7613,2651,7007,52,170,2266,6181,2318,6351
291915,202109,7558,20961,6141,18573,186,590,4621,14187,4807,14777
291920,202109,28704,71545,24502,65844,1967,5797,17849,46803,19816,52600
291930,202109,2615,6686,2242,6184,220,592,1554,4356,1774,4948
291940,202109,4095,10085,2760,7875,218,581,1617,4622,1835,5203
291950,202109,9337,27822,7874,25075,282,981,5452,17254,5734,18235
291955,202109,16186,39628,14374,37311,1182,3121,11378,29580,12560,32701
291960,202109,3414,8282,2879,7574,156,307,2272,6184,2428,6491
291970,202109,4794,11661,4010,10699,146,438,3043,8158,3189,8596
291980,202109,10266,28144,8281,24781,1027,2643,5252,16234,6279,18877
291990,202109,2409,6085,1965,5538,21,74,1819,5133,1840,5207
291992,202109,4091,9603,3337,8641,300,636,2625,6988,2925,7624
291995,202109,2262,5890,1844,5220,49,184,1446,3999,1495,4183
292000,202109,2744,6217,2232,5612,84,258,1792,4489,1876,4747
292010,202109,5912,13428,4816,11881,146,363,4066,9858,4212,10221
292020,202109,4885,13416,4095,12050,168,554,3166,9046,3334,9600
292030,202109,2039,5852,1834,5492,105,325,1202,3511,1307,3836
292040,202109,4674,11453,3656,9964,221,501,2771,7746,2992,8247
292045,202109,4280,10668,3198,9094,32,90,2866,8276,2898,8366
292050,202109,6812,18384,5521,16190,253,796,3602,10445,3855,11241
292060,202109,11718,26269,10825,25155,414,872,9559,21962,9973,22834
292070,202109,5897,14878,5141,13991,322,801,4355,11849,4677,12650
292080,202109,3364,8011,2753,7233,61,198,2486,6485,2547,6683
292090,202109,4671,9900,3265,8196,188,433,2493,6301,2681,6734
292100,202109,13140,30081,11265,27766,1761,4043,6596,17056,8357,21099
292105,202109,3781,8980,3292,8327,75,164,2788,7052,2863,7216
292110,202109,6313,14624,4489,11859,879,2405,2265,5960,3144,8365
292120,202109,7313,18168,6047,16057,360,959,4500,11770,4860,12729
292130,202109,3577,8358,2967,7606,140,390,2277,5775,2417,6165
292140,202109,5560,12285,4716,11090,190,423,4048,9471,4238,9894
292145,202109,2650,7045,2219,6322,95,226,1769,5064,1864,5290
292150,202109,15493,39889,13419,36599,260,937,11127,29741,11387,30678
292160,202109,3099,7262,2335,6288,33,80,1904,5407,1937,5487
292170,202109,9093,22991,7636,20698,381,1069,5852,15536,6233,16605
292180,202109,2998,7938,2217,6514,146,426,1402,4046,1548,4472
292190,202109,3051,7817,2601,7166,143,409,1949,5384,2092,5793
292200,202109,9223,21922,6855,18609,1236,3421,3213,9161,4449,12582
292205,202109,3827,10463,3318,9715,57,257,2888,8413,2945,8670
292210,202109,6796,15232,5516,13642,75,274,5015,12306,5090,12580
292220,202109,2293,5172,1988,4721,78,168,1547,3561,1625,3729
292225,202109,3374,9507,2980,8916,54,235,2620,7707,2674,7942
292230,202109,9025,20961,8075,19769,175,539,6998,16857,7173,17396
292240,202109,4968,13957,4361,12882,284,817,3109,9157,3393,9974
292250,202109,6153,15247,5532,14356,362,918,4247,10941,4609,11859
292260,202109,3463,8838,3081,8346,83,211,2693,7310,2776,7521
292265,202109,3588,9395,3014,8536,55,231,2456,6815,2511,7046
292270,202109,4404,9892,3498,8817,125,282,2864,7253,2989,7535
292273,202109,2885,6046,2306,5345,59,98,1666,4149,1725,4247
292275,202109,1670,4282,1315,3812,53,150,995,2924,1048,3074
292280,202109,2723,6250,2192,5641,96,171,1818,4838,1914,5009
292285,202109,2720,6290,2161,5543,81,168,1759,4570,1840,4738
292290,202109,7751,19743,6088,17455,160,518,5010,14351,5170,14869
292300,202109,10503,25595,8261,22641,826,2358,5659,15576,6485,17934
292303,202109,3032,8427,2632,7797,88,185,2183,6558,2271,6743
292305,202109,2319,6155,2143,5918,43,169,1929,5260,1972,5429
292310,202109,7205,17176,6249,16024,108,325,5562,14094,5670,14419
292320,202109,6370,16762,5081,14441,223,694,3798,10531,4021,11225
292330,202109,2776,5969,2256,5390,106,171,1736,4382,1842,4553
292335,202109,5050,12729,4454,11860,240,540,3735,10103,3975,10643
292340,202109,5568,15457,4608,13641,227,637,3373,9949,3600,10586
292350,202109,2604,6924,2171,6332,75,254,1767,5185,1842,5439
292360,202109,5163,13387,4304,11945,235,695,3051,8390,3286,9085
292370,202109,10425,24264,8971,22380,115,361,8335,20585,8450,20946
292380,202109,7039,19248,6280,17905,442,1227,4756,13451,5198,14678
292390,202109,4721,8812,3449,7364,114,208,3021,6447,3135,6655
292400,202109,23149,63719,19930,58700,1923,5482,13682,40699,15605,46181
292405,202109,4678,11053,3943,9907,94,231,3294,8139,3388,8370
292410,202109,2274,5337,1891,4852,67,134,1665,4311,1732,4445
292420,202109,3737,10487,3411,9999,100,391,2981,8561,3081,8952
292430,202109,5086,14766,3861,12534,283,908,2526,8263,2809,9171
292440,202109,8861,27535,8194,26530,107,506,7362,23715,7469,24221
292450,202109,4186,11618,3259,9855,94,335,2554,7690,2648,8025
292460,202109,5465,13925,4521,12413,239,606,3532,9633,3771,10239
292465,202109,2826,6917,2409,6390,93,192,1609,4712,1702,4904
292467,202109,2011,5397,1763,5065,286,685,1180,3573,1466,4258
292470,202109,3111,7663,2405,6579,75,120,1828,5055,1903,5175
292480,202109,6431,14839,5214,13362,70,241,4731,12032,4801,12273
292490,202109,2443,5768,2064,5225,105,189,1645,4218,1750,4407
292500,202109,7207,18363,5746,15948,406,1125,3908,10772,4314,11897
292510,202109,14257,36407,11131,31547,553,1576,7842,22234,8395,23810
292520,202109,7442,18088,6535,16750,428,1142,5144,13001,5572,14143
292525,202109,6263,14476,5169,13257,124,255,4547,11854,4671,12109
292530,202109,31483,79947,24551,68558,5214,14873,11036,31029,16250,45902
292540,202109,4624,8272,3655,7246,126,193,3306,6591,3432,6784
292550,202109,8520,21427,6536,19064,491,1272,4550,14263,5041,15535
292560,202109,4579,11243,3878,10270,125,318,2942,7755,3067,8073
292570,202109,3829,9744,3200,8629,47,157,2721,7168,2768,7325
292575,202109,6982,19584,6400,18821,428,1184,5083,15206,5511,16390
292580,202109,7844,19225,6459,17206,119,329,5495,14477,5614,14806
292590,202109,7630,19867,6407,17706,324,903,5095,13871,5419,14774
292593,202109,2953,7214,2445,6378,74,177,2059,5327,2133,5504
292595,202109,5697,14581,4879,13578,132,410,4168,11534,4300,11944
292600,202109,11079,29441,9571,27192,425,1109,7595,21713,8020,22822
292610,202109,4471,11158,3826,10061,162,368,2969,7869,3131,8237
292620,202109,6575,17586,5435,16203,135,277,4889,14903,5024,15180
292630,202109,9202,21658,7364,18745,818,2002,4559,11792,5377,13794
292640,202109,8614,24283,7462,22395,210,689,5411,16419,5621,17108
292650,202109,4542,11092,4053,10453,105,255,3692,9446,3797,9701
292660,202109,11732,30982,9905,28284,476,1390,7396,21314,7872,22704
292665,202109,2231,6414,1919,6002,70,187,1586,5066,1656,5253
292670,202109,3662,9753,2843,8236,132,382,1912,5436,2044,5818
292680,202109,4180,10586,3302,9080,164,389,2467,6646,2631,7035
292690,202109,2742,6882,1901,5518,195,504,1141,3477,1336,3981
292700,202109,10363,27401,9039,25371,730,1677,6258,18243,6988,19920
292710,202109,2765,7964,2575,7716,51,126,2352,7105,2403,7231
292720,202109,9333,21559,7872,19876,212,535,6299,16229,6511,16764
292730,202109,5130,11407,4680,10720,355,580,3848,9065,4203,9645
292740,202109,332254,780087,286872,716627,38362,94992,182969,454714,221331,549706
292750,202109,6546,16517,5773,15436,227,545,4607,12533,4834,13078
292760,202109,4130,11362,3610,10465,167,479,2736,7857,2903,8336
292770,202109,6789,16853,5483,15063,741,2054,3615,10206,4356,12260
292780,202109,2198,4186,1639,3522,76,164,1316,2718,1392,2882
292790,202109,4111,8521,3110,7433,169,349,2556,6193,2725,6542
292800,202109,11737,28728,10035,26155,354,870,8322,21544,8676,22414
292805,202109,3825,8853,3015,7819,115,300,2389,6175,2504,6475
292810,202109,11495,28337,9180,24764,618,1408,6745,18008,7363,19416
292820,202109,7475,20400,5474,17036,347,1172,3879,11860,4226,13032
292830,202109,3014,6926,2567,6387,86,191,2189,5508,2275,5699
292840,202109,9108,23245,7688,21343,134,439,6762,18565,6896,19004
292850,202109,2587,6549,2167,5952,156,399,1498,4108,1654,4507
292860,202109,16996,36919,15274,34906,399,977,13298,30034,13697,31011
292870,202109,19779,46987,17099,43293,970,2323,12052,30092,13022,32415
292880,202109,11639,30934,9911,28334,277,990,7843,21736,8120,22726
292890,202109,7500,19925,6617,18670,170,647,5819,16322,5989,16969
292895,202109,3244,6645,2437,5474,106,218,1984,4412,2090,4630
292900,202109,2721,7113,2468,6728,49,180,2056,5462,2105,5642
292905,202109,4477,11193,3562,9835,93,285,2737,7472,2830,7757
292910,202109,4812,12878,4400,12306,187,492,3441,9572,3628,10064
292920,202109,9957,26973,9237,25989,272,939,7960,22120,8232,23059
292925,202109,5468,15229,4559,13587,237,642,3246,9677,3483,10319
292930,202109,6702,18986,5809,17402,517,1639,3738,10977,4255,12616
292935,202109,2559,6163,2005,5549,13,63,1803,5019,1816,5082
292937,202109,2909,7215,2523,6726,73,189,2084,5562,2157,5751
292940,202109,3044,7433,2419,6499,244,537,1652,4639,1896,5176
292950,202109,9886,24475,8628,22659,530,1157,6525,17123,7055,18280
292960,202109,5347,12718,4461,11458,142,338,3559,9090,3701,9428
292970,202109,3989,10960,3545,10309,70,268,2971,8704,3041,8972
292975,202109,4462,9464,3959,8902,114,189,3598,8166,3712,8355
292980,202109,3617,8197,2967,7264,72,203,2506,6031,2578,6234
292990,202109,11600,31499,9734,28232,548,1674,7254,20692,7802,22366
293000,202109,2815,6505,2414,5905,48,157,1955,4770,2003,4927
293010,202109,19164,47317,15491,41717,1904,5212,9574,25824,11478,31036
293015,202109,9039,26471,7171,22933,471,1479,4879,15926,5350,17405
293020,202109,10133,28738,9116,27297,126,425,8215,24677,8341,25102
293030,202109,5347,13761,4084,11820,114,315,2809,8394,2923,8709
293040,202109,4685,11653,3919,10576,70,197,3444,9259,3514,9456
293050,202109,23959,56051,21116,51867,1332,3103,15810,38485,17142,41588
293060,202109,3735,9668,3017,8321,228,658,2087,5632,2315,6290
293070,202109,26224,61511,23067,57547,1957,5011,17294,42949,19251,47960
293075,202109,3768,11317,3286,10519,100,450,2727,8688,2827,9138
293076,202109,3685,8724,3350,8334,66,132,2987,7534,3053,7666
293077,202109,6725,17913,5377,15801,481,1485,3287,10234,3768,11719
293080,202109,4915,14113,4203,12886,79,360,3438,10343,3517,10703
293090,202109,3319,9464,2557,8179,216,643,1670,5437,1886,6080
293100,202109,6048,15521,5021,13705,241,595,3950,10791,4191,11386
293105,202109,3953,12180,3448,11154,236,760,2418,7781,2654,8541
293110,202109,2497,6025,2084,5434,72,196,1690,4355,1762,4551
293120,202109,4780,12306,4299,11581,251,482,3530,9696,3781,10178
293130,202109,3887,10366,3384,9727,58,224,2984,8496,3042,8720
293135,202109,31937,72750,23626,61878,3454,9771,11142,29526,14596,39297
293140,202109,2550,5352,2221,4961,57,99,1906,4265,1963,4364
293150,202109,5549,16198,4561,14360,303,959,3156,9965,3459,10924
293160,202109,3788,9246,3232,8643,242,389,2715,7628,2957,8017
293170,202109,5118,10339,4476,9554,104,207,3956,8416,4060,8623
293180,202109,4588,12478,3820,11105,72,265,3072,8724,3144,8989
293190,202109,14752,38793,12966,36251,116,490,11575,32115,11691,32605
293200,202109,9073,21471,7362,18785,214,558,6015,15201,6229,15759
293210,202109,5380,13721,4607,12530,304,775,3554,9697,3858,10472
293220,202109,5371,13208,3957,10887,737,2019,1942,5452,2679,7471
293230,202109,4179,10178,3119,8726,224,617,2192,6251,2416,6868
293240,202109,4681,11946,3778,10498,74,142,2823,8252,2897,8394
293245,202109,3988,10470,3617,9932,155,418,3069,8363,3224,8781
293250,202109,6165,14027,4993,12498,196,501,4100,10227,4296,10728
293260,202109,4948,12604,4082,11251,144,334,2859,7992,3003,8326
293270,202109,7491,16027,5913,14342,455,609,4591,12116,5046,12725
293280,202109,4601,11830,4009,10989,246,578,3103,8663,3349,9241
293290,202109,16290,44275,14445,41410,1660,4755,9860,28408,11520,33163
293300,202109,6027,14236,5197,13033,309,725,3813,9602,4122,10327
293305,202109,4332,10085,3777,9395,73,163,3404,8491,3477,8654
293310,202109,2195,5449,1844,4918,41,121,1476,3875,1517,3996
293315,202109,4321,9851,3560,8733,196,415,2916,7143,3112,7558
293317,202109,2788,6344,2480,5914,166,274,1932,4657,2098,4931
293320,202109,12425,29099,10998,27524,207,569,9964,24795,10171,25364
293325,202109,1841,4418,1431,3880,202,510,897,2486,1099,2996
293330,202109,65710,176257,53563,155329,8698,26085,26418,75551,35116,101636
293340,202109,2267,6231,1867,5534,103,293,1292,3815,1395,4108
293345,202109,3819,9912,3069,8769,422,940,1907,6064,2329,7004
293350,202109,6582,18463,5650,17343,52,254,5142,15972,5194,16226
293360,202109,15287,38074,13031,35068,269,1098,11523,30486,11792,31584
310010,202109,1019,2214,656,1722,40,132,247,611,287,743
310020,202109,2999,7745,2273,6482,437,1322,642,1768,1079,3090
310030,202109,1942,5337,1496,4560,213,717,972,2863,1185,3580
310040,202109,890,2245,702,1923,63,215,405,987,468,1202
310050,202109,1528,4449,1279,4059,112,449,861,2634,973,3083
310060,202109,3261,8960,2814,8368,86,310,2329,6859,2415,7169
310070,202109,344,774,246,634,12,25,179,459,191,484
310080,202109,711,1874,521,1537,78,247,253,708,331,955
310090,202109,4961,12527,4078,11101,256,741,3077,8246,3333,8987
310100,202109,3687,9759,3122,8852,74,312,2609,7200,2683,7512
310110,202109,4912,12443,3791,10571,672,2041,1853,4948,2525,6989
310120,202109,660,1550,421,1174,50,164,242,614,292,778
310130,202109,373,950,316,865,26,100,241,633,267,733
310140,202109,293,796,205,652,36,135,85,242,121,377
310150,202109,6063,15120,4518,12372,514,1605,2275,5835,2789,7440
310160,202109,9211,22121,6778,18204,1100,3212,2731,7196,3831,10408
310163,202109,1135,3273,911,2836,183,618,284,812,467,1430
310170,202109,9842,24062,7863,21050,678,1799,5514,14800,6192,16599
310180,202109,1990,4696,1444,3845,159,464,865,2233,1024,2697
310190,202109,2860,7994,2343,7078,526,1767,414,1169,940,2936
310200,202109,2067,5836,1543,4849,181,636,755,2300,936,2936
310205,202109,1167,3097,931,2720,123,398,543,1595,666,1993
310210,202109,2614,6923,2144,6085,126,350,1514,4191,1640,4541
310220,202109,1303,3466,1005,2879,88,261,646,1783,734,2044
310230,202109,2311,6181,1851,5344,230,719,1159,3142,1389,3861
310240,202109,1057,3037,896,2760,46,168,622,1840,668,2008
310250,202109,1099,2818,898,2498,17,61,659,1799,676,1860
310260,202109,3361,8429,2248,6466,612,2062,712,1650,1324,3712
310270,202109,2854,6716,2277,5943,86,246,1890,4939,1976,5185
310280,202109,2585,5842,2046,5083,231,599,1283,3072,1514,3671
310285,202109,1921,5929,1598,5351,150,534,987,3298,1137,3832
310290,202109,1262,3224,1053,2869,185,585,587,1445,772,2030
310300,202109,1654,4568,1406,4150,131,470,832,2287,963,2757
310310,202109,327,777,213,583,39,102,100,265,139,367
310320,202109,548,1342,388,1093,17,63,231,620,248,683
310330,202109,508,1180,309,828,44,133,118,274,162,407
310340,202109,8536,21670,6857,18846,935,2522,3424,9571,4359,12093
310350,202109,13489,31832,9376,25293,1477,4229,4536,11750,6013,15979
310360,202109,567,1248,446,1095,15,37,301,727,316,764
310370,202109,1324,3965,1133,3615,207,730,348,1194,555,1924
310375,202109,899,2176,642,1798,93,266,360,1013,453,1279
310380,202109,405,910,227,632,33,97,106,280,139,377
310390,202109,519,1482,418,1291,79,261,145,398,224,659
310400,202109,11797,28096,8697,23404,742,2300,5541,14355,6283,16655
310410,202109,865,2454,567,1907,74,274,235,730,309,1004
310420,202109,4926,12379,3503,9815,474,1445,1526,3964,2000,5409
310430,202109,1677,4410,1135,3419,218,718,430,1122,648,1840
310440,202109,693,1784,483,1400,41,150,263,705,304,855
310445,202109,1447,3977,1056,3214,71,206,739,2209,810,2415
310450,202109,4683,11516,3564,9768,146,508,2731,7267,2877,7775
310460,202109,1837,4774,1410,3999,220,675,526,1361,746,2036
310470,202109,3793,8274,2961,7180,277,612,2107,5253,2384,5865
310480,202109,1023,2564,799,2201,94,266,491,1309,585,1575
310490,202109,2927,7777,2304,6767,249,865,1303,3562,1552,4427
310500,202109,1432,3855,1087,3284,180,615,584,1687,764,2302
310510,202109,2221,5655,1522,4386,260,824,608,1739,868,2563
310520,202109,1204,3075,888,2507,141,377,465,1334,606,1711
310530,202109,790,1967,536,1529,71,232,190,444,261,676
310540,202109,3116,8598,2574,7632,505,1626,1183,3294,1688,4920
310550,202109,1312,3206,938,2590,72,250,553,1404,625,1654
310560,202109,16111,41004,11509,32884,1460,4629,5142,13220,6602,17849
310570,202109,1080,2770,855,2457,49,169,652,1842,701,2011
310590,202109,4366,11175,3498,9571,224,673,2072,5332,2296,6005
310600,202109,1431,4046,1168,3505,140,477,626,1763,766,2240
310610,202109,491,1304,323,1031,119,393,50,150,169,543
310620,202109,196209,483791,145440,393004,17365,54300,76794,188005,94159,242305
310630,202109,4861,12877,3771,10737,436,1271,2235,6213,2671,7484
310640,202109,1268,3541,1042,3115,163,546,507,1415,670,1961
310650,202109,2565,6918,1889,5632,151,476,1166,3334,1317,3810
310660,202109,1373,3628,1124,3284,28,86,955,2790,983,2876
310665,202109,1453,3611,1182,3242,18,66,967,2697,985,2763
310670,202109,62268,155333,52654,139173,4653,13794,36461,91712,41114,105506
310680,202109,809,1855,668,1656,18,65,572,1368,590,1433
310690,202109,2187,5395,1600,4449,111,347,977,2571,1088,2918
310700,202109,501,1076,394,943,21,66,313,730,334,796
310710,202109,6073,16637,4438,14179,828,3103,782,2240,1610,5343
310720,202109,1111,2490,868,2185,29,95,669,1619,698,1714
310730,202109,10666,27234,9088,24774,355,1155,6829,18141,7184,19296
310740,202109,6792,18070,4950,14378,666,2162,2000,5208,2666,7370
310750,202109,1326,3091,1011,2643,106,327,565,1347,671,1674
310760,202109,701,1723,486,1395,35,103,271,789,306,892
310770,202109,1139,3007,799,2482,81,299,416,1192,497,1491
310780,202109,4374,10172,3631,9218,78,208,2942,7456,3020,7664
310790,202109,1890,5837,1624,5263,333,1156,280,787,613,1943
310800,202109,2475,7129,1808,5787,340,1326,109,277,449,1603
310810,202109,1378,3302,1143,2926,54,141,818,2024,872,2165
310820,202109,1266,3143,771,2323,162,500,174,554,336,1054
310825,202109,2710,7816,2184,6959,52,289,1791,5537,1843,5826
310830,202109,2019,5471,1490,4474,255,911,621,1721,876,2632
310840,202109,2246,5937,1709,5041,353,1196,466,1174,819,2370
310850,202109,1464,3984,1213,3620,34,156,939,2700,973,2856
310855,202109,3186,8232,2467,7079,168,547,1769,4970,1937,5517
310860,202109,7069,19945,5723,17420,575,1725,3493,10799,4068,12524
310870,202109,1002,2343,793,2044,51,120,591,1516,642,1636
310880,202109,1016,2972,811,2560,109,336,457,1423,566,1759
310890,202109,2296,6446,1489,4837,255,901,229,639,484,1540
310900,202109,4048,11014,2814,8341,422,1332,1240,3385,1662,4717
310910,202109,2292,5438,1613,4379,137,443,370,924,507,1367
310920,202109,1960,4962,1491,4273,175,533,900,2531,1075,3064
310925,202109,1018,2641,833,2344,44,151,612,1639,656,1790
310930,202109,5941,14932,4184,12143,810,2323,1873,5740,2683,8063
310940,202109,7004,15928,5667,14013,186,518,4435,10721,4621,11239
310945,202109,1359,3427,1071,2964,183,527,534,1430,717,1957
310950,202109,1976,5743,1326,4304,224,789,372,1011,596,1800
310960,202109,746,1946,419,1259,76,258,85,228,161,486
310970,202109,1183,3434,831,2699,212,742,130,382,342,1124
310980,202109,331,758,196,532,21,62,114,306,135,368
310990,202109,1377,3650,1086,3164,145,440,591,1672,736,2112
311000,202109,4005,10887,2941,9158,707,2292,1192,3654,1899,5946
311010,202109,966,2599,774,2253,192,630,368,1044,560,1674
311020,202109,1207,2997,777,2223,46,142,416,1145,462,1287
311030,202109,1823,4393,1305,3546,270,831,567,1446,837,2277
311040,202109,274,845,226,741,70,237,72,220,142,457
311050,202109,3173,7598,2384,6452,361,1100,1223,3145,1584,4245
311060,202109,3446,8595,2581,7037,340,1049,1061,2648,1401,3697
311070,202109,2464,5909,1803,4910,150,528,1059,2683,1209,3211
311080,202109,1210,2673,977,2315,59,157,762,1715,821,1872
311090,202109,2368,7148,1920,6308,411,1462,604,1949,1015,3411
311100,202109,2560,7025,1522,4941,276,998,301,834,577,1832
311110,202109,3780,7607,2126,5297,435,1089,665,1716,1100,2805
311115,202109,1443,3115,1220,2826,71,149,984,2271,1055,2420
311120,202109,7279,18568,5613,15646,818,2533,2137,5253,2955,7786
311130,202109,1949,4994,1480,4340,105,387,882,2502,987,2889
311140,202109,1546,3742,1233,3311,77,238,882,2328,959,2566
311150,202109,1472,4619,1147,3979,170,667,620,2097,790,2764
311160,202109,4065,11311,2902,9189,701,2392,890,2686,1591,5078
311170,202109,936,2319,744,2060,46,128,462,1360,508,1488
311180,202109,1431,3149,921,2408,190,508,379,1003,569,1511
311190,202109,891,2427,675,2012,111,384,268,677,379,1061
311200,202109,2185,5776,1573,4594,287,924,564,1485,851,2409
311205,202109,914,2579,753,2284,42,160,477,1356,519,1516
311210,202109,1056,2997,914,2795,121,325,639,2029,760,2354
311220,202109,781,2083,659,1864,36,119,452,1199,488,1318
311230,202109,8375,24158,6373,20167,1154,3810,2311,7406,3465,11216
311240,202109,1132,2841,884,2491,180,501,400,1136,580,1637
311250,202109,1237,3421,958,2894,180,543,387,1085,567,1628
311260,202109,2871,6817,1856,5071,249,765,836,2001,1085,2766
311265,202109,1339,3391,987,2809,42,153,685,1907,727,2060
311270,202109,3063,8939,2675,8314,140,576,1960,5870,2100,6446
311280,202109,1146,2935,590,1808,90,307,97,251,187,558
311290,202109,1938,5682,1767,5337,123,368,1222,3693,1345,4061
311300,202109,4893,13107,4025,11673,163,581,3228,9177,3391,9758
311310,202109,584,1583,493,1422,33,98,324,900,357,998
311320,202109,3403,10062,2938,9081,307,1112,1525,4287,1832,5399
311330,202109,5735,14271,4538,12363,475,1330,2570,7114,3045,8444
311340,202109,11101,29929,8775,25871,2053,6530,2632,7278,4685,13808
311350,202109,2535,6035,1821,4770,175,475,995,2368,1170,2843
311360,202109,1157,2760,765,2192,199,642,263,751,462,1393
311370,202109,4896,11536,3636,9584,223,728,2364,5824,2587,6552
311380,202109,382,1131,277,911,62,204,129,437,191,641
311390,202109,1826,5395,1461,4895,633,2358,371,1133,1004,3491
311400,202109,1641,4372,1200,3537,224,672,344,891,568,1563
311410,202109,1890,5348,1502,4742,217,760,854,2604,1071,3364
311420,202109,1613,4628,1157,3698,206,743,320,862,526,1605
311430,202109,4494,11469,3004,8601,449,1327,1103,3041,1552,4368
311440,202109,3111,8399,2377,7169,641,2228,482,1340,1123,3568
311450,202109,1870,5451,1360,4496,346,1293,332,926,678,2219
311455,202109,1055,2288,716,1790,146,388,315,795,461,1183
311460,202109,540,1606,358,1216,67,269,80,221,147,490
311470,202109,538,1597,364,1203,85,316,51,156,136,472
311480,202109,1135,2743,927,2423,65,154,706,1844,771,1998
311490,202109,255,738,193,625,30,123,91,259,121,382
311500,202109,489,1163,380,999,21,68,254,642,275,710
311510,202109,3450,8650,2423,6921,299,945,1065,2845,1364,3790
311520,202109,659,1778,580,1633,74,254,330,910,404,1164
311530,202109,8934,20369,5777,15389,1313,3904,1594,4008,2907,7912
311535,202109,862,2296,596,1752,92,281,226,614,318,895
311540,202109,516,1571,460,1467,61,219,331,1025,392,1244
311545,202109,2039,5705,1748,5256,94,309,1349,4021,1443,4330
311547,202109,1562,3787,1357,3478,51,116,1008,2586,1059,2702
311550,202109,2992,7988,2403,6952,335,1090,1051,2851,1386,3941
311560,202109,326,679,209,503,80,184,48,109,128,293
311570,202109,1642,3729,1159,3061,37,107,911,2436,948,2543
311580,202109,2227,4159,1511,3304,181,314,980,2177,1161,2491
311590,202109,547,1403,440,1243,82,260,243,670,325,930
311600,202109,1747,3969,1456,3585,116,308,1135,2734,1251,3042
311610,202109,2355,7165,1960,6398,153,581,1210,3850,1363,4431
311615,202109,3437,9273,2769,8189,101,350,2228,6467,2329,6817
311620,202109,450,1124,381,1042,118,369,202,503,320,872
311630,202109,1368,3696,1130,3222,128,380,687,1916,815,2296
311640,202109,733,1925,591,1706,59,203,305,806,364,1009
311650,202109,2016,4936,1627,4338,197,557,982,2528,1179,3085
311660,202109,3021,8505,2239,6939,324,1112,593,1500,917,2612
311670,202109,1651,4132,1224,3373,149,448,532,1445,681,1893
311680,202109,2287,6221,1743,5242,117,334,1249,3737,1366,4071
311690,202109,636,1336,501,1170,39,77,371,904,410,981
311700,202109,2264,5279,1787,4611,18,85,1519,3825,1537,3910
311710,202109,1581,4466,1164,3729,276,969,396,1263,672,2232
311720,202109,448,1274,358,1116,37,132,186,589,223,721
311730,202109,3706,9362,2471,6977,682,2065,564,1569,1246,3634
311740,202109,956,2406,800,2211,73,184,650,1862,723,2046
311750,202109,4065,11713,3266,10299,356,1213,2030,6164,2386,7377
311760,202109,670,1851,549,1642,70,253,285,737,355,990
311770,202109,2219,6135,1745,5314,295,909,789,2309,1084,3218
311780,202109,1440,4010,1057,3276,154,561,382,1025,536,1586
311783,202109,2355,6162,1916,5438,35,157,1562,4264,1597,4421
311787,202109,869,2430,680,2003,101,327,300,764,401,1091
311790,202109,1562,4170,1030,3178,225,751,299,866,524,1617
311800,202109,5229,15238,4182,13027,840,2737,605,1513,1445,4250
311810,202109,966,2826,761,2470,47,162,514,1648,561,1810
311820,202109,834,1966,624,1652,59,184,398,991,457,1175
311830,202109,8789,24297,6131,18634,1664,5371,783,2313,2447,7684
311840,202109,3848,9335,3112,8293,223,623,2331,6182,2554,6805
311850,202109,381,985,309,855,13,36,208,541,221,577
311860,202109,66071,161643,51112,136302,6448,18675,29911,75415,36359,94090
311870,202109,1960,5078,1384,4081,251,847,584,1560,835,2407
311880,202109,6686,16677,5606,15198,309,687,4191,11669,4500,12356
311890,202109,1771,4124,1370,3573,84,243,971,2397,1055,2640
311900,202109,777,1938,584,1677,53,164,374,1063,427,1227
311910,202109,4217,10514,3183,9151,557,1566,1604,4782,2161,6348
311920,202109,2207,5615,1776,4998,124,293,1120,3276,1244,3569
311930,202109,4180,9467,3030,7875,822,2301,1014,2488,1836,4789
311940,202109,16540,41945,12125,33707,1640,4980,5519,14243,7159,19223
311950,202109,2446,6303,1862,5325,134,403,1146,3307,1280,3710
311960,202109,503,1220,397,1064,31,105,237,572,268,677
311970,202109,437,1371,321,1082,52,218,76,218,128,436
311980,202109,477,1247,256,825,21,70,98,304,119,374
311990,202109,542,1250,338,940,61,206,137,339,198,545
311995,202109,985,2696,523,1628,17,58,74,147,91,205
312000,202109,807,1938,606,1643,54,134,388,1070,442,1204
312010,202109,1028,2715,810,2369,39,132,558,1557,597,1689
312015,202109,1424,3985,1265,3736,43,166,1031,2974,1074,3140
312020,202109,1759,5242,1269,4169,205,704,271,783,476,1487
312030,202109,2102,5032,1818,4721,14,55,1714,4446,1728,4501
312040,202109,866,2492,620,2015,81,268,270,852,351,1120
312050,202109,1236,3705,1000,3255,210,832,352,1025,562,1857
312060,202109,952,2255,609,1793,153,459,253,744,406,1203
312070,202109,950,2637,679,2097,30,106,404,1172,434,1278
312080,202109,2811,6784,2144,5806,121,340,1442,3744,1563,4084
312083,202109,960,2401,737,2060,53,182,538,1455,591,1637
312087,202109,2608,6617,2113,5853,57,162,1688,4707,1745,4869
312090,202109,11027,28108,8697,24450,1126,3478,4626,12434,5752,15912
312100,202109,1617,4558,1289,3956,89,338,801,2343,890,2681
312110,202109,1073,3220,886,2847,177,661,333,970,510,1631
312120,202109,1055,2797,729,2229,181,636,216,543,397,1179
312125,202109,1838,4556,1550,4162,98,288,1203,3134,1301,3422
312130,202109,1099,2623,823,2169,72,212,374,906,446,1118
312140,202109,729,2065,602,1812,112,373,271,756,383,1129
312150,202109,485,1314,413,1178,20,63,279,741,299,804
312160,202109,9589,25117,7407,21327,834,2595,3665,10098,4499,12693
312170,202109,933,2392,716,1998,36,129,466,1251,502,1380
312180,202109,1434,3729,1157,3227,151,437,613,1667,764,2104
312190,202109,717,1925,538,1604,73,250,226,637,299,887
312200,202109,4645,12295,3665,10708,727,2020,1708,5110,2435,7130
312210,202109,1425,3093,1045,2559,47,129,795,1897,842,2026
312220,202109,1634,4955,1412,4547,98,332,917,2975,1015,3307
312230,202109,16210,40408,11262,31629,2374,7556,2935,6878,5309,14434
312235,202109,2035,4962,1601,4357,107,329,1143,3010,1250,3339
312240,202109,755,2343,581,1987,108,407,172,564,280,971
312245,202109,2787,6878,2303,6152,53,122,1940,5159,1993,5281
312247,202109,1068,2432,784,2032,113,315,460,1169,573,1484
312250,202109,981,2571,621,1855,78,240,218,631,296,871
312260,202109,984,2573,784,2272,35,131,612,1694,647,1825
312270,202109,752,2038,573,1677,32,120,315,852,347,972
312280,202109,428,1224,335,1063,90,302,54,159,144,461
312290,202109,866,2440,709,2171,128,433,233,666,361,1099
312300,202109,1026,3027,689,2206,167,590,132,347,299,937
312310,202109,994,2875,797,2480,118,404,389,1153,507,1557
312320,202109,2122,5294,1544,4312,338,973,332,922,670,1895
312330,202109,893,2522,728,2180,72,237,455,1319,527,1556
312340,202109,268,669,191,548,33,127,100,240,133,367
312350,202109,266,530,194,452,20,54,134,302,154,356
312352,202109,1597,4706,1410,4359,94,291,838,2789,932,3080
312360,202109,3201,8991,2380,7468,417,1446,859,2480,1276,3926
312370,202109,1994,4984,1638,4389,161,492,1027,2625,1188,3117
312380,202109,2256,5011,1881,4536,9,31,1670,3961,1679,3992
312385,202109,1304,3433,1009,2913,181,560,367,1089,548,1649
312390,202109,1975,5483,1451,4513,215,786,418,1091,633,1877
312400,202109,2998,8279,2508,7458,674,2194,823,2449,1497,4643
312410,202109,12760,33847,10403,29981,1726,5044,5901,16705,7627,21749
312420,202109,4042,10397,3327,9234,643,1925,1715,4583,2358,6508
312430,202109,8213,21273,6741,18698,336,1066,4878,13194,5214,14260
312440,202109,980,3109,803,2724,369,1339,129,401,498,1740
312450,202109,1252,3598,954,3072,264,889,298,1007,562,1896
312460,202109,478,1175,345,974,51,140,192,558,243,698
312470,202109,484,1162,298,819,30,92,105,252,135,344
312480,202109,1062,2588,753,2135,84,278,392,1044,476,1322
312490,202109,2337,5377,1867,4724,167,477,1106,2732,1273,3209
312500,202109,1079,2566,892,2317,41,144,658,1685,699,1829
312510,202109,4247,11162,3089,8975,740,2086,781,2272,1521,4358
312520,202109,280,699,214,599,42,131,100,272,142,403
312530,202109,683,1593,577,1472,30,75,454,1204,484,1279
312540,202109,1668,4460,1150,3469,141,448,641,1867,782,2315
312550,202109,820,2113,636,1758,45,143,415,1063,460,1206
312560,202109,2003,5154,1616,4538,74,203,1184,3331,1258,3534
312570,202109,2502,5737,1876,4960,443,1166,818,2287,1261,3453
312580,202109,637,1699,443,1309,56,193,195,520,251,713
312590,202109,1633,4596,1263,3842,75,299,794,2225,869,2524
312595,202109,2123,5930,1758,5342,256,701,1044,3380,1300,4081
312600,202109,1222,2881,716,1900,111,360,123,381,234,741
312610,202109,7416,18344,5000,13947,698,2134,1782,4476,2480,6610
312620,202109,2598,6533,1925,5592,48,153,1534,4535,1582,4688
312630,202109,312,855,219,687,30,113,81,252,111,365
312640,202109,533,1439,379,1176,36,133,178,545,214,678
312650,202109,2158,5256,1514,4091,75,208,1076,2755,1151,2963
312660,202109,1363,3241,1041,2707,103,266,680,1717,783,1983
312670,202109,5205,13236,4340,11880,158,570,3271,8576,3429,9146
312675,202109,1345,3354,1104,3009,57,159,904,2432,961,2591
312680,202109,1454,3953,1256,3638,42,162,1050,2972,1092,3134
312690,202109,3058,6297,2362,5471,39,99,1983,4594,2022,4693
312695,202109,1011,2615,858,2377,51,109,664,1842,715,1951
312700,202109,2134,5478,1567,4467,139,466,926,2498,1065,2964
312705,202109,1492,3439,1286,3141,13,40,1185,2871,1198,2911
312707,202109,1470,4072,1111,3445,71,281,718,2125,789,2406
312710,202109,6811,15422,4152,11326,975,2846,1184,3371,2159,6217
312720,202109,1139,2893,847,2435,92,279,530,1457,622,1736
312730,202109,1690,3890,1197,3220,98,280,710,1859,808,2139
312733,202109,1415,3651,1065,3000,28,99,737,1947,765,2046
312735,202109,776,1984,620,1689,79,207,355,902,434,1109
312737,202109,827,1790,594,1466,59,156,405,979,464,1135
312738,202109,738,1822,534,1483,50,150,314,832,364,982
312740,202109,447,1107,262,793,47,167,62,131,109,298
312750,202109,1617,4518,1201,3729,187,601,529,1555,716,2156
312760,202109,1868,5341,1333,4227,231,751,500,1536,731,2287
312770,202109,46309,108886,29277,79888,5520,16303,10129,26528,15649,42831
312780,202109,2534,7248,2138,6603,242,761,1395,4322,1637,5083
312790,202109,259,596,138,397,1,3,42,89,43,92
312800,202109,5268,14319,4031,11995,813,2557,1654,4711,2467,7268
312810,202109,1571,4153,1055,3301,262,904,379,1082,641,1986
312820,202109,1825,4711,1476,4109,67,212,1096,2991,1163,3203
312825,202109,1431,3232,1243,2988,19,55,1080,2540,1099,2595
312830,202109,2897,7954,1786,5712,334,1197,459,1379,793,2576
312840,202109,1506,3823,1195,3327,70,248,723,1886,793,2134
312850,202109,1030,2386,728,1945,19,70,461,1131,480,1201
312860,202109,1132,2857,774,2311,187,575,180,510,367,1085
312870,202109,6354,16591,4028,12205,619,1979,1052,2902,1671,4881
312880,202109,1522,3736,1176,3157,50,141,697,1904,747,2045
312890,202109,2339,5642,1735,4668,134,328,887,2418,1021,2746
312900,202109,1286,3239,1043,2915,150,465,493,1495,643,1960
312910,202109,1586,2889,871,1959,194,373,322,757,516,1130
312920,202109,1017,2665,714,2183,118,427,269,729,387,1156
312930,202109,2520,6008,1917,5114,400,1079,850,2342,1250,3421
312940,202109,1018,2729,812,2436,61,235,474,1359,535,1594
312950,202109,3179,7644,2133,5984,444,1393,797,2126,1241,3519
312960,202109,1895,4855,1592,4400,86,208,1200,3412,1286,3620
312965,202109,1700,4521,1415,4090,122,315,963,2798,1085,3113
312970,202109,1486,4071,1200,3612,142,499,741,2114,883,2613
312980,202109,25852,68807,20814,59874,4040,12355,9406,25410,13446,37765
312990,202109,534,1284,359,993,57,179,181,457,238,636
313000,202109,491,1378,371,1159,23,104,226,659,249,763
313005,202109,2636,7373,2227,6692,141,381,1589,4716,1730,5097
313010,202109,5542,14584,4406,12773,715,2252,2608,7421,3323,9673
313020,202109,1123,3287,821,2626,131,441,170,484,301,925
313030,202109,1195,2634,815,2101,65,217,546,1336,611,1553
313040,202109,858,2567,707,2268,39,165,436,1328,475,1493
313050,202109,1831,4907,1280,4076,199,763,408,1144,607,1907
313055,202109,1992,5187,1767,4867,105,294,1472,4049,1577,4343
313060,202109,1016,2430,730,1939,136,437,161,393,297,830
313065,202109,1694,4895,1492,4568,40,142,1176,3515,1216,3657
313070,202109,967,2485,743,2114,74,221,441,1215,515,1436
313080,202109,406,1115,301,915,53,178,101,252,154,430
313090,202109,5457,13871,4633,12577,314,967,3195,8571,3509,9538
313100,202109,1359,3457,1045,3007,27,110,795,2230,822,2340
313110,202109,1530,3940,1136,3264,105,360,620,1640,725,2000
313115,202109,2920,8032,2333,6918,267,927,1277,3469,1544,4396
313120,202109,3942,9137,2901,7777,194,580,1953,5240,2147,5820
313130,202109,33195,82885,25174,68396,2484,7673,14381,36660,16865,44333
313140,202109,712,1500,455,1147,27,65,333,839,360,904
313150,202109,1426,3902,1062,3261,319,1061,180,497,499,1558
313160,202109,1272,3115,998,2711,19,66,767,2014,786,2080
313170,202109,11573,31988,8529,26321,1307,4405,3305,9367,4612,13772
313180,202109,2302,5930,1683,4689,273,717,930,2599,1203,3316
313190,202109,4593,12883,3333,10319,565,1875,1170,3355,1735,5230
313200,202109,1165,3112,1008,2836,13,49,860,2353,873,2402
313210,202109,4114,11281,3382,9991,369,1103,2060,5933,2429,7036
313220,202109,1815,4651,1204,3457,154,495,515,1305,669,1800
313230,202109,3021,8234,2469,7544,45,154,2046,6386,2091,6540
313240,202109,10638,25488,7002,19802,940,3043,3341,8778,4281,11821
313250,202109,6399,18310,4861,14993,897,2737,2136,6345,3033,9082
313260,202109,739,1861,537,1511,65,231,270,676,335,907
313270,202109,6053,14458,4911,12915,521,1217,3470,9397,3991,10614
313280,202109,483,1307,316,968,36,121,131,380,167,501
313290,202109,1026,3094,772,2640,181,693,284,951,465,1644
313300,202109,1702,4447,1265,3696,303,954,344,888,647,1842
313310,202109,1297,3749,1018,3173,152,552,307,812,459,1364
313320,202109,2163,5616,1556,4655,268,905,580,1787,848,2692
313330,202109,4310,10967,3276,9417,146,485,2148,6138,2294,6623
313340,202109,1470,3242,1059,2675,76,209,764,1896,840,2105
313350,202109,3104,8389,2046,6051,229,773,791,2017,1020,2790
313360,202109,1591,3805,1091,3002,164,555,575,1441,739,1996
313370,202109,1608,4305,1309,3731,187,585,587,1512,774,2097
313375,202109,1895,4887,1216,3611,227,724,253,696,480,1420
313380,202109,6663,16281,4842,13016,746,2262,2377,5673,3123,7935
313390,202109,821,2565,715,2382,52,219,480,1543,532,1762
313400,202109,3818,9153,2938,7931,114,330,2260,5988,2374,6318
313410,202109,1424,3551,1077,2953,90,268,736,1936,826,2204
313420,202109,16373,35738,8666,23003,1973,5839,1141,2979,3114,8818
313430,202109,1009,2838,786,2380,109,412,383,1007,492,1419
313440,202109,6389,13604,4333,10954,315,828,2908,7331,3223,8159
313450,202109,770,2005,546,1579,92,285,196,487,288,772
313460,202109,2217,6137,1753,5399,346,1199,798,2341,1144,3540
313470,202109,2939,7291,2319,6387,196,533,1591,4446,1787,4979
313480,202109,1098,3054,673,2131,49,168,239,698,288,866
313490,202109,3150,7598,1648,4853,373,1191,417,1199,790,2390
313500,202109,571,1525,417,1199,31,86,180,476,211,562
313505,202109,10500,27012,8944,24898,336,1049,7171,19986,7507,21035
313507,202109,1522,3812,1242,3379,33,133,998,2625,1031,2758
313510,202109,14865,39836,11563,33374,1355,3810,5511,15597,6866,19407
313520,202109,15304,41239,12202,35967,571,1853,9167,26469,9738,28322
313530,202109,583,1686,440,1387,50,180,143,377,193,557
313535,202109,2462,6648,2020,5819,269,704,1243,3598,1512,4302
313540,202109,842,2416,678,2034,119,367,290,787,409,1154
313545,202109,1171,3768,990,3416,121,449,543,1790,664,2239
313550,202109,1869,5486,1553,4748,282,943,842,2480,1124,3423
313560,202109,2858,5414,2145,4553,63,96,1818,3893,1881,3989
313570,202109,1036,2884,847,2554,201,618,344,1025,545,1643
313580,202109,6228,15234,4892,13035,476,1287,3015,7977,3491,9264
313590,202109,1135,3039,913,2712,176,547,462,1459,638,2006
313600,202109,4284,10905,3573,9827,83,287,3063,8281,3146,8568
313610,202109,1102,2668,888,2309,79,221,584,1438,663,1659
313620,202109,5569,14414,4377,12280,474,1530,2613,7023,3087,8553
313630,202109,9198,21598,6578,17705,620,1931,4015,10495,4635,12426
313640,202109,1281,2696,802,2092,129,358,446,1168,575,1526
313650,202109,1734,5067,1365,4452,93,355,880,2902,973,3257
313652,202109,813,2433,731,2280,85,283,496,1492,581,1775
313655,202109,1178,2867,911,2533,60,163,660,1860,720,2023
313657,202109,1207,3110,949,2700,27,93,719,1937,746,2030
313660,202109,1019,2784,830,2457,72,258,537,1523,609,1781
313665,202109,5308,13677,4222,11812,388,1221,2712,7217,3100,8438
313670,202109,52793,126628,34634,96115,4579,13878,16255,42405,20834,56283
313680,202109,1092,2822,904,2509,51,153,627,1700,678,1853
313690,202109,889,2634,652,2169,140,515,192,603,332,1118
313695,202109,1934,4972,1440,4157,105,290,916,2745,1021,3035
313700,202109,3048,9317,2659,8799,240,742,2036,6827,2276,7569
313710,202109,1525,3369,1088,2789,69,182,734,1893,803,2075
313720,202109,6240,16675,4487,13040,613,1882,1880,4994,2493,6876
313730,202109,1468,3130,1082,2632,83,169,712,1764,795,1933
313740,202109,1754,6112,1471,5384,294,1225,292,926,586,2151
313750,202109,2143,5528,1680,4737,282,888,851,2229,1133,3117
313753,202109,2290,5407,1520,4138,155,474,819,2146,974,2620
313760,202109,5889,15811,4566,13259,791,2562,2170,5815,2961,8377
313770,202109,4193,11419,3322,10045,166,479,2506,7705,2672,8184
313780,202109,4221,10809,3130,9049,258,828,976,2931,1234,3759
313790,202109,542,1573,481,1466,55,181,293,865,348,1046
313800,202109,1437,3125,1049,2598,96,263,576,1357,672,1620
313810,202109,1726,4194,1396,3733,49,158,1096,2858,1145,3016
313820,202109,18544,46496,11707,32082,1955,5463,2982,7926,4937,13389
313830,202109,413,1173,293,905,53,188,105,292,158,480
313835,202109,931,2648,772,2368,71,261,418,1193,489,1454
313840,202109,7924,20187,6144,17281,1353,4098,1318,3810,2671,7908
313850,202109,1015,2440,803,2154,140,434,376,910,516,1344
313860,202109,2743,7061,2079,5843,277,914,970,2460,1247,3374
313862,202109,1326,2749,649,1774,43,124,292,790,335,914
313865,202109,2702,6919,2235,6179,89,257,1698,4593,1787,4850
313867,202109,1446,4267,1203,3824,222,696,611,2009,833,2705
313868,202109,1763,5204,1453,4613,45,177,1115,3428,1160,3605
313870,202109,1049,2656,704,2029,94,283,279,731,373,1014
313880,202109,1937,4874,1424,3997,166,525,739,1891,905,2416
313890,202109,2188,4539,1643,3833,28,86,1280,2893,1308,2979
313900,202109,4829,13358,3429,10467,803,2691,863,2323,1666,5014
313910,202109,733,2091,553,1741,96,326,114,355,210,681
313920,202109,3048,8874,2535,7820,486,1503,1270,3963,1756,5466
313925,202109,1669,4093,1349,3550,134,341,925,2421,1059,2762
313930,202109,4928,14103,3997,12450,279,944,2637,8092,2916,9036
313940,202109,9389,26316,6978,22180,674,2588,1773,6388,2447,8976
313950,202109,5561,11905,4225,10281,305,914,2764,6777,3069,7691
313960,202109,5951,13960,4002,10707,735,2220,1273,3069,2008,5289
313970,202109,1582,4133,1331,3719,22,69,862,2357,884,2426
313980,202109,1330,3397,886,2722,143,480,369,1070,512,1550
313990,202109,2012,6172,1479,5008,305,1200,573,1719,878,2919
314000,202109,10480,25792,8631,22720,637,2061,5719,14738,6356,16799
314010,202109,1508,3511,1193,3086,33,103,923,2313,956,2416
314015,202109,2074,5534,1604,4724,175,607,916,2576,1091,3183
314020,202109,540,1422,373,1134,87,318,73,241,160,559
314030,202109,828,2300,649,1968,80,228,324,982,404,1210
314040,202109,606,1627,499,1431,81,264,256,698,337,962
314050,202109,1982,5115,1468,4165,133,443,828,2193,961,2636
314053,202109,1983,5725,1593,4959,316,954,854,2779,1170,3733
314055,202109,2312,5965,1952,5424,41,153,1622,4487,1663,4640
314060,202109,1362,3505,1031,2989,29,89,737,2111,766,2200
314070,202109,5017,13244,3955,11384,721,2070,1819,5152,2540,7222
314080,202109,2221,5578,1541,4430,164,519,684,1779,848,2298
314085,202109,2410,6383,1964,5721,179,525,1203,3540,1382,4065
314090,202109,5097,13041,4374,11980,257,785,2906,8238,3163,9023
314100,202109,3112,7358,2401,6374,37,108,1798,4807,1835,4915
314110,202109,5228,14164,4250,12346,488,1570,2342,6295,2830,7865
314120,202109,740,1690,328,945,56,183,92,247,148,430
314130,202109,670,1755,438,1330,24,83,258,760,282,843
314140,202109,4704,12742,3755,11025,485,1460,1922,5549,2407,7009
314150,202109,1563,3813,1144,3102,67,172,774,2064,841,2236
314160,202109,2388,5967,1743,4809,215,644,774,2124,989,2768
314170,202109,957,2612,781,2270,39,149,519,1402,558,1551
314180,202109,5726,15320,4611,13548,356,1085,2808,8256,3164,9341
314190,202109,650,1593,487,1357,76,241,260,674,336,915
314200,202109,3121,8470,2578,7567,175,543,1788,5145,1963,5688
314210,202109,2171,5486,1720,4688,230,661,780,2066,1010,2727
314220,202109,1543,4071,1175,3443,220,719,472,1274,692,1993
314225,202109,1129,3175,933,2830,77,207,657,2006,734,2213
314230,202109,849,2147,691,1942,75,219,443,1282,518,1501
314240,202109,1134,2964,879,2575,186,569,359,1057,545,1626
314250,202109,501,1393,317,996,49,139,114,337,163,476
314260,202109,1048,2675,809,2356,155,497,429,1213,584,1710
314270,202109,3380,9281,2776,8344,66,259,2080,6189,2146,6448
314280,202109,3601,8130,2446,6385,257,751,1416,3480,1673,4231
314290,202109,4636,11678,3849,10291,338,903,2618,6853,2956,7756
314300,202109,2105,5788,1368,4234,241,821,467,1286,708,2107
314310,202109,4024,10316,2700,8042,792,2612,407,1051,1199,3663
314315,202109,1006,3156,858,2848,42,173,612,1984,654,2157
314320,202109,3244,8611,2144,6562,367,1227,793,2282,1160,3509
314330,202109,52748,143841,40166,121821,10055,31749,8697,27473,18752,59222
314340,202109,2560,6296,1620,4628,296,978,411,1015,707,1993
314345,202109,1501,4260,1213,3743,130,393,761,2320,891,2713
314350,202109,844,2259,548,1721,120,388,124,315,244,703
314360,202109,565,1626,367,1210,52,176,122,361,174,537
314370,202109,778,2006,627,1784,49,148,418,1160,467,1308
314380,202109,1168,3096,770,2401,173,615,173,520,346,1135
314390,202109,14988,36688,10071,27972,1516,4570,3566,8772,5082,13342
314400,202109,4048,11852,3121,10022,786,2644,1159,3906,1945,6550
314410,202109,2917,8001,2038,6330,258,934,628,2018,886,2952
314420,202109,859,2077,632,1713,31,110,431,1117,462,1227
314430,202109,8284,19415,5836,15436,849,2359,2793,7007,3642,9366
314435,202109,1967,5155,1530,4441,160,484,930,2638,1090,3122
314437,202109,936,2322,672,1898,72,214,349,978,421,1192
314440,202109,640,1791,456,1429,143,501,88,212,231,713
314450,202109,1481,3824,1234,3417,135,398,695,1854,830,2252
314460,202109,3251,9670,2389,7904,577,2036,594,1859,1171,3895
314465,202109,2291,6407,1944,5762,46,150,1518,4394,1564,4544
314467,202109,917,2365,773,2138,18,49,616,1656,634,1705
314470,202109,2441,6754,2015,5908,341,1072,940,2559,1281,3631
314480,202109,7899,21335,5954,17315,916,2944,2408,6176,3324,9120
314490,202109,1138,2888,839,2294,62,182,547,1448,609,1630
314500,202109,1753,4105,1277,3481,335,869,428,1242,763,2111
314505,202109,2160,5081,1767,4535,89,252,1330,3306,1419,3558
314510,202109,2101,5312,1483,4371,295,965,674,1922,969,2887
314520,202109,5498,16206,4233,13703,848,3000,693,1986,1541,4986
314530,202109,5570,17267,4993,16194,303,1156,3721,11799,4024,12955
314535,202109,2667,6703,2173,5992,81,273,1694,4659,1775,4932
314537,202109,1195,3306,918,2857,50,166,671,2053,721,2219
314540,202109,421,1032,295,827,21,63,175,468,196,531
314545,202109,2025,4681,1815,4439,31,80,1590,3973,1621,4053
314550,202109,763,1784,552,1465,35,118,329,796,364,914
314560,202109,4815,13842,3525,11043,477,1697,1348,3713,1825,5410
314570,202109,323,881,233,717,29,97,110,340,139,437
314580,202109,466,1369,373,1188,97,312,125,394,222,706
314585,202109,678,2035,522,1695,55,213,239,747,294,960
314587,202109,2213,5824,1696,5007,321,894,926,2770,1247,3664
314590,202109,4366,11419,3241,9369,405,1303,1521,4010,1926,5313
314600,202109,1994,5266,1205,3784,255,838,139,415,394,1253
314610,202109,9443,22847,6848,19049,952,3127,3180,8994,4132,12121
314620,202109,2349,5339,1872,4736,42,124,1578,3975,1620,4099
314625,202109,1606,4244,1378,3926,25,143,1194,3326,1219,3469
314630,202109,5649,13707,4610,12307,107,401,3825,10141,3932,10542
314640,202109,728,1682,538,1387,63,187,321,766,384,953
314650,202109,851,1951,539,1462,49,155,309,744,358,899
314655,202109,1615,4340,1160,3543,167,480,583,1809,750,2289
314660,202109,342,764,232,575,12,26,152,366,164,392
314670,202109,1692,3739,1176,3001,21,59,804,2006,825,2065
314675,202109,1765,4483,1492,4034,66,190,1180,3119,1246,3309
314690,202109,2127,5698,1605,4926,389,1306,575,1752,964,3058
314700,202109,11521,30755,7748,23691,1341,4452,2862,8385,4203,12837
314710,202109,8468,23116,6222,18437,926,3057,2389,6156,3315,9213
314720,202109,2290,6653,1607,5246,292,1020,362,1083,654,2103
314730,202109,2492,6328,1785,5065,296,910,653,1689,949,2599
314740,202109,3139,8655,2458,7440,329,1022,1253,3684,1582,4706
314750,202109,294,791,224,648,27,90,136,344,163,434
314760,202109,2034,5847,1314,4260,233,845,317,798,550,1643
314770,202109,1118,3156,632,1976,66,212,191,540,257,752
314780,202109,372,901,253,712,37,120,143,357,180,477
314790,202109,12529,32347,8913,25734,1552,5070,3591,9580,5143,14650
314795,202109,1595,4083,1351,3673,27,113,1091,2847,1118,2960
314800,202109,11388,28477,7244,20963,1253,3907,1954,5011,3207,8918
314810,202109,9533,24609,6959,20208,1790,5500,2207,6257,3997,11757
314820,202109,1305,3072,1018,2634,63,205,637,1555,700,1760
314830,202109,1712,4885,1430,4375,202,653,739,2197,941,2850
314840,202109,874,2666,680,2324,47,210,465,1506,512,1716
314850,202109,2329,5038,1883,4485,49,138,1626,3852,1675,3990
314860,202109,3374,9497,2819,8508,148,587,2028,5943,2176,6530
314870,202109,6684,15806,5065,13754,229,642,3782,10429,4011,11071
314875,202109,1909,5532,1693,5243,185,470,1311,4212,1496,4682
314880,202109,864,2052,669,1750,40,108,413,1088,453,1196
314890,202109,450,1316,347,1105,52,176,151,454,203,630
314900,202109,838,2136,643,1800,85,263,294,790,379,1053
314910,202109,1723,4755,1282,4032,203,743,652,1907,855,2650
314915,202109,2225,6423,1869,5791,120,357,1229,3748,1349,4105
314920,202109,512,1313,347,1068,18,46,226,714,244,760
314930,202109,5910,16239,4518,13627,725,2461,1898,5226,2623,7687
314940,202109,428,1010,355,892,38,88,230,558,268,646
314950,202109,583,1429,402,1146,26,85,220,580,246,665
314960,202109,892,2044,683,1707,24,73,501,1185,525,1258
314970,202109,1033,3005,793,2516,126,438,365,1052,491,1490
314980,202109,1678,4163,1273,3566,209,655,655,1775,864,2430
314990,202109,2652,7546,1895,5839,365,1155,416,1164,781,2319
314995,202109,1709,4631,1365,4026,25,99,934,2590,959,2689
315000,202109,1156,2886,830,2384,63,180,534,1521,597,1701
315010,202109,385,1042,299,896,49,173,147,415,196,588
315015,202109,2359,6445,2049,5930,190,629,1364,3869,1554,4498
315020,202109,808,2321,574,1810,59,215,254,750,313,965
315030,202109,630,1635,426,1269,95,295,89,227,184,522
315040,202109,934,2453,765,2160,101,322,482,1298,583,1620
315050,202109,1278,3158,946,2638,53,188,527,1392,580,1580
315053,202109,1190,3016,898,2519,56,153,530,1418,586,1571
315057,202109,1839,5296,1488,4716,143,404,987,3260,1130,3664
315060,202109,621,1824,456,1492,92,300,113,361,205,661
315070,202109,579,1457,418,1185,99,298,135,362,234,660
315080,202109,3317,8760,2575,7419,135,422,1794,4913,1929,5335
315090,202109,832,2445,623,2051,81,298,264,828,345,1126
315100,202109,1391,3960,918,2901,124,464,406,1117,530,1581
315110,202109,2145,4949,1553,4073,138,356,800,2148,938,2504
315120,202109,13257,29881,9818,24813,1165,2667,5553,14527,6718,17194
315130,202109,1723,4609,1441,4137,144,476,611,1624,755,2100
315140,202109,3035,8231,2397,7111,442,1450,1196,3324,1638,4774
315150,202109,4519,10743,3213,8688,436,1381,1554,4097,1990,5478
315160,202109,1890,4563,1284,3611,263,795,582,1584,845,2379
315170,202109,1402,4348,994,3368,204,746,272,868,476,1614
315180,202109,18328,43607,10487,29379,1304,4112,3646,8925,4950,13037
315190,202109,2292,4945,1790,4293,242,579,1236,3016,1478,3595
315200,202109,4203,11493,3106,9626,826,2789,780,2338,1606,5127
315210,202109,9248,23268,6486,17646,682,2012,3330,8147,4012,10159
315213,202109,1145,2972,992,2757,19,68,821,2227,840,2295
315217,202109,2939,8164,2228,6975,78,299,1510,4545,1588,4844
315220,202109,8904,23538,7045,20341,1004,2994,3359,9702,4363,12696
315230,202109,3114,7032,2595,6333,207,328,1832,4844,2039,5172
315240,202109,2527,7148,2102,6420,446,1420,986,3028,1432,4448
315250,202109,14439,37967,10570,30766,1589,4961,4505,12461,6094,17422
315260,202109,930,2480,520,1641,82,257,38,106,120,363
315270,202109,907,2558,667,2107,87,296,235,645,322,941
315280,202109,2965,7318,1871,5381,466,1429,332,928,798,2357
315290,202109,1202,2907,725,2151,183,602,211,611,394,1213
315300,202109,664,1591,477,1328,57,178,279,774,336,952
315310,202109,1289,3479,981,2914,69,221,575,1596,644,1817
315320,202109,676,1935,475,1535,64,232,194,575,258,807
315330,202109,809,2584,466,1688,64,263,160,517,224,780
315340,202109,3069,7283,2162,5931,355,987,1055,2862,1410,3849
315350,202109,1652,4381,1332,3885,158,537,810,2312,968,2849
315360,202109,1828,5210,1417,4390,197,648,618,1759,815,2407
315370,202109,564,1520,454,1317,81,229,208,589,289,818
315380,202109,272,756,197,595,33,113,27,70,60,183
315390,202109,1213,3320,979,2903,123,441,519,1399,642,1840
315400,202109,4236,11144,3348,9581,390,1182,1956,5320,2346,6502
315410,202109,2592,5720,1930,4756,387,1054,407,1045,794,2099
315415,202109,1494,3957,1208,3517,252,850,426,1232,678,2082
315420,202109,1543,4196,1069,3317,183,601,237,689,420,1290
315430,202109,3766,8967,2662,7327,435,1391,1206,3140,1641,4531
315440,202109,1091,2804,860,2427,73,244,506,1325,579,1569
315445,202109,2015,4700,1470,3926,86,265,1104,2903,1190,3168
315450,202109,2394,6358,1956,5637,260,651,1194,3492,1454,4143
315460,202109,41395,110484,34219,97865,4347,14133,19854,53053,24201,67186
315470,202109,687,1858,487,1384,37,122,272,726,309,848
315480,202109,1192,3339,857,2647,146,461,295,868,441,1329
315490,202109,3007,7441,2114,6021,282,813,823,2218,1105,3031
315500,202109,546,1429,345,1000,41,142,177,444,218,586
315510,202109,1309,3304,1103,3015,12,41,978,2628,990,2669
315520,202109,1041,2754,855,2457,46,144,666,1867,712,2011
315530,202109,641,1726,515,1503,112,378,276,745,388,1123
315540,202109,1681,4332,1144,3329,93,306,511,1418,604,1724
315550,202109,1909,4958,1259,3766,240,829,331,976,571,1805
315560,202109,6608,19223,5634,17489,321,924,3860,12126,4181,13050
315570,202109,2185,5686,1733,4925,174,542,887,2418,1061,2960
315580,202109,3242,7421,2509,6271,384,1028,952,2235,1336,3263
315590,202109,956,2316,744,1996,52,171,485,1223,537,1394
315600,202109,2625,7829,1847,6306,323,992,883,3253,1206,4245
315610,202109,1029,2525,773,2076,103,345,364,841,467,1186
315620,202109,543,1413,415,1221,48,156,220,651,268,807
315630,202109,1102,2831,835,2345,119,368,411,1056,530,1424
315640,202109,362,881,272,770,29,107,167,448,196,555
315645,202109,1015,2557,707,2059,151,477,190,516,341,993
315650,202109,1749,4107,1413,3641,43,123,1132,2845,1175,2968
315660,202109,2485,6047,1861,4976,88,257,1342,3454,1430,3711
315670,202109,14742,38957,11286,32780,2046,6255,5246,14460,7292,20715
315680,202109,3318,9183,2477,7610,254,916,1409,4095,1663,5011
315690,202109,3793,9078,2338,6633,492,1384,587,1818,1079,3202
315700,202109,8737,23201,6602,19075,962,2913,2993,8216,3955,11129
315710,202109,1924,4586,1380,3778,54,174,969,2590,1023,2764
315720,202109,4582,12366,3793,10968,175,663,2696,7488,2871,8151
315725,202109,2332,5862,1787,4992,227,595,1074,3153,1301,3748
315727,202109,582,1449,443,1231,51,171,194,507,245,678
315730,202109,615,1826,533,1668,93,330,181,498,274,828
315733,202109,1376,3391,1029,2822,151,469,395,1007,546,1476
315737,202109,1213,3294,953,2793,29,105,684,1924,713,2029
315740,202109,829,2264,670,1944,63,204,446,1210,509,1414
315750,202109,1304,3338,1043,2935,91,258,653,1856,744,2114
315760,202109,1199,2765,1044,2557,48,153,866,2066,914,2219
315765,202109,2036,5177,1668,4699,28,99,1478,4149,1506,4248
315770,202109,1049,2820,814,2491,317,1061,163,445,480,1506
315780,202109,32219,85262,26909,75816,1417,4843,18620,49781,20037,54624
315790,202109,3707,11147,3154,10129,307,1029,1943,6393,2250,7422
315800,202109,1370,4489,1034,3678,140,548,382,1184,522,1732
315810,202109,1366,3325,1125,2917,60,172,876,2201,936,2373
315820,202109,2732,7005,2184,6246,208,603,1527,4395,1735,4998
315830,202109,1253,3618,844,2717,88,308,274,746,362,1054
315840,202109,922,2176,655,1710,49,159,350,825,399,984
315850,202109,1242,3479,980,3030,169,538,493,1452,662,1990
315860,202109,507,1411,353,1141,56,197,123,346,179,543
315870,202109,490,1293,390,1128,26,82,274,760,300,842
315880,202109,1156,2863,804,2243,96,285,245,642,341,927
315890,202109,1771,4888,1433,4422,349,1202,714,2177,1063,3379
315895,202109,6566,17328,4917,14135,448,1443,2569,6851,3017,8294
315900,202109,831,2105,715,1942,64,173,522,1389,586,1562
315910,202109,544,1449,458,1319,71,198,300,869,371,1067
315920,202109,1495,3729,850,2518,128,459,278,729,406,1188
315930,202109,1156,2497,778,1955,137,322,344,877,481,1199
315935,202109,920,2691,730,2327,139,459,263,824,402,1283
315940,202109,634,1672,501,1473,67,206,262,743,329,949
315950,202109,1176,3208,972,2876,97,281,740,2195,837,2476
315960,202109,5861,16020,4025,12352,1052,3533,571,1240,1623,4773
315970,202109,600,1563,479,1402,59,176,313,935,372,1111
315980,202109,4451,9359,2491,6210,462,1208,970,2201,1432,3409
315990,202109,3659,9212,2858,7837,335,929,1566,4159,1901,5088
316000,202109,670,1601,513,1373,51,162,278,702,329,864
316010,202109,825,2225,615,1853,60,200,308,832,368,1032
316020,202109,967,2796,773,2420,118,410,416,1208,534,1618
316030,202109,2824,7705,2176,6534,251,761,1372,4207,1623,4968
316040,202109,2724,7568,2018,6236,322,1149,572,1530,894,2679
316045,202109,2140,5386,1968,5175,82,156,1719,4628,1801,4784
316050,202109,414,1120,324,972,49,132,177,500,226,632
316060,202109,708,1694,521,1447,17,68,374,994,391,1062
316070,202109,5672,15234,4629,13302,815,2307,2144,5993,2959,8300
316080,202109,772,2343,601,1994,149,535,96,266,245,801
316090,202109,421,1156,328,977,44,141,168,454,212,595
316095,202109,1354,4086,1054,3340,268,910,376,1113,644,2023
316100,202109,2545,7196,1854,5776,307,1049,705,1990,1012,3039
316105,202109,868,2214,706,1961,44,138,483,1375,527,1513
316110,202109,14367,39736,11997,35806,820,2714,8317,24442,9137,27156
316120,202109,1293,3497,852,2506,131,401,283,657,414,1058
316130,202109,1283,2873,850,2160,69,200,507,1239,576,1439
316140,202109,1278,3340,804,2441,84,275,372,1117,456,1392
316150,202109,2173,4729,1743,4135,210,618,797,1779,1007,2397
316160,202109,1055,2763,846,2384,37,123,606,1664,643,1787
316165,202109,906,2160,716,1873,117,349,407,999,524,1348
316170,202109,1291,3098,981,2638,48,147,685,1752,733,1899
316180,202109,1532,4217,1070,3318,157,545,267,740,424,1285
316190,202109,2808,7783,1681,5113,242,776,663,1784,905,2560
316200,202109,3418,9557,2647,8238,563,1859,850,2572,1413,4431
316210,202109,4946,14212,3504,10861,1139,3915,205,478,1344,4393
316220,202109,687,2038,461,1555,84,318,58,229,142,547
316225,202109,1624,3627,1223,3001,49,178,937,2142,986,2320
316230,202109,451,1205,347,1026,57,178,167,490,224,668
316240,202109,5734,16237,5013,14963,367,1177,3776,11094,4143,12271
316245,202109,3307,10123,2996,9606,104,550,2406,7384,2510,7934
316250,202109,11268,26375,8365,21779,1664,4637,3120,8043,4784,12680
316255,202109,2997,8109,2618,7517,111,312,1988,5801,2099,6113
316257,202109,1444,3385,1052,2718,94,256,671,1649,765,1905
316260,202109,2357,5621,1864,4850,222,565,1004,2661,1226,3226
316265,202109,1159,3073,905,2637,16,56,686,1951,702,2007
316270,202109,3871,11510,3322,10355,489,1591,1706,5079,2195,6670
316280,202109,3086,8318,2628,7492,344,1064,1426,3911,1770,4975
316290,202109,3728,10028,3014,8697,368,1137,1173,3255,1541,4392
316292,202109,5605,14408,4471,12580,586,1689,2800,7626,3386,9315
316294,202109,892,2577,678,2216,119,462,171,510,290,972
316295,202109,3496,9590,2852,8484,149,547,1997,5654,2146,6201
316300,202109,1055,2887,839,2543,33,107,592,1776,625,1883
316310,202109,819,2157,551,1680,121,423,112,284,233,707
316320,202109,712,1939,560,1705,54,188,270,798,324,986
316330,202109,1119,2828,856,2390,52,162,657,1788,709,1950
316340,202109,1020,2690,762,2227,84,303,421,1163,505,1466
316350,202109,1382,3735,1140,3327,158,464,693,2008,851,2472
316360,202109,652,1699,545,1523,47,141,413,1151,460,1292
316370,202109,5801,14453,4455,12126,602,1875,2139,5209,2741,7084
316380,202109,1780,4234,1403,3686,55,110,971,2571,1026,2681
316390,202109,797,2122,573,1735,237,815,84,217,321,1032
316400,202109,1240,3427,819,2594,105,362,287,809,392,1171
316410,202109,1168,3135,975,2845,54,173,791,2251,845,2424
316420,202109,2029,5411,1770,5079,38,126,1453,4087,1491,4213
316430,202109,910,2300,615,1806,97,329,258,675,355,1004
316440,202109,854,2573,683,2272,121,459,196,590,317,1049
316443,202109,572,1557,424,1275,92,303,107,303,199,606
316447,202109,2116,5473,1834,5030,25,82,1610,4363,1635,4445
316450,202109,2233,6488,1709,5408,244,808,972,2985,1216,3793
316460,202109,1306,3281,1068,2914,114,344,704,1826,818,2170
316470,202109,7402,20668,5382,16463,800,2738,2175,6002,2975,8740
316480,202109,205,554,178,518,47,135,81,232,128,367
316490,202109,334,880,235,698,38,116,80,201,118,317
316500,202109,1259,3797,845,2824,174,644,188,569,362,1213
316510,202109,824,2590,658,2260,109,378,334,1151,443,1529
316520,202109,1404,3314,1100,2824,122,383,596,1382,718,1765
316530,202109,1171,2997,849,2423,86,327,444,1127,530,1454
316540,202109,975,2424,783,2135,103,307,429,1067,532,1374
316550,202109,1403,3970,1203,3609,40,148,947,2806,987,2954
316553,202109,4621,13215,3351,10246,438,1476,1382,3714,1820,5190
316555,202109,2762,8169,2473,7774,85,267,2089,6607,2174,6874
316556,202109,538,1301,415,1081,25,70,259,605,284,675
316557,202109,1125,3351,975,3118,322,1125,348,1052,670,2177
316560,202109,352,962,251,811,38,143,103,308,141,451
316570,202109,1423,3935,1185,3515,290,851,395,1234,685,2085
316580,202109,408,847,258,610,32,83,135,299,167,382
316590,202109,1395,3488,978,2691,218,525,458,1242,676,1767
316600,202109,960,2879,823,2605,132,428,422,1337,554,1765
316610,202109,616,1868,505,1697,52,215,302,983,354,1198
316620,202109,2217,5584,1944,5197,86,246,1567,4167,1653,4413
316630,202109,1618,4718,1341,4204,351,1112,505,1763,856,2875
316640,202109,146,385,117,343,16,57,56,136,72,193
316650,202109,1096,3294,880,2960,83,299,553,1860,636,2159
316660,202109,202,473,86,242,11,34,18,36,29,70
316670,202109,1804,4472,1366,3782,344,981,423,1134,767,2115
316680,202109,2367,5923,1752,4770,110,319,1293,3432,1403,3751
316690,202109,1471,4038,1117,3403,184,602,490,1437,674,2039
316695,202109,1052,2993,872,2672,31,112,605,1833,636,1945
316700,202109,413,919,339,836,14,40,273,649,287,689
316710,202109,3351,10463,2638,9004,438,1636,1211,4000,1649,5636
316720,202109,22043,58496,16472,47988,2701,8423,7314,19983,10015,28406
316730,202109,490,1247,392,1071,39,118,199,509,238,627
316740,202109,792,2223,687,2059,76,261,434,1312,510,1573
316750,202109,415,1162,317,983,70,232,132,381,202,613
316760,202109,3591,11195,3022,10097,1138,4155,784,2498,1922,6653
316770,202109,1667,3642,1262,3104,27,68,1021,2572,1048,2640
316780,202109,566,1620,445,1389,159,533,94,272,253,805
316790,202109,764,2029,560,1626,100,323,161,431,261,754
316800,202109,6722,18299,5385,15886,647,2069,2561,7362,3208,9431
316805,202109,1089,2346,874,2109,56,157,681,1640,737,1797
316810,202109,634,1726,455,1390,77,261,257,754,334,1015
316820,202109,330,766,179,501,17,64,80,208,97,272
316830,202109,857,2158,676,1873,76,206,411,1141,487,1347
316840,202109,2905,7240,2313,6272,179,586,1656,4278,1835,4864
316850,202109,2035,5182,1499,4237,230,711,703,1848,933,2559
316860,202109,20879,51861,15331,43530,2274,7499,7090,19393,9364,26892
316870,202109,8400,22081,6291,18077,864,2725,2951,7887,3815,10612
316880,202109,1025,2671,840,2402,142,457,444,1200,586,1657
316890,202109,1199,2644,730,2028,83,300,470,1227,553,1527
316900,202109,2462,6430,1940,5414,396,1166,612,1599,1008,2765
316905,202109,520,1528,418,1329,111,382,168,539,279,921
316910,202109,902,2309,549,1690,123,416,50,144,173,560
316920,202109,1856,4458,1321,3665,205,615,685,1846,890,2461
316930,202109,8512,23621,6436,19921,1490,4891,1825,5288,3315,10179
316935,202109,4369,11439,3222,9334,548,1753,1311,3472,1859,5225
316940,202109,6712,19183,5232,16196,745,2504,2269,6499,3014,9003
316950,202109,2007,4545,1559,3933,45,128,1304,3255,1349,3383
316960,202109,5292,11647,3817,9675,360,992,2604,6463,2964,7455
316970,202109,4006,10868,3456,9879,493,1435,1527,4126,2020,5561
316980,202109,717,2111,546,1786,167,612,78,256,245,868
316990,202109,12940,33800,9600,27136,2182,6661,1610,4156,3792,10817
317000,202109,2563,7325,2248,6882,193,449,1656,5186,1849,5635
317005,202109,2671,7230,2122,6147,330,988,1154,3274,1484,4262
317010,202109,25548,59061,16267,44885,2933,8975,6557,18138,9490,27113
317020,202109,64953,152669,38993,107894,6929,20993,12862,32690,19791,53683
317030,202109,696,1800,547,1595,12,43,422,1218,434,1261
317040,202109,11528,28341,8108,22558,1709,5092,2820,8079,4529,13171
317043,202109,922,2021,667,1665,48,124,485,1187,533,1311
317047,202109,1206,2871,835,2280,67,203,540,1420,607,1623
317050,202109,1257,3794,916,3008,119,434,369,1037,488,1471
317052,202109,2469,6636,1978,5865,256,731,1238,3703,1494,4434
317057,202109,2078,4605,1528,3773,31,110,1103,2637,1134,2747
317060,202109,549,1419,343,1004,44,139,144,378,188,517
317065,202109,1177,3395,966,2991,62,178,606,1791,668,1969
317070,202109,7693,21007,5644,17062,919,3085,1927,5429,2846,8514
317075,202109,979,2469,733,2061,84,269,386,996,470,1265
317080,202109,6541,14878,4860,12225,1215,3316,1753,4278,2968,7594
317090,202109,4971,13909,4390,12978,296,778,3248,9680,3544,10458
317100,202109,2715,6344,1773,4807,408,1134,646,1735,1054,2869
317103,202109,2340,5923,2002,5449,70,297,1605,4203,1675,4500
317107,202109,1523,3951,1161,3289,72,237,711,1817,783,2054
317110,202109,680,1570,352,1055,64,220,108,334,172,554
317115,202109,1108,3137,945,2831,69,203,622,1864,691,2067
317120,202109,17300,45052,14154,39982,1064,3566,9153,24573,10217,28139
317130,202109,12148,27581,8040,20901,1189,3405,2936,7482,4125,10887
317140,202109,951,2227,744,1912,51,147,512,1335,563,1482
317150,202109,1011,2395,778,2100,32,95,621,1646,653,1741
317160,202109,3716,8646,2483,6727,132,378,1369,3830,1501,4208
317170,202109,1884,4645,1388,3793,169,544,684,1657,853,2201
317180,202109,2066,6224,1515,4918,291,974,393,1145,684,2119
317190,202109,1225,3265,906,2738,205,605,397,1199,602,1804
317200,202109,6364,16530,4720,13280,1002,3013,1163,2965,2165,5978
317210,202109,1235,2925,957,2548,29,107,701,1888,730,1995
317220,202109,289,841,244,759,46,154,115,354,161,508
320010,202109,4921,13942,3832,11724,410,1384,2362,6988,2772,8372
320013,202109,2184,5755,1515,4451,235,692,681,2099,916,2791
320016,202109,3111,7794,2448,6787,204,537,1749,4891,1953,5428
320020,202109,4317,10931,3200,8994,606,1897,1262,3587,1868,5484
320030,202109,1815,4948,1187,3685,215,719,409,1209,624,1928
320035,202109,2030,5340,1657,4721,378,1210,792,2145,1170,3355
320040,202109,4608,12680,3838,11295,526,1618,2140,6021,2666,7639
320050,202109,1797,4042,1551,3697,183,507,927,2136,1110,2643
320060,202109,14472,38436,10739,30874,1642,5077,4929,13092,6571,18169
320070,202109,1728,4648,1238,3679,196,658,490,1308,686,1966
320080,202109,6034,15156,4215,11544,839,2412,1535,3952,2374,6364
320090,202109,9078,23563,6014,17316,1325,4047,2140,5684,3465,9731
320100,202109,3351,8795,2746,7763,432,1303,1471,4145,1903,5448
320110,202109,2263,5163,1586,4099,195,543,856,2094,1051,2637
320115,202109,2158,6613,1844,6101,774,2683,531,1849,1305,4532
320120,202109,26160,65304,18458,51507,2497,7446,8804,23084,11301,30530
320130,202109,52975,141580,43571,124620,5098,15922,26168,72006,31266,87928
320140,202109,3871,10387,2612,7897,367,1297,1106,3218,1473,4515
320150,202109,14988,37921,10749,29968,2580,7921,1540,3788,4120,11709
320160,202109,6723,18154,4989,14862,760,2448,2190,6371,2950,8819
320170,202109,1864,5223,1350,4190,368,1123,483,1617,851,2740
320180,202109,716,2231,570,1950,191,708,144,438,335,1146
320190,202109,3065,9487,2358,7927,582,2107,570,1748,1152,3855
320200,202109,1414,3754,965,2946,213,721,309,908,522,1629
320210,202109,4615,11529,3545,9719,575,1698,1795,4656,2370,6354
320220,202109,3512,8829,2722,7537,372,1127,1537,3977,1909,5104
320225,202109,1458,4412,1042,3439,356,1267,211,678,567,1945
320230,202109,5512,14693,4179,12445,873,2786,1537,4456,2410,7242
320240,202109,17855,44100,13344,36892,3252,9779,3948,10754,7200,20533
320245,202109,3312,9540,2549,7976,855,2856,393,1190,1248,4046
320250,202109,2775,7407,1872,5339,405,1297,625,1534,1030,2831
320255,202109,2038,6139,1750,5608,443,1505,780,2515,1223,4020
320260,202109,1517,4151,919,2837,184,626,225,558,409,1184
320265,202109,2526,7653,2017,6618,849,3019,280,873,1129,3892
320270,202109,2348,6583,1812,5518,453,1506,601,1818,1054,3324
320280,202109,8090,20817,6620,18341,1267,3738,3400,9089,4667,12827
320290,202109,1437,4190,922,2974,237,835,213,640,450,1475
320300,202109,4145,12046,3298,10328,881,3044,992,2901,1873,5945
320305,202109,5483,15105,4209,12609,756,2447,1998,5810,2754,8257
320310,202109,2409,6401,1686,4910,299,939,730,1983,1029,2922
320313,202109,2626,6337,1785,4811,337,1000,498,1166,835,2166
320316,202109,1705,4615,1326,3979,215,653,727,2177,942,2830
320320,202109,23911,60992,17004,49005,3922,11705,5887,17006,9809,28711
320330,202109,3080,8170,2393,6940,410,1234,1262,3677,1672,4911
320332,202109,8746,22989,6931,19602,1457,4434,3032,8279,4489,12713
320334,202109,1902,5240,1311,4035,262,943,318,739,580,1682
320335,202109,1658,4724,1164,3581,225,802,327,920,552,1722
320340,202109,5257,12688,4330,11325,526,1458,2495,6591,3021,8049
320350,202109,5749,13781,4064,10802,434,1277,2224,5482,2658,6759
320360,202109,1498,3793,1107,3068,139,386,519,1386,658,1772
320370,202109,2713,8115,1993,6565,597,2121,582,1867,1179,3988
320380,202109,2841,7330,2344,6525,270,809,1433,3896,1703,4705
320390,202109,7930,20644,5804,16439,1205,3659,2264,5963,3469,9622
320400,202109,3488,9628,2562,7662,712,2268,782,2193,1494,4461
320405,202109,5545,14008,4208,11652,589,1780,2202,5863,2791,7643
320410,202109,5064,12774,3802,10724,689,1872,1837,5418,2526,7290
320420,202109,3622,9055,2770,7633,554,1701,886,2300,1440,4001
320425,202109,2310,5450,1762,4523,146,377,1071,2680,1217,3057
320430,202109,3418,8412,2710,7165,394,1092,1623,4110,2017,5202
320435,202109,2300,7022,1769,5883,610,2173,540,1785,1150,3958
320440,202109,1629,4408,1211,3599,189,596,529,1477,718,2073
320450,202109,1914,5336,1494,4547,269,941,682,1925,951,2866
320455,202109,4737,14044,3201,10412,738,2619,789,2256,1527,4875
320460,202109,2280,6543,1641,5207,384,1331,436,1258,820,2589
320465,202109,1473,3976,1100,3269,174,516,561,1693,735,2209
320470,202109,3928,10506,2850,8266,573,1798,774,2033,1347,3831
320480,202109,2005,5121,1620,4473,183,565,1032,2755,1215,3320
320490,202109,25209,62603,18895,51686,3099,8822,8262,22318,11361,31140
320495,202109,1448,3895,1053,3122,251,839,306,829,557,1668
320500,202109,55986,146192,44810,127008,5856,18034,26241,70974,32097,89008
320501,202109,4882,13900,3637,11602,986,3526,1067,3303,2053,6829
320503,202109,2421,6814,1562,5024,458,1581,367,1146,825,2727
320506,202109,2853,8390,2085,6672,630,2165,173,570,803,2735
320510,202109,11688,30560,9518,26885,970,3100,5917,15978,6887,19078
320515,202109,1883,5105,1463,4243,373,1201,473,1293,846,2494
320517,202109,2285,6698,1828,5715,534,1818,582,1776,1116,3594
320520,202109,41023,103158,30842,85945,4829,14876,13545,35920,18374,50796
320530,202109,36603,93542,29001,80184,2394,7748,18454,47831,20848,55579
330010,202109,25666,64712,21346,57714,2257,6736,14849,38759,17106,45495
330015,202109,1475,3506,1167,3063,200,588,663,1664,863,2252
330020,202109,20736,50640,17464,45965,2360,6803,12088,31197,14448,38000
330022,202109,2012,5288,1574,4580,250,711,855,2499,1105,3210
330023,202109,5908,13432,4504,11513,645,1822,2746,6803,3391,8625
330025,202109,7510,16805,4598,12063,940,2717,1202,2915,2142,5632
330030,202109,10917,28335,8370,24298,771,2631,5307,14628,6078,17259
330040,202109,16221,40881,13067,35676,962,2989,9148,23898,10110,26887
330045,202109,91228,208186,75424,188282,5610,13532,60258,149816,65868,163348
330050,202109,2880,7335,2182,6175,391,1206,1149,3071,1540,4277
330060,202109,5674,14358,4445,12193,813,2515,1914,4789,2727,7304
330070,202109,25260,61080,20493,54344,2825,8107,12714,33218,15539,41325
330080,202109,9440,22892,8039,20944,940,2610,5562,14256,6502,16866
330090,202109,3520,7240,2480,5824,143,352,1774,4160,1917,4512
330093,202109,2889,6756,2189,5798,130,358,1660,4363,1790,4721
330095,202109,1487,3981,1172,3420,120,373,681,1850,801,2223
330100,202109,76102,193679,65157,177777,3400,10920,50782,136141,54182,147061
330110,202109,2160,5869,1739,5186,243,789,1039,2991,1282,3780
330115,202109,2667,6269,1884,5060,257,775,1054,2716,1311,3491
330120,202109,3804,8086,2889,6937,206,569,2119,4862,2325,5431
330130,202109,4633,12143,3789,10894,479,1418,2418,6900,2897,8318
330140,202109,4096,10131,3279,8994,366,1152,2249,5952,2615,7104
330150,202109,2447,6257,1904,5398,316,909,970,2666,1286,3575
330160,202109,1440,3793,1069,3139,202,620,566,1582,768,2202
330170,202109,121289,288234,98089,257168,12989,33279,66663,176656,79652,209935
330180,202109,2085,4834,1615,4192,89,260,1144,2890,1233,3150
330185,202109,10805,25934,9047,23519,465,1454,7357,18662,7822,20116
330187,202109,4927,11894,3891,10211,532,1466,2350,6077,2882,7543
330190,202109,37927,87397,32067,79409,1955,5199,25819,63032,27774,68231
330200,202109,17548,42599,14309,38604,2708,6794,9006,25176,11714,31970
330205,202109,2374,5674,1801,4755,128,361,1227,3105,1355,3466
330210,202109,3515,8382,2586,6810,316,878,1365,3400,1681,4278
330220,202109,13411,31962,9598,25662,1735,5217,3861,9511,5596,14728
330225,202109,4188,10164,3203,8692,205,673,2307,6093,2512,6766
330227,202109,18096,42235,15126,38640,653,1665,12912,32733,13565,34398
330230,202109,2283,4898,1510,3903,129,365,856,2190,985,2555
330240,202109,25865,64399,21625,58012,2070,6290,15422,40079,17492,46369
330245,202109,1840,4393,1115,3132,228,609,403,1135,631,1744
330250,202109,42240,103272,34849,92450,5204,14293,22298,58487,27502,72780
330260,202109,5413,12457,4116,10705,299,910,3086,7737,3385,8647
330270,202109,34783,77253,21428,55295,3117,8663,9085,22071,12202,30734
330280,202109,2531,6321,1923,5324,198,593,1165,3093,1363,3686
330285,202109,27345,62636,21655,54550,1213,3610,16674,40562,17887,44172
330290,202109,4310,10037,3465,8918,319,957,2540,6272,2859,7229
330300,202109,6158,14010,4546,11747,331,937,3223,8093,3554,9030
330310,202109,2858,6748,2051,5443,154,340,1380,3651,1534,3991
330320,202109,18573,41830,14410,36638,1701,3892,10288,26633,11989,30525
330330,202109,46236,97225,36113,83617,2905,7387,26275,59154,29180,66541
330340,202109,19467,44482,14037,36169,1955,5761,7478,17858,9433,23619
330350,202109,157906,350679,130904,317998,7434,18663,109502,263677,116936,282340
330360,202109,7688,18237,6565,16886,222,518,5572,14308,5794,14826
330370,202109,5372,14751,4152,12701,931,2883,1758,5548,2689,8431
330380,202109,6080,15342,4634,12868,607,2041,2640,6878,3247,8919
330385,202109,4302,11794,3528,10680,720,2398,1791,5282,2511,7680
330390,202109,29111,74967,22437,63836,2759,9061,13646,36385,16405,45446
330395,202109,3430,8135,2800,7337,147,453,2105,5355,2252,5808
330400,202109,3632,9207,3094,8370,141,502,2360,6011,2501,6513
330410,202109,3556,9048,2561,7366,488,1511,1177,3157,1665,4668
330411,202109,3014,7932,2356,6746,149,499,1651,4505,1800,5004
330412,202109,1737,4692,1424,4178,129,421,944,2628,1073,3049
330414,202109,25865,62804,21113,56332,1442,4106,16093,42147,17535,46253
330415,202109,5086,13208,3847,11044,387,1152,2195,6153,2582,7305
330420,202109,13409,32122,9646,26089,1019,3157,5403,13490,6422,16647
330430,202109,10195,23671,8582,21495,266,832,6986,16985,7252,17817
330440,202109,2942,7426,2250,6285,266,847,1398,3738,1664,4585
330450,202109,1516,4119,1202,3591,150,480,673,1960,823,2440
330452,202109,19340,47252,15504,41332,1742,5281,10245,26195,11987,31476
330455,202109,603296,1379735,472872,1195741,58939,158788,315362,779778,374301,938566
330460,202109,1213,3187,910,2764,156,503,480,1424,636,1927
330470,202109,5632,13441,4017,10953,1143,3224,1147,3166,2290,6390
330475,202109,10429,25684,8443,23132,1203,3805,5518,14639,6721,18444
330480,202109,6271,15721,5262,14254,419,1234,3674,9637,4093,10871
330490,202109,120288,268354,97773,238233,10604,26454,70038,168822,80642,195276
330500,202109,8174,19302,6770,17410,628,1802,4931,12386,5559,14188
330510,202109,44300,105326,33214,89822,4806,14081,21053,55743,25859,69824
330513,202109,1341,3299,1086,2969,202,565,602,1685,804,2250
330515,202109,2671,6922,2151,6201,347,1119,1249,3464,1596,4583
330520,202109,12481,31555,10247,28161,1094,3340,6714,17909,7808,21249
330530,202109,1797,4243,1315,3535,242,702,621,1665,863,2367
330540,202109,3035,7759,2338,6580,604,1732,858,2394,1462,4126
330550,202109,10583,25282,8183,22167,1935,5805,3904,10315,5839,16120
330555,202109,19941,40382,16577,36465,737,1738,13859,30731,14596,32469
330560,202109,4340,11047,3504,9696,546,1517,2080,5616,2626,7133
330570,202109,2858,7549,2448,6960,386,1185,1593,4487,1979,5672
330575,202109,5886,14652,5075,13309,309,899,4101,10426,4410,11325
330580,202109,19968,50886,15785,43474,2376,7111,8411,21867,10787,28978
330590,202109,1555,4020,1283,3666,242,678,787,2312,1029,2990
330600,202109,13543,33987,10965,29855,878,2770,7246,19005,8124,21775
330610,202109,10042,25879,8090,22841,734,2292,5448,15037,6182,17329
330615,202109,2212,5849,1755,5241,327,994,1090,3325,1417,4319
330620,202109,4416,12053,3476,10455,699,2237,1516,4279,2215,6516
330630,202109,26846,65326,21155,56527,1257,3962,15282,39346,16539,43308
350010,202109,2243,5845,1270,3786,259,839,261,581,520,1420
350020,202109,739,1844,423,1244,47,150,142,394,189,544
350030,202109,3741,10137,2856,8639,663,2239,1327,3703,1990,5942
350040,202109,795,2239,456,1513,60,231,141,355,201,586
350050,202109,1510,3634,1004,2775,210,648,352,799,562,1447
350055,202109,966,2491,766,2180,88,272,459,1235,547,1507
350060,202109,251,628,145,411,19,62,61,162,80,224
350070,202109,3432,8930,2270,6824,446,1461,786,2092,1232,3553
350075,202109,645,1810,487,1509,171,558,68,218,239,776
350080,202109,688,1764,465,1379,59,199,194,521,253,720
350090,202109,622,1439,379,1030,65,189,162,409,227,598
350100,202109,2511,6490,1768,5202,112,418,1125,3080,1237,3498
350110,202109,509,1239,352,971,20,59,215,582,235,641
350115,202109,1258,3553,1024,3081,158,531,519,1400,677,1931
350120,202109,685,1567,384,1029,34,111,210,493,244,604
350130,202109,3347,8689,2629,7377,468,1336,1270,3350,1738,4686
350140,202109,807,2198,570,1757,47,191,302,846,349,1037
350150,202109,562,1655,453,1445,95,296,136,403,231,699
350160,202109,12044,30117,8249,23107,1056,3325,4872,12867,5928,16192
350170,202109,2591,7109,2153,6178,323,1039,1111,2862,1434,3901
350180,202109,1050,2504,578,1646,84,257,208,541,292,798
350190,202109,3024,8384,2069,6329,341,1201,909,2347,1250,3548
350200,202109,475,1312,362,1099,20,67,236,666,256,733
350210,202109,6312,14383,4335,11326,475,1383,2709,6726,3184,8109
350220,202109,3074,8274,2103,6390,421,1315,706,1944,1127,3259
350230,202109,1040,2595,861,2348,157,459,489,1286,646,1745
350240,202109,676,1898,439,1346,97,310,115,300,212,610
350250,202109,3301,8900,2419,7416,626,2067,711,2129,1337,4196
350260,202109,875,1991,562,1480,56,164,345,858,401,1022
350270,202109,4835,12518,3841,10660,509,1585,2141,5455,2650,7040
350275,202109,2580,6754,2050,5957,295,942,1277,3547,1572,4489
350280,202109,19536,43863,12074,31806,1809,4997,5135,12818,6944,17815
350290,202109,3298,8946,2270,6856,401,1313,917,2561,1318,3874
350300,202109,674,1768,504,1453,56,165,292,782,348,947
350310,202109,1001,2775,744,2277,112,400,321,892,433,1292
350315,202109,620,1507,410,1160,24,77,219,562,243,639
350320,202109,16435,41275,12157,33792,2297,7067,5025,12830,7322,19897
350330,202109,14864,35587,10777,27988,1065,3072,6918,16899,7983,19971
350335,202109,402,1113,310,940,37,128,145,413,182,541
350340,202109,1242,3122,773,2269,120,410,330,852,450,1262
350350,202109,769,1886,594,1695,64,210,369,1040,433,1250
350360,202109,1115,3239,852,2708,205,674,287,920,492,1594
350370,202109,716,1754,511,1365,164,414,169,433,333,847
350380,202109,4740,12774,3408,10028,984,2822,898,2703,1882,5525
350390,202109,11525,29399,9128,25432,1541,4558,4776,12670,6317,17228
350395,202109,460,1139,238,721,25,78,87,232,112,310
350400,202109,8654,20715,6063,16510,1504,4374,1667,4455,3171,8829
350410,202109,10814,29381,7993,24053,1536,5096,3198,8852,4734,13948
350420,202109,885,2320,600,1730,89,272,150,368,239,640
350430,202109,736,1911,590,1692,74,238,356,945,430,1183
350440,202109,2157,5244,1752,4650,140,381,1137,2944,1277,3325
350450,202109,6746,18288,5206,15624,1099,3623,2142,6023,3241,9646
350460,202109,1952,4953,1125,3301,165,506,409,1073,574,1579
350470,202109,263,666,206,569,10,33,146,389,156,422
350480,202109,1036,2474,685,1889,133,421,185,416,318,837
350490,202109,2058,5238,1459,4264,313,948,477,1261,790,2209
350500,202109,687,1809,509,1501,63,204,241,667,304,871
350510,202109,1269,3158,952,2608,98,297,580,1505,678,1802
350520,202109,2352,6875,1837,5898,266,956,821,2367,1087,3323
350530,202109,3057,7580,2310,6157,241,736,1367,3354,1608,4090
350535,202109,1560,4134,1344,3832,185,575,833,2308,1018,2883
350540,202109,2098,4762,1569,4007,176,448,1007,2473,1183,2921
350550,202109,8826,21467,6133,16996,634,2093,3523,8961,4157,11054
350560,202109,3976,10867,3188,9523,268,862,2091,6025,2359,6887
350570,202109,26638,72405,21710,63169,3662,11787,11398,31587,15060,43374
350580,202109,2183,5695,1359,4031,349,1128,275,671,624,1799
350590,202109,5263,13911,3867,10841,486,1545,2288,5911,2774,7456
350600,202109,36599,83595,22989,60292,3282,9781,10671,25519,13953,35300
350610,202109,7347,19522,5244,15455,789,2577,2599,7139,3388,9716
350620,202109,448,1113,273,832,23,69,153,435,176,504
350630,202109,1602,3955,1177,3227,76,273,779,1961,855,2234
350635,202109,10231,24416,7592,20263,924,2712,4725,12007,5649,14719
350640,202109,965,2537,513,1548,75,218,147,392,222,610
350650,202109,9116,23718,6327,18306,1098,3425,2548,6829,3646,10254
350660,202109,4757,12076,3683,10316,563,1547,2028,5703,2591,7250
350670,202109,1841,4877,1499,4374,186,549,945,2766,1131,3315
350680,202109,1136,3014,781,2375,135,428,322,931,457,1359
350690,202109,1361,3463,968,2800,157,488,509,1436,666,1924
350700,202109,5085,12619,3724,10505,795,2535,1624,4368,2419,6903
350710,202109,3039,8091,2566,7262,444,1424,1355,3519,1799,4943
350715,202109,803,2245,677,2036,94,338,342,924,436,1262
350720,202109,164,427,121,356,17,49,44,114,61,163
350730,202109,656,1764,550,1575,28,97,400,1078,428,1175
350740,202109,1808,4686,1251,3598,210,657,449,1162,659,1819
350745,202109,607,1485,346,1010,30,112,153,400,183,512
350750,202109,10773,27535,8355,23364,1404,4577,3956,9910,5360,14487
350760,202109,15898,38660,11632,31389,2207,6635,5240,12640,7447,19275
350770,202109,1125,2704,685,1939,46,143,425,1165,471,1308
350775,202109,738,1685,511,1353,61,157,253,682,314,839
350780,202109,2503,5916,1802,4919,323,1025,596,1887,919,2912
350790,202109,2157,5645,1388,4198,245,775,388,980,633,1755
350800,202109,3686,10303,3167,9407,246,833,2213,6354,2459,7187
350810,202109,3020,7124,2299,6087,426,1044,1040,2816,1466,3860
350820,202109,1000,2299,588,1576,78,236,273,655,351,891
350830,202109,907,2449,521,1613,76,243,152,384,228,627
350840,202109,3511,10071,2672,8514,568,2052,1203,3469,1771,5521
350850,202109,8426,22572,6665,19426,1245,3934,3341,9102,4586,13036
350860,202109,3807,9875,3269,9147,110,390,2540,7044,2650,7434
350870,202109,2732,7447,2043,6341,250,857,1187,3571,1437,4428
350880,202109,1415,3908,1120,3336,287,901,279,779,566,1680
350890,202109,562,1452,362,1036,53,161,135,335,188,496
350900,202109,8439,22124,5612,16299,1002,3157,2313,6127,3315,9284
350910,202109,953,2252,812,2041,94,249,586,1439,680,1688
350920,202109,12861,30990,10909,27889,401,1268,9049,22280,9450,23548
350925,202109,4304,11398,3094,9266,551,1803,1506,4151,2057,5954
350930,202109,1535,3936,1079,3063,68,200,673,1855,741,2055
350940,202109,2346,6025,1802,5146,177,582,1141,3080,1318,3662
350945,202109,907,2490,698,2089,105,326,358,996,463,1322
350950,202109,95384,239495,73992,200061,8871,26140,46364,119486,55235,145626
350960,202109,6706,17802,5182,14992,632,2058,3064,8423,3696,10481
350970,202109,3669,10025,2625,8128,742,2536,596,1571,1338,4107
350980,202109,679,1805,543,1548,131,393,248,697,379,1090
350990,202109,1906,5155,1426,4386,316,1086,530,1558,846,2644
350995,202109,858,2618,773,2449,61,225,532,1625,593,1850
351000,202109,3006,7836,2044,6026,391,1200,702,2021,1093,3221
351010,202109,379,916,241,683,28,90,119,322,147,412
351015,202109,903,2636,739,2290,115,391,345,957,460,1348
351020,202109,9014,24023,6875,20390,1541,4505,3120,9105,4661,13610
351030,202109,3001,8678,2394,7487,332,1147,1321,3979,1653,5126
351040,202109,5329,12955,4468,11679,214,656,3673,9348,3887,10004
351050,202109,17427,41677,12747,34554,2337,6705,5962,15891,8299,22596
351060,202109,51561,126922,39690,106925,3791,11322,27076,70208,30867,81530
351070,202109,1407,3418,785,2373,192,627,127,369,319,996
351080,202109,2851,6741,2058,5800,206,686,1386,3710,1592,4396
351090,202109,339,946,251,788,49,153,74,239,123,392
351100,202109,2799,7370,1837,5475,387,1221,505,1498,892,2719
351110,202109,6455,16185,4292,12268,653,2085,1967,5251,2620,7336
351120,202109,765,1967,541,1578,69,219,203,563,272,782
351130,202109,1259,3158,584,1762,101,319,153,411,254,730
351140,202109,2361,6426,1774,5326,343,1164,778,2041,1121,3205
351150,202109,2898,8110,1971,6124,258,890,736,2056,994,2946
351160,202109,1131,3431,825,2732,154,554,202,546,356,1100
351170,202109,1382,3727,1179,3375,84,266,843,2321,927,2587
351190,202109,1066,2908,734,2247,138,416,269,781,407,1197
351200,202109,1670,3900,1250,3300,91,276,890,2207,981,2483
351210,202109,1651,3987,1050,2878,77,250,611,1530,688,1780
351220,202109,3483,9515,2987,8708,280,836,2038,5837,2318,6673
351230,202109,1946,5091,1457,4236,264,868,700,1833,964,2701
351240,202109,2538,6352,1566,4364,348,1056,541,1345,889,2401
351250,202109,1141,2949,676,2026,68,215,270,805,338,1020
351260,202109,948,2315,687,1847,150,410,242,608,392,1018
351270,202109,534,1426,390,1135,39,131,190,478,229,609
351280,202109,4070,10402,3154,8713,624,1768,1382,3678,2006,5446
351290,202109,1292,3165,911,2502,120,368,560,1464,680,1832
351300,202109,19934,52506,13988,41279,2334,7476,6354,17750,8688,25226
351310,202109,3667,8761,2802,7426,145,484,2088,5254,2233,5738
351320,202109,995,2787,723,2249,123,411,238,646,361,1057
351330,202109,501,1207,412,1045,21,66,289,650,310,716
351340,202109,6591,18152,5338,15955,1267,3903,2400,7136,3667,11039
351350,202109,12257,29963,10139,26638,916,2577,7502,19109,8418,21686
351360,202109,3980,10333,3277,9302,677,2086,1485,3900,2162,5986
351370,202109,2119,5769,1425,4335,313,1036,432,1185,745,2221
351380,202109,49950,118026,35455,93204,4086,11610,21084,52732,25170,64342
351385,202109,424,1063,174,521,24,67,56,145,80,212
351390,202109,1391,3339,863,2565,114,398,501,1394,615,1792
351400,202109,992,2686,826,2359,98,286,541,1497,639,1783
351410,202109,2760,7492,1990,6012,332,993,787,2318,1119,3311
351420,202109,504,1194,287,813,37,101,166,434,203,535
351430,202109,993,2593,798,2274,59,166,567,1566,626,1732
351440,202109,3621,9361,2408,6921,436,1316,657,1613,1093,2929
351450,202109,1816,4708,1215,3618,243,815,230,508,473,1323
351460,202109,935,2370,741,2072,144,404,431,1188,575,1592
351470,202109,1261,3126,1001,2704,77,264,676,1708,753,1972
351480,202109,2621,7483,2060,6540,359,1262,910,2660,1269,3922
351490,202109,2121,5818,1824,5287,60,241,1504,4220,1564,4461
351492,202109,359,954,298,824,7,21,227,610,234,631
351495,202109,204,517,159,432,16,37,95,257,111,294
351500,202109,41392,98960,31629,82953,4354,11998,19607,49220,23961,61218
351510,202109,13148,31835,9582,25859,1080,3358,6070,15566,7150,18924
351512,202109,509,1336,375,1045,68,196,124,317,192,513
351515,202109,3383,7520,2131,5555,363,1067,596,1622,959,2689
351518,202109,2608,6423,1726,4879,219,710,954,2371,1173,3081
351519,202109,683,1834,422,1321,76,246,68,187,144,433
351520,202109,1366,3342,609,1804,52,180,290,769,342,949
351530,202109,361,926,209,606,37,115,94,227,131,342
351535,202109,1902,4598,1375,3692,216,619,688,1729,904,2348
351540,202109,2778,6753,1877,5156,219,704,836,2005,1055,2709
351550,202109,7569,18499,5148,14142,494,1552,2941,7445,3435,8997
351560,202109,463,1311,360,1108,81,267,106,296,187,563
351565,202109,256,715,206,622,40,135,56,141,96,276
351570,202109,22822,59023,17481,48596,1679,5073,11169,29698,12848,34771
351580,202109,238,603,137,419,16,48,57,179,73,227
351590,202109,524,1171,276,738,23,87,163,389,186,476
351600,202109,1399,3701,1074,3090,123,388,593,1589,716,1977
351610,202109,796,1855,498,1329,31,84,285,714,316,798
351620,202109,24787,63985,18097,52659,2735,9058,8505,22370,11240,31428
351630,202109,30272,76828,24415,67008,2972,8804,15915,41851,18887,50655
351640,202109,18584,47321,14623,40332,1319,4267,10023,26224,11342,30491
351650,202109,379,1000,188,596,25,81,55,157,80,238
351660,202109,775,2095,509,1543,77,241,113,287,190,528
351670,202109,6337,16650,4180,12049,892,2541,1706,4580,2598,7121
351680,202109,444,1228,293,902,37,124,82,205,119,329
351685,202109,404,1141,325,1016,85,274,109,319,194,593
351690,202109,1180,2920,656,1891,90,299,300,764,390,1063
351700,202109,1358,3321,988,2699,203,562,476,1221,679,1783
351710,202109,811,2131,596,1735,56,189,332,871,388,1060
351720,202109,1531,3874,1025,2994,162,516,431,1154,593,1670
351730,202109,994,2564,820,2300,64,206,508,1359,572,1565
351740,202109,3600,8875,2876,7507,484,1388,1482,3506,1966,4894
351750,202109,1568,3925,939,2815,156,500,400,1119,556,1619
351760,202109,3434,9399,2555,7719,476,1641,1072,2905,1548,4546
351770,202109,1946,5486,1573,4788,256,827,904,2636,1160,3463
351780,202109,1235,3080,745,2178,101,353,292,777,393,1130
351790,202109,1427,3372,1139,2992,175,476,665,1767,840,2243
351800,202109,541,1227,272,721,33,93,108,240,141,333
351810,202109,1127,2909,943,2642,62,157,642,1714,704,1871
351820,202109,2787,7619,1993,6100,492,1644,496,1373,988,3017
351830,202109,4731,12343,3655,10495,300,997,2346,6406,2646,7403
351840,202109,9341,24899,7069,20778,891,2964,3985,10844,4876,13808
351850,202109,1596,4328,1052,3228,149,515,373,965,522,1480
351860,202109,2806,7884,2154,6692,322,1125,1203,3694,1525,4819
351870,202109,25108,62535,18707,52077,4357,12612,7765,21661,12122,34273
351880,202109,145179,362344,109673,302397,21208,65124,56521,146928,77729,212052
351885,202109,958,2511,746,2163,53,192,500,1387,553,1579
351890,202109,891,2279,569,1741,110,358,114,306,224,664
351900,202109,1182,3060,900,2636,118,328,542,1575,660,1903
351905,202109,473,1288,335,1018,30,102,170,457,200,559
351907,202109,22374,57460,17512,48953,1860,5824,11360,30287,13220,36111
351910,202109,1753,4406,1248,3352,85,258,749,1797,834,2055
351920,202109,931,2466,703,2016,107,340,292,757,399,1097
351925,202109,940,2429,722,2041,89,289,380,990,469,1279
351930,202109,3384,9214,3025,8565,534,1545,2060,5729,2594,7274
351940,202109,1127,2833,816,2296,128,389,398,1109,526,1498
351950,202109,1791,3947,1358,3323,65,192,989,2318,1054,2510
351960,202109,5336,13192,3896,10662,870,2545,1724,4401,2594,6946
351970,202109,7772,22114,6169,19358,894,3214,3494,10482,4388,13696
351980,202109,1069,2497,699,1893,91,291,396,960,487,1251
351990,202109,1539,3580,1120,2957,49,174,565,1333,614,1507
352000,202109,2809,7798,2423,7004,256,837,1618,4382,1874,5219
352010,202109,2439,6317,1979,5563,522,1644,437,1242,959,2886
352020,202109,1452,3900,1120,3342,152,522,569,1578,721,2100
352030,202109,6123,15795,4780,13589,809,2487,2511,6861,3320,9348
352040,202109,3713,9458,2629,7335,416,1272,970,2376,1386,3648
352042,202109,3377,7951,2298,6246,372,1153,1164,2999,1536,4152
352044,202109,2184,5657,1298,3986,188,641,267,760,455,1401
352050,202109,13545,35245,9008,26398,2070,6937,1855,4638,3925,11575
352060,202109,764,2011,568,1651,93,297,242,635,335,932
352070,202109,953,1917,622,1485,59,161,335,724,394,885
352080,202109,497,1252,289,839,32,107,97,253,129,360
352090,202109,1590,4576,1323,4069,156,554,645,1789,801,2343
352100,202109,3598,9851,2872,8490,567,1836,1275,3596,1842,5432
352110,202109,661,1862,498,1546,102,329,199,566,301,895
352115,202109,567,1499,472,1346,62,199,278,777,340,976
352120,202109,918,2628,741,2278,71,194,444,1276,515,1470
352130,202109,2163,5856,1446,4151,226,649,607,1625,833,2274
352140,202109,1181,3180,843,2517,141,430,377,1091,518,1521
352150,202109,923,2401,719,2067,81,250,492,1375,573,1625
352160,202109,1053,2547,764,2086,64,218,437,1140,501,1358
352170,202109,3118,8139,2491,6944,269,836,1612,4210,1881,5046
352180,202109,2472,6534,1847,5416,420,1392,570,1473,990,2865
352190,202109,1302,3442,1035,3040,179,462,535,1643,714,2105
352200,202109,334,1004,239,814,32,120,88,298,120,418
352210,202109,21149,48490,16561,42328,926,2672,12995,32440,13921,35112
352215,202109,711,1795,590,1607,88,255,336,886,424,1141
352220,202109,23578,56394,16746,44666,2691,7963,8607,20930,11298,28893
352230,202109,15725,43834,12183,37268,2839,9620,4310,12077,7149,21697
352240,202109,10479,26458,8008,22426,1705,5346,3502,9141,5207,14487
352250,202109,24342,66130,19581,58097,2804,8960,12231,35470,15035,44430
352260,202109,5146,12569,3513,9469,512,1577,2035,4918,2547,6495
352265,202109,970,2651,857,2491,98,305,590,1657,688,1962
352270,202109,1501,4392,1112,3575,230,792,383,1147,613,1939
352280,202109,2497,6148,1878,5259,197,642,1125,2949,1322,3591
352290,202109,1288,3601,1043,3147,128,422,564,1538,692,1960
352300,202109,902,2374,622,1797,83,278,332,889,415,1167
352310,202109,43876,114554,32909,95733,7477,22361,15002,43641,22479,66002
352320,202109,6977,17647,5416,14747,714,2184,3021,7399,3735,9583
352330,202109,2386,6113,1828,5327,275,948,1073,2899,1348,3847
352340,202109,6613,17101,4957,14098,759,2450,2527,6597,3286,9047
352350,202109,2351,6472,1840,5359,160,560,1141,3080,1301,3640
352360,202109,1330,3467,1082,3027,83,269,802,2154,885,2423
352370,202109,1134,3124,981,2873,17,69,804,2305,821,2374
352380,202109,869,2305,650,1926,139,419,217,618,356,1037
352390,202109,15544,37631,10643,29037,1694,5032,5815,14932,7509,19964
352400,202109,3708,10138,3014,8846,600,2044,1383,3774,1983,5818
352410,202109,3539,8881,2698,7484,226,754,1693,4479,1919,5233
352420,202109,863,2100,623,1759,114,342,241,634,355,976
352430,202109,8669,20963,6323,16904,1071,3261,3276,8188,4347,11449
352440,202109,19633,52186,14760,42859,3399,10235,5348,14967,8747,25202
352450,202109,802,1922,418,1272,59,199,157,450,216,649
352460,202109,3168,8424,2228,6758,421,1396,959,2724,1380,4120
352470,202109,3490,8736,2672,7420,275,892,1704,4462,1979,5354
352480,202109,4396,10243,2952,7691,417,1291,1449,3279,1866,4570
352490,202109,812,2281,650,1996,102,345,297,850,399,1195
352500,202109,10902,27634,7430,21198,2876,9002,897,1479,3773,10481
352510,202109,4062,10904,3052,9112,555,1778,1492,4277,2047,6055
352520,202109,3038,7716,2359,6601,386,1231,1366,3475,1752,4706
352530,202109,11508,28943,7885,22194,1325,4211,2967,7149,4292,11360
352540,202109,608,1740,453,1419,65,217,168,471,233,688
352550,202109,1039,2804,728,2224,121,421,261,715,382,1136
352560,202109,605,1644,471,1393,67,218,261,711,328,929
352570,202109,2512,7017,1636,5140,358,1229,202,469,560,1698
352580,202109,645,1654,538,1458,44,136,372,960,416,1096
352585,202109,354,936,259,769,19,76,164,439,183,515
352590,202109,13731,35397,9702,27860,2248,7070,4576,12158,6824,19228
352600,202109,1982,5309,1563,4554,144,452,993,2748,1137,3200
352610,202109,2893,7873,2174,6653,421,1453,905,2582,1326,4035
352620,202109,5883,14550,4477,12552,1212,3434,1836,5197,3048,8631
352630,202109,884,2139,663,1826,113,357,315,810,428,1167
352640,202109,3158,7939,2287,6389,229,647,1323,3529,1552,4176
352650,202109,626,1734,436,1329,59,196,168,478,227,674
352660,202109,1138,3253,942,2859,100,329,583,1712,683,2041
352670,202109,10180,26954,6940,20621,1596,5212,2239,6037,3835,11249
352680,202109,3398,9730,2376,7447,382,1391,1098,3028,1480,4419
352690,202109,28645,70466,22538,60285,1261,3987,16314,41805,17575,45792
352700,202109,675,1652,507,1413,129,401,185,497,314,898
352710,202109,5467,13871,3918,11080,919,2820,1643,4305,2562,7125
352720,202109,8541,22419,6692,19052,2250,6648,2046,5412,4296,12060
352725,202109,601,1401,343,940,23,67,185,473,208,540
352730,202109,5636,16334,5096,15115,581,1865,2294,5884,2875,7749
352740,202109,2417,5728,1832,4866,174,541,1107,2755,1281,3296
352750,202109,437,1080,273,788,42,136,112,276,154,412
352760,202109,1796,4856,1400,4088,114,319,798,2331,912,2650
352770,202109,937,2451,656,1910,121,372,264,720,385,1092
352780,202109,679,1884,486,1488,102,281,123,397,225,678
352790,202109,460,1189,342,962,28,84,146,360,174,444
352800,202109,1337,3929,934,3006,233,774,139,361,372,1135
352810,202109,1236,2860,802,2116,147,399,450,1135,597,1534
352820,202109,478,1319,349,1091,67,211,77,222,144,433
352830,202109,616,1538,297,885,26,77,82,204,108,281
352840,202109,4149,11504,3383,10137,991,3266,1236,3485,2227,6751
352850,202109,11590,27716,8070,22050,1999,6027,2843,6906,4842,12933
352860,202109,1117,3035,855,2573,146,472,331,937,477,1409
352870,202109,909,2223,635,1687,54,160,393,995,447,1155
352880,202109,1784,4197,1246,3256,202,546,573,1442,775,1988
352885,202109,318,857,246,737,27,82,146,422,173,504
352890,202109,721,1714,476,1214,49,140,278,613,327,753
352900,202109,18954,48453,12558,35893,2015,6054,5369,14323,7384,20377
352910,202109,426,1113,247,741,24,73,88,223,112,296
352920,202109,2746,6884,2031,5688,115,360,1418,3834,1533,4194
352930,202109,6027,15958,4532,13078,777,2469,2207,5920,2984,8389
352940,202109,23373,61482,17275,49095,2993,9257,8584,22828,11577,32085
352950,202109,589,1525,369,1115,91,280,79,221,170,501
352960,202109,774,2029,456,1376,67,223,129,310,196,533
352965,202109,230,637,147,470,40,127,39,111,79,238
352970,202109,3069,7254,2375,6115,222,630,1607,4041,1829,4671
352980,202109,1401,3594,1102,3149,255,812,561,1549,816,2361
352990,202109,4464,11961,3368,10138,630,2063,1682,4861,2312,6924
353000,202109,504,1341,293,856,42,137,75,168,117,305
353010,202109,2719,6615,1801,4941,332,1064,791,1944,1123,3008
353020,202109,3677,9347,2212,6357,303,962,776,2101,1079,3063
353030,202109,4770,11761,3304,9260,716,2194,969,2550,1685,4744
353040,202109,682,1534,481,1240,107,269,219,548,326,817
353050,202109,5414,15057,3861,11931,705,2330,1777,5238,2482,7568
353060,202109,50604,126832,41931,113105,2711,8636,31853,82953,34564,91589
353070,202109,10434,29063,7665,23146,1308,4359,3421,9370,4729,13729
353080,202109,4499,12031,2977,9110,532,1866,1147,3023,1679,4889
353090,202109,627,1823,504,1576,30,100,323,968,353,1068
353100,202109,308,811,146,457,23,72,40,102,63,174
353110,202109,7718,19789,6186,17645,1372,4010,2996,8957,4368,12967
353120,202109,426,1044,328,883,39,130,169,398,208,528
353130,202109,2712,6203,1716,4501,399,1168,615,1421,1014,2589
353140,202109,2808,6851,2052,5596,98,325,1482,3871,1580,4196
353150,202109,1665,4037,1192,3269,249,702,490,1278,739,1980
353160,202109,643,1636,463,1344,60,174,209,549,269,723
353170,202109,559,1450,416,1248,78,246,190,584,268,830
353180,202109,10585,25356,8377,21853,925,2613,5913,14898,6838,17511
353190,202109,3564,9380,2860,7972,373,1118,1661,4302,2034,5420
353200,202109,1871,4900,1069,3303,171,598,334,911,505,1509
353205,202109,430,1265,359,1114,57,183,171,513,228,696
353210,202109,938,2102,612,1585,22,56,434,1089,456,1145
353215,202109,401,1071,317,922,47,147,150,402,197,549
353220,202109,772,2021,505,1478,101,286,93,257,194,543
353230,202109,851,2274,666,1991,183,581,239,660,422,1241
353240,202109,2436,6463,2026,5807,272,895,1227,3365,1499,4260
353250,202109,1305,2908,821,2130,102,297,462,1134,564,1431
353260,202109,1220,2789,679,1905,93,287,321,844,414,1131
353270,202109,727,1853,616,1662,49,148,427,1081,476,1229
353280,202109,701,1860,494,1492,132,400,124,360,256,760
353282,202109,1906,5253,1598,4710,176,553,998,2796,1174,3349
353284,202109,366,813,201,521,19,70,100,223,119,293
353286,202109,180,441,110,329,19,54,38,107,57,161
353290,202109,1502,3932,921,2764,170,487,265,732,435,1219
353300,202109,2203,5771,1632,4665,264,865,732,1844,996,2709
353310,202109,420,1011,308,820,20,67,207,522,227,589
353320,202109,702,1677,589,1522,9,33,508,1301,517,1334
353325,202109,711,2017,497,1541,101,314,173,517,274,831
353330,202109,630,1584,435,1231,59,169,220,568,279,737
353340,202109,3170,8486,2369,6914,452,1469,1170,3128,1622,4597
353350,202109,3931,9721,2798,7585,620,1715,899,2198,1519,3913
353360,202109,683,1868,526,1569,55,172,304,881,359,1053
353370,202109,593,1643,494,1488,45,138,348,1020,393,1158
353380,202109,301,859,247,760,25,79,122,352,147,431
353390,202109,6707,16263,5054,13547,434,1328,3178,8029,3612,9357
353400,202109,504,1327,377,1091,69,226,151,366,220,592
353410,202109,546,1442,409,1195,70,193,231,684,301,877
353420,202109,440,1130,272,790,62,174,24,66,86,240
353430,202109,2322,6238,1815,5317,327,1039,889,2449,1216,3488
353440,202109,70231,184315,51842,149249,7853,24602,28790,78007,36643,102609
353450,202109,385,954,261,743,33,109,126,324,159,433
353460,202109,3390,8972,2524,7388,253,802,1050,2905,1303,3707
353470,202109,8878,22757,6481,18339,1049,3349,2938,7666,3987,11015
353475,202109,1667,4167,1164,3189,164,502,583,1467,747,1969
353480,202109,1655,4343,1329,3793,53,189,966,2669,1019,2858
353490,202109,1142,2943,782,2273,108,358,366,983,474,1341
353500,202109,1099,2572,801,2113,168,457,446,1140,614,1597
353510,202109,864,2502,633,1969,140,443,180,488,320,931
353520,202109,1065,2724,681,2045,70,242,337,913,407,1155
353530,202109,2532,6536,1996,5573,251,795,1106,2862,1357,3657
353540,202109,2186,5761,1801,5153,277,832,1059,2921,1336,3753
353550,202109,6118,15343,4975,13531,751,2118,2899,7563,3650,9681
353560,202109,2434,6356,1862,5504,490,1557,573,1520,1063,3077
353570,202109,613,1582,448,1311,54,178,244,664,298,842
353580,202109,2255,5831,1704,4758,376,1042,754,2050,1130,3092
353590,202109,720,1838,498,1439,82,248,238,698,320,946
353600,202109,1763,4309,1327,3558,162,424,730,1911,892,2335
353610,202109,689,1992,511,1646,88,348,188,546,276,894
353620,202109,2848,7300,2050,5963,379,1221,753,1999,1132,3220
353625,202109,533,1319,363,1026,31,97,214,582,245,679
353630,202109,1441,4240,1211,3769,220,756,528,1510,748,2266
353640,202109,1404,3580,1125,3146,155,432,633,1749,788,2181
353650,202109,7996,20969,6115,17505,690,2147,3580,9654,4270,11801
353657,202109,403,1039,292,858,28,94,132,348,160,442
353660,202109,1343,2813,925,2260,309,776,344,795,653,1571
353670,202109,4226,11459,3282,9661,610,2007,1571,4231,2181,6238
353680,202109,727,1860,541,1598,70,240,325,885,395,1125
353690,202109,428,1109,208,631,22,76,47,121,69,197
353700,202109,2143,5456,1766,4841,118,383,1312,3442,1430,3825
353710,202109,5575,12441,3344,8502,405,1065,1738,3913,2143,4978
353715,202109,453,1200,267,827,7,27,97,283,104,310
353720,202109,2079,5317,1598,4584,240,733,892,2493,1132,3226
353730,202109,4541,11705,3498,9874,449,1490,1940,5007,2389,6497
353740,202109,2110,5427,1491,4358,338,1082,503,1324,841,2406
353750,202109,934,2763,682,2281,145,531,168,524,313,1055
353760,202109,13493,30345,10365,26205,2149,5431,5371,13469,7520,18900
353770,202109,690,2006,416,1356,64,231,50,150,114,381
353780,202109,5811,15334,4681,13287,1001,3143,2317,6075,3318,9218
353790,202109,2921,8518,2131,6861,524,1853,435,1211,959,3064
353800,202109,19709,50152,15519,43446,2297,6664,8536,23801,10833,30465
353810,202109,1280,3360,843,2456,124,409,373,1018,497,1427
353820,202109,1836,4814,1263,3696,251,809,420,1125,671,1934
353830,202109,676,1674,493,1376,86,250,215,577,301,827
353850,202109,1668,4493,1295,3806,260,770,480,1367,740,2137
353860,202109,2773,7383,2111,6275,472,1596,976,2584,1448,4180
353870,202109,31521,80878,22698,64048,2833,8805,12042,31083,14875,39888
353880,202109,3296,8893,2599,7601,219,728,1585,4435,1804,5163
353890,202109,2982,6295,2161,5112,164,425,1539,3385,1703,3810
353900,202109,766,2110,565,1717,78,273,235,658,313,931
353910,202109,2623,7040,2195,6366,207,686,1540,4372,1747,5058
353920,202109,1981,5349,1432,4306,332,1114,347,868,679,1982
353930,202109,4686,12169,3212,9407,529,1800,1390,3527,1919,5327
353940,202109,1236,3484,869,2744,139,469,288,814,427,1283
353950,202109,3372,8927,2577,7455,506,1564,1335,3618,1841,5182
353960,202109,858,2185,604,1706,122,329,215,586,337,915
353970,202109,665,1557,496,1300,41,124,348,891,389,1015
353980,202109,16929,41828,13247,35560,780,2459,9711,24913,10491,27372
353990,202109,989,2382,609,1697,109,324,283,741,392,1065
354000,202109,2642,6217,1484,4077,327,920,258,665,585,1585
354010,202109,360,916,256,748,51,156,130,371,181,527
354020,202109,3870,10145,3083,8578,638,1933,1399,3535,2037,5468
354025,202109,742,2019,498,1544,71,249,141,407,212,656
354030,202109,531,1147,292,765,62,169,143,346,205,515
354040,202109,832,1896,541,1435,30,92,399,1017,429,1109
354050,202109,972,2721,694,2215,151,528,235,698,386,1226
354060,202109,3601,9926,2549,7710,465,1540,1049,2832,1514,4372
354070,202109,3938,10076,2664,7607,442,1443,1203,2955,1645,4398
354075,202109,2885,8013,2300,6958,311,1007,1345,3973,1656,4980
354080,202109,1403,3815,941,2906,181,589,281,783,462,1372
354085,202109,456,926,364,808,0,0,279,569,279,569
354090,202109,1705,4692,1467,4211,80,245,1143,3205,1223,3450
354100,202109,20558,54169,14252,43351,3026,9883,5480,16486,8506,26369
354105,202109,1468,3654,1029,2869,127,358,502,1313,629,1671
354110,202109,458,1269,330,1020,58,177,113,340,171,517
354120,202109,1410,3731,969,2805,194,608,325,829,519,1437
354130,202109,5580,14484,3710,10905,883,2737,208,400,1091,3137
354140,202109,20326,49352,13943,37702,2199,6614,6258,15417,8457,22031
354150,202109,3014,7039,2313,5947,465,1240,942,2372,1407,3612
354160,202109,2927,8304,2217,6907,574,1933,681,1915,1255,3848
354165,202109,713,2048,544,1716,83,305,282,823,365,1128
354170,202109,1952,5304,1630,4710,103,333,994,2730,1097,3063
354180,202109,400,1096,293,876,47,144,136,366,183,510
354190,202109,1616,4448,1134,3453,72,245,569,1643,641,1888
354200,202109,908,2165,696,1842,70,208,456,1134,526,1342
354210,202109,921,2398,755,2131,52,164,521,1374,573,1538
354220,202109,3296,8669,2512,7145,359,1113,1349,3595,1708,4708
354230,202109,814,1984,658,1798,34,113,488,1292,522,1405
354240,202109,1801,4893,1212,3716,200,651,388,1065,588,1716
354250,202109,649,1571,405,1148,90,277,115,304,205,581
354260,202109,8290,21483,6307,18057,1173,3642,2936,7983,4109,11625
354270,202109,1049,3092,856,2717,177,551,335,1029,512,1580
354280,202109,838,2040,716,1865,60,189,489,1178,549,1367
354290,202109,954,2980,802,2673,121,395,417,1432,538,1827
354300,202109,3625,10406,3071,9395,762,2343,1317,3977,2079,6320
354310,202109,747,2188,617,1938,146,489,241,697,387,1186
354320,202109,1020,2428,675,1860,102,315,271,661,373,976
354323,202109,519,1210,324,854,55,130,136,337,191,467
354325,202109,1566,4582,1101,3525,181,578,342,1039,523,1617
354330,202109,9840,24423,6755,18292,803,2431,4025,10131,4828,12562
354340,202109,35605,87702,24705,68848,3305,10447,13943,36895,17248,47342
354350,202109,1251,3151,990,2727,141,396,581,1527,722,1923
354360,202109,644,1617,389,1201,84,258,87,269,171,527
354370,202109,1035,2875,834,2559,122,396,503,1491,625,1887
354380,202109,676,1753,487,1446,85,336,136,312,221,648
354390,202109,14681,34830,9793,26347,1604,4634,4699,11825,6303,16459
354400,202109,1606,5051,1254,4229,210,762,461,1514,671,2276
354410,202109,6584,17012,5012,13985,897,2763,2510,6495,3407,9258
354420,202109,1551,3945,1157,3253,145,436,704,1872,849,2308
354425,202109,2839,6804,2027,5402,458,1249,821,2169,1279,3418
354430,202109,1582,4158,1233,3619,105,335,756,2122,861,2457
354440,202109,640,1634,427,1214,70,219,187,482,257,701
354450,202109,462,1198,270,836,37,122,90,234,127,356
354460,202109,895,2222,604,1716,83,243,308,861,391,1104
354470,202109,481,1190,337,919,22,71,171,403,193,474
354480,202109,1336,2960,869,2219,74,178,543,1316,617,1494
354490,202109,840,2425,618,1945,111,369,275,797,386,1166
354500,202109,2243,6115,1805,5424,544,1690,430,1317,974,3007
354510,202109,754,2063,613,1798,42,128,359,955,401,1083
354515,202109,368,1019,265,808,40,137,108,318,148,455
354520,202109,7254,19451,5138,15000,673,2269,2853,7702,3526,9971
354530,202109,4565,12721,3548,10752,905,2722,1191,3746,2096,6468
354540,202109,1388,3584,1017,2927,215,650,377,1062,592,1712
354550,202109,626,1618,495,1365,69,209,285,747,354,956
354560,202109,2377,5658,1286,3575,163,458,666,1705,829,2163
354570,202109,1297,3193,531,1471,96,266,69,182,165,448
354580,202109,8697,22612,5745,16961,882,2819,2874,8108,3756,10927
354600,202109,2092,5317,1652,4539,185,549,1080,2822,1265,3371
354610,202109,462,1176,272,801,23,69,141,402,164,471
354620,202109,497,1348,309,991,39,156,129,377,168,533
354625,202109,318,845,190,604,31,104,37,90,68,194
354630,202109,2240,6478,1812,5647,615,1971,350,1011,965,2982
354640,202109,3441,9664,2600,7996,367,1253,1092,3089,1459,4342
354650,202109,912,2347,739,2066,63,175,471,1296,534,1471
354660,202109,3794,8771,2039,5859,184,633,936,2431,1120,3064
354670,202109,1108,3004,778,2339,150,491,296,810,446,1301
354680,202109,5637,14324,4256,12112,911,2759,2168,6215,3079,8974
354690,202109,508,1554,368,1243,77,284,112,348,189,632
354700,202109,953,2507,685,1992,77,241,370,986,447,1227
354710,202109,526,1372,374,1068,48,151,163,396,211,547
354720,202109,300,721,140,409,63,182,23,71,86,253
354730,202109,10324,28613,7918,24010,1013,3360,4567,13284,5580,16644
354740,202109,318,854,128,418,13,51,27,73,40,124
354750,202109,2834,7169,1873,5384,253,786,824,2091,1077,2877
354760,202109,2259,5891,1612,4706,346,1091,554,1426,900,2517
354765,202109,378,1002,162,503,18,64,43,117,61,181
354770,202109,2550,6186,1876,4997,296,832,904,2249,1200,3081
354780,202109,59130,146091,45340,119599,3862,11664,30276,74757,34138,86421
354790,202109,1031,2793,801,2425,75,248,495,1438,570,1686
354800,202109,2664,6761,2068,5811,499,1406,909,2425,1408,3831
354805,202109,1405,3181,978,2564,116,292,565,1395,681,1687
354810,202109,664,1910,398,1357,51,195,111,346,162,541
354820,202109,990,2764,694,2202,103,364,192,481,295,845
354830,202109,497,1186,315,861,60,175,96,249,156,424
354840,202109,937,2321,580,1600,59,171,308,781,367,952
354850,202109,21677,55055,15172,43645,1580,5134,9300,25363,10880,30497
354860,202109,1794,4903,1124,3522,172,589,342,962,514,1551
354870,202109,62277,155124,48272,129497,4718,13875,31002,78455,35720,92330
354880,202109,6055,14761,3019,8452,332,1065,1201,2761,1533,3826
354890,202109,16264,40399,12594,34241,1676,5086,7285,19223,8961,24309
354900,202109,425,1052,278,792,61,190,82,181,143,371
354910,202109,6167,15935,3831,11706,855,2765,784,2217,1639,4982
354920,202109,538,1409,269,870,32,113,60,166,92,279
354925,202109,314,880,186,598,25,88,47,130,72,218
354930,202109,388,930,255,696,25,77,127,318,152,395
354940,202109,2475,7135,1797,5669,590,2013,429,1217,1019,3230
354950,202109,1588,3959,1259,3521,54,190,934,2483,988,2673
354960,202109,945,2481,709,2125,81,266,373,1044,454,1310
354970,202109,4416,11959,3465,10350,357,1217,2250,6485,2607,7702
354980,202109,35090,82101,24022,63250,2424,7568,14934,36569,17358,44137
354990,202109,71893,178056,53867,145219,4079,12774,35917,90674,39996,103448
354995,202109,2952,6465,2226,5521,140,405,1674,4004,1814,4409
355000,202109,1661,4049,1244,3433,211,672,606,1512,817,2184
355010,202109,4044,10734,2495,7472,805,2481,353,1075,1158,3556
355020,202109,3767,10250,2782,8528,528,1819,1193,3430,1721,5249
355030,202109,1446262,3507870,1056737,2762193,151466,434650,551089,1325441,702555,1760091
355040,202109,3163,7561,2452,6642,259,724,1804,4854,2063,5578
355050,202109,1075,2381,798,1998,186,531,331,735,517,1266
355060,202109,6481,17027,4727,13820,734,2494,2434,6448,3168,8942
355070,202109,10295,25559,8392,22536,972,2978,5373,13494,6345,16472
355080,202109,969,2725,624,2081,128,466,97,264,225,730
355090,202109,1250,3453,982,3002,206,654,402,1154,608,1808
355100,202109,23163,59245,18049,51655,2706,8209,11011,31065,13717,39274
355110,202109,899,2439,653,2059,164,585,95,271,259,856
355120,202109,756,1939,541,1618,48,151,260,761,308,912
355130,202109,856,1884,443,1134,32,106,283,660,315,766
355140,202109,2056,4510,1725,4060,89,234,1434,3287,1523,3521
355150,202109,4487,11568,3570,9958,380,1183,2307,6163,2687,7346
355160,202109,2294,6135,1654,5004,395,1305,410,1143,805,2448
355170,202109,11698,28807,9162,24582,1565,4521,4919,12781,6484,17302
355180,202109,2975,7704,2121,6288,392,1295,881,2386,1273,3681
355190,202109,1938,4985,1516,4313,397,1115,746,2264,1143,3379
355200,202109,851,2567,719,2351,201,712,291,914,492,1626
355210,202109,3142,8434,2423,6962,434,1391,1176,3153,1610,4544
355220,202109,49216,127350,39147,108209,7821,23015,17775,45456,25596,68471
355230,202109,1221,3040,658,1934,119,345,239,655,358,1000
355240,202109,26579,69028,18759,53593,2230,6917,10527,28116,12757,35033
355250,202109,39410,103014,29414,83847,7382,21999,11228,30636,18610,52635
355255,202109,677,1668,372,1121,54,172,134,395,188,567
355260,202109,1596,3768,1125,3006,128,410,659,1627,787,2037
355270,202109,1192,3454,920,2907,204,673,355,1021,559,1694
355280,202109,32854,81769,23631,64777,2901,8636,12559,32216,15460,40852
355290,202109,947,2512,731,2146,142,397,323,915,465,1312
355300,202109,1371,3947,1089,3407,188,637,402,1171,590,1808
355310,202109,966,2628,720,2222,98,295,410,1282,508,1577
355320,202109,537,1389,401,1139,73,233,161,374,234,607
355330,202109,3060,7651,2366,6467,120,417,1808,4709,1928,5126
355340,202109,4316,9497,3294,8140,399,911,2036,5131,2435,6042
355350,202109,1386,3875,1031,3197,197,642,399,1192,596,1834
355360,202109,1244,3127,952,2678,116,353,560,1535,676,1888
355365,202109,380,972,202,660,48,152,26,87,74,239
355370,202109,5615,14166,4336,12115,1041,2652,1830,5663,2871,8315
355380,202109,2977,7844,2251,6534,373,1193,842,2115,1215,3308
355385,202109,1504,3890,1242,3513,107,363,798,2056,905,2419
355390,202109,852,2287,614,1777,131,411,239,617,370,1028
355395,202109,2048,5511,1450,4325,234,733,519,1364,753,2097
355400,202109,9563,26633,7569,22722,1722,5864,2847,7588,4569,13452
355410,202109,23875,64794,14847,46050,2851,9666,4177,12535,7028,22201
355420,202109,638,2002,532,1808,139,512,138,434,277,946
355430,202109,3847,9609,2892,7886,603,1663,1351,3621,1954,5284
355440,202109,793,2122,489,1485,77,234,143,399,220,633
355450,202109,3387,8631,2277,6477,351,1078,1007,2588,1358,3666
355460,202109,528,1255,332,935,46,163,168,420,214,583
355465,202109,453,1166,352,1006,44,138,203,563,247,701
355470,202109,1157,2933,675,1982,176,571,193,497,369,1068
355475,202109,352,813,289,729,14,33,219,538,233,571
355480,202109,4171,11278,3387,10094,458,1582,2196,6368,2654,7950
355490,202109,972,2548,551,1683,44,145,278,772,322,917
355495,202109,843,2320,613,1932,63,249,230,641,293,890
355500,202109,7126,18001,4359,12707,639,2027,1605,4282,2244,6309
355510,202109,1442,3445,927,2592,129,395,385,961,514,1356
355520,202109,384,870,190,553,35,103,63,188,98,291
355530,202109,383,904,147,434,10,36,61,160,71,196
355535,202109,523,1390,399,1196,74,278,186,512,260,790
355540,202109,11265,27468,9247,24645,1188,3477,6281,16164,7469,19641
355550,202109,638,1848,526,1631,59,204,294,839,353,1043
355560,202109,1197,3046,677,2044,152,522,27,76,179,598
355570,202109,282,757,145,457,22,72,34,83,56,155
355580,202109,1247,2969,779,2173,136,448,290,709,426,1157
355590,202109,179,453,139,389,15,47,86,229,101,276
355600,202109,1609,3891,1058,2954,164,490,380,1064,544,1554
355610,202109,1883,4558,1251,3466,136,414,676,1755,812,2169
355620,202109,5288,13726,3960,11127,397,1334,2263,5818,2660,7152
355630,202109,2525,6741,1786,5381,264,832,930,2698,1194,3530
355635,202109,916,2631,678,2161,112,386,207,594,319,980
355640,202109,3336,9025,2284,6932,459,1417,674,2043,1133,3460
355645,202109,4293,11836,3138,9803,453,1547,1686,5077,2139,6624
355650,202109,6697,17815,5170,15024,1308,3996,1519,3903,2827,7899
355660,202109,1456,3678,1015,2897,163,492,299,851,462,1343
355670,202109,4020,10599,2745,7771,325,1082,1424,3559,1749,4641
355680,202109,2971,7984,1401,4353,330,1119,95,278,425,1397
355690,202109,815,2340,534,1792,129,480,11,19,140,499
355695,202109,263,730,153,479,13,58,30,65,43,123
355700,202109,7853,21940,6468,18913,971,3102,3677,10077,4648,13179
355710,202109,9591,22401,6366,16546,847,2488,3186,7314,4033,9802
355715,202109,500,1330,273,827,59,190,46,119,105,309
355720,202109,1494,4147,1178,3587,169,542,655,1889,824,2431
355730,202109,967,2606,791,2291,124,397,407,1099,531,1496
410010,202109,1323,3620,1018,2986,191,606,251,703,442,1309
410020,202109,1073,3153,817,2578,275,808,178,563,453,1371
410030,202109,1616,4320,1382,3957,197,588,753,2194,950,2782
410040,202109,13537,36670,9888,29789,2143,6924,3082,8535,5225,15459
410045,202109,841,2234,608,1774,90,289,233,610,323,899
410050,202109,2379,5879,1648,4626,251,796,617,1601,868,2397
410060,202109,2155,5969,1685,5056,365,1156,519,1474,884,2630
410070,202109,2063,5137,1538,4195,231,714,612,1478,843,2192
410080,202109,1395,3681,987,2945,270,839,197,588,467,1427
410090,202109,1159,2898,980,2620,107,263,557,1579,664,1842
410100,202109,2006,5658,1323,4061,192,670,126,375,318,1045
410105,202109,504,1252,290,840,31,88,107,289,138,377
410110,202109,3448,8488,2437,6598,312,904,1147,2912,1459,3816
410115,202109,591,1508,426,1218,54,161,165,430,219,591
410120,202109,2761,7429,2382,6880,469,1439,1314,3685,1783,5124
410130,202109,1300,3445,1122,3112,204,639,590,1523,794,2162
410140,202109,17240,41294,11419,30935,2033,6035,3130,7694,5163,13729
410150,202109,17256,39988,8824,23738,1489,4440,2170,5180,3659,9620
410160,202109,3049,8287,2433,7208,550,1748,810,2385,1360,4133
410165,202109,707,1863,578,1600,64,203,334,859,398,1062
410170,202109,3017,7671,1999,5533,429,1287,119,343,548,1630
410180,202109,15560,42658,11959,35412,1663,5380,6124,16786,7787,22166
410185,202109,439,1272,316,960,56,179,89,233,145,412
410190,202109,2245,5532,1621,4425,328,936,426,1083,754,2019
410200,202109,6079,13573,3343,8886,531,1601,452,1146,983,2747
410210,202109,3342,8212,2166,6137,358,1143,717,1724,1075,2867
410220,202109,563,1444,369,1088,57,173,88,244,145,417
410230,202109,1864,4898,1427,4038,220,665,599,1534,819,2199
410240,202109,5423,13970,3691,10602,724,2310,521,1323,1245,3633
410250,202109,2640,6256,1954,5165,137,437,963,2474,1100,2911
410260,202109,1932,4777,1198,3404,159,459,558,1524,717,1983
410270,202109,495,1302,355,1052,46,157,141,407,187,564
410275,202109,657,1826,466,1416,77,250,184,514,261,764
410280,202109,2463,6382,1626,4746,205,685,670,1775,875,2460
410290,202109,3523,9637,2431,7350,709,2110,574,1734,1283,3844
410300,202109,722,1751,570,1515,60,181,278,671,338,852
410302,202109,354,899,201,610,16,51,99,292,115,343
410304,202109,1322,3364,1098,2944,122,347,683,1757,805,2104
410305,202109,1782,4214,1245,3444,108,332,799,2127,907,2459
410310,202109,2708,7395,2193,6440,302,997,1166,3327,1468,4324
410315,202109,662,1550,412,1151,149,417,100,288,249,705
410320,202109,1090,2979,734,2257,108,378,125,352,233,730
410322,202109,668,1732,352,1012,40,117,147,369,187,486
410330,202109,1586,3811,1093,2895,180,498,311,822,491,1320
410335,202109,885,2344,673,1946,96,293,278,739,374,1032
410337,202109,859,2091,595,1580,84,235,203,483,287,718
410340,202109,529,1484,353,1062,27,82,162,397,189,479
410345,202109,2603,6691,1416,4142,264,797,392,989,656,1786
410347,202109,762,1945,561,1573,55,190,178,498,233,688
410350,202109,1677,4046,1203,3272,143,422,579,1451,722,1873
410360,202109,4430,10847,3379,9023,508,1412,1419,3680,1927,5092
410370,202109,14474,38239,9369,26426,1082,3314,3954,9728,5036,13042
410380,202109,1729,4273,1263,3446,196,571,408,991,604,1562
410390,202109,2820,6919,1886,5295,377,1188,641,1586,1018,2774
410395,202109,954,2664,771,2292,159,477,291,884,450,1361
410400,202109,7055,17930,5371,14782,740,2156,2795,7240,3535,9396
410405,202109,901,2054,629,1656,106,316,293,715,399,1031
410410,202109,1354,3511,1269,3379,149,469,810,2234,959,2703
410420,202109,11725,31238,8843,25508,1338,4322,3741,9646,5079,13968
410425,202109,3500,9619,2400,7375,387,1284,869,2405,1256,3689
410430,202109,13777,33910,9700,26522,1431,4292,3587,9057,5018,13349
410440,202109,2387,6951,2044,6326,320,1105,1061,3198,1381,4303
410442,202109,2472,7241,1948,6092,486,1574,527,1535,1013,3109
410445,202109,2333,6575,1687,5329,329,1170,269,927,598,2097
410450,202109,1553,3783,1158,3165,217,634,442,1147,659,1781
410460,202109,2304,5645,1699,4609,188,547,815,2090,1003,2637
410465,202109,2912,8250,2297,7094,414,1346,787,2258,1201,3604
410470,202109,2196,5900,1537,4724,394,1393,212,705,606,2098
410480,202109,39685,93791,21650,61968,3132,9983,5000,12122,8132,22105
410490,202109,11823,31970,8507,25237,1463,4609,3474,9569,4937,14178
410500,202109,1961,5008,1325,3823,256,821,345,852,601,1673
410510,202109,1903,4693,1284,3552,251,666,381,1054,632,1720
410520,202109,3122,9609,2743,8849,952,3173,808,2668,1760,5841
410530,202109,1696,4049,790,2176,103,302,210,471,313,773
410540,202109,2959,7868,2045,6030,316,1012,861,2401,1177,3413
410550,202109,7959,20850,5319,15229,881,2758,1444,3554,2325,6312
410560,202109,1575,4052,1160,3211,242,728,375,880,617,1608
410570,202109,2706,7187,1949,5858,537,1924,193,580,730,2504
410580,202109,27736,70461,20235,56925,3413,10335,9208,24154,12621,34489
410590,202109,1613,4530,1125,3406,152,486,340,860,492,1346
410600,202109,1854,4841,1433,4042,335,929,423,1256,758,2185
410610,202109,738,1880,558,1551,64,207,255,644,319,851
410620,202109,2621,7283,1762,5319,388,1249,244,707,632,1956
410630,202109,2634,6737,1728,4950,292,1009,380,860,672,1869
410640,202109,5020,11596,3459,8900,728,2165,420,1091,1148,3256
410645,202109,1145,3153,938,2893,275,878,444,1374,719,2252
410650,202109,2475,6593,1709,5072,320,1009,628,1705,948,2714
410655,202109,938,2229,656,1725,24,66,335,835,359,901
410657,202109,637,1690,386,1146,51,158,112,270,163,428
410660,202109,3632,9033,2142,5837,367,1023,666,1652,1033,2675
410670,202109,1062,2599,647,1821,133,359,199,512,332,871
410680,202109,2674,7847,1842,5797,420,1327,272,881,692,2208
410685,202109,551,1391,412,1157,100,315,153,392,253,707
410690,202109,140175,334267,94653,251538,14093,42561,38511,90036,52604,132597
410700,202109,2570,6413,2129,5727,399,1087,963,2523,1362,3610
410710,202109,922,2291,606,1706,113,334,242,616,355,950
410712,202109,683,1887,568,1677,103,339,271,747,374,1086
410715,202109,879,2499,555,1776,64,206,228,692,292,898
410720,202109,3478,8708,2797,7483,418,1332,771,1999,1189,3331
410725,202109,1162,2808,677,1905,141,421,92,217,233,638
410730,202109,737,1948,577,1653,117,380,123,358,240,738
410740,202109,920,2537,675,2068,85,291,271,826,356,1117
410750,202109,1863,4598,1490,3926,238,668,699,1761,937,2429
410752,202109,386,936,209,598,28,83,99,262,127,345
410753,202109,356,1047,249,801,41,148,54,158,95,306
410754,202109,1127,2862,933,2573,69,166,635,1829,704,1995
410755,202109,596,1515,427,1189,53,153,198,500,251,653
410760,202109,3803,9707,2746,7791,643,2103,661,1726,1304,3829
410765,202109,15330,41824,11963,35215,2023,6445,2900,7433,4923,13878
410770,202109,1106,2560,778,2013,71,180,390,1005,461,1185
410773,202109,1330,3470,1165,3221,118,358,753,2018,871,2376
410775,202109,1573,3822,1378,3535,60,179,934,2328,994,2507
410780,202109,666,1629,448,1217,67,180,135,345,202,525
410785,202109,748,1900,569,1598,89,282,184,511,273,793
410790,202109,918,2546,760,2252,185,577,64,138,249,715
410800,202109,3559,7822,2858,6814,53,157,1865,4309,1918,4466
410810,202109,466,1216,349,988,33,100,136,326,169,426
410820,202109,984,2707,522,1551,99,302,91,233,190,535
410830,202109,42869,101034,29652,79217,5691,16955,11696,29139,17387,46094
410832,202109,1066,2740,853,2369,90,280,511,1335,601,1615
410840,202109,9179,22692,5425,15628,984,3096,1439,3812,2423,6908
410845,202109,1201,2947,928,2529,169,474,382,1024,551,1498
410850,202109,2303,6429,2012,5907,323,987,948,2722,1271,3709
410855,202109,796,1957,508,1401,56,154,247,620,303,774
410860,202109,4650,11149,3642,9519,264,826,2278,5612,2542,6438
410865,202109,1505,4260,1293,3864,129,412,749,2296,878,2708
410870,202109,1274,3351,1037,2956,101,295,665,1874,766,2169
410880,202109,4850,12639,3357,9911,517,1542,510,1598,1027,3140
410890,202109,1062,2909,814,2435,172,575,257,718,429,1293
410895,202109,1039,3225,872,2869,267,965,211,654,478,1619
410900,202109,897,2378,630,1859,101,311,149,367,250,678
410910,202109,428,983,265,675,14,51,141,313,155,364
410920,202109,901,2158,651,1753,84,251,324,842,408,1093
410930,202109,1777,4483,1223,3510,276,918,211,582,487,1500
410940,202109,23974,63725,17429,52194,3504,11470,5577,16172,9081,27642
410950,202109,1987,5727,1787,5432,68,201,1460,4428,1528,4629
410960,202109,8155,19603,5684,15560,1233,3740,2263,6129,3496,9869
410965,202109,1216,2994,828,2277,76,230,502,1342,578,1572
410970,202109,4294,11330,3043,8910,670,2320,432,1035,1102,3355
410975,202109,1421,3410,1081,2889,127,375,516,1327,643,1702
410980,202109,8090,19778,5254,14723,576,1764,2352,5949,2928,7713
410990,202109,1461,3452,987,2701,186,594,392,1041,578,1635
411000,202109,700,1851,495,1475,64,214,154,385,218,599
411005,202109,504,1233,297,800,51,151,98,224,149,375
411007,202109,2400,6521,1905,5644,455,1426,643,1840,1098,3266
411010,202109,4342,12788,3414,10918,830,2885,368,1066,1198,3951
411020,202109,2444,6738,1975,5910,553,1703,510,1509,1063,3212
411030,202109,799,1927,562,1456,50,165,295,667,345,832
411040,202109,1045,2621,563,1586,71,222,175,406,246,628
411050,202109,2051,6264,1676,5455,384,1355,264,719,648,2074
411060,202109,2148,5651,1389,4066,271,890,268,743,539,1633
411065,202109,443,1113,289,815,36,109,123,331,159,440
411070,202109,7869,19503,6209,16771,756,2229,3246,8485,4002,10714
411080,202109,1862,4918,1553,4401,377,1250,348,932,725,2182
411090,202109,839,2203,549,1634,45,157,157,434,202,591
411095,202109,2829,6542,1564,4248,194,543,384,959,578,1502
411100,202109,1264,3222,886,2535,87,282,315,913,402,1195
411110,202109,659,1682,313,939,36,108,22,47,58,155
411120,202109,1388,3714,1140,3265,308,1036,259,673,567,1709
411125,202109,5479,15688,4876,14583,1106,3242,2275,7142,3381,10384
411130,202109,754,1972,542,1577,101,267,183,593,284,860
411140,202109,2336,7004,1960,6237,595,2008,507,1604,1102,3612
411150,202109,4133,10318,2769,7540,497,1571,251,488,748,2059
411155,202109,1030,2615,644,1886,103,300,284,780,387,1080
411160,202109,380,864,260,685,29,76,70,189,99,265
411170,202109,792,2258,609,1853,137,444,218,626,355,1070
411180,202109,5880,15228,4592,13024,682,2083,2228,5909,2910,7992
411190,202109,1921,4833,1413,3899,198,596,563,1401,761,1997
411200,202109,5073,13528,3677,10950,868,2893,821,2103,1689,4996
411210,202109,3436,7594,2334,5807,417,1128,795,1876,1212,3004
411220,202109,921,2315,644,1789,148,457,179,464,327,921
411230,202109,884,2324,645,1873,136,419,209,583,345,1002
411240,202109,1682,3941,1149,3008,133,407,562,1340,695,1747
411250,202109,2330,6062,1687,4910,321,1105,506,1378,827,2483
411260,202109,344,860,224,625,23,69,96,234,119,303
411270,202109,2089,5456,1544,4382,212,636,746,1955,958,2591
411275,202109,1539,3508,1067,2740,142,442,512,1207,654,1649
411280,202109,1369,3665,936,2846,233,726,128,360,361,1086
411290,202109,867,2232,543,1602,72,218,265,759,337,977
411295,202109,1311,3276,941,2572,116,334,418,1073,534,1407
411300,202109,1088,2688,711,1960,73,229,324,765,397,994
411310,202109,920,2079,711,1795,89,230,307,761,396,991
411320,202109,5729,14470,4171,11700,612,1839,1833,4620,2445,6459
411325,202109,1457,4043,1209,3591,232,651,621,1925,853,2576
411330,202109,3460,9190,2525,7480,562,1817,750,2230,1312,4047
411340,202109,871,2341,529,1593,85,269,145,395,230,664
411342,202109,1102,2637,616,1678,104,291,201,507,305,798
411345,202109,1165,2926,887,2476,62,184,642,1794,704,1978
411350,202109,3037,7964,1962,5791,458,1473,335,871,793,2344
411360,202109,759,1802,546,1472,73,214,213,531,286,745
411370,202109,63113,153208,46041,124014,3345,10611,27308,68017,30653,78628
411373,202109,1473,3654,1193,3242,115,334,642,1772,757,2106
411375,202109,1160,2862,836,2257,133,363,329,871,462,1234
411380,202109,1203,2729,816,2010,47,126,508,1154,555,1280
411390,202109,1561,4223,1220,3481,199,610,480,1190,679,1800
411400,202109,2466,5936,1840,4776,157,490,988,2399,1145,2889
411410,202109,2811,7677,2075,6139,437,1414,463,1274,900,2688
411420,202109,4558,10925,2453,6934,319,1025,465,962,784,1987
411430,202109,3770,9953,2862,8264,578,1812,977,2581,1555,4393
411435,202109,426,1164,276,853,59,178,86,234,145,412
411440,202109,2652,7261,2115,6249,441,1396,660,1843,1101,3239
411450,202109,2539,6713,1918,5667,243,716,1059,3172,1302,3888
411460,202109,4536,11517,2846,8272,422,1430,548,1405,970,2835
411470,202109,844,2107,623,1694,102,315,239,564,341,879
411480,202109,5425,14104,3955,11380,652,2237,1542,3961,2194,6198
411490,202109,1682,4280,1293,3635,143,473,565,1407,708,1880
411500,202109,1362,3577,920,2637,152,471,179,412,331,883
411510,202109,2420,5977,1948,5201,337,1059,546,1485,883,2544
411520,202109,34780,84053,20703,56793,2326,7288,8232,19952,10558,27240
411530,202109,1006,2579,602,1802,93,306,94,236,187,542
411535,202109,534,1534,348,1094,43,156,101,284,144,440
411540,202109,2701,6536,1871,5050,118,382,1023,2703,1141,3085
411545,202109,936,2666,786,2401,73,233,505,1547,578,1780
411550,202109,745,1854,547,1489,81,230,109,326,190,556
411560,202109,2089,5616,1197,3694,138,481,61,145,199,626
411570,202109,7484,17123,5052,13492,1138,3276,945,2542,2083,5818
411573,202109,799,2125,661,1885,108,314,293,807,401,1121
411575,202109,2134,5699,1588,4610,273,832,420,1161,693,1993
411580,202109,5070,11616,3083,8546,420,1419,558,1353,978,2772
411585,202109,639,1885,306,982,58,181,54,167,112,348
411590,202109,427,1145,315,923,42,122,159,430,201,552
411600,202109,341,840,211,627,35,105,69,190,104,295
411605,202109,1619,3734,1050,2841,140,482,518,1374,658,1856
411610,202109,2723,6270,1930,4882,66,222,1336,3151,1402,3373
411620,202109,2829,7427,2401,6767,363,1089,1330,3731,1693,4820
411630,202109,854,2137,532,1547,65,229,204,528,269,757
411640,202109,472,1206,322,889,43,129,96,227,139,356
411650,202109,222,634,147,469,29,99,32,78,61,177
411660,202109,955,2419,695,1947,58,167,281,735,339,902
411670,202109,1523,3585,1042,2685,112,303,542,1276,654,1579
411680,202109,1492,3936,1119,3201,180,590,451,1231,631,1821
411690,202109,4147,10326,3119,8566,678,1840,812,2413,1490,4253
411695,202109,662,1943,455,1411,47,160,190,541,237,701
411700,202109,1813,4577,1205,3417,259,753,194,529,453,1282
411705,202109,2176,6384,1836,5792,332,973,1050,3567,1382,4540
411710,202109,2094,5235,1437,4007,319,890,342,901,661,1791
411720,202109,1120,2576,795,2008,134,356,316,765,450,1121
411721,202109,1043,2533,782,2052,134,328,233,610,367,938
411722,202109,929,2433,539,1574,98,308,186,452,284,760
411725,202109,1271,3479,850,2651,195,654,167,492,362,1146
411727,202109,1557,4265,1008,3093,219,674,107,300,326,974
411729,202109,688,1657,391,1075,46,152,143,345,189,497
411730,202109,5549,14383,4285,11959,797,2408,1965,5319,2762,7727
411740,202109,540,1372,283,816,75,195,55,146,130,341
411745,202109,846,2381,588,1802,66,229,150,360,216,589
411750,202109,5885,15257,4286,12122,559,1699,2051,5435,2610,7134
411760,202109,7121,18616,5497,15839,1679,5028,1026,3353,2705,8381
411770,202109,3238,9154,2333,7182,506,1677,415,1122,921,2799
411780,202109,2766,7622,2396,6956,683,2070,793,2359,1476,4429
411790,202109,2995,7131,1704,4815,326,1045,422,1026,748,2071
411800,202109,1134,3216,806,2424,126,420,157,410,283,830
411810,202109,1660,4228,1235,3393,212,606,526,1331,738,1937
411820,202109,12457,34637,10161,30666,2377,7700,4479,13081,6856,20781
411830,202109,573,1399,428,1139,85,245,67,183,152,428
411840,202109,12875,33593,8901,25431,1427,4384,2553,6505,3980,10889
411845,202109,621,1725,366,1138,53,190,92,243,145,433
411850,202109,7761,19423,5269,15064,1234,3877,1016,2615,2250,6492
411860,202109,731,1992,523,1563,79,238,117,303,196,541
411870,202109,607,1730,427,1331,83,281,100,294,183,575
411880,202109,2405,5812,1736,4759,237,712,681,1773,918,2485
411885,202109,1160,2988,841,2413,128,431,251,638,379,1069
411890,202109,1481,3880,1061,3101,179,585,105,285,284,870
411900,202109,840,2288,524,1613,117,375,103,302,220,677
411910,202109,1106,3225,802,2587,178,674,305,891,483,1565
411915,202109,16191,39264,11170,30155,1581,4710,4732,11484,6313,16194
411920,202109,1221,3440,1003,3007,211,732,373,1020,584,1752
411925,202109,515,1337,368,1065,79,235,152,410,231,645
411930,202109,5108,15103,4281,13587,1839,6342,280,1084,2119,7426
411940,202109,3419,9800,2654,8184,615,1923,876,2449,1491,4372
411950,202109,15264,40429,12615,36037,1558,5045,7600,20684,9158,25729
411960,202109,6322,16421,4970,13752,861,2539,2044,5411,2905,7950
411965,202109,498,1352,356,1065,49,163,158,435,207,598
411970,202109,1247,2755,963,2379,186,437,407,1155,593,1592
411980,202109,1541,3675,1112,2977,284,752,401,1057,685,1809
411990,202109,39813,102145,25651,76629,4532,14948,9116,25543,13648,40491
411995,202109,4166,9996,3196,8487,894,2587,809,2067,1703,4654
412000,202109,1894,4343,1301,3346,35,114,899,2143,934,2257
412010,202109,647,1938,482,1570,76,258,126,355,202,613
412015,202109,561,1555,452,1357,69,212,251,753,320,965
412020,202109,472,1303,301,943,44,162,123,349,167,511
412030,202109,620,1735,459,1441,68,215,160,493,228,708
412033,202109,1002,2586,710,2006,86,250,263,627,349,877
412035,202109,753,2015,482,1525,60,206,248,751,308,957
412040,202109,701,1854,388,1199,58,173,49,142,107,315
412050,202109,1646,4074,1118,3095,245,751,248,685,493,1436
412060,202109,7585,21521,6275,18912,1607,5494,1709,4917,3316,10411
412065,202109,647,1764,473,1413,98,318,111,329,209,647
412070,202109,1264,3239,989,2706,130,386,381,938,511,1324
412080,202109,2381,6413,1662,4986,238,760,516,1378,754,2138
412085,202109,333,794,116,351,12,33,24,59,36,92
412090,202109,6478,16337,4736,13156,1064,3123,1736,4834,2800,7957
412100,202109,1797,4709,1345,3877,433,1415,300,891,733,2306
412110,202109,928,2409,622,1795,88,274,208,564,296,838
412120,202109,2168,6011,1637,5017,331,1125,423,1089,754,2214
412125,202109,685,1914,462,1435,86,262,92,288,178,550
412130,202109,853,2084,580,1583,94,256,145,405,239,661
412135,202109,647,1701,308,921,46,153,94,235,140,388
412140,202109,1831,4373,1244,3356,190,618,262,670,452,1288
412150,202109,2929,7405,2480,6627,368,1122,1476,3722,1844,4844
412160,202109,920,2817,516,1711,64,236,64,168,128,404
412170,202109,4531,12170,3797,10989,686,2233,1602,4246,2288,6479
412175,202109,1354,3773,1127,3388,236,755,467,1387,703,2142
412180,202109,1750,4758,1284,3902,157,543,563,1575,720,2118
412190,202109,3484,8574,2560,6970,307,897,1074,2897,1381,3794
412200,202109,1921,5491,1285,4059,307,1050,186,551,493,1601
412210,202109,678,1589,426,1161,56,171,169,411,225,582
412215,202109,3453,9150,2596,7481,626,1767,1012,3147,1638,4914
412217,202109,1036,2651,860,2333,41,111,611,1589,652,1700
412220,202109,5796,15996,4759,14127,1318,3791,1432,4555,2750,8346
412230,202109,2795,8002,2194,6850,339,1211,525,1391,864,2602
412240,202109,7885,20084,5031,14443,859,2651,1481,3792,2340,6443
412250,202109,2103,5314,1547,4252,353,1005,302,749,655,1754
412260,202109,1329,3437,994,2765,156,443,290,762,446,1205
412265,202109,962,2544,760,2191,160,474,300,827,460,1301
412270,202109,1080,2919,698,2114,86,290,273,743,359,1033
412280,202109,430,1156,335,995,81,248,90,256,171,504
412290,202109,1077,2710,748,2124,109,342,248,637,357,979
412300,202109,1720,4423,1208,3527,252,763,272,819,524,1582
412310,202109,763,2153,583,1782,106,372,175,492,281,864
412320,202109,806,2040,515,1455,48,162,146,401,194,563
412330,202109,1656,4320,1136,3361,242,752,387,1169,629,1921
412340,202109,1268,3397,837,2467,101,341,114,317,215,658
412350,202109,3128,8056,2037,5899,359,1129,365,945,724,2074
412360,202109,271,725,194,563,6,28,127,345,133,373
412370,202109,881,2471,598,1868,118,410,74,219,192,629
412380,202109,1604,4322,1135,3396,282,883,118,393,400,1276
412382,202109,501,1203,332,927,38,131,149,340,187,471
412385,202109,2265,6078,1850,5295,596,1603,576,1826,1172,3429
412390,202109,2607,6151,2084,5342,358,942,725,1843,1083,2785
412395,202109,726,2030,520,1561,73,206,225,677,298,883
412400,202109,960,2482,691,1965,129,406,197,541,326,947
412402,202109,2378,5754,1658,4578,423,1180,222,662,645,1842
412405,202109,3229,8377,2114,6314,516,1769,133,367,649,2136
412410,202109,6517,16576,4766,13729,771,2565,1569,4173,2340,6738
412420,202109,560,1385,372,1007,27,81,183,423,210,504
412430,202109,616,1541,332,960,34,102,132,352,166,454
412440,202109,2897,7583,1939,5795,438,1385,411,1238,849,2623
412450,202109,523,1487,350,1058,42,129,36,82,78,211
412460,202109,1149,2904,896,2477,165,492,393,1038,558,1530
412470,202109,1602,4920,1319,4296,294,1019,284,904,578,1923
412480,202109,1114,2880,746,2116,121,376,260,647,381,1023
412490,202109,1380,3306,1094,2801,137,349,553,1331,690,1680
412500,202109,2075,5143,1568,4216,319,884,438,1062,757,1946
412510,202109,2002,5960,1374,4405,317,1090,175,496,492,1586
412520,202109,1362,3387,757,2148,166,462,103,280,269,742
412530,202109,722,1884,514,1464,77,247,113,313,190,560
412535,202109,851,2180,576,1653,109,344,112,264,221,608
412540,202109,1216,3022,881,2431,85,300,292,846,377,1146
412545,202109,714,1825,494,1390,84,260,136,368,220,628
412550,202109,35737,93364,25542,73230,3908,12102,10527,27322,14435,39424
412555,202109,304,784,206,577,23,71,67,150,90,221
412560,202109,5059,14212,3834,11420,663,2206,1161,3413,1824,5619
412570,202109,4702,11581,2729,7819,478,1586,355,1041,833,2627
412575,202109,1067,2656,851,2290,115,342,452,1137,567,1479
412580,202109,1508,3830,1078,3033,74,244,596,1584,670,1828
412590,202109,416,1090,233,719,30,96,25,70,55,166
412600,202109,1722,4523,1316,3731,177,550,621,1637,798,2187
412610,202109,879,2293,633,1769,79,240,281,673,360,913
412620,202109,1299,3340,997,2887,183,606,314,836,497,1442
412625,202109,9052,23584,5573,16676,745,2495,333,928,1078,3423
412627,202109,1173,3246,761,2393,141,494,206,633,347,1127
412630,202109,2965,8509,2144,6759,385,1275,599,1693,984,2968
412635,202109,427,1140,290,848,32,103,96,223,128,326
412640,202109,1074,2783,622,1838,75,231,172,443,247,674
412650,202109,1763,4679,1392,3949,229,732,537,1321,766,2053
412660,202109,2618,6675,1896,5304,246,731,661,1661,907,2392
412665,202109,411,1011,321,851,66,181,135,353,201,534
412667,202109,1874,4807,1366,3827,187,568,589,1572,776,2140
412670,202109,899,2082,580,1567,108,326,151,377,259,703
412680,202109,2177,5668,1515,4413,180,608,537,1354,717,1962
412690,202109,1194,3105,860,2469,148,471,305,817,453,1288
412700,202109,1991,5159,1664,4653,211,648,908,2484,1119,3132
412710,202109,6061,17260,4495,13926,815,2784,1190,3169,2005,5953
412720,202109,1212,3458,932,2859,140,454,228,569,368,1023
412730,202109,2657,6807,1859,5246,309,994,726,1872,1035,2866
412740,202109,2005,5505,1378,4240,209,740,190,587,399,1327
412750,202109,4172,10684,3392,9569,277,891,2225,5993,2502,6884
412760,202109,3045,8109,2530,7236,472,1514,1350,3609,1822,5123
412770,202109,11051,28057,6020,18103,788,2542,1285,3201,2073,5743
412780,202109,1226,3191,930,2663,196,613,348,955,544,1568
412785,202109,2229,5166,1578,4095,157,413,1057,2689,1214,3102
412788,202109,1463,4044,1198,3586,333,991,447,1299,780,2290
412790,202109,1395,3641,805,2457,109,379,249,654,358,1033
412795,202109,1294,3295,703,2098,90,286,127,355,217,641
412796,202109,2256,6329,1865,5632,370,1198,601,1660,971,2858
412800,202109,3839,9194,2681,7077,280,864,1313,3061,1593,3925
412810,202109,12769,32208,8345,23353,1000,3242,3310,8162,4310,11404
412820,202109,6383,17292,4520,13532,1075,3436,1291,3812,2366,7248
412830,202109,359,1005,260,793,40,114,71,203,111,317
412840,202109,1952,4732,1399,3678,141,415,685,1630,826,2045
412850,202109,2877,7375,2103,6080,307,959,895,2501,1202,3460
412853,202109,1559,3870,1296,3415,171,497,678,1585,849,2082
412855,202109,1371,3505,829,2385,119,383,212,534,331,917
412860,202109,774,1892,525,1491,79,240,268,711,347,951
412862,202109,680,1661,461,1291,101,290,169,439,270,729
412863,202109,1292,3836,1143,3563,260,831,516,1609,776,2440
412865,202109,727,1959,532,1563,154,467,117,368,271,835
412870,202109,879,2254,632,1850,175,568,149,486,324,1054
412880,202109,890,2375,596,1799,102,345,115,310,217,655
420005,202109,434,1249,258,842,28,92,122,400,150,492
420010,202109,3362,8124,2260,6280,124,373,1667,4685,1791,5058
420020,202109,445,1356,295,969,47,180,69,161,116,341
420030,202109,98,343,63,253,16,72,20,76,36,148
420040,202109,523,1551,324,1105,67,253,28,70,95,323
420050,202109,723,1614,483,1198,78,208,284,633,362,841
420055,202109,160,485,81,292,20,89,21,65,41,154
420060,202109,112,305,70,204,7,23,15,35,22,58
420070,202109,748,2197,558,1799,111,355,222,697,333,1052
420075,202109,81,200,40,119,7,26,12,18,19,44
420080,202109,385,1061,299,862,72,238,117,317,189,555
420090,202109,424,1291,271,930,62,228,48,138,110,366
420100,202109,1300,3283,1089,2964,64,185,878,2354,942,2539
420110,202109,260,819,233,758,41,142,121,382,162,524
420120,202109,604,1613,408,1191,59,197,211,539,270,736
420125,202109,363,1077,253,832,65,239,82,246,147,485
420127,202109,316,806,123,366,15,48,47,130,62,178
420130,202109,3768,10140,2875,8679,408,1455,1351,3716,1759,5171
420140,202109,3910,10296,2850,8467,753,2515,521,1573,1274,4088
420150,202109,685,1709,478,1362,46,153,285,778,331,931
420160,202109,191,450,69,212,8,28,18,54,26,82
420165,202109,155,429,93,294,20,60,31,86,51,146
420170,202109,294,909,199,665,27,100,65,185,92,285
420180,202109,174,545,109,380,17,59,27,82,44,141
420190,202109,210,633,125,422,27,99,48,154,75,253
420195,202109,1568,3926,1176,3314,292,967,319,787,611,1754
420200,202109,5272,12528,3270,8838,415,1344,1418,3315,1833,4659
420205,202109,1945,5108,1315,3825,186,571,696,2020,882,2591
420207,202109,2005,5095,1265,3681,202,662,529,1429,731,2091
420208,202109,324,910,185,640,55,197,42,121,97,318
420209,202109,155,485,99,311,13,45,50,142,63,187
420210,202109,3424,8623,2393,6951,364,1213,1229,3383,1593,4596
420213,202109,801,2394,680,2162,146,495,333,1044,479,1539
420215,202109,211,635,148,492,40,148,36,114,76,262
420220,202109,297,855,181,602,30,122,80,241,110,363
420230,202109,5407,14325,4141,11976,573,1789,2243,6180,2816,7969
420240,202109,14854,40589,9577,28452,1142,3879,4606,11863,5748,15742
420243,202109,404,1104,332,967,50,171,212,585,262,756
420245,202109,1539,3874,1149,3209,85,291,725,1901,810,2192
420250,202109,457,1244,389,1131,52,172,238,658,290,830
420253,202109,472,1134,332,930,34,95,192,537,226,632
420257,202109,159,405,101,304,13,50,55,162,68,212
420260,202109,1149,2925,843,2509,112,393,567,1652,679,2045
420270,202109,564,1453,294,856,40,131,116,313,156,444
420280,202109,1301,3783,1025,3206,179,627,404,1184,583,1811
420285,202109,127,277,61,170,8,36,24,44,32,80
420287,202109,460,1042,332,870,82,225,127,334,209,559
420290,202109,5057,14119,3912,11576,534,1779,2286,6267,2820,8046
420300,202109,7662,21328,4479,13795,776,2639,1448,3855,2224,6494
420310,202109,815,1855,428,1169,41,128,240,614,281,742
420315,202109,799,2195,547,1766,89,310,257,815,346,1125
420320,202109,5432,14348,3909,11848,1057,3537,1007,2844,2064,6381
420325,202109,346,960,245,758,32,99,103,297,135,396
420330,202109,990,2826,625,2055,102,374,191,576,293,950
420340,202109,947,2579,710,2162,154,473,148,403,302,876
420350,202109,1206,3046,898,2506,68,228,635,1734,703,1962
420360,202109,3004,8095,1620,5122,289,999,116,355,405,1354
420370,202109,1212,3132,995,2780,76,257,733,1972,809,2229
420380,202109,4488,11584,3027,8909,597,1867,1201,3325,1798,5192
420390,202109,1084,2620,754,1960,129,387,308,575,437,962
420395,202109,1199,3356,830,2609,125,436,136,310,261,746
420400,202109,1020,2778,717,2166,114,399,316,890,430,1289
420410,202109,592,1541,459,1271,31,91,330,899,361,990
420415,202109,293,851,217,688,50,171,86,289,136,460
420417,202109,599,1735,467,1471,126,417,178,568,304,985
420419,202109,140,497,112,431,40,161,9,37,49,198
420420,202109,12138,31017,8163,23787,2122,6999,2400,6326,4522,13325
420425,202109,645,1709,444,1287,33,112,225,627,258,739
420430,202109,3187,8400,1901,5626,416,1305,639,1724,1055,3029
420435,202109,261,673,139,441,19,68,69,210,88,278
420440,202109,708,1873,438,1314,126,401,134,371,260,772
420445,202109,261,631,172,472,32,87,77,194,109,281
420450,202109,753,2165,543,1710,88,348,202,542,290,890
420455,202109,2051,4879,1497,4054,235,669,721,1885,956,2554
420460,202109,9523,24972,7197,20691,976,3168,3767,10303,4743,13471
420470,202109,602,1554,318,984,57,206,58,152,115,358
420475,202109,67,178,26,85,6,21,2,6,8,27
420480,202109,5304,12863,3269,9517,607,1943,1203,3436,1810,5379
420490,202109,378,1044,269,812,53,173,107,314,160,487
420500,202109,1368,3685,888,2814,136,495,410,1265,546,1760
420510,202109,156,434,77,253,13,52,18,51,31,103
420515,202109,77,210,49,143,7,34,17,46,24,80
420517,202109,765,2074,647,1850,71,213,417,1193,488,1406
420519,202109,307,739,219,610,19,62,136,380,155,442
420520,202109,278,735,144,474,18,61,10,31,28,92
420530,202109,825,2358,562,1785,75,291,229,630,304,921
420535,202109,233,681,95,324,15,56,37,122,52,178
420540,202109,39931,94416,26548,71904,3652,11119,10014,23462,13666,34581
420543,202109,215,627,164,512,20,66,79,217,99,283
420545,202109,1274,3757,965,3081,164,594,342,957,506,1551
420550,202109,3676,9617,2416,7507,368,1353,1078,3356,1446,4709
420555,202109,309,877,220,691,22,76,130,391,152,467
420560,202109,395,965,261,764,47,149,156,453,203,602
420570,202109,2531,6578,1965,5541,312,991,928,2514,1240,3505
420580,202109,1839,4684,1312,3850,292,910,417,1245,709,2155
420590,202109,2813,7483,1715,5112,281,991,479,1105,760,2096
420600,202109,1086,3055,848,2618,96,366,518,1511,614,1877
420610,202109,370,1060,239,769,60,194,80,266,140,460
420620,202109,778,1892,522,1476,116,341,195,547,311,888
420630,202109,924,2766,677,2170,76,275,404,1220,480,1495
420640,202109,507,1354,255,838,78,254,43,135,121,389
420650,202109,3710,9661,2342,6842,321,1036,949,2410,1270,3446
420660,202109,431,1099,275,769,56,158,56,142,112,300
420665,202109,677,1748,446,1361,73,244,198,542,271,786
420670,202109,1250,3416,790,2454,126,485,286,756,412,1241
420675,202109,192,521,117,376,18,78,60,177,78,255
420680,202109,313,708,164,501,29,96,80,231,109,327
420690,202109,873,2564,551,1824,72,288,147,414,219,702
420700,202109,2705,7009,2060,5942,208,655,1267,3547,1475,4202
420710,202109,1046,2922,816,2434,81,303,501,1335,582,1638
420720,202109,1188,3250,857,2682,142,481,455,1341,597,1822
420730,202109,3230,8305,2419,6972,398,1282,1292,3550,1690,4832
420740,202109,502,1468,277,972,55,213,19,75,74,288
420750,202109,1979,5610,1273,3997,210,775,517,1474,727,2249
420757,202109,84,199,38,108,4,6,17,49,21,55
420760,202109,314,903,171,525,32,110,50,138,82,248
420765,202109,457,1289,219,709,26,88,102,314,128,402
420768,202109,1382,3792,1205,3508,140,401,898,2617,1038,3018
420770,202109,443,1226,208,727,24,96,67,219,91,315
420775,202109,270,791,186,599,33,115,72,194,105,309
420780,202109,952,2692,570,1799,110,376,92,260,202,636
420785,202109,202,527,144,408,14,50,71,165,85,215
420790,202109,1036,3045,773,2518,116,444,443,1365,559,1809
420800,202109,670,1642,352,1020,70,232,155,422,225,654
420810,202109,1488,4479,1216,3943,313,1174,490,1358,803,2532
420820,202109,13205,32554,9597,26692,1652,5114,4526,11647,6178,16761
420830,202109,4597,11802,3442,9748,585,1747,1504,4090,2089,5837
420840,202109,485,1432,234,860,57,205,18,76,75,281
420845,202109,2603,6499,1653,4805,309,1071,695,1895,1004,2966
420850,202109,1104,3452,685,2357,113,415,151,455,264,870
420860,202109,373,953,215,668,35,112,56,151,91,263
420870,202109,787,2185,580,1774,152,515,215,585,367,1100
420880,202109,1085,3220,839,2711,163,625,320,929,483,1554
420890,202109,8337,22339,5214,15917,708,2330,1805,4881,2513,7211
420895,202109,178,512,110,337,25,78,36,109,61,187
420900,202109,1550,3793,947,2744,118,415,435,1092,553,1507
420910,202109,32771,85272,21074,62891,3014,10220,8688,22744,11702,32964
420915,202109,508,1800,376,1421,57,211,204,780,261,991
420917,202109,459,1150,205,560,35,94,97,264,132,358
420920,202109,80,215,36,119,2,5,7,25,9,30
420930,202109,16974,43294,12132,34837,2028,6447,5505,14881,7533,21328
420940,202109,3247,7830,1967,5638,427,1379,419,966,846,2345
420945,202109,135,384,107,326,19,66,46,128,65,194
420950,202109,359,1023,207,669,27,104,56,160,83,264
420960,202109,1078,2594,763,2065,118,366,349,841,467,1207
420970,202109,2401,6420,1670,5090,449,1403,481,1475,930,2878
420980,202109,275,904,237,824,109,392,59,209,168,601
420985,202109,327,917,176,597,43,165,46,136,89,301
420990,202109,321,993,186,661,29,109,40,141,69,250
421000,202109,572,1681,418,1347,88,314,100,277,188,591
421003,202109,472,1108,160,463,3,8,18,42,21,50
421005,202109,67,197,51,173,12,42,22,74,34,116
421010,202109,3376,9113,2420,7335,455,1556,690,1828,1145,3384
421020,202109,384,1181,304,1035,43,174,151,483,194,657
421030,202109,813,2347,624,1973,167,590,229,659,396,1249
421040,202109,648,1551,402,1171,30,99,249,709,279,808
421050,202109,1049,2780,692,2006,136,433,269,689,405,1122
421055,202109,177,480,102,308,16,51,60,165,76,216
421060,202109,690,1965,494,1550,91,327,244,699,335,1026
421070,202109,662,1954,413,1332,65,232,166,500,231,732
421080,202109,523,1486,428,1307,42,156,252,749,294,905
421085,202109,379,1056,152,511,14,44,28,75,42,119
421090,202109,274,699,152,423,12,43,51,125,63,168
421100,202109,794,1755,342,1004,75,248,87,201,162,449
421105,202109,1583,4208,1109,3307,170,542,538,1515,708,2057
421110,202109,1146,2943,933,2647,46,154,638,1882,684,2036
421120,202109,1066,3153,764,2500,120,436,221,624,341,1060
421125,202109,299,764,215,613,73,239,76,183,149,422
421130,202109,5000,14229,4116,12499,920,3175,2100,5973,3020,9148
421140,202109,345,929,212,642,39,116,78,214,117,330
421145,202109,442,1192,280,841,67,213,79,206,146,419
421150,202109,651,1779,433,1347,65,234,188,522,253,756
421160,202109,519,1416,390,1166,58,200,237,661,295,861
421165,202109,229,672,141,457,29,94,53,166,82,260
421170,202109,1099,2971,931,2698,141,396,577,1718,718,2114
421175,202109,988,2408,595,1794,109,376,264,770,373,1146
421180,202109,397,1037,219,676,39,144,101,278,140,422
421185,202109,321,815,219,608,22,72,127,337,149,409
421187,202109,277,847,174,589,29,95,57,190,86,285
421189,202109,365,1040,283,879,43,143,116,333,159,476
421190,202109,11624,30921,8004,24028,1363,4374,3100,8550,4463,12924
421200,202109,712,1968,593,1768,89,312,346,970,435,1282
421205,202109,190,499,138,416,24,87,64,178,88,265
421210,202109,1095,2738,619,1915,115,368,228,685,343,1053
421220,202109,1397,4081,1085,3441,231,807,370,1066,601,1873
421223,202109,319,868,199,645,45,137,95,309,140,446
421225,202109,842,2430,716,2222,113,417,440,1333,553,1750
421227,202109,670,1875,436,1383,76,263,199,650,275,913
421230,202109,582,1492,375,1108,74,247,143,413,217,660
421240,202109,294,846,143,493,18,76,28,86,46,162
421250,202109,2161,5334,1531,4320,160,498,935,2532,1095,3030
421260,202109,225,706,51,187,10,44,5,14,15,58
421265,202109,695,1799,614,1681,18,46,529,1440,547,1486
421270,202109,350,926,150,510,28,97,46,146,74,243
421280,202109,2066,5359,1556,4526,210,739,890,2436,1100,3175
421290,202109,990,2662,505,1530,105,337,105,286,210,623
421300,202109,285,726,136,430,12,47,19,55,31,102
421310,202109,197,565,136,444,27,89,70,225,97,314
421315,202109,239,610,157,445,43,117,42,128,85,245
421320,202109,641,2010,340,1134,34,97,34,61,68,158
421330,202109,607,1765,437,1408,94,344,112,320,206,664
421335,202109,352,1059,283,937,60,217,118,376,178,593
421340,202109,1428,3869,1031,3167,168,594,500,1416,668,2010
421350,202109,1547,3943,1021,3032,195,633,391,1101,586,1734
421360,202109,2282,5995,1367,4144,253,899,516,1339,769,2238
421370,202109,741,2347,460,1606,75,283,139,412,214,695
421380,202109,849,2184,730,1999,88,274,437,1147,525,1421
421390,202109,169,448,66,220,14,41,26,73,40,114
421400,202109,354,1088,260,869,51,196,132,410,183,606
421410,202109,175,489,83,298,20,77,22,71,42,148
421415,202109,184,527,126,380,21,75,38,89,59,164
421420,202109,561,1511,455,1308,49,161,279,787,328,948
421430,202109,100,310,72,239,7,23,18,55,25,78
421440,202109,630,1673,375,1191,66,200,157,480,223,680
421450,202109,480,1374,279,926,30,110,39,139,69,249
421460,202109,355,1060,194,716,15,57,23,63,38,120
421470,202109,308,840,193,605,31,96,67,230,98,326
421480,202109,2797,7387,1864,5515,335,1158,756,2052,1091,3210
421490,202109,119,402,72,270,11,39,14,44,25,83
421500,202109,2159,6194,1445,4685,344,1294,342,970,686,2264
421505,202109,301,815,250,743,31,115,167,472,198,587
421507,202109,435,1199,246,803,51,187,88,259,139,446
421510,202109,373,1035,239,715,38,119,122,339,160,458
421520,202109,498,1310,309,887,29,85,168,432,197,517
421530,202109,291,839,161,544,23,98,33,82,56,180
421535,202109,382,1000,244,757,40,150,139,410,179,560
421540,202109,313,740,174,524,27,90,57,156,84,246
421545,202109,627,1834,466,1547,100,407,225,685,325,1092
421550,202109,2110,5484,1703,4870,328,974,946,2688,1274,3662
421555,202109,169,511,67,238,6,22,8,14,14,36
421560,202109,87,291,58,218,9,39,20,69,29,108
421565,202109,929,2348,625,1878,154,526,195,558,349,1084
421567,202109,432,1313,287,928,84,299,88,250,172,549
421568,202109,333,973,231,730,40,147,90,269,130,416
421569,202109,154,434,73,233,9,28,43,140,52,168
421570,202109,1319,3549,926,2732,194,631,295,787,489,1418
421575,202109,295,850,223,660,30,100,109,296,139,396
421580,202109,4400,11762,2815,8491,382,1340,1090,2800,1472,4140
421590,202109,168,500,124,404,30,110,46,142,76,252
421600,202109,587,1536,392,1129,73,242,141,346,214,588
421605,202109,740,1916,535,1587,98,261,268,849,366,1110
421610,202109,1050,2795,706,2155,114,386,223,665,337,1051
421620,202109,3857,10094,2367,7389,448,1630,761,2208,1209,3838
421625,202109,130,362,65,200,9,25,19,57,28,82
421630,202109,2630,6788,1700,5018,291,1026,630,1550,921,2576
421635,202109,269,710,188,546,14,44,120,319,134,363
421640,202109,676,1803,492,1529,111,385,197,603,308,988
421650,202109,2520,6814,1725,5354,362,1296,566,1544,928,2840
421660,202109,10791,29520,7648,23427,1106,3790,3500,9729,4606,13519
421670,202109,765,2135,548,1630,93,311,254,721,347,1032
421680,202109,1115,2914,863,2490,147,464,533,1425,680,1889
421690,202109,1387,3888,952,2986,166,569,323,1010,489,1579
421700,202109,552,1623,389,1260,82,292,128,393,210,685
421710,202109,199,634,102,346,21,75,24,71,45,146
421715,202109,127,324,97,263,21,57,53,140,74,197
421720,202109,2014,5384,1190,3623,281,899,313,829,594,1728
421725,202109,264,634,146,431,20,61,71,185,91,246
421730,202109,404,1117,236,675,31,94,129,339,160,433
421740,202109,774,2163,519,1619,115,386,161,457,276,843
421750,202109,887,2092,434,1260,90,281,173,462,263,743
421755,202109,169,468,93,286,15,55,42,115,57,170
421760,202109,1021,2652,697,2068,126,400,235,590,361,990
421770,202109,2394,6230,1725,5075,448,1282,590,1859,1038,3141
421775,202109,212,550,128,389,15,49,55,156,70,205
421780,202109,840,2427,549,1809,107,395,233,687,340,1082
421790,202109,871,2334,496,1622,100,339,206,655,306,994
421795,202109,175,481,122,354,22,69,38,100,60,169
421800,202109,2668,7055,1943,5726,231,780,1127,3145,1358,3925
421810,202109,645,1753,441,1370,45,166,255,778,300,944
421820,202109,992,2862,612,1940,108,382,208,550,316,932
421825,202109,1386,3732,1232,3500,102,315,907,2515,1009,2830
421830,202109,2008,5771,1636,5087,335,1114,625,1905,960,3019
421835,202109,239,577,160,450,37,126,60,151,97,277
421840,202109,208,651,147,515,22,85,34,105,56,190
421850,202109,379,1040,219,727,52,202,54,135,106,337
421860,202109,305,836,173,564,24,89,65,186,89,275
421870,202109,4649,11472,3420,9195,482,1552,1848,4375,2330,5927
421875,202109,300,866,124,373,20,57,31,78,51,135
421880,202109,680,1888,468,1428,93,310,138,400,231,710
421885,202109,232,640,148,449,35,111,49,128,84,239
421890,202109,865,2515,640,2066,104,397,358,1094,462,1491
421895,202109,403,1008,346,933,39,108,234,667,273,775
421900,202109,1046,2746,802,2249,100,319,404,1017,504,1336
421910,202109,319,920,201,646,27,107,48,125,75,232
421915,202109,374,1048,221,694,48,147,43,122,91,269
421917,202109,583,1326,333,1009,118,376,82,265,200,641
421920,202109,370,1104,266,901,100,349,82,277,182,626
421930,202109,2636,6554,1419,4257,287,988,512,1310,799,2298
421935,202109,405,1241,323,1067,62,210,187,604,249,814
421940,202109,378,1081,178,563,28,96,37,87,65,183
421950,202109,3161,7807,1804,5228,343,1085,469,1178,812,2263
421960,202109,181,440,97,282,14,54,32,68,46,122
421970,202109,1918,4864,1203,3408,226,751,494,1213,720,1964
421985,202109,304,828,191,596,23,79,74,216,97,295
422000,202109,1961,4963,1599,4410,147,481,1107,2996,1254,3477
430003,202109,577,1526,380,1173,67,219,171,525,238,744
430005,202109,271,710,173,535,24,81,86,258,110,339
430010,202109,1754,4115,1393,3563,250,626,867,2205,1117,2831
430020,202109,593,1343,445,1147,48,146,296,725,344,871
430030,202109,953,2210,526,1447,126,378,173,440,299,818
430040,202109,10575,24510,6422,17380,1661,4775,998,2781,2659,7556
430045,202109,470,1169,335,924,25,78,226,609,251,687
430047,202109,237,510,95,254,21,50,26,73,47,123
430050,202109,873,2188,514,1471,104,317,135,367,239,684
430055,202109,279,673,140,385,18,59,72,170,90,229
430057,202109,81,168,28,77,8,27,4,7,12,34
430060,202109,18163,47147,14122,40818,2752,8322,6755,19272,9507,27594
430063,202109,809,2222,659,1920,133,386,353,1033,486,1419
430064,202109,1138,2998,841,2413,200,598,364,1014,564,1612
430066,202109,100,203,72,161,8,19,54,115,62,134
430070,202109,732,1864,126,412,23,90,20,48,43,138
430080,202109,914,2213,554,1517,93,306,294,681,387,987
430085,202109,926,2001,550,1404,95,249,247,614,342,863
430087,202109,841,1988,704,1809,61,163,503,1276,564,1439
430090,202109,515,1350,199,640,17,72,50,143,67,215
430100,202109,897,2127,546,1473,101,301,165,385,266,686
430105,202109,1290,3306,874,2593,124,423,420,1183,544,1606
430107,202109,183,521,103,314,20,61,26,71,46,132
430110,202109,2276,5593,1681,4709,302,881,795,2165,1097,3046
430120,202109,1261,3607,840,2569,142,429,370,1117,512,1546
430130,202109,3571,7916,2619,6592,844,2179,468,1446,1312,3625
430140,202109,1020,2575,726,2047,165,438,370,1030,535,1468
430150,202109,572,1453,311,930,71,222,87,264,158,486
430155,202109,248,628,121,362,20,60,23,57,43,117
430160,202109,20970,47326,16486,41129,1796,4790,10162,24899,11958,29689
430163,202109,3302,7520,2321,5997,77,250,1760,4445,1837,4695
430165,202109,312,769,100,311,12,27,16,45,28,72
430170,202109,978,2542,349,1174,57,198,42,121,99,319
430175,202109,667,1898,564,1684,132,377,273,823,405,1200
430180,202109,674,1614,513,1338,70,168,316,839,386,1007
430185,202109,690,1718,354,1011,99,253,50,139,149,392
430187,202109,783,1653,572,1390,70,184,344,833,414,1017
430190,202109,1442,3642,1147,3188,241,705,534,1422,775,2127
430192,202109,126,333,43,125,6,19,9,21,15,40
430195,202109,424,1217,65,226,8,32,7,14,15,46
430200,202109,1073,3090,850,2688,289,938,226,751,515,1689
430205,202109,453,1147,405,1061,13,46,362,922,375,968
430210,202109,6287,15990,4199,11604,679,1998,1242,2725,1921,4723
430215,202109,313,798,201,579,35,99,77,225,112,324
430220,202109,669,1638,209,677,20,69,53,138,73,207
430222,202109,200,538,145,429,19,61,49,141,68,202
430223,202109,266,672,204,568,15,35,121,329,136,364
430225,202109,16,32,10,23,0,0,7,16,7,16
430230,202109,2012,5310,1655,4764,139,452,1223,3452,1362,3904
430235,202109,383,1049,240,744,37,125,58,154,95,279
430237,202109,514,1173,383,963,16,45,297,728,313,773
430240,202109,1378,3148,781,2128,81,263,409,1010,490,1273
430245,202109,723,1943,563,1646,124,382,294,865,418,1247
430250,202109,950,2242,684,1832,230,660,47,113,277,773
430258,202109,140,374,101,292,7,17,55,155,62,172
430260,202109,703,1799,482,1384,56,181,279,808,335,989
430265,202109,225,639,151,495,28,87,55,187,83,274
430270,202109,3036,7258,2393,6275,360,1022,1491,3790,1851,4812
430280,202109,5254,11984,3669,9333,692,1790,1655,4124,2347,5914
430290,202109,2295,5149,1876,4666,64,186,1584,3843,1648,4029
430300,202109,10631,25752,8042,21384,1216,3562,4340,11067,5556,14629
430310,202109,12667,30613,8642,23295,1084,3230,4314,10814,5398,14044
430320,202109,1050,2588,582,1677,61,176,341,975,402,1151
430330,202109,715,1700,429,1143,77,210,163,400,240,610
430340,202109,614,1418,398,1068,64,160,235,623,299,783
430350,202109,8323,20117,6372,16792,695,2004,4040,10091,4735,12095
430355,202109,311,821,118,375,16,53,15,42,31,95
430360,202109,880,2068,586,1558,107,328,242,594,349,922
430367,202109,346,735,196,493,32,100,109,251,141,351
430370,202109,545,1422,223,658,29,81,60,141,89,222
430380,202109,717,1721,341,1027,76,262,93,267,169,529
430390,202109,3392,7985,2093,5666,410,1249,301,580,711,1829
430400,202109,1036,2185,788,1853,64,172,469,1068,533,1240
430410,202109,550,1275,383,1007,55,140,244,633,299,773
430420,202109,2692,6995,2065,5712,407,1208,1073,2804,1480,4012
430430,202109,573,1430,260,796,59,169,53,172,112,341
430435,202109,1578,3907,1215,3324,207,610,641,1740,848,2350
430440,202109,3977,10535,3149,9144,294,940,2016,5800,2310,6740
430450,202109,6958,16818,5545,14350,1081,2996,2652,6559,3733,9555
430460,202109,36070,88408,26914,73511,4252,12721,14032,36688,18284,49409
430461,202109,230,597,74,224,14,49,28,65,42,114
430462,202109,305,798,168,525,32,104,49,142,81,246
430463,202109,6497,16549,4779,13430,911,2860,2236,5944,3147,8804
430465,202109,456,1141,360,958,63,188,224,571,287,759
430466,202109,4503,10994,3559,9517,742,2047,1739,4405,2481,6452
430467,202109,509,1196,355,959,49,161,197,484,246,645
430468,202109,1326,3181,1058,2796,79,241,756,1943,835,2184
430469,202109,588,1578,85,257,11,32,19,40,30,72
430470,202109,5772,14562,3844,11122,1098,3452,954,2581,2052,6033
430471,202109,560,1548,458,1364,68,209,271,776,339,985
430480,202109,675,1864,432,1337,58,191,103,273,161,464
430485,202109,175,446,66,194,21,58,7,22,28,80
430490,202109,399,1015,222,656,23,83,111,284,134,367
430495,202109,400,1063,264,806,42,133,112,319,154,452
430500,202109,1015,2550,709,2031,227,691,201,528,428,1219
430510,202109,28402,71494,20293,56233,3195,9892,9464,24059,12659,33951
430511,202109,352,980,139,440,16,54,19,56,35,110
430512,202109,1015,2206,794,1882,172,416,306,727,478,1143
430513,202109,809,1967,377,1072,61,187,177,459,238,646
430515,202109,391,1071,284,857,39,113,153,457,192,570
430517,202109,1225,3547,922,2863,156,477,489,1524,645,2001
430520,202109,1385,3394,748,2062,130,385,175,424,305,809
430530,202109,1005,2462,417,1234,68,204,117,332,185,536
430535,202109,3645,9136,2640,7321,364,1045,1336,3573,1700,4618
430537,202109,405,1233,352,1114,25,71,273,868,298,939
430540,202109,622,1465,342,978,67,192,158,448,225,640
430543,202109,984,1684,597,1249,63,137,229,566,292,703
430544,202109,770,2110,532,1596,124,381,165,483,289,864
430545,202109,2547,6240,1902,5281,307,869,1065,2957,1372,3826
430550,202109,351,981,256,778,49,154,96,274,145,428
430558,202109,120,277,56,152,7,14,22,62,29,76
430560,202109,285,653,142,413,23,76,50,136,73,212
430570,202109,870,2099,626,1663,105,324,307,736,412,1060
430580,202109,836,2050,597,1688,162,483,244,707,406,1190
430583,202109,200,490,38,115,4,12,11,23,15,35
430585,202109,231,559,123,341,19,58,50,119,69,177
430587,202109,203,536,151,444,21,68,62,169,83,237
430590,202109,1395,3320,1154,2962,71,214,928,2326,999,2540
430593,202109,22,65,14,40,2,4,6,17,8,21
430595,202109,438,1088,129,411,12,43,18,43,30,86
430597,202109,457,1135,238,697,23,69,72,169,95,238
430600,202109,2016,5116,853,2413,126,368,201,526,327,894
430605,202109,1331,3390,971,2732,110,345,486,1308,596,1653
430607,202109,607,1346,464,1131,34,83,326,780,360,863
430610,202109,5892,13446,3940,10534,1046,3221,892,2275,1938,5496
430613,202109,299,689,89,258,11,30,24,56,35,86
430620,202109,665,1590,494,1281,72,213,294,680,366,893
430630,202109,433,1168,122,383,22,70,31,75,53,145
430632,202109,454,1161,199,579,31,86,81,223,112,309
430635,202109,582,1315,439,1072,46,119,326,784,372,903
430637,202109,466,1088,354,920,37,110,239,596,276,706
430640,202109,1135,2982,762,2221,113,328,307,836,420,1164
430642,202109,379,1023,278,802,50,146,134,361,184,507
430645,202109,154,360,60,158,12,34,18,37,30,71
430650,202109,1751,4769,1377,4148,403,1191,555,1834,958,3025
430655,202109,292,716,180,502,27,87,91,222,118,309
430660,202109,5388,13362,4126,11314,858,2462,1854,5009,2712,7471
430670,202109,662,1559,504,1298,47,123,287,752,334,875
430673,202109,552,1230,238,653,38,105,93,230,131,335
430675,202109,247,713,55,200,7,23,12,39,19,62
430676,202109,5369,12915,4277,11274,536,1481,2687,6947,3223,8428
430680,202109,1071,2777,624,1859,165,498,139,389,304,887
430690,202109,2888,7610,2271,6504,766,2322,643,1759,1409,4081
430692,202109,221,670,173,588,13,42,130,454,143,496
430693,202109,972,2500,592,1764,111,382,157,441,268,823
430695,202109,412,1014,254,707,34,86,131,351,165,437
430697,202109,417,1035,322,890,67,158,171,515,238,673
430700,202109,7940,18942,4898,13377,961,2823,1213,2934,2174,5757
430705,202109,403,936,198,562,19,52,80,208,99,260
430710,202109,1748,3605,1217,2905,148,396,737,1712,885,2108
430720,202109,809,1890,395,1159,46,134,195,557,241,691
430730,202109,1029,2738,719,2141,94,277,382,1111,476,1388
430740,202109,675,1790,353,1128,59,190,96,314,155,504
430745,202109,359,960,238,706,56,190,77,195,133,385
430750,202109,1518,3724,1024,2860,336,975,356,970,692,1945
430755,202109,459,1113,297,792,27,82,163,399,190,481
430760,202109,2114,5099,1621,4352,317,938,783,1989,1100,2927
430770,202109,6690,16354,5198,14107,614,1902,3352,8733,3966,10635
430780,202109,1974,4801,1224,3526,196,621,563,1561,759,2182
430781,202109,484,1321,283,856,64,178,83,227,147,405
430783,202109,350,795,209,577,24,70,127,327,151,397
430786,202109,32,113,23,87,4,17,4,16,8,33
430790,202109,4724,11246,3337,8860,348,1080,2052,5056,2400,6136
430800,202109,785,1753,594,1479,44,107,389,960,433,1067
430805,202109,372,934,243,670,12,42,168,441,180,483
430807,202109,541,1329,298,867,31,97,144,382,175,479
430810,202109,760,1786,336,967,40,136,131,326,171,462
430820,202109,1233,3285,748,2332,127,410,227,660,354,1070
430825,202109,268,654,90,245,11,26,32,82,43,108
430830,202109,1775,4847,1433,4195,120,340,990,2863,1110,3203
430840,202109,1101,2586,743,2004,115,288,469,1292,584,1580
430843,202109,181,427,85,227,8,24,33,74,41,98
430845,202109,488,1128,317,853,45,126,159,405,204,531
430850,202109,2307,5868,1573,4477,245,753,581,1704,826,2457
430860,202109,924,2151,442,1233,56,184,204,478,260,662
430865,202109,531,1323,377,1058,101,291,103,286,204,577
430870,202109,591,1554,257,817,42,141,72,195,114,336
430880,202109,1522,3381,1041,2645,167,421,568,1404,735,1825
430885,202109,172,451,91,290,6,17,55,172,61,189
430890,202109,1024,2472,686,1905,50,207,145,372,195,579
430900,202109,3170,6788,2219,5448,167,515,1512,3475,1679,3990
430905,202109,896,2172,580,1576,101,295,253,654,354,949
430910,202109,2199,5830,1667,4750,252,824,780,1930,1032,2754
430912,202109,511,1411,359,1103,37,106,221,692,258,798
430915,202109,511,1507,378,1235,135,422,103,359,238,781
430920,202109,23788,59449,18433,50550,2326,6944,11224,29982,13550,36926
430925,202109,91,203,39,114,4,12,19,54,23,66
430930,202109,10893,25091,7173,19417,1324,3566,3062,8611,4386,12177
430940,202109,981,2494,608,1726,125,369,215,556,340,925
430950,202109,849,1856,549,1354,38,121,363,818,401,939
430955,202109,394,1016,109,300,24,64,34,74,58,138
430957,202109,167,554,152,521,19,65,102,347,121,412
430960,202109,1392,3249,797,2174,153,430,324,838,477,1268
430965,202109,1586,3714,1225,3150,69,180,922,2414,991,2594
430970,202109,377,892,205,563,29,97,105,252,134,349
430975,202109,521,1482,401,1207,76,245,207,594,283,839
430980,202109,394,881,228,605,25,76,108,257,133,333
430990,202109,575,1605,384,1165,56,180,169,503,225,683
430995,202109,564,1413,429,1197,60,175,242,656,302,831
431000,202109,1409,3293,603,1729,115,360,43,106,158,466
431010,202109,2412,6275,1637,4910,330,1068,486,1295,816,2363
431020,202109,7929,17035,4747,12322,917,2741,1736,3929,2653,6670
431030,202109,361,975,177,588,33,126,25,77,58,203
431033,202109,3976,9082,2603,6940,537,1488,988,2617,1525,4105
431036,202109,341,745,71,208,7,24,21,45,28,69
431040,202109,901,2227,579,1675,65,213,291,771,356,984
431041,202109,446,1023,318,827,26,64,188,488,214,552
431043,202109,323,802,190,560,38,128,95,266,133,394
431046,202109,107,280,44,134,6,16,8,22,14,38
431050,202109,1378,3267,977,2619,195,558,436,1197,631,1755
431053,202109,693,1766,392,1160,73,234,125,324,198,558
431055,202109,608,1428,496,1252,60,134,357,900,417,1034
431057,202109,228,649,128,416,28,90,35,106,63,196
431060,202109,5784,14109,3915,10986,857,2634,1173,3155,2030,5789
431065,202109,408,993,297,810,41,122,151,403,192,525
431070,202109,423,1120,253,758,55,181,73,201,128,382
431075,202109,222,628,132,423,33,113,37,120,70,233
431080,202109,601,1598,420,1214,65,215,158,431,223,646
431085,202109,799,2044,508,1396,56,157,271,729,327,886
431087,202109,409,1114,330,957,25,75,224,652,249,727
431090,202109,412,946,162,485,25,82,42,131,67,213
431100,202109,3493,7499,2394,6081,274,700,1339,3409,1613,4109
431110,202109,1438,3254,982,2462,221,577,416,938,637,1515
431112,202109,641,1689,525,1478,42,146,366,972,408,1118
431113,202109,415,1083,346,955,58,171,183,487,241,658
431115,202109,976,2705,768,2325,77,296,494,1397,571,1693
431120,202109,2743,6965,1911,5421,493,1530,495,1305,988,2835
431123,202109,377,1025,251,742,58,152,131,401,189,553
431125,202109,990,2739,791,2356,269,786,287,903,556,1689
431127,202109,200,537,66,220,8,28,11,33,19,61
431130,202109,3053,7568,2293,6351,330,1014,1285,3454,1615,4468
431140,202109,6012,13979,3661,9612,433,1220,1610,3691,2043,4911
431142,202109,537,1360,402,1137,46,131,249,707,295,838
431150,202109,1054,2744,769,2231,140,441,346,970,486,1411
431160,202109,672,1870,437,1350,88,292,125,373,213,665
431162,202109,542,1318,329,927,38,122,169,423,207,545
431164,202109,183,423,47,146,8,25,10,30,18,55
431170,202109,452,1212,321,946,97,292,90,255,187,547
431171,202109,676,1547,556,1390,139,292,301,803,440,1095
431173,202109,427,1079,319,923,80,267,138,374,218,641
431175,202109,1341,3061,851,2237,136,349,326,818,462,1167
431177,202109,835,2176,652,1891,111,393,423,1158,534,1551
431179,202109,343,734,104,291,15,43,29,77,44,120
431180,202109,2243,5617,1398,3961,318,922,432,1157,750,2079
431190,202109,607,1521,271,778,35,98,84,206,119,304
431198,202109,402,1112,324,965,89,283,111,344,200,627
431200,202109,375,932,91,248,17,49,13,36,30,85
431205,202109,218,589,117,372,36,116,33,115,69,231
431210,202109,640,1508,514,1338,141,378,208,569,349,947
431213,202109,259,677,194,554,9,31,106,296,115,327
431215,202109,631,1475,296,847,27,85,142,374,169,459
431217,202109,159,401,109,306,14,45,60,150,74,195
431220,202109,548,1396,342,994,33,113,194,518,227,631
431225,202109,1517,3511,1167,2946,123,322,794,1995,917,2317
431230,202109,702,1934,564,1639,87,258,329,929,416,1187
431235,202109,173,454,20,71,2,4,4,19,6,23
431237,202109,344,1064,275,904,51,191,130,397,181,588
431238,202109,33,94,27,81,4,14,13,31,17,45
431240,202109,4825,11477,3848,9972,439,1276,2460,6030,2899,7306
431242,202109,260,659,226,603,41,116,136,347,177,463
431244,202109,366,902,185,522,24,85,72,170,96,255
431245,202109,1341,3056,858,2239,61,171,484,1216,545,1387
431247,202109,286,699,175,477,29,93,79,180,108,273
431250,202109,1783,4326,1313,3693,287,811,662,2012,949,2823
431260,202109,276,733,175,546,24,89,60,186,84,275
431261,202109,264,778,209,680,15,52,118,363,133,415
431262,202109,350,978,181,588,13,39,115,378,128,417
431265,202109,1627,3771,673,1920,79,261,225,554,304,815
431267,202109,248,610,162,432,6,21,118,291,124,312
431270,202109,2880,6349,1544,4098,330,878,499,1388,829,2266
431275,202109,116,320,64,202,21,65,12,39,33,104
431280,202109,239,640,78,247,5,18,14,33,19,51
431290,202109,357,1039,235,739,39,129,40,105,79,234
431295,202109,70,169,21,61,4,12,4,10,8,22
431300,202109,300,785,60,187,7,18,20,56,27,74
431301,202109,295,823,65,207,10,30,6,20,16,50
431303,202109,634,1596,386,1091,22,77,176,444,198,521
431306,202109,2356,5499,1448,3985,194,597,628,1543,822,2140
431308,202109,27,81,24,75,10,34,12,36,22,70
431310,202109,556,1477,388,1123,49,139,182,491,231,630
431320,202109,668,1806,370,1179,63,190,102,289,165,479
431330,202109,1777,4120,909,2545,146,463,364,897,510,1360
431333,202109,221,579,121,358,19,55,46,119,65,174
431335,202109,36,105,19,69,4,10,0,0,4,10
431337,202109,2750,6989,2095,5936,320,1065,1270,3425,1590,4490
431339,202109,424,1072,316,883,89,254,114,311,203,565
431340,202109,19235,46008,13532,36491,1956,5870,6618,16567,8574,22437
431342,202109,426,956,310,771,28,56,239,596,267,652
431344,202109,396,994,242,706,12,34,129,371,141,405
431346,202109,224,546,84,259,13,42,22,57,35,99
431349,202109,734,1821,440,1191,85,226,190,502,275,728
431350,202109,4377,10872,3307,9084,403,1266,1878,4908,2281,6174
431360,202109,579,1344,293,801,87,242,67,183,154,425
431365,202109,2109,4758,1668,4164,119,335,1284,3156,1403,3491
431370,202109,4720,11066,3458,9065,652,1799,1754,4660,2406,6459
431380,202109,856,2232,697,1983,54,156,482,1373,536,1529
431390,202109,2697,6519,1711,4780,155,515,911,2236,1066,2751
431395,202109,1398,3302,1023,2744,191,534,534,1435,725,1969
431400,202109,317,882,181,574,35,108,36,109,71,217
431402,202109,920,2003,684,1651,84,198,470,1122,554,1320
431403,202109,202,555,154,455,27,81,67,191,94,272
431405,202109,4983,12732,3886,10917,608,1882,2028,5360,2636,7242
431406,202109,561,1541,391,1182,75,220,187,581,262,801
431407,202109,497,1302,355,1004,68,210,200,538,268,748
431410,202109,18230,44165,12536,34378,1642,5173,6866,17401,8508,22574
431413,202109,235,634,58,188,6,19,11,36,17,55
431415,202109,720,1704,455,1260,72,243,218,534,290,777
431417,202109,575,1256,382,953,58,166,209,504,267,670
431420,202109,1649,3616,1244,3064,150,386,747,1791,897,2177
431430,202109,581,1457,289,880,44,144,91,241,135,385
431440,202109,31235,71058,21866,56685,3453,9767,9201,22004,12654,31771
431442,202109,140,397,69,234,13,50,9,28,22,78
431445,202109,385,1069,104,330,12,34,12,32,24,66
431446,202109,274,778,206,644,31,112,100,300,131,412
431447,202109,781,2006,433,1262,88,265,131,383,219,648
431449,202109,790,2033,488,1416,88,239,181,542,269,781
431450,202109,2329,4688,1815,3966,71,169,1443,3073,1514,3242
431454,202109,39,129,32,110,8,25,11,35,19,60
431455,202109,598,1387,300,781,34,94,149,350,183,444
431460,202109,2970,6959,2050,5349,539,1463,502,1322,1041,2785
431470,202109,1419,3886,1041,3090,184,552,429,1283,613,1835
431475,202109,243,651,59,196,4,14,10,24,14,38
431477,202109,410,1047,248,722,42,113,98,263,140,376
431478,202109,222,581,50,153,8,21,4,9,12,30
431480,202109,3542,8523,2841,7462,714,1868,1386,3660,2100,5528
431490,202109,111263,256002,84783,215926,5519,16675,62387,152269,67906,168944
431500,202109,503,1267,377,1036,66,194,198,516,264,710
431505,202109,254,607,173,483,12,40,123,339,135,379
431507,202109,334,779,135,395,45,143,33,86,78,229
431510,202109,1671,4144,1130,3104,278,807,372,1027,650,1834
431513,202109,227,489,123,317,11,22,73,185,84,207
431514,202109,119,295,90,245,4,11,62,159,66,170
431515,202109,479,1166,354,952,83,224,198,499,281,723
431517,202109,56,166,45,136,5,15,22,64,27,79
431520,202109,396,984,166,505,15,55,75,197,90,252
431530,202109,4991,10602,2978,7545,601,1482,1032,2642,1633,4124
431531,202109,212,503,131,352,17,39,54,138,71,177
431532,202109,558,1271,343,889,67,192,150,374,217,566
431535,202109,245,642,112,347,22,73,25,67,47,140
431540,202109,1811,5656,1677,5473,57,208,1357,4455,1414,4663
431545,202109,371,936,75,222,7,22,22,60,29,82
431550,202109,2182,5396,1570,4263,253,726,786,2044,1039,2770
431555,202109,681,1533,405,1073,34,99,232,609,266,708
431560,202109,24838,57857,16618,45054,3225,8921,5850,16616,9075,25537
431570,202109,4435,10542,3739,9534,433,1205,2680,6592,3113,7797
431575,202109,303,710,243,626,73,160,108,293,181,453
431580,202109,602,1550,388,1130,47,155,207,573,254,728
431590,202109,616,1664,465,1373,89,266,182,538,271,804
431595,202109,370,996,245,734,43,125,87,239,130,364
431600,202109,1525,3523,1091,2876,211,606,477,1209,688,1815
431610,202109,1436,3531,979,2715,158,416,487,1380,645,1796
431620,202109,490,1232,232,647,41,120,89,221,130,341
431630,202109,1346,3251,653,1863,95,273,255,692,350,965
431640,202109,6465,14851,5474,13599,492,1281,4117,10260,4609,11541
431642,202109,621,1436,381,986,40,98,167,404,207,502
431643,202109,385,926,181,512,16,42,53,152,69,194
431645,202109,1882,4099,1480,3571,50,153,1220,2898,1270,3051
431647,202109,308,734,97,281,7,15,26,65,33,80
431650,202109,128,337,89,276,8,27,40,110,48,137
431660,202109,890,2302,421,1312,59,215,110,295,169,510
431670,202109,1211,2836,730,1969,122,345,347,852,469,1197
431673,202109,236,607,88,299,6,23,13,31,19,54
431675,202109,405,1038,107,366,9,31,19,60,28,91
431680,202109,8364,20602,6135,16592,1313,3664,2691,7072,4004,10736
431690,202109,25369,60695,17348,46504,3179,9082,7722,20277,10901,29359
431695,202109,199,475,114,331,22,72,57,145,79,217
431697,202109,474,1096,367,934,50,125,220,562,270,687
431700,202109,1381,3465,1128,3016,189,458,639,1725,828,2183
431710,202109,13900,31948,9861,26230,1440,4122,5353,14188,6793,18310
431720,202109,6892,16511,4154,11418,994,2836,841,2102,1835,4938
431725,202109,27,75,21,65,3,10,9,24,12,34
431730,202109,4098,9438,2572,7082,550,1570,862,2542,1412,4112
431740,202109,5414,12418,3615,9484,887,2704,979,2239,1866,4943
431750,202109,7837,19781,5931,16764,1416,4168,2211,6206,3627,10374
431755,202109,332,879,80,253,11,26,13,36,24,62
431760,202109,5504,12173,3776,9445,417,1167,2355,5590,2772,6757
431770,202109,2006,4501,1531,3877,117,287,1133,2820,1250,3107
431775,202109,204,513,103,316,21,68,16,38,37,106
431780,202109,2247,5326,1464,3924,223,642,604,1569,827,2211
431790,202109,797,2088,528,1549,87,240,233,699,320,939
431795,202109,282,687,138,413,28,83,34,94,62,177
431800,202109,8465,19613,5309,14731,1238,4105,494,1419,1732,5524
431805,202109,286,681,77,258,10,40,8,16,18,56
431810,202109,3396,7732,2123,5470,388,1027,925,2297,1313,3324
431820,202109,2178,5673,1691,4894,462,1440,620,1821,1082,3261
431830,202109,9118,19558,6752,16374,1777,5084,1507,3565,3284,8649
431840,202109,2734,6853,2197,6009,309,871,1424,3872,1733,4743
431842,202109,506,1231,180,537,25,81,74,202,99,283
431843,202109,335,867,244,688,29,85,118,323,147,408
431844,202109,201,535,70,232,16,59,20,74,36,133
431845,202109,510,1319,358,1021,40,112,208,586,248,698
431846,202109,285,716,244,657,12,32,214,577,226,609
431848,202109,153,381,80,230,11,35,18,38,29,73
431849,202109,412,999,81,237,9,24,14,27,23,51
431850,202109,4253,11134,3284,9280,723,2236,1124,3054,1847,5290
431860,202109,648,1495,352,938,55,159,205,525,260,684
431861,202109,94,261,59,182,9,28,19,60,28,88
431862,202109,472,1458,392,1319,75,276,200,641,275,917
431870,202109,21842,53587,17511,46919,1856,5609,11019,28283,12875,33892
431880,202109,4029,10156,2868,8121,402,1322,1431,3824,1833,5146
431890,202109,4729,11665,2967,8323,806,2444,521,1628,1327,4072
431900,202109,983,2411,634,1792,98,300,320,848,418,1148
431910,202109,779,1807,291,786,40,115,85,195,125,310
431912,202109,493,1298,383,1108,77,238,219,631,296,869
431915,202109,1130,2620,886,2237,30,85,689,1707,719,1792
431920,202109,1259,2849,1041,2567,35,74,883,2171,918,2245
431930,202109,696,1792,481,1391,176,490,162,492,338,982
431935,202109,84,217,60,169,16,46,13,34,29,80
431936,202109,316,869,182,540,34,104,85,233,119,337
431937,202109,142,348,91,248,10,24,39,88,49,112
431940,202109,3124,7169,1853,4894,155,446,1015,2556,1170,3002
431950,202109,1954,4954,1564,4323,350,1015,687,1835,1037,2850
431960,202109,3004,7114,2255,5796,589,1620,664,1667,1253,3287
431970,202109,398,990,173,498,36,112,39,89,75,201
431971,202109,86,211,38,116,4,16,8,17,12,33
431973,202109,492,1556,398,1367,42,133,278,968,320,1101
431975,202109,108,216,21,63,2,7,6,17,8,24
431980,202109,978,2503,759,2145,138,426,390,1041,528,1467
431990,202109,5905,13873,4203,11438,435,1438,2360,6160,2795,7598
432000,202109,12301,28490,9034,23496,1885,5028,4282,11037,6167,16065
432010,202109,2754,6335,1853,4841,336,924,768,1829,1104,2753
432020,202109,1801,4636,1108,3157,239,715,348,954,587,1669
432023,202109,550,1306,275,767,36,101,122,306,158,407
432026,202109,953,2608,703,2123,183,539,208,643,391,1182
432030,202109,377,912,226,614,17,53,131,335,148,388
432032,202109,342,854,235,640,24,71,136,337,160,408
432035,202109,665,1833,581,1694,167,462,254,794,421,1256
432040,202109,1110,2597,430,1297,57,191,178,475,235,666
432045,202109,159,445,101,322,20,63,38,124,58,187
432050,202109,563,1350,419,1107,75,210,192,509,267,719
432055,202109,560,1485,368,1134,125,393,66,188,191,581
432057,202109,181,482,143,385,9,22,73,186,82,208
432060,202109,436,1038,136,421,34,115,34,96,68,211
432065,202109,208,567,152,449,36,113,58,173,94,286
432067,202109,742,2085,629,1837,56,185,466,1308,522,1493
432070,202109,1734,4310,1202,3319,206,643,524,1314,730,1957
432080,202109,5031,11416,3812,9575,588,1716,1818,4320,2406,6036
432085,202109,379,994,278,836,59,191,131,390,190,581
432090,202109,2289,5553,1344,3752,236,686,606,1587,842,2273
432100,202109,994,2433,489,1449,105,333,84,209,189,542
432110,202109,2112,5405,1463,4261,338,1090,192,499,530,1589
432120,202109,3223,8394,2568,7331,438,1368,1212,3288,1650,4656
432130,202109,2662,6526,2210,5860,632,1697,953,2577,1585,4274
432132,202109,197,558,112,364,20,66,57,164,77,230
432135,202109,1017,2336,681,1767,64,176,474,1216,538,1392
432140,202109,1723,4935,1319,4125,174,580,818,2531,992,3111
432143,202109,1435,3697,1096,3178,71,221,714,2047,785,2268
432145,202109,1798,4665,1150,3353,172,521,373,910,545,1431
432146,202109,104,287,78,250,26,93,23,65,49,158
432147,202109,488,1295,289,892,102,314,62,186,164,500
432149,202109,451,1079,232,647,26,71,100,247,126,318
432150,202109,3419,8347,2552,6864,494,1430,1142,2984,1636,4414
432160,202109,5463,13728,3984,11386,875,2801,1337,3679,2212,6480
432162,202109,233,507,36,104,5,18,12,27,17,45
432163,202109,137,315,27,72,0,0,5,6,5,6
432166,202109,666,1797,527,1524,104,347,192,478,296,825
432170,202109,1615,4242,1119,3333,204,665,466,1295,670,1960
432180,202109,3159,7334,1718,4667,288,823,677,1606,965,2429
432183,202109,381,1072,269,828,58,201,90,254,148,455
432185,202109,842,2127,489,1446,45,144,237,656,282,800
432190,202109,2048,4836,1426,3861,133,416,891,2281,1024,2697
432195,202109,871,2173,592,1671,127,329,231,673,358,1002
432200,202109,3581,8689,2605,7180,351,1010,1564,4279,1915,5289
432210,202109,409,1069,259,778,51,172,113,291,164,463
432215,202109,614,1761,557,1678,45,111,422,1293,467,1404
432218,202109,263,637,120,332,11,36,56,134,67,170
432220,202109,3733,8594,2653,6837,510,1295,1254,3238,1764,4533
432225,202109,106,288,76,229,12,34,45,136,57,170
432230,202109,763,1762,407,1112,43,117,184,455,227,572
432232,202109,487,1177,308,879,59,174,114,292,173,466
432234,202109,275,690,127,370,19,47,22,59,41,106
432235,202109,44,124,18,56,5,17,4,12,9,29
432237,202109,309,783,274,727,13,24,226,593,239,617
432240,202109,16781,39839,12334,33916,934,2495,7958,22879,8892,25374
432250,202109,5706,15770,4240,12879,1056,3327,1760,5332,2816,8659
432252,202109,445,1062,285,763,32,89,152,379,184,468
432253,202109,889,2591,598,1871,150,509,51,142,201,651
432254,202109,697,1615,203,590,31,79,43,120,74,199
432255,202109,103,258,58,168,4,11,28,74,32,85
432260,202109,5167,12894,3828,10419,1021,2855,1379,3611,2400,6466
432270,202109,2016,5352,1631,4636,480,1475,441,1205,921,2680
432280,202109,1469,3580,774,2235,102,331,273,658,375,989
432285,202109,142,427,22,67,2,6,3,7,5,13
432290,202109,350,948,203,611,65,205,41,92,106,297
432300,202109,27211,66537,20503,55880,2563,7970,12595,32800,15158,40770
432310,202109,862,2234,624,1800,65,192,413,1195,478,1387
432320,202109,202,462,81,242,8,28,28,73,36,101
432330,202109,224,487,69,209,11,27,12,39,23,66
432335,202109,162,455,59,201,7,27,13,43,20,70
432340,202109,323,793,143,460,13,41,41,132,54,173
432345,202109,761,1640,653,1513,16,39,551,1258,567,1297
432350,202109,344,861,183,554,29,84,65,203,94,287
432360,202109,234,693,45,154,4,12,13,43,17,55
432370,202109,301,733,205,571,16,54,140,379,156,433
432375,202109,484,1177,364,947,87,228,158,406,245,634
432377,202109,163,501,34,114,2,7,7,14,9,21
432380,202109,1917,5030,1317,3944,201,640,679,1989,880,2629
500020,202109,2963,7306,2159,5984,219,686,1336,3583,1555,4269
500025,202109,1211,2940,758,2091,77,206,395,1063,472,1269
500060,202109,8322,23010,5706,17581,699,2282,3313,10358,4012,12640
500070,202109,4666,11546,3314,9269,591,1700,1467,4146,2058,5846
500080,202109,1699,4060,1042,2872,196,615,399,962,595,1577
500085,202109,2049,5055,1433,3992,364,1054,632,1672,996,2726
500090,202109,2206,5656,1497,4435,214,683,490,1566,704,2249
500100,202109,3751,9365,2848,7898,425,1300,1467,3821,1892,5121
500110,202109,8729,21692,5769,17053,1124,3661,1787,6134,2911,9795
500124,202109,2180,6117,1745,5409,310,854,902,2973,1212,3827
500150,202109,1408,3082,915,2388,137,392,404,1002,541,1394
500190,202109,5198,13243,3342,9655,654,1867,905,2511,1559,4378
500200,202109,2710,6210,1867,4809,170,444,1155,2873,1325,3317
500210,202109,4892,11279,3466,9408,1008,2627,1461,4124,2469,6751
500215,202109,1446,3879,1056,3181,101,341,600,1789,701,2130
500220,202109,2994,8008,2058,6296,366,1166,731,2157,1097,3323
500230,202109,2114,4768,1610,4078,198,483,1082,2701,1280,3184
500240,202109,4216,12032,3028,9585,424,1428,1291,4164,1715,5592
500260,202109,3431,7199,2230,5591,289,746,1245,2987,1534,3733
500270,202109,144002,332373,88619,240414,13360,39815,35123,88076,48483,127891
500280,202109,1471,3618,995,2882,180,536,450,1307,630,1843
500290,202109,3850,9202,2302,6479,341,1088,745,1810,1086,2898
500295,202109,3831,9052,2484,6693,419,1252,1026,2403,1445,3655
500310,202109,1031,2072,712,1678,99,216,384,921,483,1137
500315,202109,4043,10702,3242,9534,250,741,2363,7064,2613,7805
500320,202109,20403,53144,14111,42854,3563,11124,4612,15206,8175,26330
500325,202109,5339,11572,3674,9287,412,1026,2288,5820,2700,6846
500330,202109,6963,15424,4556,11974,380,1058,2390,6544,2770,7602
500345,202109,2116,5078,1418,3986,294,869,525,1457,819,2326
500348,202109,2461,6194,1825,5109,232,700,1076,3022,1308,3722
500350,202109,1356,3618,757,2318,94,282,302,901,396,1183
500370,202109,28499,71360,20540,58518,2434,7956,11117,30936,13551,38892
500375,202109,2609,6699,1761,5005,266,835,628,1602,894,2437
500380,202109,3506,8604,2444,6825,704,2114,439,1257,1143,3371
500390,202109,664,1376,411,1058,58,171,242,600,300,771
500400,202109,1629,4058,1074,2995,191,585,358,892,549,1477
500410,202109,2515,5963,1756,4856,183,475,995,2885,1178,3360
500430,202109,2780,6679,1917,5422,265,834,799,2412,1064,3246
500440,202109,1445,3416,851,2454,134,422,286,875,420,1297
500450,202109,1644,3995,986,2843,143,444,274,719,417,1163
500460,202109,3776,9823,2248,6828,362,1243,646,1863,1008,3106
500470,202109,2565,6736,1602,4796,419,1389,349,921,768,2310
500480,202109,2150,6502,1809,5974,166,523,1349,4537,1515,5060
500490,202109,1143,2589,673,1878,119,402,176,495,295,897
500500,202109,4375,11298,2819,8779,763,2799,299,965,1062,3764
500510,202109,737,1822,485,1361,40,111,300,819,340,930
500515,202109,1742,4450,1347,3820,175,537,782,2107,957,2644
500520,202109,3448,9912,2660,8528,682,2144,1063,3740,1745,5884
500525,202109,978,2755,773,2455,66,226,503,1593,569,1819
500540,202109,4796,12244,2788,8613,636,2475,236,649,872,3124
500560,202109,5615,14920,4521,13560,293,859,3672,11225,3965,12084
500568,202109,4595,9872,2814,7229,725,1821,870,2348,1595,4169
500570,202109,8291,18896,5314,13976,832,2413,2306,5598,3138,8011
500580,202109,3247,8328,2366,6782,584,1698,971,2814,1555,4512
500600,202109,3485,8597,2491,7017,550,1606,1011,2917,1561,4523
500620,202109,8323,21264,5620,16210,1021,3080,2359,6473,3380,9553
500625,202109,555,1473,367,1105,63,192,93,267,156,459
500627,202109,785,1993,478,1459,92,298,132,378,224,676
500630,202109,7597,16778,4256,11345,837,2440,1204,3163,2041,5603
500635,202109,3040,9366,2340,8438,164,578,1601,6367,1765,6945
500640,202109,1830,3900,1203,3063,47,136,805,1996,852,2132
500660,202109,19682,48391,13443,39348,3887,12976,3452,10398,7339,23374
500690,202109,2663,6977,1721,5389,454,1609,379,1195,833,2804
500710,202109,3155,8153,2371,6815,610,1868,730,1939,1340,3807
500720,202109,5207,12853,3461,9922,765,2334,1115,3228,1880,5562
500730,202109,1142,2764,621,1812,119,337,141,433,260,770
500740,202109,4825,11283,3219,8788,455,1302,1555,4103,2010,5405
500750,202109,1059,2635,734,2080,91,238,310,833,401,1071
500755,202109,983,2497,566,1722,98,330,126,344,224,674
500769,202109,5465,13216,3101,8800,556,1704,437,1122,993,2826
500770,202109,1447,3858,974,3055,168,594,313,948,481,1542
500780,202109,1241,2932,791,2193,150,482,212,525,362,1007
500790,202109,7296,19005,5487,15887,1161,3625,2363,6811,3524,10436
500793,202109,2097,5204,1510,4212,352,1046,513,1312,865,2358
500795,202109,2741,6682,2197,6001,120,298,1729,4973,1849,5271
500797,202109,791,1979,517,1490,157,463,142,426,299,889
500800,202109,3527,7809,2163,5768,617,1961,297,862,914,2823
500830,202109,18761,45865,12893,35309,2698,7800,4486,11622,7184,19422
500840,202109,1452,3481,936,2507,127,337,391,986,518,1323
510010,202109,1882,4164,1288,3419,114,243,924,2480,1038,2723
510020,202109,4239,10383,2260,6511,393,1239,617,1554,1010,2793
510025,202109,6998,16508,4336,12321,601,1851,1977,5382,2578,7233
510030,202109,3107,6638,2085,5163,323,792,1057,2517,1380,3309
510035,202109,1248,3210,800,2510,127,413,414,1413,541,1826
510040,202109,2471,5366,1837,4553,200,452,1119,2922,1319,3374
510050,202109,2281,4620,1537,3684,211,524,993,2383,1204,2907
510060,202109,1383,3398,866,2475,138,422,258,688,396,1110
510080,202109,1455,3666,981,2919,201,638,454,1260,655,1898
510100,202109,694,1585,495,1278,66,171,278,693,344,864
510120,202109,284,513,161,368,11,22,121,277,132,299
510125,202109,2093,5165,1650,4519,152,544,933,2376,1085,2920
510130,202109,1604,3945,1100,3141,230,677,372,1090,602,1767
510140,202109,3162,7926,2117,6613,774,2736,703,2201,1477,4937
510160,202109,1805,4572,1345,3981,144,405,1003,3049,1147,3454
510170,202109,4999,12801,3726,10755,844,2523,1549,4416,2393,6939
510180,202109,15232,33312,9940,25840,2061,5875,3344,9571,5405,15446
510185,202109,1826,4668,1172,3726,463,1504,240,1031,703,2535
510190,202109,2132,5963,1362,4678,358,1368,249,930,607,2298
510250,202109,18263,44727,13474,37516,2462,7150,6702,19242,9164,26392
510260,202109,1841,7800,1536,7283,242,1242,952,4932,1194,6174
510263,202109,3330,9195,2045,6530,331,1167,401,1112,732,2279
510267,202109,5519,15465,3134,10092,508,1752,470,1264,978,3016
510268,202109,1275,3140,960,2635,122,333,571,1531,693,1864
510269,202109,1040,2757,641,2000,141,498,222,639,363,1137
510270,202109,3135,8627,2137,6878,338,1235,852,2714,1190,3949
510279,202109,1832,4638,1096,3362,164,549,386,1085,550,1634
510285,202109,1158,2978,764,2296,210,720,203,546,413,1266
510300,202109,3805,9383,2821,8070,413,1184,1658,5008,2071,6192
510305,202109,1469,4004,915,2953,177,603,212,776,389,1379
510310,202109,984,2358,673,1861,180,512,202,582,382,1094
510320,202109,3770,9138,2613,7202,558,1715,549,1488,1107,3203
510325,202109,4399,12625,3160,10356,870,3061,850,2833,1720,5894
510330,202109,2661,7890,1770,6319,308,1121,622,2606,930,3727
510335,202109,5002,14165,3788,12209,563,1936,2027,6625,2590,8561
510336,202109,448,1247,326,1061,44,142,173,628,217,770
510337,202109,1450,4102,924,3169,335,1271,198,696,533,1967
510340,202109,96889,212302,63600,164834,14347,43028,20754,51045,35101,94073
510343,202109,1144,2927,746,2220,117,402,345,965,462,1367
510345,202109,1290,3610,970,2974,156,469,426,1295,582,1764
510350,202109,3161,7845,2156,6191,455,1323,944,2728,1399,4051
510360,202109,2076,4132,1294,3227,77,123,906,2455,983,2578
510370,202109,1783,4945,1322,4196,182,644,783,2551,965,3195
510380,202109,583,1397,330,978,52,180,136,402,188,582
510385,202109,1230,4039,916,3461,87,378,608,2379,695,2757
510390,202109,1332,3374,895,2854,278,884,269,1045,547,1929
510395,202109,737,1596,501,1255,27,61,323,859,350,920
510410,202109,4936,13164,3575,10857,676,2137,1813,5773,2489,7910
510420,202109,2579,5234,1737,4132,112,265,1174,2796,1286,3061
510450,202109,590,1417,338,968,82,242,52,153,134,395
510452,202109,857,2393,638,1990,77,248,382,1153,459,1401
510454,202109,1014,2726,770,2319,87,250,481,1521,568,1771
510455,202109,993,2623,684,2045,130,425,248,672,378,1097
510460,202109,1895,4686,1396,3937,152,483,844,2276,996,2759
510480,202109,5040,11808,3412,8922,584,1691,1380,3416,1964,5107
510490,202109,1758,4414,1315,3861,251,705,785,2360,1036,3065
510500,202109,1599,3851,973,2877,198,612,276,801,474,1413
510510,202109,3785,10475,2724,8666,644,2288,874,2894,1518,5182
510515,202109,5447,13555,3577,10276,745,2429,1120,2826,1865,5255
510517,202109,1204,3254,891,2745,269,942,168,471,437,1413
510520,202109,2349,4637,1288,3320,107,285,601,1697,708,1982
510523,202109,1306,3011,917,2424,161,433,563,1501,724,1934
510525,202109,7888,21078,5824,17068,895,2804,2773,7673,3668,10477
510530,202109,560,1431,413,1216,27,90,274,795,301,885
510550,202109,2368,6820,1729,5736,347,1210,823,2732,1170,3942
510558,202109,2406,6316,1758,5314,242,681,820,2742,1062,3423
510560,202109,1617,4526,1000,3335,184,662,230,832,414,1494
510562,202109,6029,14747,4384,11956,989,2817,1536,4515,2525,7332
510590,202109,3038,7474,2229,6417,150,435,1629,4820,1779,5255
510600,202109,1472,3223,986,2523,158,394,501,1266,659,1660
510610,202109,2670,6281,1794,5142,210,653,1076,3076,1286,3729
510615,202109,2834,6821,1978,5499,294,894,1148,3205,1442,4099
510617,202109,1036,3097,814,2747,81,319,569,1973,650,2292
510618,202109,1245,3264,889,2685,192,634,407,1194,599,1828
510619,202109,815,2034,481,1435,71,199,91,239,162,438
510620,202109,1472,3286,684,1991,171,599,35,71,206,670
510621,202109,1636,4280,990,3070,218,744,269,727,487,1471
510622,202109,5033,13666,3423,10346,1108,3624,458,1294,1566,4918
510623,202109,2800,6866,2040,5668,474,1453,669,1850,1143,3303
510624,202109,1657,4200,818,2643,95,340,174,506,269,846
510625,202109,3160,7505,1762,5065,302,977,427,1236,729,2213
510626,202109,1512,3625,951,2736,235,778,201,591,436,1369
510627,202109,642,1623,351,1065,82,281,87,275,169,556
510628,202109,1506,3416,998,2758,230,670,384,1051,614,1721
510629,202109,1679,4627,1197,3760,207,709,405,1282,612,1991
510630,202109,3509,9483,2078,6797,464,1622,376,1377,840,2999
510631,202109,587,1385,425,1145,17,37,322,907,339,944
510637,202109,3825,8833,2712,7220,622,1839,846,2289,1468,4128
510642,202109,5577,15411,4256,13435,932,3274,1998,6301,2930,9575
510645,202109,1066,2061,662,1565,190,408,267,677,457,1085
510650,202109,7312,18111,5744,16395,675,1712,3806,12263,4481,13975
510665,202109,1849,3964,1167,2899,252,586,424,1157,676,1743
510670,202109,433,915,249,652,30,83,132,350,162,433
510675,202109,6456,17359,4431,13660,1182,4039,821,2392,2003,6431
510677,202109,2245,5666,1555,4650,210,735,853,2500,1063,3235
510680,202109,714,1783,403,1210,72,248,102,250,174,498
510682,202109,1581,4423,1149,3730,372,1377,297,886,669,2263
510685,202109,496,1398,349,1106,53,172,182,578,235,750
510700,202109,4129,9654,2883,7970,252,743,2183,6030,2435,6773
510704,202109,11267,26216,7537,19939,1741,4933,1828,4696,3569,9629
510706,202109,2236,6442,1541,5297,314,1113,771,2873,1085,3986
510710,202109,2876,6965,1860,5047,418,1163,568,1496,986,2659
510715,202109,638,1367,458,1129,29,77,270,657,299,734
510718,202109,2402,5426,1421,4094,349,978,562,1950,911,2928
510719,202109,466,966,276,714,28,81,161,388,189,469
510720,202109,894,2019,594,1593,117,343,268,694,385,1037
510724,202109,877,2333,610,1832,80,255,327,937,407,1192
510726,202109,1063,1927,580,1342,70,172,286,669,356,841
510729,202109,632,1459,293,836,33,106,79,243,112,349
510730,202109,3016,7124,2053,5668,237,762,1081,2863,1318,3625
510735,202109,1127,3073,877,2733,74,259,665,2057,739,2316
510740,202109,1033,2496,662,1819,113,313,325,866,438,1179
510757,202109,498,1573,385,1395,116,452,137,467,253,919
510760,202109,45499,98253,27478,71055,5552,16274,8658,20536,14210,36810
510770,202109,4349,9625,2990,7925,190,457,2075,5768,2265,6225
510774,202109,356,881,254,727,38,111,137,401,175,512
510775,202109,657,1711,415,1312,90,308,80,240,170,548
510776,202109,571,1367,406,1087,73,208,170,437,243,645
510777,202109,1619,4165,1164,3576,137,455,802,2455,939,2910
510779,202109,803,2088,602,1761,59,150,363,1137,422,1287
510780,202109,3932,9900,2910,8419,677,1894,1245,4093,1922,5987
510785,202109,2041,5201,1190,3697,341,1119,184,669,525,1788
510787,202109,2882,8018,1901,6014,539,1809,150,448,689,2257
510788,202109,596,1356,410,1077,67,178,185,561,252,739
510790,202109,19266,48140,12270,35800,2849,9145,1869,4998,4718,14143
510792,202109,9820,26523,6050,19247,1211,4291,1007,2922,2218,7213
510794,202109,1250,3337,892,2735,303,1027,158,418,461,1445
510795,202109,9177,23300,6141,17935,1297,4196,1694,4758,2991,8954
510800,202109,1634,4099,1078,3169,317,954,134,376,451,1330
510805,202109,1567,4265,1110,3442,224,780,435,1242,659,2022
510810,202109,662,1316,434,1016,129,307,143,364,272,671
510820,202109,797,1480,449,1052,22,62,254,599,276,661
510830,202109,923,2127,695,1843,36,81,543,1506,579,1587
510835,202109,596,1417,395,1129,44,138,248,688,292,826
510840,202109,60053,124690,41140,101662,8071,18616,20022,54535,28093,73151
510850,202109,1930,4595,1186,3450,384,1290,137,334,521,1624
510860,202109,2460,6254,1553,4775,470,1738,188,541,658,2279
510880,202109,775,2108,589,1779,148,481,182,551,330,1032
510885,202109,674,1571,437,1229,86,252,132,392,218,644
510890,202109,763,2135,575,1811,148,506,240,743,388,1249
510895,202109,1345,3380,882,2615,158,566,390,1084,548,1650
520005,202109,3037,7621,2357,6757,687,1982,884,3027,1571,5009
520010,202109,2509,6851,1792,5498,407,1393,590,1638,997,3031
520013,202109,3354,8234,2192,6168,511,1444,604,1876,1115,3320
520015,202109,526,1271,380,1065,90,248,149,443,239,691
520017,202109,1266,3107,929,2604,223,636,377,1021,600,1657
520020,202109,445,972,344,855,24,74,280,681,304,755
520025,202109,34722,94294,29488,87025,3233,9861,20674,61156,23907,71017
520030,202109,5956,14588,4813,13036,300,842,3583,9670,3883,10512
520050,202109,421,988,256,693,16,41,160,450,176,491
520055,202109,1912,4491,1229,3208,164,356,638,1663,802,2019
520060,202109,1620,4226,1171,3437,263,903,298,842,561,1745
520080,202109,1868,4772,1427,4173,253,744,674,2184,927,2928
520082,202109,976,2393,737,2007,78,222,373,1061,451,1283
520085,202109,979,2428,757,2086,138,408,365,993,503,1401
520090,202109,892,1735,626,1445,84,147,445,1089,529,1236
520110,202109,38804,102226,26835,82185,7465,26122,2676,7484,10141,33606
520120,202109,217,511,125,361,11,37,55,157,66,194
520130,202109,4075,9561,3137,8114,647,1717,1289,3377,1936,5094
520140,202109,43370,112835,29857,89682,10262,33449,3601,11309,13863,44758
520145,202109,623,1392,426,1114,80,229,225,536,305,765
520150,202109,650,1503,486,1301,68,193,252,678,320,871
520160,202109,859,1984,596,1537,107,262,216,608,323,870
520170,202109,4913,9853,3261,7975,184,536,2489,6036,2673,6572
520180,202109,2523,6586,2038,5868,326,1039,1135,3198,1461,4237
520215,202109,1768,4180,1253,3396,277,780,433,1132,710,1912
520235,202109,717,1587,463,1217,45,132,243,633,288,765
520250,202109,1556,3859,1104,3135,324,981,269,869,593,1850
520260,202109,842,1917,538,1445,98,256,206,565,304,821
520280,202109,838,1921,650,1638,129,323,314,830,443,1153
520310,202109,1033,2187,661,1635,144,393,241,641,385,1034
520320,202109,1796,4704,1358,3988,170,506,775,2320,945,2826
520330,202109,4752,12075,3567,10136,523,1713,1813,5009,2336,6722
520340,202109,2545,5456,1559,4114,171,405,929,2560,1100,2965
520350,202109,2887,6786,2047,5535,557,1600,803,2201,1360,3801
520355,202109,1949,5239,1385,4135,437,1362,202,512,639,1874
520357,202109,773,1821,563,1506,42,90,408,1132,450,1222
520360,202109,739,1885,566,1599,138,412,180,519,318,931
520380,202109,1469,3605,899,2582,117,343,391,1064,508,1407
520390,202109,1081,2365,644,1802,188,591,190,570,378,1161
520393,202109,638,1435,411,1085,61,169,167,420,228,589
520396,202109,904,2262,762,2057,38,103,556,1490,594,1593
520400,202109,1652,3960,1268,3443,131,392,909,2453,1040,2845
520410,202109,2187,4675,1430,3553,183,505,775,1798,958,2303
520420,202109,384,860,305,740,21,54,244,564,265,618
520425,202109,1580,3824,873,2443,239,724,129,352,368,1076
520430,202109,2380,5312,1376,3778,237,763,63,165,300,928
520440,202109,2991,7141,1768,4948,408,1242,427,1126,835,2368
520450,202109,12657,29377,8632,23462,2641,7937,1829,5190,4470,13127
520455,202109,726,1959,522,1638,141,449,139,483,280,932
520460,202109,1057,2405,826,2110,77,170,653,1710,730,1880
520465,202109,832,2054,680,1850,59,178,515,1364,574,1542
520470,202109,2163,5332,1644,4649,480,1424,618,1904,1098,3328
520480,202109,896,2414,618,1952,181,592,158,482,339,1074
520485,202109,1583,4487,1287,4064,187,580,825,2586,1012,3166
520490,202109,4128,11043,3096,9406,843,2661,1325,4180,2168,6841
520495,202109,1624,3512,1234,2985,66,156,978,2383,1044,2539
520500,202109,1434,3642,1020,2885,191,576,478,1353,669,1929
520505,202109,787,1700,551,1407,62,156,366,942,428,1098
520510,202109,7750,18842,5256,15064,1011,3264,1758,5160,2769,8424
520520,202109,1225,2968,918,2498,209,618,339,908,548,1526
520530,202109,2449,6593,1813,5468,368,1182,855,2656,1223,3838
520540,202109,3068,7867,2010,5837,366,1151,541,1479,907,2630
520545,202109,1107,2771,859,2367,198,488,361,1054,559,1542
520547,202109,979,2513,783,2200,162,476,408,1125,570,1601
520549,202109,14903,38275,12401,34713,1487,4393,8444,23323,9931,27716
520551,202109,4640,12194,3848,11038,411,1339,2715,7633,3126,8972
520552,202109,840,2108,686,1910,152,400,368,1110,520,1510
520570,202109,556,1240,362,937,91,201,120,360,211,561
520580,202109,2293,5048,1705,4367,181,479,1163,2983,1344,3462
520590,202109,1320,3187,898,2498,253,729,272,756,525,1485
520620,202109,8387,22001,6597,19348,1483,4487,3155,9438,4638,13925
520630,202109,862,2126,616,1720,62,180,287,801,349,981
520640,202109,2472,5908,1866,4887,415,1077,793,2170,1208,3247
520650,202109,1031,2245,731,1827,124,318,372,990,496,1308
520660,202109,566,1367,303,897,48,158,81,242,129,400
520670,202109,950,2529,797,2315,61,189,543,1551,604,1740
520680,202109,762,1881,581,1592,95,256,309,860,404,1116
520690,202109,319,733,213,573,69,176,58,171,127,347
520710,202109,422,1011,300,816,16,42,200,528,216,570
520725,202109,1486,3458,1016,2689,115,360,637,1632,752,1992
520735,202109,824,1962,549,1505,113,273,216,639,329,912
520740,202109,2525,5524,1934,4806,351,796,1035,2855,1386,3651
520750,202109,695,1651,482,1319,77,216,225,599,302,815
520753,202109,1252,3358,944,2765,161,496,378,1035,539,1531
520760,202109,1327,2877,1132,2647,33,66,1028,2439,1061,2505
520780,202109,1554,3604,1121,2995,127,324,584,1571,711,1895
520790,202109,3620,8422,2527,6678,366,974,1326,3642,1692,4616
520800,202109,17269,43395,13475,37800,1823,5192,8096,23371,9919,28563
520810,202109,1335,2757,1014,2393,156,353,656,1683,812,2036
520815,202109,579,1747,430,1428,84,288,114,392,198,680
520830,202109,1927,4044,1365,3396,102,229,1059,2622,1161,2851
520840,202109,2816,7338,2280,6636,838,2722,626,1910,1464,4632
520850,202109,709,1710,526,1444,149,484,166,456,315,940
520860,202109,7301,19161,5375,15917,1311,4152,2013,5815,3324,9967
520870,202109,117542,268735,79903,211673,16229,46147,29828,77177,46057,123324
520880,202109,7566,21255,5798,18002,1235,4012,2114,6528,3349,10540
520890,202109,4443,10178,3041,8019,482,1410,1443,3693,1925,5103
520910,202109,4748,11679,3050,8787,679,2149,776,2132,1455,4281
520915,202109,737,2009,458,1397,89,295,153,431,242,726
520920,202109,4654,10203,3316,8561,507,1311,1615,4482,2122,5793
520929,202109,701,1638,539,1415,56,124,299,841,355,965
520940,202109,991,2573,773,2265,49,117,590,1733,639,1850
520945,202109,525,1133,383,948,13,33,260,638,273,671
520960,202109,1122,2582,868,2213,277,649,369,1026,646,1675
520970,202109,2721,7196,2132,6259,454,1524,542,1731,996,3255
520980,202109,793,1876,583,1597,95,258,247,662,342,920
520990,202109,3082,7940,2471,7170,333,893,1655,4918,1988,5811
520993,202109,1194,2749,820,2160,136,394,419,1074,555,1468
520995,202109,2427,6024,1811,5167,276,807,713,2138,989,2945
521000,202109,9127,23533,5988,17715,1088,3350,1659,4812,2747,8162
521010,202109,3696,9461,2754,7807,271,760,1576,4452,1847,5212
521015,202109,803,1966,560,1530,40,125,351,916,391,1041
521020,202109,3654,9030,2139,6121,566,1784,203,610,769,2394
521030,202109,554,1205,389,956,45,97,228,586,273,683
521040,202109,7901,18944,5832,15701,1277,3510,2299,6500,3576,10010
521056,202109,955,2445,743,2136,248,693,195,643,443,1336
521060,202109,1014,2669,736,2139,141,432,277,803,418,1235
521080,202109,1135,2398,593,1568,79,235,268,635,347,870
521090,202109,3217,8420,2136,6264,510,1654,245,749,755,2403
521100,202109,1861,4162,1376,3484,230,543,842,2187,1072,2730
521120,202109,4703,11067,3488,9546,201,514,1693,5449,1894,5963
521130,202109,1036,2310,586,1543,20,52,286,812,306,864
521140,202109,1424,3585,1056,2936,101,290,573,1574,674,1864
521150,202109,12746,27452,7968,20654,1409,4169,3611,9596,5020,13765
521160,202109,690,1397,477,1100,78,152,287,666,365,818
521170,202109,1086,2494,797,2063,73,208,483,1206,556,1414
521180,202109,7853,20888,6414,18428,1087,3296,3292,9250,4379,12546
521190,202109,11037,26690,6526,19279,1584,4987,1377,4294,2961,9281
521200,202109,728,1720,511,1383,51,140,320,867,371,1007
521205,202109,657,1581,505,1347,22,58,388,995,410,1053
521210,202109,758,1939,438,1286,75,233,105,245,180,478
521220,202109,3762,8845,2515,6938,378,1146,1119,3105,1497,4251
521225,202109,401,842,289,714,60,136,166,428,226,564
521230,202109,1390,3431,1211,3210,358,955,600,1738,958,2693
521250,202109,32469,83022,25320,72706,8954,26362,7507,23443,16461,49805
521260,202109,554,1266,412,1051,71,175,221,558,292,733
521270,202109,1882,4545,1646,4271,102,223,1273,3336,1375,3559
521280,202109,1807,4771,1354,4029,308,993,560,1694,868,2687
521290,202109,537,1195,377,994,47,140,236,605,283,745
521295,202109,1195,2562,942,2293,82,149,787,1976,869,2125
521300,202109,1949,4691,1523,4096,288,719,892,2523,1180,3242
521305,202109,728,1670,526,1388,83,202,302,819,385,1021
521308,202109,4994,12849,3469,10063,318,931,2072,5868,2390,6799
521310,202109,8916,22384,6239,17828,1168,3661,2788,7605,3956,11266
521340,202109,416,945,297,765,23,60,200,515,223,575
521350,202109,2090,5222,1598,4495,145,468,1122,3074,1267,3542
521370,202109,1252,3135,764,2314,220,769,90,301,310,1070
521375,202109,1368,3321,927,2625,196,557,273,879,469,1436
521377,202109,1562,3242,1152,2741,129,208,875,2233,1004,2441
521380,202109,6442,16718,4160,12520,451,1448,1040,3356,1491,4804
521385,202109,707,1646,534,1420,58,140,293,849,351,989
521390,202109,718,1755,495,1408,143,457,154,467,297,924
521400,202109,2863,6462,2295,5796,250,578,1603,4185,1853,4763
521405,202109,1421,3586,1019,2880,143,419,540,1508,683,1927
521410,202109,815,2137,615,1796,99,283,312,955,411,1238
521440,202109,1210,2916,894,2451,281,861,279,751,560,1612
521450,202109,4044,11723,2911,9499,770,2485,630,2277,1400,4762
521460,202109,5739,14544,4049,11614,1159,3491,1136,3302,2295,6793
521470,202109,719,1847,459,1354,64,174,173,517,237,691
521480,202109,428,1039,269,750,63,163,84,231,147,394
521483,202109,2395,5577,1658,4483,327,920,712,1943,1039,2863
521486,202109,1847,4339,1392,3701,96,204,963,2601,1059,2805
521487,202109,416,980,294,817,51,137,155,445,206,582
521490,202109,933,2429,700,2046,37,131,489,1382,526,1513
521500,202109,2246,5411,1694,4609,100,331,1197,3156,1297,3487
521520,202109,760,1724,552,1426,87,200,243,658,330,858
521523,202109,12503,36604,10230,33044,2698,9313,2981,9920,5679,19233
521525,202109,1103,2475,842,2122,77,195,596,1489,673,1684
521530,202109,2362,5951,1444,4136,288,824,389,1098,677,1922
521540,202109,846,2118,586,1702,82,256,269,816,351,1072
521550,202109,1665,4155,923,2677,165,538,224,665,389,1203
521560,202109,4893,12163,3338,10052,739,2207,1421,4746,2160,6953
521565,202109,695,1611,511,1337,80,195,288,755,368,950
521570,202109,3596,9651,2459,7448,474,1714,141,444,615,2158
521580,202109,511,1211,307,860,44,129,111,283,155,412
521590,202109,701,1580,515,1320,82,225,310,773,392,998
521600,202109,457,1176,295,869,28,68,134,394,162,462
521630,202109,1745,3728,1100,2821,233,640,358,906,591,1546
521640,202109,2079,4723,1352,3651,249,701,472,1261,721,1962
521645,202109,574,1457,370,1090,122,344,70,193,192,537
521680,202109,1208,3499,918,2964,238,854,178,597,416,1451
521690,202109,555,1316,460,1196,62,172,288,745,350,917
521710,202109,3375,8148,2171,6178,356,1165,631,1610,987,2775
521720,202109,2391,5291,1574,4097,240,627,847,2227,1087,2854
521730,202109,3748,10075,2883,8634,755,2661,796,1978,1551,4639
521740,202109,4089,10291,3076,8790,778,2415,819,2407,1597,4822
521760,202109,15604,40954,12101,35683,2708,8709,4621,14683,7329,23392
521770,202109,3232,7490,2143,5771,586,1721,499,1413,1085,3134
521800,202109,6859,17728,4968,14659,1098,3290,2003,6477,3101,9767
521805,202109,863,1793,589,1446,154,361,254,674,408,1035
521810,202109,682,1577,495,1327,83,215,285,789,368,1004
521830,202109,5671,15309,4517,13541,284,1006,3311,9738,3595,10744
521839,202109,838,1945,608,1570,87,258,364,855,451,1113
521850,202109,6426,14318,4028,10780,890,2470,688,1929,1578,4399
521860,202109,1603,4207,1107,3302,179,579,368,1034,547,1613
521870,202109,712,1934,508,1547,97,343,130,339,227,682
521878,202109,727,1821,516,1420,55,179,290,730,345,909
521880,202109,19513,47055,13343,37406,3460,10143,4477,12651,7937,22794
521890,202109,3296,8379,2187,6406,574,1820,472,1254,1046,3074
521900,202109,1512,3484,837,2413,233,659,68,199,301,858
521910,202109,1360,2786,934,2287,106,255,521,1368,627,1623
521920,202109,524,1354,377,1109,61,208,184,516,245,724
521925,202109,786,1981,564,1638,86,270,307,878,393,1148
521930,202109,5645,13270,3711,10379,995,2611,1308,4215,2303,6826
521935,202109,1094,2562,746,1969,71,199,424,1069,495,1268
521940,202109,1373,2899,870,2216,187,531,367,905,554,1436
521945,202109,683,1753,525,1487,101,288,270,788,371,1076
521950,202109,785,1861,544,1488,111,308,239,652,350,960
521960,202109,743,1880,502,1433,49,158,274,731,323,889
521970,202109,2628,6278,2055,5585,170,436,1550,4315,1720,4751
521971,202109,790,1840,555,1476,149,360,142,392,291,752
521973,202109,1548,3875,1286,3525,74,156,1043,2891,1117,3047
521975,202109,12366,31761,10063,28580,1850,5296,5975,17152,7825,22448
521980,202109,2603,5965,1998,5169,152,383,1504,3993,1656,4376
521990,202109,1148,3128,929,2750,188,595,385,1122,573,1717
522000,202109,2808,7120,2205,6368,403,1177,1215,3704,1618,4881
522005,202109,342,804,250,663,49,138,116,307,165,445
522010,202109,4343,10390,3117,8425,608,1782,1226,3202,1834,4984
522015,202109,1084,2754,792,2303,252,692,278,859,530,1551
522020,202109,5689,13149,3679,10032,774,2273,1357,3887,2131,6160
522026,202109,834,2173,539,1644,84,281,163,441,247,722
522028,202109,501,1215,343,946,80,238,103,287,183,525
522040,202109,3525,7626,2546,6325,261,739,1781,4313,2042,5052
522045,202109,18348,49488,13555,41087,3094,10012,3806,11221,6900,21233
522050,202109,1235,3116,835,2411,172,561,303,780,475,1341
522060,202109,3037,7786,2136,6321,238,694,1164,3577,1402,4271
522068,202109,1895,4657,1505,4191,104,250,1213,3433,1317,3683
522070,202109,719,1678,592,1496,13,33,515,1281,528,1314
522100,202109,760,1884,521,1515,70,221,269,750,339,971
522108,202109,1121,2603,882,2273,51,120,715,1813,766,1933
522119,202109,1763,4139,1375,3631,195,532,786,2147,981,2679
522130,202109,438,1080,311,908,32,85,210,644,242,729
522140,202109,21228,54029,14899,42837,3505,10724,4300,11753,7805,22477
522145,202109,808,1960,560,1592,162,449,215,627,377,1076
522150,202109,1118,2674,789,2135,207,563,222,622,429,1185
522155,202109,1112,2751,859,2374,177,421,485,1416,662,1837
522157,202109,671,1490,548,1342,21,55,448,1119,469,1174
522160,202109,6151,15518,3986,11604,1039,3253,338,1079,1377,4332
522170,202109,2631,6607,1969,5637,292,848,1127,3294,1419,4142
522180,202109,596,1392,376,980,61,168,95,264,156,432
522185,202109,20529,49138,14440,40835,5335,16639,3038,9293,8373,25932
522190,202109,782,1806,533,1389,106,271,213,547,319,818
522200,202109,1717,4713,1162,3694,250,858,236,714,486,1572
522205,202109,1785,4122,1336,3502,168,452,766,2020,934,2472
522220,202109,1345,3173,998,2668,129,326,597,1658,726,1984
522230,202109,1298,3149,1053,2804,191,603,561,1446,752,2049
530010,202109,190638,503150,156573,452849,22029,69024,95243,269878,117272,338902
110001,202108,4136,11297,2767,8741,609,2072,1022,3297,1631,5369
110002,202108,13718,34687,9980,28430,2660,8052,2681,7758,5341,15810
110003,202108,619,1811,461,1484,116,388,130,390,246,778
110004,202108,12727,32110,8546,24888,1719,5403,2566,7462,4285,12865
110005,202108,2596,6609,1810,5345,363,1140,485,1563,848,2703
110006,202108,1786,4916,1108,3492,173,608,234,710,407,1318
110007,202108,1348,3379,853,2545,262,819,210,772,472,1591
110008,202108,3583,9328,2651,7983,324,904,1698,5560,2022,6464
110009,202108,4500,12289,2891,9379,586,2037,1131,3696,1717,5733
110010,202108,8242,24947,6093,20901,1207,4156,2957,11121,4164,15277
110011,202108,7406,19230,4992,14910,1621,5159,672,2091,2293,7250
110012,202108,16316,40010,9839,28856,2123,6799,896,2806,3019,9605
110013,202108,5470,15440,3821,12151,1514,5137,418,1482,1932,6619
110014,202108,4114,10557,2791,8050,505,1558,1266,3547,1771,5105
110015,202108,5949,14949,3633,10582,755,2439,945,2479,1700,4918
110018,202108,3952,9780,2312,6923,403,1407,595,1811,998,3218
110020,202108,78388,182490,56688,153183,12728,35446,22563,67911,35291,103357
110025,202108,5461,12953,3689,9961,667,1932,1703,4556,2370,6488
110026,202108,541,1336,389,1114,90,299,153,463,243,762
110028,202108,7378,18171,4509,13103,1026,3312,604,1753,1630,5065
110029,202108,1604,3846,939,2695,191,568,354,1060,545,1628
110030,202108,13350,30253,8221,22661,1722,5486,1292,3947,3014,9433
110032,202108,3468,9490,2084,6592,673,2120,370,1288,1043,3408
110033,202108,3719,11280,2801,9596,968,3341,705,2730,1673,6071
110034,202108,3399,7818,2242,6242,695,2198,704,2150,1399,4348
110037,202108,1717,4967,1271,4159,297,971,564,1906,861,2877
110040,202108,3049,8222,2192,6673,561,1861,693,2033,1254,3894
110045,202108,5056,14182,3673,11662,945,3230,1187,3937,2132,7167
110050,202108,1845,4919,1272,3897,417,1432,183,528,600,1960
110060,202108,923,2685,623,1981,167,576,129,395,296,971
110070,202108,1621,4913,1148,3868,330,1184,248,783,578,1967
110080,202108,6764,15288,5104,13319,945,2319,3044,8622,3989,10941
110090,202108,617,1641,425,1297,83,267,136,412,219,679
110092,202108,1297,3652,905,2914,175,571,426,1490,601,2061
110094,202108,2958,8607,2164,7050,858,3013,235,796,1093,3809
110100,202108,1759,5083,1381,4356,382,1283,541,1755,923,3038
110110,202108,1823,4865,1313,4050,467,1485,252,899,719,2384
110120,202108,1353,3807,1031,3187,228,767,370,1126,598,1893
110130,202108,2971,7235,1717,4873,116,338,165,402,281,740
110140,202108,2210,6324,1537,4966,339,1153,494,1616,833,2769
110143,202108,1383,3726,981,2930,288,866,174,532,462,1398
110145,202108,914,2355,569,1718,130,393,221,705,351,1098
110146,202108,517,1291,361,1045,72,180,178,551,250,731
110147,202108,789,2001,503,1459,61,202,203,505,264,707
110148,202108,855,2328,476,1541,122,458,63,198,185,656
110149,202108,3389,8821,2239,6951,748,2449,475,1594,1223,4043
110150,202108,2880,6945,1830,5393,518,1706,433,1523,951,3229
110155,202108,776,2210,546,1664,116,393,189,522,305,915
110160,202108,1520,4534,1101,3615,298,1017,270,899,568,1916
110170,202108,2194,5527,1396,4062,226,705,743,2084,969,2789
110175,202108,1877,5221,1300,4070,209,669,501,1660,710,2329
110180,202108,1514,3995,1061,3097,139,441,566,1614,705,2055
120001,202108,3453,9838,2812,8889,460,1527,1749,5657,2209,7184
120005,202108,2001,7443,1826,7198,148,603,1453,5870,1601,6473
120010,202108,5513,15869,4688,14666,412,1197,3492,11270,3904,12467
120013,202108,2285,7559,2005,7224,427,1471,1246,4830,1673,6301
120017,202108,2641,8081,2305,7583,372,1216,1424,4989,1796,6205
120020,202108,15863,58567,14601,56179,966,4104,11753,45495,12719,49599
120025,202108,3230,8783,2596,8031,324,993,1853,5911,2177,6904
120030,202108,6568,25528,6084,24639,397,1905,4728,19378,5125,21283
120032,202108,1832,7837,1749,7689,91,558,1498,6468,1589,7026
120033,202108,4296,15374,4036,14915,89,513,3544,12935,3633,13448
120034,202108,2819,9891,2417,9205,91,516,2026,7621,2117,8137
120035,202108,3906,14785,3697,14424,272,1251,3084,11997,3356,13248
120038,202108,2819,8721,2390,8031,495,1698,1335,4581,1830,6279
120039,202108,2084,8766,1951,8511,107,655,1593,6915,1700,7570
120040,202108,46787,140962,39923,130067,5009,17109,25693,84582,30702,101691
120042,202108,3482,12441,3236,11994,131,642,2755,10119,2886,10761
120043,202108,1531,5982,1378,5757,40,240,1259,5259,1299,5499
120045,202108,6254,15874,5395,14909,136,515,4876,13331,5012,13846
120050,202108,9614,33872,8799,32639,362,1782,7406,27588,7768,29370
120060,202108,9674,37576,8847,36373,336,2094,7727,31554,8063,33648
120070,202108,3356,10356,2907,9751,260,834,2123,7398,2383,8232
120080,202108,4523,13887,4018,13151,450,1463,2967,9974,3417,11437
130002,202108,3356,12339,3002,11814,158,521,2632,10613,2790,11134
130006,202108,2579,9202,2146,8456,218,802,1586,6401,1804,7203
130008,202108,2797,9572,2484,9122,56,280,2175,8002,2231,8282
130010,202108,4047,11639,3407,10912,90,235,3093,10076,3183,10311
130014,202108,3515,9897,2718,8646,448,1442,1675,5437,2123,6879
130020,202108,3073,11716,2747,11229,97,554,2327,9515,2424,10069
130030,202108,11072,33928,10103,32811,341,791,9107,30238,9448,31029
130040,202108,4375,12394,3614,11394,334,875,2835,9230,3169,10105
130050,202108,7818,27935,6543,26275,187,821,5917,24103,6104,24924
130060,202108,8009,30729,6862,29255,383,1984,5785,24673,6168,26657
130063,202108,6696,21541,5974,20744,195,844,5454,19015,5649,19859
130068,202108,4001,13362,3361,12489,177,926,2611,9612,2788,10538
130070,202108,7962,21424,6536,19882,320,804,5363,17012,5683,17816
130080,202108,7584,26324,6639,25253,239,1205,5707,22152,5946,23357
130083,202108,2875,9119,2557,8730,155,578,2126,7432,2281,8010
130090,202108,3699,11188,3281,10683,41,174,2958,9834,2999,10008
130100,202108,8246,24496,6976,23177,110,234,6505,22238,6615,22472
130110,202108,8720,24376,7135,22427,1075,2696,5069,17356,6144,20052
130115,202108,5282,16412,4541,15573,99,310,4036,14098,4135,14408
130120,202108,14255,49889,12551,47642,1078,4407,10124,38945,11202,43352
130130,202108,5814,17488,4449,15681,421,1485,3184,11452,3605,12937
130140,202108,7503,25609,6557,24529,188,992,5756,21678,5944,22670
130150,202108,3802,13916,3576,13664,59,366,3319,12734,3378,13100
130160,202108,5511,18745,4733,17757,310,1044,4000,15503,4310,16547
130165,202108,3324,12314,3119,12071,117,490,2817,11029,2934,11519
130170,202108,12118,34184,9773,31482,726,2314,7901,26142,8627,28456
130180,202108,4576,14683,4347,14426,42,196,4198,13921,4240,14117
130185,202108,19382,46539,15858,42770,1208,2013,13000,37757,14208,39770
130190,202108,19650,63092,15797,57463,1577,5487,11430,43340,13007,48827
130195,202108,2551,9055,2058,8387,79,368,1722,7041,1801,7409
130200,202108,2814,7553,2292,6889,82,282,1970,5911,2052,6193
130210,202108,1398,5140,1261,4976,100,558,1033,3967,1133,4525
130220,202108,2448,7995,2057,7516,66,265,1816,6747,1882,7012
130230,202108,5103,19864,4447,18945,189,1125,3901,16593,4090,17718
130240,202108,12902,37606,10492,34491,145,806,9527,31366,9672,32172
130250,202108,27072,79220,23206,74867,1580,4269,18909,63591,20489,67860
130255,202108,4831,15490,4197,14398,131,532,3447,11867,3578,12399
130260,202108,267172,721673,217037,651620,58627,184856,98213,310566,156840,495422
130270,202108,10242,34833,8475,32115,1502,5349,5293,21333,6795,26682
130280,202108,3711,14488,3419,14161,80,401,3205,13407,3285,13808
130290,202108,14297,45476,12490,43225,666,2241,10707,37884,11373,40125
130300,202108,5081,16853,4576,16186,143,747,4010,14188,4153,14935
130310,202108,6694,21461,5792,20323,274,1123,4968,17494,5242,18617
130320,202108,3554,11406,2949,10614,386,1311,2164,8118,2550,9429
130330,202108,4863,15081,3905,13943,208,869,3326,11938,3534,12807
130340,202108,25050,74032,21575,70107,1511,3702,18199,61457,19710,65159
130350,202108,4130,14614,3722,14106,146,711,3287,12437,3433,13148
130353,202108,7722,20321,6183,18378,782,2154,4417,13772,5199,15926
130356,202108,5474,16839,4540,15403,830,2705,2668,9703,3498,12408
130360,202108,3125,10066,2683,9474,75,295,2404,8502,2479,8797
130370,202108,5895,23170,5065,22019,311,1664,4011,17550,4322,19214
130380,202108,7439,30634,6913,29881,384,2117,5896,25333,6280,27450
130390,202108,6307,25475,5622,24359,548,2513,4443,19481,4991,21994
130395,202108,2505,7769,2147,7204,183,585,1686,5740,1869,6325
130400,202108,2899,8710,2487,8175,92,239,2234,7505,2326,7744
130406,202108,11149,37861,9324,35658,1760,6569,6145,24763,7905,31332
130410,202108,4606,15640,3944,14556,1119,4273,1840,7058,2959,11331
130420,202108,14574,48894,12128,45849,954,4161,9398,36007,10352,40168
130423,202108,4608,13966,4041,13320,188,697,3557,11696,3745,12393
130426,202108,2814,11116,2608,10873,55,293,2418,10176,2473,10469
130430,202108,4469,12224,3849,11417,195,629,3338,9862,3533,10491
130440,202108,5303,15937,4460,14932,79,313,4154,13998,4233,14311
140002,202108,2424,6951,2119,6585,102,349,1769,5615,1871,5964
140005,202108,3404,9328,2958,8811,134,336,2516,7749,2650,8085
140010,202108,56236,147678,45077,131208,11025,33985,18689,55972,29714,89957
140015,202108,3967,11451,3367,10727,233,674,2906,9506,3139,10180
140017,202108,5286,13653,4656,12860,343,755,3832,10968,4175,11723
140020,202108,5341,15171,4611,14234,252,962,3794,11656,4046,12618
140023,202108,2623,7577,2155,6912,201,640,1648,5406,1849,6046
140028,202108,2002,5110,1692,4723,77,245,1369,3830,1446,4075
140030,202108,5571,13871,4961,13173,325,590,4376,12007,4701,12597
140040,202108,2715,10282,2511,10015,83,509,2309,9071,2392,9580
140045,202108,2682,9723,2225,9095,391,1331,1397,6388,1788,7719
140047,202108,6511,18075,5428,16515,596,1861,3887,12037,4483,13898
140050,202108,1464,4218,1238,3899,118,340,933,3061,1051,3401
140060,202108,1769,4522,1539,4200,113,284,1263,3525,1376,3809
140070,202108,1946,9959,1883,9837,108,768,1612,8316,1720,9084
150010,202108,46498,115176,41953,109357,1019,2225,37603,98224,38622,100449
150013,202108,2051,5050,1713,4685,147,265,1361,3981,1508,4246
150020,202108,14627,43294,13489,41812,1844,4719,10474,34052,12318,38771
150030,202108,8896,33106,8079,32120,504,1936,6984,28254,7488,30190
150034,202108,4485,10513,3687,9544,251,558,3074,8158,3325,8716
150040,202108,16835,42649,14804,40403,1245,1789,12461,36946,13706,38735
150050,202108,7321,24588,6690,23764,122,498,6184,22196,6306,22694
150060,202108,22947,60850,18502,54299,2675,7961,12114,36312,14789,44273
150070,202108,7292,26198,6392,25128,231,998,5755,22884,5986,23882
150080,202108,95761,211824,78529,188251,19957,52712,19741,58730,39698,111442
150085,202108,8352,23251,7587,22361,123,347,7105,21135,7228,21482
150090,202108,10448,36440,9851,35307,775,2587,7988,29021,8763,31608
150095,202108,6074,16757,5318,15838,261,499,4633,14303,4894,14802
150100,202108,2926,10019,2586,9467,222,671,2022,7660,2244,8331
150110,202108,4454,17933,4142,17583,174,768,3819,16363,3993,17131
150120,202108,8291,25377,7852,24862,281,678,6981,22782,7262,23460
150125,202108,810,2018,591,1726,101,359,362,1030,463,1389
150130,202108,23623,65942,20291,60896,3981,10586,12288,40066,16269,50652
150140,202108,276704,616851,233223,558015,35563,80279,133646,333540,169209,413819
150145,202108,4417,13527,3717,12419,1057,3326,1680,6457,2737,9783
150150,202108,17401,42670,15139,39853,761,2003,12538,33041,13299,35044
150157,202108,3711,9832,2947,8838,323,907,2036,6453,2359,7360
150160,202108,3341,9104,3107,8769,451,1123,2108,6158,2559,7281
150170,202108,25824,80658,22651,75382,4124,12703,13770,49174,17894,61877
150172,202108,5290,13943,4237,12489,304,735,3167,9740,3471,10475
150175,202108,1727,5234,1436,4706,238,811,852,2833,1090,3644
150178,202108,10912,28282,8982,26069,320,629,7919,23557,8239,24186
150180,202108,23457,79581,21205,77030,1383,3510,18440,69519,19823,73029
150190,202108,7073,22538,6558,21916,184,713,5963,19934,6147,20647
150195,202108,5463,16678,5125,16163,201,651,4577,14443,4778,15094
150200,202108,6004,17374,5485,16801,56,138,5187,16007,5243,16145
150210,202108,27964,92722,26206,90484,1501,4505,21964,78565,23465,83070
150215,202108,8946,24537,7754,22740,1314,3749,4598,13987,5912,17736
150220,202108,13177,35876,11489,33495,1142,2992,7897,23731,9039,26723
150230,202108,13191,36287,11685,34273,1287,3269,7999,24656,9286,27925
150240,202108,34261,91919,28486,82301,7015,20865,10596,30716,17611,51581
150250,202108,4370,16204,4062,15862,579,2197,3198,12793,3777,14990
150260,202108,2798,8771,2516,8354,127,382,2057,6943,2184,7325
150270,202108,9384,25928,6618,20976,2041,6835,1533,5218,3574,12053
150275,202108,7099,21949,6459,21056,224,770,5587,18223,5811,18993
150276,202108,2495,6423,2145,5995,264,625,1413,4486,1677,5111
150277,202108,5370,13606,4264,12321,386,1006,3147,9747,3533,10753
150280,202108,7221,28061,6965,27657,390,1446,6066,24420,6456,25866
150285,202108,3350,11592,2930,10931,227,817,2163,8297,2390,9114
150290,202108,10557,28188,9512,27074,357,638,8532,25057,8889,25695
150293,202108,9751,23348,7558,20506,1103,2878,4623,13272,5726,16150
150295,202108,7859,20633,5674,17637,1807,5982,1851,6748,3658,12730
150300,202108,2460,7128,2227,6841,34,111,2055,6350,2089,6461
150304,202108,4394,12534,3631,11379,614,1740,2282,7630,2896,9370
150307,202108,6213,19469,5692,18609,270,871,4594,15157,4864,16028
150309,202108,6686,19052,5371,16853,857,2603,3119,10276,3976,12879
150310,202108,7528,29341,7188,28944,193,984,6425,26168,6618,27152
150320,202108,9434,25422,8605,24223,367,1071,6729,18906,7096,19977
150330,202108,14206,44217,13120,42569,1277,3668,9831,33307,11108,36975
150340,202108,2612,7507,2314,7064,349,972,1584,5018,1933,5990
150345,202108,8805,24442,7898,23257,424,1274,6797,20100,7221,21374
150350,202108,9316,22958,8512,21926,672,1180,7060,18740,7732,19920
150360,202108,24781,66089,19759,59820,2223,4922,13793,45394,16016,50316
150370,202108,11503,33544,9431,30742,1086,2858,6787,24079,7873,26937
150375,202108,3821,15112,3461,14606,203,925,3009,12849,3212,13774
150380,202108,11601,28757,9560,26098,114,406,8518,23215,8632,23621
150390,202108,7882,31019,7051,29745,1090,3860,5018,22674,6108,26534
150400,202108,6859,23848,6569,23321,223,720,5830,20840,6053,21560
150405,202108,9479,24286,8266,22844,517,1001,6696,19200,7213,20201
150410,202108,2030,6128,1728,5620,267,702,1079,3730,1346,4432
150420,202108,40978,110399,31478,96611,8455,27123,11067,39759,19522,66882
150430,202108,8733,24595,7937,23578,909,1843,6194,19437,7103,21280
150440,202108,5992,18139,5423,17368,924,2586,3601,12301,4525,14887
150442,202108,28451,64545,23567,58620,2506,5865,16426,41755,18932,47620
150445,202108,6716,19783,5879,18551,199,601,5114,16215,5313,16816
150450,202108,5378,22161,4973,21626,383,1834,4204,18355,4587,20189
150460,202108,8551,27729,7783,26751,221,810,6711,23892,6932,24702
150470,202108,21510,55511,19190,52881,336,945,18099,49877,18435,50822
150475,202108,5362,16044,4571,14869,635,1776,3257,11105,3892,12881
150480,202108,14250,43990,12769,41838,2326,6380,8518,30236,10844,36616
150490,202108,8538,29315,7793,28385,334,1180,6738,24827,7072,26007
150495,202108,5534,18122,5268,17771,91,424,4842,16254,4933,16678
150497,202108,2880,8959,2314,7987,500,1755,1224,4548,1724,6303
150500,202108,3428,8529,3036,7979,282,676,2308,6062,2590,6738
150503,202108,5169,12906,3550,10811,1011,3254,1119,3945,2130,7199
150506,202108,11132,31742,9305,29262,1919,5316,5750,20162,7669,25478
150510,202108,10116,35684,8766,33262,1367,4732,5649,22807,7016,27539
150520,202108,7878,29034,7556,28639,160,873,6922,26157,7082,27030
150530,202108,12555,41863,10814,39372,1306,3719,7923,30739,9229,34458
150540,202108,5211,13619,4459,12509,283,688,3696,10443,3979,11131
150543,202108,7317,19361,5994,17718,429,1228,4681,14500,5110,15728
150548,202108,10404,31946,9322,30453,219,831,8314,27286,8533,28117
150549,202108,2025,5778,1724,5354,48,158,1442,4524,1490,4682
150550,202108,21634,61642,17914,55618,4639,14469,7197,24074,11836,38543
150553,202108,33931,92514,26880,80379,7593,22823,10500,32818,18093,55641
150555,202108,2059,5312,1614,4618,192,422,1075,3277,1267,3699
150560,202108,1988,5746,1766,5327,312,858,1019,3233,1331,4091
150563,202108,2703,7858,2228,7049,435,1401,1240,3997,1675,5398
150565,202108,4670,14464,4165,13679,95,388,3494,11563,3589,11951
150570,202108,6783,20309,6329,19698,432,1126,5336,16957,5768,18083
150580,202108,10786,41346,9178,39557,560,2762,7289,33126,7849,35888
150590,202108,8498,28646,7268,27183,142,823,6670,24899,6812,25722
150600,202108,9835,31948,9142,31121,211,797,8486,29058,8697,29855
150610,202108,3032,8403,2703,7893,107,334,2298,6681,2405,7015
150611,202108,3436,9135,3066,8639,101,307,2721,7646,2822,7953
150613,202108,14330,38030,10841,32256,1945,6105,5460,16165,7405,22270
150616,202108,3728,10063,2713,8353,587,1852,1175,3636,1762,5488
150618,202108,7251,20232,5901,18176,581,1736,3717,12057,4298,13793
150619,202108,7006,18766,5773,17075,266,617,4846,14616,5112,15233
150620,202108,6942,22631,5971,21010,650,2120,4045,14741,4695,16861
150630,202108,6763,17321,6182,16621,306,732,5387,14557,5693,15289
150635,202108,5143,13703,4301,12366,601,1596,2771,8176,3372,9772
150640,202108,2308,6721,2104,6465,40,107,1962,6103,2002,6210
150650,202108,11854,31764,10253,29262,2875,7786,4488,14121,7363,21907
150655,202108,5807,16465,5255,15660,198,573,4571,13671,4769,14244
150658,202108,4678,13048,3597,11323,699,2282,1838,6120,2537,8402
150660,202108,5970,16491,5285,15545,630,1697,3578,10813,4208,12510
150670,202108,9358,20575,7451,18427,703,1303,6008,15667,6711,16970
150680,202108,72576,205626,56048,179791,13458,41797,24176,88828,37634,130625
150690,202108,2878,6861,2473,6406,100,187,2181,5813,2281,6000
150700,202108,6266,18095,5593,17227,376,873,4421,14136,4797,15009
150710,202108,3843,12603,3485,12043,301,963,2615,9293,2916,10256
150715,202108,5219,14367,4276,12949,288,759,3396,10510,3684,11269
150720,202108,7021,24169,6518,23426,433,1511,5406,19828,5839,21339
150730,202108,12964,37828,10993,34960,1208,3933,8177,26735,9385,30668
150740,202108,4201,11299,3674,10481,327,755,2751,8081,3078,8836
150745,202108,5206,14335,4182,12855,658,2084,2852,8959,3510,11043
150746,202108,1806,5117,1634,4880,74,162,1368,4166,1442,4328
150747,202108,5227,15530,4630,14613,702,1851,3180,10649,3882,12500
150750,202108,3864,11730,3217,10734,222,776,2457,8465,2679,9241
150760,202108,12070,34856,10919,33250,1596,4310,7549,23997,9145,28307
150770,202108,6788,23429,6334,22921,226,532,5743,21561,5969,22093
150775,202108,1045,2756,826,2481,128,407,499,1514,627,1921
150780,202108,4576,13796,4058,13180,154,405,3651,12196,3805,12601
150790,202108,6162,16643,5287,15701,304,730,3859,13280,4163,14010
150795,202108,15099,44340,13083,41310,3007,8879,7482,25184,10489,34063
150796,202108,4041,9476,3509,8868,242,482,2930,7613,3172,8095
150797,202108,4301,12656,3708,11833,181,404,3107,10227,3288,10631
150800,202108,13747,42087,12337,40226,1582,4708,9041,30767,10623,35475
150803,202108,7648,22963,7118,22171,439,1075,6060,19245,6499,20320
150805,202108,3685,10904,3124,10106,277,821,2358,7863,2635,8684
150808,202108,6328,17690,4646,14929,1690,5978,699,2623,2389,8601
150810,202108,21634,54761,16374,48470,3237,9737,8265,27568,11502,37305
150812,202108,5787,15544,5100,14447,433,1298,3873,10771,4306,12069
150815,202108,10122,28568,8449,26609,690,2062,6956,22354,7646,24416
150820,202108,12245,32481,10390,30192,1231,2847,7723,23943,8954,26790
150830,202108,12574,43798,11630,42656,490,1738,9917,37958,10407,39696
150835,202108,2696,8285,2318,7688,339,1111,1492,4991,1831,6102
150840,202108,8058,21801,6500,19381,1021,3334,3739,10998,4760,14332
160005,202108,1247,3291,1099,3108,67,219,928,2641,995,2860
160010,202108,2486,6540,2317,6357,19,93,2245,6098,2264,6191
160015,202108,2944,8224,2605,7817,68,201,2406,7270,2474,7471
160020,202108,2213,6775,1927,6424,171,468,1482,5209,1653,5677
160021,202108,1283,4619,1181,4489,52,263,945,3658,997,3921
160023,202108,1365,4598,1207,4333,171,565,791,3047,962,3612
160025,202108,1854,5538,1742,5412,13,42,1687,5256,1700,5298
160027,202108,8967,24712,7989,23471,722,1966,6306,18973,7028,20939
160030,202108,80211,218451,65095,198134,13797,39099,34035,115223,47832,154322
160040,202108,6019,19794,5483,19123,84,321,5134,18048,5218,18369
160050,202108,5087,14663,3974,13208,1439,4545,1433,6027,2872,10572
160053,202108,4071,12039,3663,11535,300,798,2935,9692,3235,10490
160055,202108,968,2745,934,2707,28,84,860,2512,888,2596
160060,202108,27096,67505,22163,61952,1501,3783,17008,50593,18509,54376
160070,202108,2678,9953,2385,9500,207,759,1859,7741,2066,8500
160080,202108,3436,10562,3034,10113,23,125,2861,9596,2884,9721
170025,202108,676,1708,483,1415,88,240,239,761,327,1001
170030,202108,1302,3798,1009,3296,167,499,463,1587,630,2086
170035,202108,1525,3856,1121,3230,77,239,728,2084,805,2323
170040,202108,1982,5361,1577,4785,105,340,1009,3142,1114,3482
170070,202108,1978,4532,1407,3805,94,283,828,2351,922,2634
170100,202108,2510,7037,2077,6327,253,669,1263,4021,1516,4690
170105,202108,741,2080,515,1604,151,425,152,498,303,923
170110,202108,1030,2985,798,2563,105,349,433,1346,538,1695
170130,202108,1337,3841,977,3164,171,587,495,1607,666,2194
170190,202108,1486,4002,1107,3407,298,1019,338,1092,636,2111
170200,202108,2134,4962,1407,3791,216,584,559,1529,775,2113
170210,202108,26452,69849,20011,59205,6030,19438,3042,9797,9072,29235
170215,202108,1368,3567,1095,3189,45,178,877,2544,922,2722
170220,202108,6082,18269,5053,16426,1392,4363,1799,6673,3191,11036
170230,202108,1275,3626,939,2975,272,892,163,560,435,1452
170240,202108,2698,7318,2154,6454,141,450,1560,4601,1701,5051
170255,202108,4102,11481,2972,9499,627,1945,1246,4161,1873,6106
170270,202108,963,2304,654,1858,60,156,374,1062,434,1218
170290,202108,2995,8591,2604,8074,153,411,2034,6554,2187,6965
170300,202108,2108,5491,1707,4895,196,491,1153,3414,1349,3905
170305,202108,686,1811,580,1643,82,230,291,854,373,1084
170307,202108,1001,3237,821,2907,98,345,477,1714,575,2059
170310,202108,1639,4011,1173,3288,168,494,566,1617,734,2111
170320,202108,1079,2759,811,2327,80,234,504,1489,584,1723
170330,202108,936,2793,845,2662,42,173,702,2156,744,2329
170360,202108,567,1468,404,1212,22,76,274,774,296,850
170370,202108,1305,3377,941,2769,245,692,293,942,538,1634
170380,202108,1910,5291,1449,4582,83,273,844,2792,927,3065
170382,202108,566,1636,472,1480,27,115,356,1074,383,1189
170384,202108,1669,5652,1371,5096,282,1012,682,2681,964,3693
170386,202108,1027,2745,642,2011,71,257,235,698,306,955
170388,202108,649,1765,456,1443,65,219,212,673,277,892
170389,202108,1079,3254,882,2922,54,196,634,2156,688,2352
170390,202108,1836,4037,1381,3498,33,74,1162,3019,1195,3093
170410,202108,626,1704,451,1398,21,84,298,892,319,976
170460,202108,395,1025,325,920,42,118,215,620,257,738
170510,202108,973,2647,709,2193,41,151,457,1313,498,1464
170550,202108,6797,17609,5016,14789,1358,4285,1064,3401,2422,7686
170555,202108,1451,3792,1143,3319,106,279,532,1659,638,1938
170560,202108,1068,2892,814,2541,76,215,505,1688,581,1903
170600,202108,1342,3530,1085,3170,284,703,497,1649,781,2352
170610,202108,1649,4234,1197,3558,84,261,744,2193,828,2454
170625,202108,450,1166,301,876,41,108,118,335,159,443
170650,202108,1273,3669,1009,3235,115,381,619,2024,734,2405
170700,202108,3524,10200,2660,8537,516,1664,1149,3735,1665,5399
170710,202108,1525,3864,1190,3346,172,478,715,2057,887,2535
170720,202108,1807,4429,1379,3747,307,814,665,1878,972,2692
170730,202108,1122,2940,842,2482,131,310,456,1434,587,1744
170740,202108,2166,6924,1867,6383,164,617,1343,4573,1507,5190
170755,202108,922,2446,650,2000,92,293,261,812,353,1105
170765,202108,1176,2993,832,2453,151,438,353,1095,504,1533
170770,202108,1935,5348,1566,4785,148,462,1063,3276,1211,3738
170820,202108,3538,10315,2751,8905,552,1807,1233,4199,1785,6006
170825,202108,1053,2389,863,2145,101,226,625,1577,726,1803
170830,202108,1418,3705,1155,3300,240,621,677,2039,917,2660
170900,202108,2845,8668,2400,8029,219,620,1873,6458,2092,7078
170930,202108,3889,10442,2959,8714,677,2108,899,2684,1576,4792
170950,202108,11581,31367,8081,25116,2117,7532,861,2926,2978,10458
170980,202108,484,1244,373,1065,35,103,241,672,276,775
171050,202108,1696,5192,1475,4816,50,219,1223,3975,1273,4194
171070,202108,1400,3860,1203,3571,326,897,512,1830,838,2727
171090,202108,1099,2693,862,2364,94,265,536,1449,630,1714
171110,202108,597,1569,415,1238,81,225,178,502,259,727
171150,202108,1092,2634,691,1965,74,241,425,1189,499,1430
171180,202108,800,2117,528,1608,101,281,223,691,324,972
171190,202108,1942,6214,1689,5782,261,927,1041,3686,1302,4613
171195,202108,819,2523,653,2209,74,288,405,1345,479,1633
171200,202108,633,1711,475,1453,115,381,167,501,282,882
171215,202108,399,1078,327,962,30,99,214,600,244,699
171240,202108,815,2586,647,2283,27,147,441,1525,468,1672
171245,202108,757,2122,595,1816,51,170,380,1116,431,1286
171250,202108,1023,2705,751,2294,136,441,349,1082,485,1523
171270,202108,507,1728,396,1490,92,350,159,648,251,998
171280,202108,911,2652,735,2337,70,227,450,1469,520,1696
171320,202108,4155,11361,3246,9778,661,1853,1214,3937,1875,5790
171330,202108,2852,7708,2197,6548,519,1541,926,2893,1445,4434
171360,202108,1495,4154,1182,3697,98,290,827,2714,925,3004
171370,202108,735,1807,563,1568,47,124,395,1114,442,1238
171380,202108,1521,3997,1274,3664,153,414,851,2589,1004,3003
171395,202108,1050,2731,728,2158,64,194,463,1338,527,1532
171420,202108,2055,5804,1497,4711,269,822,659,2151,928,2973
171430,202108,1094,3117,922,2801,55,172,641,1882,696,2054
171488,202108,2453,6945,1951,6136,318,1018,1020,3253,1338,4271
171500,202108,991,2454,737,2064,72,181,488,1385,560,1566
171510,202108,846,2651,733,2440,43,167,535,1767,578,1934
171515,202108,500,1227,377,1050,43,128,227,600,270,728
171525,202108,761,2030,576,1744,37,120,365,1076,402,1196
171550,202108,356,992,273,863,38,142,148,439,186,581
171570,202108,1150,3380,971,3068,129,397,573,1891,702,2288
171575,202108,1792,4756,1162,3643,128,410,506,1603,634,2013
171610,202108,5964,16226,4413,13589,893,3119,1103,3721,1996,6840
171620,202108,2681,7380,2277,6799,100,392,1884,5597,1984,5989
171630,202108,1066,2659,825,2337,86,237,580,1696,666,1933
171650,202108,2130,5882,1652,5093,400,1321,477,1663,877,2984
171660,202108,2437,5991,1685,4759,209,527,975,2789,1184,3316
171665,202108,1276,3518,1010,3088,187,622,480,1480,667,2102
171670,202108,1983,5186,1501,4382,233,714,735,2185,968,2899
171700,202108,1234,3393,902,2791,109,318,493,1541,602,1859
171720,202108,811,2043,639,1781,58,168,461,1272,519,1440
171750,202108,1367,3748,930,2925,213,702,132,509,345,1211
171780,202108,1263,3137,935,2667,80,245,653,1846,733,2091
171790,202108,1450,4566,1181,4024,181,602,566,1959,747,2561
171800,202108,752,1978,575,1724,68,238,329,968,397,1206
171820,202108,11891,32536,8803,27282,2110,6813,2353,7988,4463,14801
171830,202108,1615,4991,1380,4592,128,479,876,2939,1004,3418
171840,202108,792,2058,613,1782,21,62,396,1158,417,1220
171845,202108,670,1602,508,1366,46,168,331,853,377,1021
171850,202108,972,3080,815,2735,74,285,559,1842,633,2127
171855,202108,1084,3238,926,2947,58,170,602,1883,660,2053
171865,202108,448,1309,377,1196,58,189,204,617,262,806
171870,202108,862,2302,601,1836,73,203,311,975,384,1178
171875,202108,1350,3771,1089,3370,35,153,834,2546,869,2699
171880,202108,1252,3609,1096,3402,43,113,871,2781,914,2894
171884,202108,961,2661,716,2228,143,469,260,845,403,1314
171886,202108,1464,3840,1059,3202,281,974,229,708,510,1682
171888,202108,730,2005,509,1603,27,106,316,954,343,1060
171889,202108,415,1219,303,1011,71,260,110,351,181,611
171890,202108,1215,3356,885,2830,158,477,498,1613,656,2090
171900,202108,571,1901,438,1598,79,254,175,679,254,933
172000,202108,605,1732,508,1566,67,199,269,825,336,1024
172010,202108,1043,3449,901,3181,78,282,564,2009,642,2291
172015,202108,384,1284,287,1091,49,176,123,486,172,662
172020,202108,2893,7817,2533,7355,160,469,1863,5674,2023,6143
172025,202108,721,1951,538,1659,43,142,381,1174,424,1316
172030,202108,1283,3719,1079,3387,63,192,813,2552,876,2744
172049,202108,1367,3199,914,2581,185,459,437,1385,622,1844
172065,202108,1475,3680,1169,3294,99,208,921,2787,1020,2995
172080,202108,2415,6995,1963,6209,123,388,1299,4128,1422,4516
172085,202108,485,1301,313,943,60,174,110,312,170,486
172090,202108,4166,10166,3248,8962,138,345,2478,6959,2616,7304
172093,202108,483,1403,344,1157,20,96,204,654,224,750
172097,202108,702,1786,484,1411,63,188,213,609,276,797
172100,202108,51445,124015,37156,101904,6220,18427,14054,39356,20274,57783
172110,202108,1652,5813,1423,5461,111,443,1077,4261,1188,4704
172120,202108,5246,15034,4117,13194,517,1702,2282,7536,2799,9238
172125,202108,401,1065,309,920,24,79,186,525,210,604
172130,202108,640,1555,501,1328,19,71,357,871,376,942
172208,202108,2661,6289,2131,5607,238,464,1499,4132,1737,4596
172210,202108,2763,6812,2118,5997,293,892,1235,3694,1528,4586
210005,202108,19450,54092,14591,46168,4055,13283,5580,18533,9635,31816
210010,202108,1958,5973,1772,5751,73,280,1555,5076,1628,5356
210015,202108,3426,10027,3000,9459,152,447,2485,7912,2637,8359
210020,202108,7441,17439,6352,16174,95,267,5839,14947,5934,15214
210030,202108,4729,15364,4354,14801,375,1236,3512,12165,3887,13401
210040,202108,1961,4462,1739,4197,57,129,1482,3507,1539,3636
210043,202108,6117,17272,5203,15985,388,1164,4093,12763,4481,13927
210047,202108,6661,20363,5457,18767,134,645,4724,16276,4858,16921
210050,202108,2244,7391,1788,6552,193,724,1210,4528,1403,5252
210055,202108,1976,6131,1796,5858,57,193,1552,5095,1609,5288
210060,202108,7574,27202,6752,25756,755,2807,4573,18097,5328,20904
210070,202108,7235,20039,6728,19364,40,158,6377,18307,6417,18465
210080,202108,4322,14340,4103,14102,37,213,3795,13131,3832,13344
210083,202108,5762,16060,4781,15003,114,317,4433,14091,4547,14408
210087,202108,3024,8178,2593,7600,131,341,2122,6292,2253,6633
210090,202108,9288,28452,8675,27394,693,1594,7145,23117,7838,24711
210095,202108,6711,21180,6129,20441,306,1082,5103,17522,5409,18604
210100,202108,6804,20728,6035,19460,522,1652,4484,14668,5006,16320
210110,202108,2945,9252,2713,8971,55,281,2438,8039,2493,8320
210120,202108,23882,63154,19746,57862,2012,4470,13363,42182,15375,46652
210125,202108,4487,11973,3900,11282,788,1826,2633,8249,3421,10075
210130,202108,4386,11189,3633,10258,161,328,3081,8816,3242,9144
210135,202108,1613,4407,1346,3998,84,179,1097,3355,1181,3534
210140,202108,20169,51439,15584,45562,3075,8245,8501,26749,11576,34994
210150,202108,4524,10540,4022,9860,203,361,3389,8320,3592,8681
210160,202108,17658,49315,15144,46189,1347,3971,10730,34373,12077,38344
210170,202108,15827,47432,14711,46019,898,2166,12753,40701,13651,42867
210173,202108,2325,8802,2177,8547,97,542,1881,7320,1978,7862
210177,202108,3518,9572,3050,8991,266,650,2487,7661,2753,8311
210180,202108,1442,3810,1254,3583,23,61,1135,3253,1158,3314
210190,202108,5526,14438,4660,13273,86,280,4017,11351,4103,11631
210193,202108,1385,3935,1211,3659,37,110,893,2763,930,2873
210197,202108,2157,6543,1983,6307,157,449,1628,5311,1785,5760
210200,202108,7928,25000,7047,23563,409,1423,5596,18781,6005,20204
210203,202108,7263,21023,6165,19567,361,1141,4942,16063,5303,17204
210207,202108,4006,9574,3096,8577,164,337,2559,7285,2723,7622
210210,202108,8067,25675,7351,24672,142,785,6306,21026,6448,21811
210215,202108,2543,7929,2181,7391,115,549,1637,5484,1752,6033
210220,202108,6293,21367,5921,20821,138,921,5239,18083,5377,19004
210230,202108,5402,15758,4902,15018,472,1117,4027,12722,4499,13839
210232,202108,11528,35174,9441,31997,1784,5848,5576,20467,7360,26315
210235,202108,3413,10257,3010,9672,154,562,2515,8120,2669,8682
210237,202108,3099,9579,2666,9063,28,132,2483,8452,2511,8584
210240,202108,2645,8100,2433,7751,68,219,2036,6400,2104,6619
210250,202108,5979,17630,5444,16959,60,323,4982,15477,5042,15800
210255,202108,2658,7914,2269,7247,273,869,1492,4761,1765,5630
210260,202108,5566,16351,4897,15380,281,865,4111,13003,4392,13868
210270,202108,5093,13712,4542,13017,81,336,4084,11613,4165,11949
210275,202108,3496,8840,3035,8268,98,253,2506,6839,2604,7092
210280,202108,5807,16009,4673,14295,246,871,3528,10676,3774,11547
210290,202108,7633,19564,6838,18581,113,310,6395,17407,6508,17717
210300,202108,32788,89040,26785,80403,2763,8606,17480,55027,20243,63633
210310,202108,3178,7930,2801,7383,115,236,2456,6545,2571,6781
210312,202108,2843,6910,2536,6582,20,76,2419,6245,2439,6321
210315,202108,3098,8439,2668,7958,96,246,2336,7170,2432,7416
210317,202108,4241,13145,3828,12660,91,447,3449,11358,3540,11805
210320,202108,19527,57148,17848,54969,347,1434,15918,48902,16265,50336
210325,202108,3719,10371,3181,9676,121,338,2734,8566,2855,8904
210330,202108,24784,67765,19888,61582,5118,14048,10421,36881,15539,50929
210340,202108,10459,29677,9311,28163,698,1964,7240,22505,7938,24469
210350,202108,9174,26125,8062,24775,128,422,7222,22320,7350,22742
210355,202108,4299,14028,3797,13242,97,443,3223,11315,3320,11758
210360,202108,14156,42961,12587,40661,515,2131,9579,30462,10094,32593
210370,202108,11214,24710,8648,22010,257,412,7879,20556,8136,20968
210375,202108,3313,8698,2505,7566,757,2416,838,2809,1595,5225
210380,202108,5525,13926,4753,13012,266,633,3998,11069,4264,11702
210390,202108,2828,9160,2622,8813,108,430,2266,7586,2374,8016
210400,202108,4558,13622,4029,12994,126,364,3582,11775,3708,12139
210405,202108,7081,18504,5731,16620,1142,2949,3173,9982,4315,12931
210407,202108,2076,6600,1756,6049,75,285,1392,4761,1467,5046
210408,202108,2688,9662,2502,9395,150,641,1984,7524,2134,8165
210409,202108,3961,13188,3590,12684,100,500,3001,10743,3101,11243
210410,202108,3596,10484,3057,9596,129,464,2439,7575,2568,8039
210420,202108,3935,12268,3521,11526,214,586,2927,9750,3141,10336
210430,202108,2280,6619,2018,6280,109,292,1698,5390,1807,5682
210440,202108,4494,11817,3892,11067,82,231,3536,10031,3618,10262
210450,202108,2392,6978,2055,6498,107,326,1672,5305,1779,5631
210455,202108,4571,11662,3470,10271,925,2755,1628,5142,2553,7897
210460,202108,3807,10690,3224,9934,59,209,2822,8688,2881,8897
210462,202108,1736,5109,1470,4684,42,152,1177,3779,1219,3931
210465,202108,2771,7941,2411,7435,77,330,1949,5883,2026,6213
210467,202108,6029,18678,5246,17660,288,1000,4351,14912,4639,15912
210470,202108,2009,5290,1497,4561,112,253,1116,3567,1228,3820
210480,202108,16975,48505,14062,44932,1315,3426,10085,35412,11400,38838
210490,202108,3716,9155,3011,8200,71,173,2569,6986,2640,7159
210500,202108,6443,24225,5929,23362,400,1785,4849,19065,5249,20850
210510,202108,5963,19452,5197,18624,104,467,4682,17006,4786,17473
210515,202108,3783,11016,3272,10419,192,635,2658,8706,2850,9341
210520,202108,2555,7321,2286,6962,65,230,1953,5896,2018,6126
210530,202108,52887,128747,40794,111029,6805,21838,12232,40643,19037,62481
210535,202108,3434,10921,3148,10506,136,462,2669,8983,2805,9445
210540,202108,15252,42691,12686,39136,1653,4445,8660,28343,10313,32788
210542,202108,6839,15535,5407,13960,533,1050,4160,11488,4693,12538
210545,202108,2255,6893,2121,6680,37,145,1894,5909,1931,6054
210547,202108,3669,12819,3265,12074,258,909,2507,9492,2765,10401
210550,202108,6121,18282,4810,16180,329,1231,3384,11728,3713,12959
210560,202108,3816,11308,3378,10614,134,379,2827,8868,2961,9247
210565,202108,1501,4714,1254,4361,57,293,970,3386,1027,3679
210570,202108,10731,28806,9527,27339,297,752,8322,24417,8619,25169
210580,202108,3046,8014,2438,7227,144,355,1661,5195,1805,5550
210590,202108,4349,12794,3784,12079,60,310,3385,10757,3445,11067
210592,202108,2682,7776,2448,7402,21,96,2110,6325,2131,6421
210594,202108,2563,6799,1972,5881,107,306,1458,4515,1565,4821
210596,202108,2729,9312,2438,8781,173,563,1928,7107,2101,7670
210598,202108,1877,5268,1733,5054,56,166,1530,4446,1586,4612
210600,202108,3093,8187,2539,7402,146,376,1869,5547,2015,5923
210610,202108,2862,7679,2448,7182,55,208,2113,6203,2168,6411
210620,202108,2906,7453,2389,6821,70,178,2130,6122,2200,6300
210630,202108,3124,10155,2850,9695,108,462,2356,7944,2464,8406
210632,202108,4554,13989,4044,13269,216,849,3237,10554,3453,11403
210635,202108,1763,6182,1665,6010,102,339,1356,5008,1458,5347
210637,202108,2584,8366,2225,7851,132,570,1664,5991,1796,6561
210640,202108,4666,16335,4372,15996,56,256,4024,14764,4080,15020
210650,202108,7525,21186,6818,20271,145,427,6098,18216,6243,18643
210660,202108,8250,24021,7365,22591,244,986,6266,18881,6510,19867
210663,202108,2767,7644,2525,7362,183,366,2046,6295,2229,6661
210667,202108,2024,6418,1813,6109,63,206,1596,5472,1659,5678
210670,202108,5013,16057,4556,15347,108,460,4018,13523,4126,13983
210675,202108,5186,13762,4436,12812,348,800,3511,10601,3859,11401
210680,202108,4759,11275,4015,10412,97,160,3648,9584,3745,9744
210690,202108,7698,23300,6415,21877,241,943,5620,19450,5861,20393
210700,202108,2812,7736,2219,6875,160,430,1580,5124,1740,5554
210710,202108,5086,15350,4486,14519,95,470,3989,12777,4084,13247
210720,202108,3125,9847,2766,9398,56,303,2458,8293,2514,8596
210725,202108,1330,4323,1151,4045,49,166,791,2926,840,3092
210730,202108,1231,3109,1040,2843,49,123,894,2441,943,2564
210735,202108,4830,13672,4114,12757,213,536,3493,11196,3706,11732
210740,202108,5306,13755,4569,12905,89,231,3915,11095,4004,11326
210745,202108,4523,12100,4190,11678,110,270,3792,10554,3902,10824
210750,202108,23929,60758,20722,56683,2402,5674,13846,40482,16248,46156
210760,202108,6017,15571,5064,14561,73,155,4763,13884,4836,14039
210770,202108,6253,15802,5404,14824,54,210,5094,13920,5148,14130
210780,202108,7699,23480,6703,21840,641,1751,5093,17000,5734,18751
210790,202108,4383,13582,3950,13023,208,440,3237,11243,3445,11683
210800,202108,4927,13091,4214,12145,90,336,3738,10678,3828,11014
210805,202108,4070,14382,3872,14088,128,572,3396,12363,3524,12935
210810,202108,4915,14137,4482,13576,339,784,3638,11427,3977,12211
210820,202108,7061,19853,5922,18047,721,2184,3492,11059,4213,13243
210825,202108,6993,21044,6299,20125,325,834,5318,17445,5643,18279
210830,202108,8010,21971,7276,21100,363,841,6321,18766,6684,19607
210840,202108,3245,8399,2925,7980,41,124,2626,7088,2667,7212
210845,202108,6551,17403,5840,16624,45,146,5560,15957,5605,16103
210850,202108,6003,19751,4943,18155,237,1065,3893,14374,4130,15439
210860,202108,21807,53988,18114,49445,1171,2699,14180,40965,15351,43664
210870,202108,7616,19164,6077,17419,219,492,5344,15497,5563,15989
210880,202108,4270,12883,3820,12330,201,672,3009,9779,3210,10451
210890,202108,3993,11319,3601,10861,373,908,2769,8727,3142,9635
210900,202108,4748,13468,3685,11524,1455,4898,523,1914,1978,6812
210905,202108,2057,5477,1718,5048,52,94,1557,4694,1609,4788
210910,202108,7230,21586,5976,19563,709,2339,3942,13044,4651,15383
210920,202108,3209,10433,2781,9867,67,375,2493,8755,2560,9130
210923,202108,1636,4643,1388,4255,86,239,1023,3159,1109,3398
210927,202108,5165,16341,4513,15561,485,1579,3322,11951,3807,13530
210930,202108,2528,8339,2212,7738,145,491,1695,5939,1840,6430
210940,202108,4081,11378,3795,11049,107,403,3479,10026,3586,10429
210945,202108,6958,19291,6226,18432,261,670,5211,15905,5472,16575
210950,202108,5292,14442,4065,12742,587,1376,2656,9184,3243,10560
210955,202108,1587,4802,1366,4442,351,1076,698,2440,1049,3516
210960,202108,9216,26701,7992,24859,1564,4447,4915,16245,6479,20692
210970,202108,1400,4123,1123,3656,92,268,842,2728,934,2996
210975,202108,1822,5491,1642,5207,101,326,1302,4160,1403,4486
210980,202108,10044,23310,8800,22023,105,240,8286,20869,8391,21109
210990,202108,16964,46129,13133,41157,734,2286,9624,31503,10358,33789
211000,202108,14966,42386,12466,39289,1125,3171,9224,30714,10349,33885
211003,202108,5831,16806,4875,15648,122,457,4211,13845,4333,14302
211010,202108,6471,22486,5776,21597,111,512,5147,19537,5258,20049
211020,202108,8293,23549,7177,22278,243,804,6086,19521,6329,20325
211023,202108,2056,6506,1908,6317,99,309,1600,5310,1699,5619
211027,202108,3224,9870,3057,9615,232,586,2576,8288,2808,8874
211030,202108,3883,10505,3469,9994,276,661,2723,8129,2999,8790
211040,202108,4805,16708,4433,16084,100,586,3990,14365,4090,14951
211050,202108,9167,23464,8345,22398,83,291,7666,20565,7749,20856
211060,202108,6983,20914,6336,20035,166,649,5585,17659,5751,18308
211065,202108,2347,6234,1952,5746,90,227,1611,4856,1701,5083
211070,202108,8297,24922,7092,23135,503,1519,5668,18733,6171,20252
211080,202108,1342,3629,1077,3214,30,153,857,2436,887,2589
211085,202108,2143,5800,1814,5359,99,207,1507,4688,1606,4895
211090,202108,3189,8717,2865,8351,30,138,2659,7728,2689,7866
211100,202108,6855,17106,6331,16481,37,120,5897,15448,5934,15568
211102,202108,3262,10584,2981,10167,216,841,2448,8271,2664,9112
211105,202108,2427,7420,2024,6708,147,499,1472,4841,1619,5340
211107,202108,4953,15190,4208,14094,154,595,3274,11498,3428,12093
211110,202108,6189,16318,4854,14293,363,981,3619,10839,3982,11820
211120,202108,45703,109760,37441,100116,5933,14318,23289,66913,29222,81231
211125,202108,2103,6200,1775,5692,47,155,1498,4836,1545,4991
211130,202108,181866,426625,155343,392430,24272,55991,78441,222716,102713,278707
211140,202108,5117,14698,4478,13890,242,594,3727,11753,3969,12347
211150,202108,9669,25555,8123,23566,378,921,6773,19929,7151,20850
211153,202108,2474,7112,1971,6490,312,993,1234,4320,1546,5313
211157,202108,1183,3636,990,3286,32,132,722,2396,754,2528
211160,202108,4393,11886,3460,10569,132,442,2651,8010,2783,8452
211163,202108,1600,5097,1449,4877,41,166,1275,4320,1316,4486
211167,202108,1621,4905,1508,4739,28,96,1389,4362,1417,4458
211170,202108,6581,15919,6101,15368,73,143,5772,14532,5845,14675
211172,202108,2636,7015,2268,6470,98,286,1814,5058,1912,5344
211174,202108,2907,8285,2630,7974,28,139,2475,7471,2503,7610
211176,202108,4333,12054,3379,10657,152,611,2730,8577,2882,9188
211178,202108,5135,11234,4397,10452,18,72,4246,10016,4264,10088
211180,202108,4164,13440,3826,12956,213,732,3135,10702,3348,11434
211190,202108,3123,9032,2649,8337,31,168,2369,7400,2400,7568
211195,202108,1440,3939,1229,3620,128,245,957,2974,1085,3219
211200,202108,2204,6205,1765,5585,206,582,1207,3904,1413,4486
211210,202108,6339,19176,5715,18350,335,1193,4703,15080,5038,16273
211220,202108,38842,95394,32022,87084,3535,8587,23163,65033,26698,73620
211223,202108,5405,13978,4437,12688,419,1134,3157,9134,3576,10268
211227,202108,1779,5689,1592,5425,60,257,1245,4292,1305,4549
211230,202108,8006,22215,7027,20746,383,845,5757,17434,6140,18279
211240,202108,8084,25220,7647,24658,213,834,7002,22468,7215,23302
211245,202108,7152,17646,6335,16785,85,213,6079,16081,6164,16294
211250,202108,13430,41534,12136,39713,915,3031,9548,31446,10463,34477
211260,202108,8215,26087,7305,24888,229,887,6482,22293,6711,23180
211270,202108,10382,32640,8860,30601,357,1594,7167,25020,7524,26614
211280,202108,12676,34141,11397,32529,833,1896,9451,27962,10284,29858
211285,202108,1909,6013,1703,5733,130,448,1291,4471,1421,4919
211290,202108,7631,22481,6890,21502,220,737,5887,18445,6107,19182
211300,202108,7849,22314,6878,20740,272,837,5599,16713,5871,17550
211400,202108,11912,32725,9739,29759,1067,3132,6455,20904,7522,24036
220005,202108,1925,4806,1744,4557,35,102,1496,3844,1531,3946
220010,202108,1509,4228,1238,3747,20,78,959,2889,979,2967
220020,202108,3916,10304,3347,9522,132,419,2781,7878,2913,8297
220025,202108,2267,5065,1946,4605,27,57,1622,3737,1649,3794
220027,202108,1326,3243,1131,2981,20,62,978,2539,998,2601
220030,202108,3461,8485,3232,8185,96,229,2817,7070,2913,7299
220040,202108,7450,22033,6506,20259,1573,4470,3265,10827,4838,15297
220045,202108,1525,4516,1259,4080,23,116,1052,3355,1075,3471
220050,202108,4784,12789,4065,11866,57,263,3741,10803,3798,11066
220060,202108,2466,5066,2110,4656,27,63,1998,4399,2025,4462
220070,202108,2475,6104,2107,5572,75,133,1757,4668,1832,4801
220080,202108,755,2107,651,1959,19,59,556,1669,575,1728
220090,202108,1787,4224,1501,3816,13,39,1233,3260,1246,3299
220095,202108,672,1606,631,1564,42,69,547,1400,589,1469
220100,202108,1459,3862,1176,3421,39,130,957,2700,996,2830
220105,202108,2110,6307,1851,5821,116,377,1404,4415,1520,4792
220110,202108,3444,9450,3137,8936,34,166,2813,7915,2847,8081
220115,202108,2807,7888,2591,7609,83,233,2339,6868,2422,7101
220117,202108,1460,3387,1157,2974,6,26,977,2458,983,2484
220120,202108,13453,34911,12283,33469,76,242,11532,31382,11608,31624
220130,202108,1172,3010,991,2760,7,36,899,2461,906,2497
220140,202108,2191,4447,1853,4053,98,227,1623,3534,1721,3761
220150,202108,6580,18892,5998,17894,117,461,5106,15017,5223,15478
220155,202108,1225,3418,980,2980,39,113,700,2097,739,2210
220157,202108,1089,2596,921,2341,23,68,731,1808,754,1876
220160,202108,2920,7938,2510,7201,31,120,2047,5757,2078,5877
220170,202108,1662,4238,1417,3881,16,71,1259,3407,1275,3478
220173,202108,2277,6115,1760,5176,46,131,1434,4110,1480,4241
220177,202108,2074,5734,1969,5618,8,27,1945,5545,1953,5572
220180,202108,1149,2707,932,2351,5,19,741,1754,746,1773
220190,202108,7233,17552,6165,16101,353,921,4719,12627,5072,13548
220191,202108,1635,4753,1482,4496,75,246,1050,3152,1125,3398
220192,202108,2114,5479,1557,4504,27,81,1258,3594,1285,3675
220194,202108,1759,4916,1563,4603,49,179,1296,3776,1345,3955
220196,202108,2099,5299,1908,5015,32,119,1661,4291,1693,4410
220198,202108,1296,3486,1102,3236,7,16,1018,3025,1025,3041
220200,202108,5320,15105,4644,14221,75,293,4003,12272,4078,12565
220202,202108,2215,6138,1902,5634,23,110,1635,4762,1658,4872
220205,202108,2555,7220,2283,6721,54,199,1929,5597,1983,5796
220207,202108,796,2362,666,2140,54,182,446,1446,500,1628
220208,202108,1750,5183,1462,4655,168,568,891,2808,1059,3376
220209,202108,1617,4547,1404,4170,28,104,1157,3399,1185,3503
220210,202108,1830,4301,1591,3938,13,45,1393,3357,1406,3402
220211,202108,1674,4130,1534,3943,16,55,1340,3449,1356,3504
220213,202108,1855,4790,1604,4366,18,58,1310,3470,1328,3528
220217,202108,2321,6562,2179,6398,49,86,2016,6046,2065,6132
220220,202108,10996,27707,9200,25042,671,1488,6232,17962,6903,19450
220225,202108,1013,2651,831,2415,4,27,783,2250,787,2277
220230,202108,5707,14121,4883,12982,153,336,4207,11291,4360,11627
220240,202108,3131,8842,2826,8337,109,354,2337,6857,2446,7211
220245,202108,1844,4125,1402,3590,13,50,1275,3294,1288,3344
220250,202108,3043,8328,2670,7858,12,56,2499,7329,2511,7385
220253,202108,1634,4309,1468,4036,56,163,1244,3362,1300,3525
220255,202108,2013,4583,1735,4202,32,127,1515,3551,1547,3678
220260,202108,4582,13465,3999,12419,175,566,3151,9790,3326,10356
220265,202108,1402,4258,1266,4088,39,170,1066,3376,1105,3546
220270,202108,6052,19357,5729,18778,182,855,4797,15253,4979,16108
220271,202108,1517,3845,1327,3579,22,69,1161,3114,1183,3183
220272,202108,1796,5075,1602,4723,46,131,1211,3483,1257,3614
220273,202108,1287,3587,1079,3210,46,165,828,2421,874,2586
220275,202108,2407,5432,1920,4772,36,57,1702,4262,1738,4319
220277,202108,2254,5488,1927,5027,44,99,1611,4152,1655,4251
220280,202108,1716,3890,1424,3517,17,49,1220,2997,1237,3046
220285,202108,1484,3655,1268,3400,7,23,1180,3144,1187,3167
220290,202108,6874,18531,5459,16559,339,1039,4005,12533,4344,13572
220300,202108,2048,5742,1666,5244,31,153,1402,4385,1433,4538
220310,202108,3112,8138,2457,7381,39,162,2096,6270,2135,6432
220320,202108,3148,8951,2431,7642,55,252,1908,5844,1963,6096
220323,202108,1690,4756,1318,4175,55,166,1076,3364,1131,3530
220325,202108,1262,3678,1090,3396,24,112,908,2774,932,2886
220327,202108,1624,4403,1421,4088,34,131,1172,3281,1206,3412
220330,202108,4699,10882,4000,10043,56,169,3623,9052,3679,9221
220335,202108,1695,5053,1530,4833,31,91,1362,4330,1393,4421
220340,202108,1949,4999,1504,4261,56,158,1023,2825,1079,2983
220342,202108,1212,3446,1084,3252,55,169,854,2557,909,2726
220345,202108,3183,7045,2444,6006,19,53,2213,5424,2232,5477
220350,202108,3404,8455,2722,7457,139,357,1936,5384,2075,5741
220360,202108,1252,3170,994,2742,16,43,793,2180,809,2223
220370,202108,8842,25124,8045,23854,174,585,6942,20447,7116,21032
220375,202108,1663,4617,1479,4393,2,7,1412,4218,1414,4225
220380,202108,1529,3542,1262,3175,16,35,1109,2782,1125,2817
220385,202108,864,2011,713,1752,6,15,623,1516,629,1531
220390,202108,10891,27247,8401,23473,2039,5502,3044,9490,5083,14992
220400,202108,1564,3612,1199,3052,23,70,927,2274,950,2344
220410,202108,1201,3239,978,2854,45,121,796,2307,841,2428
220415,202108,847,2125,714,1912,24,59,573,1519,597,1578
220420,202108,2061,5626,1663,4880,59,162,1261,3650,1320,3812
220430,202108,2666,6765,2443,6452,57,179,2144,5577,2201,5756
220435,202108,1826,4603,1564,4219,39,122,1310,3460,1349,3582
220440,202108,2417,7338,2048,6781,71,316,1760,5722,1831,6038
220450,202108,2555,6541,2070,5941,49,156,1779,5123,1828,5279
220455,202108,1314,4007,1253,3921,6,35,1132,3536,1138,3571
220460,202108,1041,2480,967,2389,29,59,838,2058,867,2117
220465,202108,2438,7271,2146,6822,189,540,1589,5200,1778,5740
220470,202108,3693,9881,3325,9293,139,318,2671,7428,2810,7746
220480,202108,2907,7263,2347,6384,249,498,1504,4213,1753,4711
220490,202108,2530,6203,2189,5780,25,114,1905,4963,1930,5077
220500,202108,3119,7557,2695,6912,98,215,2107,5350,2205,5565
220510,202108,2664,7213,2141,6290,81,200,1699,5051,1780,5251
220515,202108,1712,4030,1588,3857,39,63,1378,3343,1417,3406
220520,202108,5106,12977,4621,12296,89,236,4033,10693,4122,10929
220525,202108,1470,3522,1257,3259,8,35,1156,2981,1164,3016
220527,202108,1342,3624,1159,3363,16,61,997,2932,1013,2993
220530,202108,1448,3549,1257,3305,31,91,1147,3003,1178,3094
220535,202108,811,2176,759,2106,30,75,612,1703,642,1778
220540,202108,3289,10248,3064,9819,142,460,2572,8230,2714,8690
220545,202108,1488,4306,1382,4140,56,209,1172,3467,1228,3676
220550,202108,8815,26610,7854,24935,450,1469,5979,18841,6429,20310
220551,202108,1443,3953,1279,3694,27,97,1046,2968,1073,3065
220552,202108,1691,4741,1383,4199,22,109,1116,3285,1138,3394
220553,202108,1817,4541,1492,4113,56,94,1222,3497,1278,3591
220554,202108,939,2353,692,1961,54,123,467,1316,521,1439
220555,202108,2575,7070,2232,6642,32,112,1867,5723,1899,5835
220556,202108,1233,3482,1076,3186,39,152,801,2291,840,2443
220557,202108,1756,5178,1451,4502,104,350,1031,3127,1135,3477
220558,202108,1432,3672,1127,3245,17,66,969,2761,986,2827
220559,202108,1857,4450,1579,4025,17,37,1289,3329,1306,3366
220560,202108,1789,3973,1475,3577,46,83,1326,3256,1372,3339
220570,202108,7593,21784,6932,20852,497,1311,5498,16818,5995,18129
220580,202108,7093,18756,6466,17763,108,272,5821,15978,5929,16250
220585,202108,2138,6508,1752,5814,36,94,1447,4841,1483,4935
220590,202108,1422,3755,1176,3396,95,232,839,2492,934,2724
220595,202108,2684,7122,2429,6779,16,72,2181,6044,2197,6116
220600,202108,1466,3171,1241,2906,73,89,1060,2549,1133,2638
220605,202108,1637,4692,1405,4277,16,91,1152,3408,1168,3499
220610,202108,2861,8139,2681,7870,26,132,2515,7338,2541,7470
220620,202108,8177,24414,7502,23504,140,705,6847,21246,6987,21951
220630,202108,390,1126,304,972,24,80,204,639,228,719
220635,202108,1819,5368,1632,4977,40,178,1282,3799,1322,3977
220640,202108,2453,6736,2087,6216,66,258,1703,5026,1769,5284
220650,202108,2172,5793,1866,5331,27,87,1525,4344,1552,4431
220660,202108,2603,8069,2216,7434,67,324,1857,6142,1924,6466
220665,202108,1284,3781,1088,3460,28,140,916,2849,944,2989
220667,202108,1681,5021,1517,4727,66,228,1228,3810,1294,4038
220669,202108,1714,4951,1643,4843,48,179,1472,4264,1520,4443
220670,202108,2249,5699,1802,5080,19,73,1562,4402,1581,4475
220672,202108,3312,7961,2685,7202,84,276,2392,6336,2476,6612
220675,202108,1341,3552,1197,3292,33,85,980,2684,1013,2769
220680,202108,2805,7416,2676,7239,114,215,2429,6685,2543,6900
220690,202108,1630,4214,1437,3923,63,182,1127,3071,1190,3253
220695,202108,934,2535,868,2417,21,60,756,2097,777,2157
220700,202108,10613,25001,8610,22300,344,823,6590,16997,6934,17820
220710,202108,939,2482,691,2027,29,79,527,1509,556,1588
220720,202108,2156,5030,1939,4746,16,60,1701,4116,1717,4176
220730,202108,1352,3665,1153,3341,14,62,985,2796,999,2858
220735,202108,1014,2273,800,1950,27,73,655,1549,682,1622
220740,202108,1396,3537,1122,3177,32,73,939,2706,971,2779
220750,202108,3962,9769,3490,9100,163,364,3086,8074,3249,8438
220755,202108,1414,3312,1181,2967,20,60,985,2421,1005,2481
220760,202108,3169,8445,2783,7931,59,170,2541,7290,2600,7460
220770,202108,24697,71061,20962,64796,6128,19880,7301,23724,13429,43604
220775,202108,1212,2952,1077,2782,8,27,1038,2665,1046,2692
220777,202108,1643,4096,1264,3524,35,82,965,2716,1000,2798
220779,202108,1288,3292,1116,3036,21,63,976,2626,997,2689
220780,202108,5932,14349,5117,13143,219,610,4088,10328,4307,10938
220785,202108,1501,3297,1318,3063,6,14,1262,2916,1268,2930
220790,202108,10447,28935,9412,27451,164,675,7944,22973,8108,23648
220793,202108,948,2456,762,2137,7,10,634,1807,641,1817
220795,202108,1442,3623,1267,3389,26,75,1110,2968,1136,3043
220800,202108,18875,40702,16070,37056,590,1250,12586,29008,13176,30258
220810,202108,3099,8434,2612,7591,41,116,2169,6243,2210,6359
220820,202108,5189,13143,4514,12151,241,513,3509,9492,3750,10005
220830,202108,7437,19223,6667,18143,256,719,5498,14784,5754,15503
220840,202108,12523,36983,10486,32912,2325,6897,4923,16195,7248,23092
220850,202108,3226,9696,2906,9303,43,217,2594,8325,2637,8542
220855,202108,719,1764,628,1644,22,59,565,1474,587,1533
220860,202108,1075,2613,939,2405,13,57,859,2166,872,2223
220865,202108,2491,6464,1925,5463,63,234,1420,3903,1483,4137
220870,202108,3155,8392,2618,7695,26,123,2413,7082,2439,7205
220880,202108,5437,12596,4684,11663,71,249,4305,10612,4376,10861
220885,202108,1447,4204,1202,3802,64,197,935,3024,999,3221
220887,202108,1608,3372,1345,3039,13,28,1246,2804,1259,2832
220890,202108,1437,4247,1253,3982,46,151,1042,3369,1088,3520
220900,202108,2043,4802,1709,4375,30,71,1496,3817,1526,3888
220910,202108,1582,4190,1333,3822,65,163,1086,3156,1151,3319
220915,202108,999,2606,803,2254,16,52,618,1660,634,1712
220920,202108,1469,4458,1275,4204,60,219,1052,3510,1112,3729
220930,202108,1821,4758,1531,4345,21,61,1427,4043,1448,4104
220935,202108,1121,3181,907,2724,23,99,590,1678,613,1777
220937,202108,1546,3968,1329,3624,23,81,1072,2875,1095,2956
220940,202108,1618,4359,1292,3790,29,89,1012,2936,1041,3025
220945,202108,480,1590,402,1433,16,85,302,1053,318,1138
220950,202108,1446,3283,960,2542,20,56,761,1944,781,2000
220955,202108,1656,4118,1375,3640,26,65,1182,3093,1208,3158
220960,202108,826,2064,617,1715,28,81,438,1168,466,1249
220965,202108,1830,4896,1589,4547,17,104,1373,3857,1390,3961
220970,202108,2037,4704,1498,3915,24,57,1264,3270,1288,3327
220975,202108,695,1924,595,1799,11,62,533,1566,544,1628
220980,202108,1173,3242,1042,3064,33,116,870,2545,903,2661
220985,202108,1326,3322,1150,3067,54,121,935,2452,989,2573
220987,202108,1494,4330,1320,4027,56,184,1069,3241,1125,3425
220990,202108,1733,4707,1528,4402,14,80,1311,3729,1325,3809
220995,202108,1168,3354,969,2988,30,88,729,2258,759,2346
220997,202108,2402,7179,2218,6881,42,173,1975,6061,2017,6234
221000,202108,4567,12283,4023,11488,82,345,3465,9801,3547,10146
221005,202108,1518,3861,1384,3636,15,69,1204,3072,1219,3141
221010,202108,1284,2807,1009,2471,18,51,879,2118,897,2169
221020,202108,1581,4706,1438,4462,19,70,1107,3408,1126,3478
221030,202108,1711,4058,1463,3755,19,52,1274,3326,1293,3378
221035,202108,1558,3933,1363,3674,21,26,1217,3356,1238,3382
221037,202108,736,1933,611,1720,9,25,445,1192,454,1217
221038,202108,541,1477,421,1269,13,41,284,852,297,893
221039,202108,890,2389,755,2166,26,108,610,1691,636,1799
221040,202108,4351,12352,3798,11378,188,517,3035,9154,3223,9671
221050,202108,3990,10215,3532,9639,67,198,3186,8699,3253,8897
221060,202108,8957,24541,7433,22053,338,784,5930,17844,6268,18628
221062,202108,1150,3628,993,3369,34,144,803,2710,837,2854
221063,202108,1115,2975,961,2754,54,154,759,2156,813,2310
221065,202108,2706,6809,2372,6234,15,49,2090,5422,2105,5471
221070,202108,3510,10532,2835,9122,308,945,1721,5668,2029,6613
221080,202108,3568,8594,2929,7652,58,184,2414,6210,2472,6394
221090,202108,1450,3611,1193,3208,8,28,1018,2692,1026,2720
221093,202108,1432,3894,1306,3652,138,351,894,2472,1032,2823
221095,202108,886,2290,754,2090,8,21,639,1746,647,1767
221097,202108,882,2211,666,1827,22,54,497,1296,519,1350
221100,202108,122572,318481,102181,284217,10155,29917,66506,179782,76661,209699
221110,202108,10023,29409,9185,28308,129,618,8261,25276,8390,25894
221120,202108,4897,13304,4365,12474,160,446,3783,10866,3943,11312
221130,202108,5700,14166,4329,11585,814,2005,2191,5923,3005,7928
221135,202108,1804,4464,1611,4211,36,92,1446,3788,1482,3880
221140,202108,1375,3139,1156,2864,10,33,1050,2565,1060,2598
221150,202108,1118,2763,874,2347,22,99,677,1701,699,1800
221160,202108,755,1835,667,1723,27,35,536,1406,563,1441
221170,202108,1025,2871,940,2718,9,35,826,2352,835,2387
230010,202108,3131,8040,2580,7116,34,107,2129,5747,2163,5854
230015,202108,3162,9947,2797,9212,151,537,1978,6530,2129,7067
230020,202108,13211,40996,12366,39735,363,1359,10579,33940,10942,35299
230030,202108,13246,32361,11120,29602,242,627,9673,25806,9915,26433
230040,202108,4611,11622,3819,10337,39,181,3212,8572,3251,8753
230050,202108,2793,8489,2133,6984,329,1020,950,3052,1279,4072
230060,202108,2428,6505,1948,5652,27,105,1543,4398,1570,4503
230070,202108,4256,10726,3418,9180,216,596,2413,6410,2629,7006
230075,202108,9092,28878,8321,27540,624,2167,6410,21189,7034,23356
230080,202108,3102,6452,2360,5551,5,12,2159,5099,2164,5111
230090,202108,4531,10831,3838,9749,194,451,3070,7763,3264,8214
230100,202108,19016,47410,16657,44320,1407,3473,11869,31972,13276,35445
230110,202108,12988,37703,10876,33633,1718,5219,5659,17694,7377,22913
230120,202108,8010,20729,7014,19151,537,1255,5157,14290,5694,15545
230125,202108,3237,8420,2625,7458,94,288,2023,5669,2117,5957
230130,202108,5721,17298,4654,14978,392,1296,3012,9619,3404,10915
230140,202108,3492,10292,2964,9219,82,341,2267,6890,2349,7231
230150,202108,1670,4881,1374,4236,221,597,790,2526,1011,3123
230160,202108,6660,16813,5752,15446,126,386,4827,12778,4953,13164
230170,202108,6644,18303,5451,15912,363,931,3855,11192,4218,12123
230180,202108,1672,4575,1417,4082,18,79,1155,3224,1173,3303
230185,202108,4589,12603,3889,11444,297,877,2833,8391,3130,9268
230190,202108,14336,40650,12035,36432,1340,4077,7116,21420,8456,25497
230195,202108,5568,15835,5048,14886,401,1143,3765,11120,4166,12263
230200,202108,5135,13883,4310,12363,157,439,3312,9344,3469,9783
230205,202108,4435,12355,3879,11538,236,661,2929,8696,3165,9357
230210,202108,10486,24539,8859,22386,396,1080,6922,17268,7318,18348
230220,202108,14328,35389,12578,32905,613,1572,10347,26817,10960,28389
230230,202108,7154,20456,6400,18955,446,1236,4741,14044,5187,15280
230240,202108,13080,34589,11296,31552,271,1129,9331,25451,9602,26580
230250,202108,9134,24809,8460,23777,226,728,6845,18666,7071,19394
230260,202108,15171,43509,13122,39947,2237,6307,6964,21986,9201,28293
230270,202108,7920,20645,6091,17274,581,1567,3854,11093,4435,12660
230280,202108,20780,54391,17042,48180,430,1637,13449,36685,13879,38322
230290,202108,5099,13725,4204,12060,236,558,3204,9186,3440,9744
230300,202108,4991,12931,4519,12299,86,229,3990,10845,4076,11074
230310,202108,4825,13443,4093,12133,122,463,2949,8550,3071,9013
230320,202108,8050,22712,6755,20384,195,788,5228,15448,5423,16236
230330,202108,4890,12928,3889,11051,113,343,2956,8192,3069,8535
230340,202108,3940,11790,3381,10659,216,710,2392,7427,2608,8137
230350,202108,18459,49393,16090,45931,818,2604,10978,31537,11796,34141
230360,202108,3070,7867,2437,6767,123,325,1713,4691,1836,5016
230365,202108,3154,7617,2607,6813,54,227,2226,5735,2280,5962
230370,202108,61667,164784,52656,151719,6928,20100,32932,95397,39860,115497
230380,202108,6468,17458,5111,14999,112,404,3819,10935,3931,11339
230390,202108,3543,10135,3069,9366,79,301,2401,7249,2480,7550
230393,202108,3507,9891,2790,8436,65,330,2183,6342,2248,6672
230395,202108,5901,15828,5101,14504,412,1092,3501,10006,3913,11098
230400,202108,5567,14972,4948,13980,64,310,4030,11097,4094,11407
230410,202108,13971,40712,11562,36367,930,3085,7857,24813,8787,27898
230420,202108,30270,80581,24675,71120,2865,8403,14129,40300,16994,48703
230423,202108,4945,14255,4330,13063,152,498,3438,10264,3590,10762
230425,202108,5888,17547,5376,16520,478,1470,3792,11602,4270,13072
230426,202108,2938,7448,2162,5972,27,89,1644,4438,1671,4527
230427,202108,1935,5255,1392,4154,83,254,894,2563,977,2817
230428,202108,10125,26262,8689,24139,1382,3624,4861,13585,6243,17209
230430,202108,5058,13908,3990,12071,158,504,2990,8944,3148,9448
230435,202108,6326,15950,5263,14106,730,1772,3090,8419,3820,10191
230440,202108,438434,1053133,366150,948977,32636,88785,244842,624203,277478,712988
230445,202108,4374,11395,3513,9886,206,552,2401,6599,2607,7151
230450,202108,3704,10339,3225,9642,225,795,2371,6893,2596,7688
230460,202108,2186,5964,1898,5515,46,184,1608,4635,1654,4819
230465,202108,4352,11792,3673,10514,113,371,2787,7689,2900,8060
230470,202108,11612,37419,10412,35225,873,3192,7317,24489,8190,27681
230480,202108,1510,4276,1260,3829,60,236,936,2739,996,2975
230490,202108,2689,7313,2282,6553,167,523,1443,3908,1610,4431
230495,202108,5891,16939,5201,15717,531,1660,3282,9926,3813,11586
230500,202108,9575,29970,8496,28031,243,949,6927,22888,7170,23837
230510,202108,1706,4833,1343,4083,160,513,735,2188,895,2701
230520,202108,4861,13064,4200,11927,350,876,2907,8308,3257,9184
230523,202108,15922,45840,12695,39123,2800,8514,3138,10367,5938,18881
230526,202108,3868,10673,3305,9746,198,491,2413,7219,2611,7710
230530,202108,5602,17147,4719,15439,353,1198,3361,10884,3714,12082
230533,202108,4742,10817,3878,9483,116,271,3223,7777,3339,8048
230535,202108,5348,14618,4527,13242,320,915,3002,8880,3322,9795
230540,202108,16327,43657,13994,40217,283,984,11607,33152,11890,34136
230550,202108,22057,56351,17773,49237,1495,4123,11588,31900,13083,36023
230560,202108,8122,19680,6612,17327,60,233,5690,14784,5750,15017
230565,202108,3191,8640,2680,7706,118,416,2060,5816,2178,6232
230570,202108,3492,8761,2975,8045,86,211,2441,6598,2527,6809
230580,202108,11614,29002,9975,26680,406,985,8187,21928,8593,22913
230590,202108,9378,25778,7825,22992,458,1420,5822,16630,6280,18050
230600,202108,3910,9637,3094,8249,91,219,2104,5671,2195,5890
230610,202108,6855,18518,6082,17233,458,1207,4786,13538,5244,14745
230620,202108,2179,5718,1695,4804,103,313,1058,2889,1161,3202
230625,202108,8672,23440,7319,21042,1907,5715,2390,7073,4297,12788
230630,202108,11533,32359,10080,29628,1302,3512,6280,18779,7582,22291
230640,202108,27852,82795,25208,78626,1119,4226,20254,62361,21373,66587
230650,202108,5475,14253,4641,12843,115,399,3806,10275,3921,10674
230655,202108,9409,31239,8848,30291,643,2135,7077,24539,7720,26674
230660,202108,6217,18108,5062,16091,129,668,4098,12764,4227,13432
230670,202108,6418,14828,4665,12073,138,396,3703,9329,3841,9725
230680,202108,2778,7367,2331,6584,116,275,1669,4752,1785,5027
230690,202108,7405,21258,6362,19239,391,1335,4102,12185,4493,13520
230700,202108,10743,26544,8711,22877,411,897,6410,16621,6821,17518
230710,202108,7031,21691,6163,19856,706,2111,4015,13022,4721,15133
230720,202108,1940,5581,1600,4929,101,273,1130,3414,1231,3687
230725,202108,4392,12454,3945,11682,393,1237,2446,7155,2839,8392
230730,202108,60433,156465,47534,137394,10714,32665,14552,45545,25266,78210
230740,202108,6290,17097,5337,15578,136,394,4253,12416,4389,12810
230750,202108,8682,22588,7236,20200,168,510,5771,15740,5939,16250
230760,202108,11404,29327,9891,27062,483,1502,7488,19982,7971,21484
230763,202108,5180,13547,4327,12052,109,468,3501,9430,3610,9898
230765,202108,42696,112190,35471,100710,5199,15188,18621,52034,23820,67222
230770,202108,26233,62758,21964,57217,2170,5548,14855,38830,17025,44378
230780,202108,6669,22687,6022,21169,911,2990,3402,12408,4313,15398
230790,202108,3194,8763,2868,8243,103,399,2215,6167,2318,6566
230800,202108,8562,26276,7522,24209,1057,3410,4265,13642,5322,17052
230810,202108,11271,33464,10123,31616,363,1265,7917,24385,8280,25650
230820,202108,3645,11395,3009,10024,252,957,1854,5865,2106,6822
230830,202108,7768,20703,6623,18827,120,469,5473,15152,5593,15621
230835,202108,4368,10130,3387,8617,92,246,2727,6849,2819,7095
230837,202108,3259,9537,2912,8947,111,403,2337,7052,2448,7455
230840,202108,9668,27423,8300,25079,1039,2818,5656,17362,6695,20180
230850,202108,10080,28213,8472,25116,370,1135,6189,18129,6559,19264
230860,202108,5648,13743,4682,12369,58,179,4136,10837,4194,11016
230870,202108,16554,39703,14263,35947,403,1082,11668,28881,12071,29963
230880,202108,2195,6421,2012,6125,41,208,1606,4757,1647,4965
230890,202108,4590,14410,4187,13638,314,1071,3083,9948,3397,11019
230900,202108,3145,8730,2727,7962,162,535,1897,5378,2059,5913
230910,202108,3259,8523,2632,7562,58,252,2126,6109,2184,6361
230920,202108,4926,13371,4133,12121,101,364,3292,9457,3393,9821
230930,202108,6958,18775,5829,16793,284,761,4087,11749,4371,12510
230940,202108,8483,20859,7370,19193,206,465,6185,16060,6391,16525
230945,202108,6738,18794,5767,16986,282,953,4113,11844,4395,12797
230950,202108,6363,15682,5620,14678,119,262,4823,12680,4942,12942
230960,202108,14058,39139,12327,35939,2229,6311,5860,17153,8089,23464
230970,202108,14398,36999,12046,33395,1645,4362,7151,19954,8796,24316
230980,202108,2794,7873,2456,7286,334,916,1568,4811,1902,5727
230990,202108,1724,4717,1423,4133,61,228,1015,2824,1076,3052
231000,202108,2658,6940,2152,5957,92,207,1593,4324,1685,4531
231010,202108,3791,8596,2979,7227,26,93,2608,6151,2634,6244
231020,202108,8409,24951,7512,23281,1255,3475,4423,14223,5678,17698
231025,202108,7894,20813,6866,19152,745,1944,4833,13674,5578,15618
231030,202108,7622,22044,6001,18697,1045,3003,3030,9639,4075,12642
231040,202108,3002,8361,2612,7663,122,348,2052,5933,2174,6281
231050,202108,12171,30151,9942,26278,639,1543,7460,19358,8099,20901
231060,202108,2978,8210,2624,7653,54,149,2193,6410,2247,6559
231070,202108,8271,23281,7117,21261,629,1868,4806,14214,5435,16082
231080,202108,4034,11144,3412,10136,142,527,2582,7514,2724,8041
231085,202108,7141,16604,5687,14922,226,493,4458,11798,4684,12291
231090,202108,4648,11805,3433,9512,105,380,2335,6206,2440,6586
231095,202108,2320,6746,1844,5744,173,524,1205,3759,1378,4283
231100,202108,3358,9384,2745,8222,138,442,2058,6120,2196,6562
231110,202108,3781,10707,3463,10126,133,446,2610,7502,2743,7948
231120,202108,2438,6839,2030,6136,77,255,1477,4424,1554,4679
231123,202108,1978,5007,1658,4460,94,208,1192,3225,1286,3433
231126,202108,5669,15164,4647,13262,291,762,3339,9456,3630,10218
231130,202108,22475,55193,18656,50463,1081,3160,13885,37119,14966,40279
231135,202108,4283,11825,3550,10419,184,554,2507,7290,2691,7844
231140,202108,17032,46821,13751,41238,645,2256,9810,28776,10455,31032
231150,202108,6163,16267,4618,13348,630,1858,1980,5902,2610,7760
231160,202108,6482,19364,5772,18085,788,2310,3288,10661,4076,12971
231170,202108,4624,12899,3868,11488,250,751,2700,7794,2950,8545
231180,202108,14988,41192,12230,35558,2838,8034,4748,14100,7586,22134
231190,202108,4108,11240,3372,9927,70,253,2606,7539,2676,7792
231195,202108,5335,15315,4444,13549,270,853,3211,9745,3481,10598
231200,202108,7934,24083,6934,22093,174,835,5515,17057,5689,17892
231210,202108,5056,14373,4301,13120,150,515,3324,9935,3474,10450
231220,202108,12979,32238,10233,27219,511,1331,7492,19347,8003,20678
231230,202108,9317,29273,8226,27259,577,2088,5966,19872,6543,21960
231240,202108,11893,33819,10475,31190,1701,4812,6191,18771,7892,23583
231250,202108,2197,5476,1449,3862,113,314,859,2208,972,2522
231260,202108,3371,9178,2938,8491,276,730,1979,5902,2255,6632
231270,202108,6501,16647,5217,14537,154,557,3953,10724,4107,11281
231280,202108,1802,5453,1648,5176,91,263,1235,3870,1326,4133
231290,202108,38755,112770,32242,99923,5497,16753,14683,45154,20180,61907
231300,202108,4236,11357,3332,9589,157,498,2293,6431,2450,6929
231310,202108,7825,19414,6215,16506,542,1422,4223,10944,4765,12366
231320,202108,7875,21209,6128,18156,90,383,4868,14208,4958,14591
231325,202108,2571,6413,2111,5745,174,330,1476,4153,1650,4483
231330,202108,10057,28785,8367,25459,1618,4504,4394,14142,6012,18646
231335,202108,5795,15060,4919,13681,67,283,4333,11924,4400,12207
231340,202108,18777,55424,16940,52224,1193,3584,12769,39679,13962,43263
231350,202108,16149,43500,14737,41477,237,810,13270,37052,13507,37862
231355,202108,4513,13057,4072,12244,234,701,3183,9487,3417,10188
231360,202108,7934,23163,6873,21343,299,966,5440,16850,5739,17816
231370,202108,2228,6003,1779,5203,37,109,1354,3942,1391,4051
231375,202108,4364,13373,3986,12763,115,487,3343,10591,3458,11078
231380,202108,6183,16397,5584,15582,190,448,4566,12892,4756,13340
231390,202108,3533,9982,3177,9377,108,387,2373,6817,2481,7204
231395,202108,4295,12071,3578,10936,299,911,2327,7101,2626,8012
231400,202108,9947,28059,8321,25108,248,1048,6312,18648,6560,19696
231410,202108,15152,45852,13841,43714,668,2089,11157,35202,11825,37291
240010,202108,2653,6780,2064,5743,221,600,1202,3307,1423,3907
240020,202108,13104,35612,10943,31804,648,2173,7200,20688,7848,22861
240030,202108,3108,7223,2772,6726,111,296,2396,5757,2507,6053
240040,202108,852,2405,724,2166,30,110,495,1426,525,1536
240050,202108,3465,9045,2786,7833,49,129,2130,5882,2179,6011
240060,202108,1447,3775,1176,3283,20,69,958,2613,978,2682
240070,202108,2261,6304,2028,5808,202,574,1463,4099,1665,4673
240080,202108,3003,7927,2424,6913,68,231,1823,5133,1891,5364
240090,202108,2313,5624,1886,4918,16,42,1574,4055,1590,4097
240100,202108,10637,25451,8471,21662,189,539,6679,16500,6868,17039
240110,202108,4628,12900,3867,11513,178,635,2838,8270,3016,8905
240120,202108,3473,9409,2825,8610,188,582,2022,6292,2210,6874
240130,202108,3822,7690,3151,6832,30,66,2880,6180,2910,6246
240140,202108,1803,5341,1549,4852,164,552,1042,3237,1206,3789
240145,202108,6798,18462,5536,16314,857,2565,3154,9399,4011,11964
240150,202108,992,2790,872,2550,50,147,672,1925,722,2072
240160,202108,1489,4387,1246,3934,35,132,942,2986,977,3118
240165,202108,1002,2666,833,2346,22,88,697,1918,719,2006
240170,202108,2745,7120,2308,6355,227,628,1516,4126,1743,4754
240180,202108,3074,8944,2446,7673,563,1691,1045,3496,1608,5187
240185,202108,1279,3880,1180,3709,56,190,988,3094,1044,3284
240190,202108,1097,3126,943,2873,19,75,795,2440,814,2515
240200,202108,11330,28039,9003,24121,930,2584,5091,13408,6021,15992
240210,202108,3394,8177,2754,7148,22,109,2323,5828,2345,5937
240220,202108,7483,22122,6730,20960,314,1292,5365,16498,5679,17790
240230,202108,5961,14847,4766,12896,233,564,3713,10126,3946,10690
240240,202108,1850,5234,1208,3773,114,368,413,1161,527,1529
240250,202108,3101,7868,2696,7309,68,199,2317,6228,2385,6427
240260,202108,14053,41070,12138,37887,1742,5054,7347,24248,9089,29302
240270,202108,2433,7027,2127,6511,116,342,1556,4911,1672,5253
240280,202108,1766,4369,1475,3899,62,144,1158,3042,1220,3186
240290,202108,1200,3446,976,2957,26,108,690,1975,716,2083
240300,202108,2382,5942,1716,4739,76,209,1059,2873,1135,3082
240310,202108,8630,22496,6791,19237,900,2670,3434,9552,4334,12222
240320,202108,2129,5643,1542,4510,31,128,1162,3251,1193,3379
240325,202108,32795,85227,26206,73952,4286,12347,12167,34161,16453,46508
240330,202108,1845,4919,1415,4109,56,184,979,2714,1035,2898
240340,202108,2021,4568,1644,4009,54,120,1353,3244,1407,3364
240350,202108,2306,5670,2055,5388,37,92,1860,4903,1897,4995
240360,202108,10000,26646,8843,24848,966,2617,5984,17119,6950,19736
240370,202108,2072,5193,1603,4263,65,173,1134,2926,1199,3099
240375,202108,955,2350,796,2079,26,87,628,1581,654,1668
240380,202108,2278,6384,1697,5111,146,401,956,2872,1102,3273
240390,202108,1080,2538,775,1978,24,43,498,1189,522,1232
240400,202108,1561,3702,1197,3086,35,114,847,2050,882,2164
240410,202108,607,1742,496,1528,44,153,313,914,357,1067
240420,202108,4781,16113,4230,14933,458,1817,2572,8923,3030,10740
240430,202108,3580,8911,2962,7851,172,516,2215,5692,2387,6208
240440,202108,2592,5623,2200,5074,145,277,1749,4068,1894,4345
240450,202108,4685,12402,3678,10546,360,1028,2126,5884,2486,6912
240460,202108,3161,8540,2810,7976,240,708,2213,6266,2453,6974
240470,202108,3667,10920,2761,9030,652,1977,1154,4049,1806,6026
240480,202108,612,1619,412,1184,33,85,193,534,226,619
240485,202108,2274,6145,1836,5376,124,340,1251,3691,1375,4031
240490,202108,1667,4163,1304,3507,84,174,934,2550,1018,2724
240500,202108,2215,5883,1912,5356,109,288,1522,4286,1631,4574
240510,202108,1739,4540,1504,4184,83,255,1189,3274,1272,3529
240520,202108,1578,3673,1207,3176,83,188,875,2396,958,2584
240530,202108,2369,6289,2124,5913,96,277,1760,4826,1856,5103
240540,202108,2407,5828,2120,5388,64,109,1823,4668,1887,4777
240550,202108,738,1979,665,1838,15,62,570,1526,585,1588
240560,202108,3329,8461,2814,7781,276,658,2031,5779,2307,6437
240570,202108,2903,7422,1954,5386,306,813,675,1769,981,2582
240580,202108,8062,23437,7119,21707,610,1714,5589,17284,6199,18998
240590,202108,813,1950,715,1796,8,24,573,1404,581,1428
240600,202108,1876,4951,1380,3953,43,121,924,2552,967,2673
240610,202108,4358,11325,3734,10228,118,349,2887,7752,3005,8101
240615,202108,1295,3270,1045,2835,116,299,705,1889,821,2188
240620,202108,1882,5116,1618,4675,113,277,1275,3713,1388,3990
240630,202108,2115,5769,1904,5413,137,279,1347,4005,1484,4284
240640,202108,989,2576,787,2247,27,93,578,1619,605,1712
240650,202108,4180,11475,3569,10243,240,640,2649,7553,2889,8193
240660,202108,3118,7844,2770,7404,63,175,2504,6716,2567,6891
240670,202108,2560,6974,2055,5957,144,424,1340,3793,1484,4217
240680,202108,1667,4316,1352,3791,76,204,991,2713,1067,2917
240690,202108,1076,2596,846,2217,15,61,682,1715,697,1776
240700,202108,2556,7223,2084,6354,78,250,1583,4775,1661,5025
240710,202108,16833,42255,14166,37793,1675,4351,9091,24082,10766,28433
240720,202108,5367,12879,4622,11843,471,1164,3340,8540,3811,9704
240725,202108,1180,3259,899,2730,38,113,607,1786,645,1899
240730,202108,2356,6383,1879,5448,51,163,1434,4098,1485,4261
240740,202108,1939,5130,1561,4384,50,173,1143,3052,1193,3225
240750,202108,2209,7065,1871,6352,238,836,1048,3611,1286,4447
240760,202108,1743,3865,1258,3145,74,99,970,2482,1044,2581
240770,202108,3288,8952,2775,8217,126,431,2252,6606,2378,7037
240780,202108,4724,12994,3899,11622,551,1596,2362,7261,2913,8857
240790,202108,913,2498,756,2208,15,62,573,1617,588,1679
240800,202108,51305,119333,39946,102384,5141,13108,21077,53998,26218,67106
240810,202108,94664,237486,80440,214511,8562,23521,53212,139227,61774,162748
240820,202108,6046,17465,5230,15998,701,2074,3235,10086,3936,12160
240830,202108,8876,24834,7860,23338,242,919,6492,19097,6734,20016
240840,202108,1122,2731,895,2372,25,63,646,1654,671,1717
240850,202108,1472,3908,1037,2987,64,181,572,1595,636,1776
240860,202108,1393,3597,1048,2989,13,56,809,2203,822,2259
240870,202108,1114,2764,841,2309,145,411,447,1259,592,1670
240880,202108,1327,4103,1168,3797,75,305,873,2770,948,3075
240890,202108,4579,12272,3514,10292,463,1455,1799,5033,2262,6488
240895,202108,2967,8861,2727,8479,209,601,2211,7021,2420,7622
240910,202108,3626,9461,3066,8482,48,160,2517,6822,2565,6982
240920,202108,1037,2616,829,2294,98,195,457,1359,555,1554
240930,202108,3768,8358,3103,7546,237,340,2251,5873,2488,6213
240933,202108,1712,4159,1448,3784,35,130,1264,3250,1299,3380
240940,202108,6202,15088,4839,12734,572,1466,2771,7156,3343,8622
240950,202108,1131,3257,985,2989,30,118,797,2354,827,2472
240960,202108,695,2100,623,1955,21,63,488,1511,509,1574
240970,202108,1911,4843,1532,4196,60,215,1251,3333,1311,3548
240980,202108,3392,9869,2997,9174,101,441,2445,7336,2546,7777
240990,202108,2712,7349,2395,6764,237,736,1710,4644,1947,5380
241000,202108,969,2479,762,2111,28,68,571,1548,599,1616
241010,202108,2911,8974,2640,8409,171,597,1943,6130,2114,6727
241020,202108,2230,5754,1690,4706,96,264,1154,3107,1250,3371
241025,202108,1834,5119,1468,4462,38,157,1073,3192,1111,3349
241030,202108,2516,7772,2023,6730,241,791,1274,4269,1515,5060
241040,202108,2317,7120,2022,6604,78,364,1588,5142,1666,5506
241050,202108,1432,3912,1165,3427,33,116,851,2428,884,2544
241060,202108,802,2183,698,1973,34,93,487,1339,521,1432
241070,202108,708,1849,603,1678,13,36,469,1262,482,1298
241080,202108,1140,3192,875,2655,31,99,622,1865,653,1964
241090,202108,2024,5799,1653,5162,52,227,1295,3995,1347,4222
241100,202108,1237,3335,944,2746,68,182,607,1725,675,1907
241105,202108,965,2873,788,2544,240,769,263,867,503,1636
241110,202108,1025,2784,769,2255,40,109,508,1443,548,1552
241120,202108,7807,21731,6586,19617,877,2524,3955,12152,4832,14676
241140,202108,3481,8990,2683,7416,142,395,1945,5258,2087,5653
241142,202108,810,2146,599,1752,28,87,354,990,382,1077
241150,202108,6189,15500,5476,14379,178,426,4417,11501,4595,11927
241160,202108,1221,3260,966,2795,145,428,584,1634,729,2062
241170,202108,1426,3515,1205,3135,36,113,985,2467,1021,2580
241180,202108,1094,2748,820,2228,97,263,393,1071,490,1334
241190,202108,1204,3077,1004,2680,14,61,741,1899,755,1960
241200,202108,20739,52445,17935,47904,2740,7224,10483,27931,13223,35155
241210,202108,1500,3884,1079,3065,106,322,617,1715,723,2037
241220,202108,9527,26709,8356,24777,1719,5065,4104,12577,5823,17642
241230,202108,2992,7767,2644,7229,119,325,2175,5904,2294,6229
241240,202108,1291,3522,825,2523,80,251,323,991,403,1242
241250,202108,5806,16160,4659,14054,162,652,3441,10013,3603,10665
241255,202108,2409,7200,2128,6642,131,444,1601,4912,1732,5356
241260,202108,5128,12984,4090,11290,105,362,3257,8813,3362,9175
241270,202108,1701,4862,1417,4329,110,339,1002,3080,1112,3419
241280,202108,2270,5537,1949,4967,71,169,1650,4143,1721,4312
241290,202108,3417,8242,2515,6800,75,219,1962,5183,2037,5402
241300,202108,1575,4098,1273,3580,32,100,865,2371,897,2471
241310,202108,2228,5367,1922,4936,22,56,1672,4345,1694,4401
241320,202108,970,3084,831,2822,82,331,532,1795,614,2126
241330,202108,1819,4561,1433,4048,16,88,1258,3529,1274,3617
241335,202108,3490,9458,3058,8682,123,373,2490,6981,2613,7354
241340,202108,1613,4417,1266,3720,237,758,553,1548,790,2306
241350,202108,2232,5993,1947,5484,117,308,1504,4223,1621,4531
241355,202108,1369,3620,1115,3136,12,30,849,2353,861,2383
241360,202108,2108,5341,1585,4301,40,100,1179,3123,1219,3223
241370,202108,1432,3799,1115,3158,55,155,793,2178,848,2333
241380,202108,717,1893,556,1594,78,197,275,806,353,1003
241390,202108,2759,7917,2457,7470,199,506,1860,5795,2059,6301
241400,202108,3703,10051,3284,9423,159,503,2614,7458,2773,7961
241410,202108,2529,7304,2054,6337,310,987,1115,3449,1425,4436
241415,202108,1745,4944,1455,4393,49,161,1080,3208,1129,3369
241420,202108,2519,7503,2180,6939,441,1513,1193,3795,1634,5308
241430,202108,636,1668,445,1269,15,42,290,791,305,833
241440,202108,8088,23910,7231,22418,338,1117,5751,17833,6089,18950
241445,202108,1253,3019,1089,2804,37,71,936,2510,973,2581
241450,202108,2921,6868,2450,6132,369,769,1639,4255,2008,5024
241460,202108,4054,10671,3268,9066,212,525,2218,6053,2430,6578
241470,202108,1437,3750,1181,3368,24,80,973,2771,997,2851
241475,202108,1293,3486,1028,2986,21,95,778,2146,799,2241
241480,202108,3122,9438,2561,8234,777,2493,802,2885,1579,5378
241490,202108,685,1582,538,1377,20,43,411,1038,431,1081
241500,202108,811,2221,731,2120,3,10,690,2017,693,2027
250010,202108,2706,7858,2270,6966,53,190,1671,5015,1724,5205
250020,202108,1718,4430,1252,3548,58,99,882,2517,940,2616
250030,202108,7120,19085,6279,17785,564,1546,4640,13082,5204,14628
250040,202108,4290,12455,3717,11427,343,1026,2647,8040,2990,9066
250050,202108,3697,9667,3340,9203,90,321,2819,7747,2909,8068
250053,202108,1251,3380,1145,3216,83,209,843,2378,926,2587
250057,202108,709,2352,653,2269,9,37,598,2104,607,2141
250060,202108,5758,14539,5190,13836,291,713,4310,11591,4601,12304
250070,202108,4197,11326,3523,10179,23,87,2856,8066,2879,8153
250073,202108,797,2057,647,1825,13,28,515,1436,528,1464
250077,202108,2395,6070,1817,5148,56,177,1414,3956,1470,4133
250080,202108,5335,12654,4492,11603,59,205,3985,10153,4044,10358
250090,202108,3534,8245,3077,7642,59,147,2660,6502,2719,6649
250100,202108,3714,10942,3332,10257,156,493,2608,7896,2764,8389
250110,202108,4955,13645,4472,12966,265,896,3466,9919,3731,10815
250115,202108,756,1852,558,1553,12,49,424,1154,436,1203
250120,202108,1914,5419,1600,4904,23,114,1278,3880,1301,3994
250130,202108,5745,15273,4846,13995,64,335,4148,11822,4212,12157
250135,202108,1248,3362,1086,3089,15,49,958,2726,973,2775
250140,202108,2367,6680,2199,6477,106,376,1903,5606,2009,5982
250150,202108,4831,14685,4322,13822,131,516,3478,10961,3609,11477
250153,202108,1404,3647,1160,3290,38,94,911,2574,949,2668
250157,202108,1915,5377,1722,5035,60,204,1385,3988,1445,4192
250160,202108,4018,9703,3201,8610,44,145,2787,7503,2831,7648
250170,202108,1913,4867,1721,4598,24,86,1494,3935,1518,4021
250180,202108,21510,50022,18391,46079,708,2025,14688,35919,15396,37944
250190,202108,4235,10979,3563,10001,311,901,2528,6973,2839,7874
250200,202108,2100,5321,1790,4912,72,173,1484,4108,1556,4281
250205,202108,891,2687,769,2502,9,39,628,2024,637,2063
250210,202108,1583,4662,1433,4432,49,202,1142,3467,1191,3669
250215,202108,1667,4381,1396,4003,79,232,804,2357,883,2589
250220,202108,680,1851,539,1634,23,81,361,1079,384,1160
250230,202108,1742,3837,1224,3075,21,59,981,2416,1002,2475
250240,202108,2503,7232,2201,6704,33,140,1891,5678,1924,5818
250250,202108,4719,12793,4125,11946,92,273,3512,10241,3604,10514
250260,202108,1715,4699,1451,4243,54,124,1141,3335,1195,3459
250270,202108,1227,3655,1118,3519,56,193,845,2743,901,2936
250280,202108,3621,9443,3231,8891,156,349,2541,7050,2697,7399
250290,202108,1562,4080,1339,3755,17,51,1071,2982,1088,3033
250300,202108,5605,14579,5035,13909,152,647,4272,11435,4424,12082
250310,202108,1215,3319,1012,2979,38,120,762,2232,800,2352
250320,202108,12796,27856,11043,25864,256,666,9961,23048,10217,23714
250330,202108,2449,6584,2060,6046,196,441,1580,4761,1776,5202
250340,202108,1190,2933,1053,2757,13,34,963,2512,976,2546
250350,202108,4295,11792,3773,10896,222,468,2953,8832,3175,9300
250355,202108,2096,6109,1878,5818,26,132,1695,5244,1721,5376
250360,202108,1840,4908,1651,4657,36,120,1401,3905,1437,4025
250370,202108,14273,35349,11864,31753,227,747,10069,26525,10296,27272
250375,202108,1229,3102,989,2816,4,17,932,2671,936,2688
250380,202108,1679,4196,1541,4024,34,119,1364,3467,1398,3586
250390,202108,1910,4760,1608,4297,72,187,1296,3437,1368,3624
250400,202108,71345,172337,52804,143999,14485,42915,13875,40392,28360,83307
250403,202108,1846,4998,1650,4771,63,319,1305,3593,1368,3912
250407,202108,1388,3248,1077,2799,107,217,672,1908,779,2125
250410,202108,686,1779,585,1615,7,15,483,1300,490,1315
250415,202108,1937,5273,1691,4893,29,130,1454,4183,1483,4313
250420,202108,1235,3322,1107,3147,24,80,1002,2835,1026,2915
250430,202108,6396,15507,5427,14241,153,425,4447,11452,4600,11877
250435,202108,1603,4436,1286,3905,10,41,980,2927,990,2968
250440,202108,4747,12294,4115,11497,79,175,3639,10172,3718,10347
250450,202108,1848,4818,1520,4369,33,110,1246,3605,1279,3715
250460,202108,7476,19837,6653,18643,409,1167,5279,14782,5688,15949
250470,202108,1576,4030,1297,3595,49,154,1028,2796,1077,2950
250480,202108,4055,10851,3440,10106,37,121,3043,9025,3080,9146
250485,202108,755,1654,564,1388,50,82,393,952,443,1034
250490,202108,5302,12308,4721,11646,159,429,4195,10184,4354,10613
250500,202108,2070,5606,1849,5229,59,146,1500,4248,1559,4394
250510,202108,5578,13724,4806,12694,75,155,4192,11181,4267,11336
250520,202108,1939,5073,1659,4688,110,320,1216,3411,1326,3731
250523,202108,2223,5437,1953,5083,71,272,1631,4098,1702,4370
250527,202108,1696,4261,1528,4075,23,62,1352,3628,1375,3690
250530,202108,665,1669,571,1529,16,41,501,1344,517,1385
250535,202108,1430,4037,1286,3776,22,84,1032,2946,1054,3030
250540,202108,3150,6958,2625,6374,80,143,2308,5723,2388,5866
250550,202108,796,2505,703,2323,20,66,520,1705,540,1771
250560,202108,1804,4875,1581,4559,40,133,1338,3785,1378,3918
250570,202108,2797,8063,2399,7353,82,266,1874,5681,1956,5947
250580,202108,1083,2777,953,2598,45,158,804,2137,849,2295
250590,202108,896,2341,795,2197,19,54,667,1829,686,1883
250600,202108,8285,21228,6887,19377,244,730,5513,15416,5757,16146
250610,202108,3011,8397,2689,7924,103,362,2233,6523,2336,6885
250620,202108,866,2198,743,1993,17,44,530,1410,547,1454
250625,202108,2465,7012,2200,6578,40,190,1879,5485,1919,5675
250630,202108,10774,28744,8824,25430,939,2722,5678,16011,6617,18733
250640,202108,3666,9646,3280,9141,79,302,2871,7896,2950,8198
250650,202108,1024,2393,857,2169,15,39,748,1863,763,1902
250660,202108,1688,4106,1348,3641,46,105,1097,2891,1143,2996
250670,202108,2422,7355,2205,6981,36,154,1925,5981,1961,6135
250680,202108,6039,13736,5401,13023,51,194,5045,11990,5096,12184
250690,202108,6901,15355,5801,14000,107,228,5104,12273,5211,12501
250700,202108,4457,12333,3877,11458,572,1636,2461,7374,3033,9010
250710,202108,4460,12619,3892,11808,274,819,2838,8655,3112,9474
250720,202108,2891,7569,2591,7147,28,140,2328,6358,2356,6498
250730,202108,4291,11143,3763,10447,114,419,3147,8515,3261,8934
250740,202108,2034,4914,1681,4453,99,220,1309,3504,1408,3724
250750,202108,111654,267163,94959,243847,7531,20090,69320,175066,76851,195156
250760,202108,2440,6074,2133,5581,67,176,1749,4471,1816,4647
250770,202108,4182,12235,3746,11656,479,1342,2590,8327,3069,9669
250780,202108,1821,4781,1535,4277,65,197,1193,3255,1258,3452
250790,202108,2602,7438,2255,6923,89,355,1658,4974,1747,5329
250800,202108,2497,6470,2190,5978,103,198,1764,4896,1867,5094
250810,202108,1326,3399,1112,3098,41,75,923,2632,964,2707
250820,202108,2004,5492,1840,5312,28,113,1668,4790,1696,4903
250830,202108,6149,18001,5031,15735,264,934,3361,10209,3625,11143
250840,202108,776,2434,670,2227,18,67,505,1692,523,1759
250850,202108,1839,5296,1646,4952,32,119,1367,4025,1399,4144
250855,202108,1060,2936,916,2708,55,174,710,2093,765,2267
250860,202108,3411,9772,2815,8765,476,1446,1554,4947,2030,6393
250870,202108,1054,2838,898,2586,42,134,723,2060,765,2194
250880,202108,1656,4181,1375,3765,88,255,1048,2862,1136,3117
250890,202108,10695,26529,9435,24878,429,1400,7597,19258,8026,20658
250900,202108,3094,8071,2678,7350,98,218,2252,6140,2350,6358
250905,202108,2609,7016,2409,6742,37,125,2217,6201,2254,6326
250910,202108,6359,15217,5263,13981,63,181,4620,12329,4683,12510
250915,202108,2203,5015,1542,4302,26,53,1350,3860,1376,3913
250920,202108,3663,9083,3226,8422,273,612,2483,6485,2756,7097
250930,202108,2374,6251,2137,5946,45,191,1852,5027,1897,5218
250933,202108,1236,3570,1097,3321,25,103,872,2587,897,2690
250937,202108,750,1996,629,1801,22,74,493,1432,515,1506
250939,202108,1912,4859,1675,4561,59,139,1318,3597,1377,3736
250940,202108,4112,10720,3606,10058,23,74,3233,9025,3256,9099
250950,202108,1793,4530,1446,4076,28,103,1177,3267,1205,3370
250960,202108,1140,3303,1002,3083,25,116,817,2441,842,2557
250970,202108,8436,21334,7406,19681,208,618,6092,15883,6300,16501
250980,202108,2438,6378,2205,6046,24,109,1932,5169,1956,5278
250990,202108,2110,6232,1769,5651,56,217,1327,4195,1383,4412
251000,202108,2081,5786,1683,5101,33,135,1373,4144,1406,4279
251010,202108,2764,7510,2507,7113,24,87,2247,6388,2271,6475
251020,202108,1673,4501,1498,4223,30,126,1299,3596,1329,3722
251030,202108,1068,2776,875,2443,48,120,586,1633,634,1753
251040,202108,1901,5153,1604,4657,27,121,1337,3852,1364,3973
251050,202108,1074,2904,904,2582,45,147,647,1776,692,1923
251060,202108,1111,2322,842,1985,12,34,640,1496,652,1530
251065,202108,498,1332,380,1114,8,23,265,749,273,772
251070,202108,765,1920,637,1736,8,31,548,1451,556,1482
251080,202108,19433,48136,15738,42595,2278,6257,9359,25786,11637,32043
251090,202108,2918,8203,2463,7408,58,174,1941,5815,1999,5989
251100,202108,833,2598,736,2408,24,84,579,1831,603,1915
251110,202108,1805,4664,1525,4176,70,150,1156,3176,1226,3326
251120,202108,7973,21279,6719,19757,330,1057,5213,15468,5543,16525
251130,202108,4005,8700,3516,8148,50,131,3216,7405,3266,7536
251140,202108,4455,12134,3965,11447,69,260,3291,9412,3360,9672
251150,202108,2712,7672,2474,7286,67,291,2118,6088,2185,6379
251160,202108,2261,6451,1954,6000,30,135,1681,5060,1711,5195
251170,202108,1666,4372,1460,4108,20,65,1309,3656,1329,3721
251180,202108,2708,7083,2220,6399,147,407,1558,4510,1705,4917
251190,202108,4552,11668,4109,11166,36,190,3741,9976,3777,10166
251200,202108,4498,12834,3964,12160,68,265,3489,10735,3557,11000
251203,202108,1008,3166,920,2962,22,86,691,2160,713,2246
251207,202108,1151,3045,870,2596,16,69,605,1765,621,1834
251210,202108,8069,19724,6599,17736,339,689,4932,13618,5271,14307
251220,202108,1309,3024,981,2596,74,146,721,1984,795,2130
251230,202108,4854,13217,4183,12019,115,356,3295,9252,3410,9608
251240,202108,3735,10174,3135,9158,182,457,2314,6749,2496,7206
251250,202108,11068,28893,9695,26562,678,1854,7244,19344,7922,21198
251260,202108,518,1409,468,1327,13,53,375,1031,388,1084
251270,202108,4378,13364,3922,12741,108,405,3195,10601,3303,11006
251272,202108,1338,3627,1222,3474,63,201,1012,2828,1075,3029
251274,202108,928,2538,742,2196,57,185,489,1386,546,1571
251275,202108,1251,3473,1060,3160,28,112,835,2421,863,2533
251276,202108,1351,3637,1174,3399,24,118,959,2692,983,2810
251278,202108,626,1666,563,1573,40,106,434,1223,474,1329
251280,202108,2302,6103,2096,5801,54,141,1762,4852,1816,4993
251290,202108,6413,14328,5831,13628,178,484,5156,11756,5334,12240
251300,202108,904,2608,816,2474,9,46,692,2084,701,2130
251310,202108,2893,7911,2521,7352,36,173,2095,5985,2131,6158
251315,202108,1818,5505,1646,5171,125,338,1228,3854,1353,4192
251320,202108,1664,4349,1223,3584,29,96,916,2639,945,2735
251330,202108,2158,4969,1782,4525,25,73,1586,4062,1611,4135
251335,202108,1136,3141,1016,2961,22,95,894,2554,916,2649
251340,202108,3841,8980,3069,7966,129,328,2352,6128,2481,6456
251350,202108,1091,3038,995,2880,30,91,816,2338,846,2429
251360,202108,1910,5205,1537,4676,11,63,1267,3854,1278,3917
251365,202108,775,2023,607,1701,5,14,486,1342,491,1356
251370,202108,25640,65887,21917,60633,3374,9078,12386,35656,15760,44734
251380,202108,1313,3543,1117,3215,13,77,960,2699,973,2776
251385,202108,793,1990,614,1669,22,58,454,1196,476,1254
251390,202108,6622,18784,5840,17570,541,1589,3867,11787,4408,13376
251392,202108,1018,2725,860,2484,27,106,675,1920,702,2026
251394,202108,649,1817,523,1601,36,105,370,1128,406,1233
251396,202108,670,1799,567,1617,17,45,390,1097,407,1142
251398,202108,1049,2587,742,2053,17,51,551,1491,568,1542
251400,202108,1339,3089,1052,2702,22,79,856,2129,878,2208
251410,202108,1601,3684,1288,3242,21,79,1090,2640,1111,2719
251420,202108,2039,5208,1673,4770,35,114,1343,3795,1378,3909
251430,202108,1597,4727,1435,4447,31,140,1235,3809,1266,3949
251440,202108,1119,3072,906,2677,43,96,698,2112,741,2208
251445,202108,1591,4360,1465,4183,30,87,1259,3555,1289,3642
251450,202108,4461,13007,3989,12282,77,285,3332,10189,3409,10474
251455,202108,889,2634,812,2492,16,63,656,1968,672,2031
251460,202108,992,2747,839,2512,15,46,693,2085,708,2131
251465,202108,476,1349,408,1220,7,28,307,892,314,920
251470,202108,1217,3277,917,2675,76,227,528,1481,604,1708
251480,202108,1054,2696,862,2362,13,47,668,1754,681,1801
251490,202108,1989,5110,1592,4558,77,204,1178,3411,1255,3615
251500,202108,2034,5567,1865,5357,39,139,1683,4824,1722,4963
251510,202108,2758,8029,2304,7141,121,383,1579,4789,1700,5172
251520,202108,1069,2677,828,2249,72,177,533,1417,605,1594
251530,202108,15124,35502,12198,31877,85,457,10846,27870,10931,28327
251540,202108,3151,8706,2831,8140,69,243,2402,6814,2471,7057
251550,202108,4007,9099,3204,8132,136,213,2638,6814,2774,7027
251560,202108,567,1704,506,1610,53,177,353,1090,406,1267
251570,202108,970,2685,794,2337,21,93,636,1825,657,1918
251580,202108,2027,4778,1824,4489,32,112,1573,3739,1605,3851
251590,202108,1647,3961,1391,3661,69,164,1151,2999,1220,3163
251593,202108,956,2749,860,2585,88,258,555,1665,643,1923
251597,202108,2146,5949,1925,5655,19,87,1725,5016,1744,5103
251600,202108,6518,17213,5677,15930,205,563,4638,12884,4843,13447
251610,202108,3190,8992,2755,8191,255,673,1863,5676,2118,6349
251615,202108,1346,3254,1081,2857,23,64,875,2242,898,2306
251620,202108,19788,44161,15171,38519,78,261,13130,33638,13208,33899
251630,202108,4955,11328,3978,9974,205,496,2975,7412,3180,7908
251640,202108,2306,6040,2061,5667,21,94,1850,4983,1871,5077
251650,202108,4067,10713,3528,10013,130,376,2973,8452,3103,8828
251660,202108,3664,10653,3239,9925,57,238,2701,8162,2758,8400
251670,202108,4234,11585,3739,10888,38,181,3359,9713,3397,9894
251675,202108,714,1887,644,1803,94,234,439,1259,533,1493
251680,202108,2671,6782,2235,6220,43,131,1845,5169,1888,5300
251690,202108,3210,8859,2736,8051,77,219,2082,6102,2159,6321
251700,202108,2283,6179,1902,5711,39,151,1611,4749,1650,4900
251710,202108,812,2047,574,1572,35,111,337,863,372,974
251720,202108,1354,3755,1095,3312,19,82,851,2494,870,2576
251740,202108,612,1692,486,1456,41,148,325,934,366,1082
260005,202108,30608,63755,25252,56898,1877,4050,19160,42429,21037,46479
260010,202108,10651,27194,8795,24228,477,1323,5225,14515,5702,15838
260020,202108,7080,16156,5924,14518,67,285,5068,12172,5135,12457
260030,202108,7075,17638,5960,16032,125,367,4871,13010,4996,13377
260040,202108,7929,19503,6680,17742,436,1113,4867,13145,5303,14258
260050,202108,14338,36509,11930,33856,230,677,10953,31277,11183,31954
260060,202108,4338,10292,3727,9331,298,592,2796,7188,3094,7780
260070,202108,11063,27010,9487,24774,340,1090,7682,19576,8022,20666
260080,202108,6636,14961,5768,13811,111,315,4848,11431,4959,11746
260090,202108,4819,12106,4301,11400,379,987,3245,8645,3624,9632
260100,202108,3055,8122,2568,7397,32,169,2163,6137,2195,6306
260105,202108,5113,13765,4584,13054,123,386,3894,10961,4017,11347
260110,202108,22741,62128,20244,58517,851,2785,16808,47962,17659,50747
260120,202108,14919,38458,12589,35075,1445,3848,8117,22997,9562,26845
260130,202108,3268,8047,2891,7506,230,538,2157,5548,2387,6086
260140,202108,13226,29166,11383,27000,498,1311,9667,22576,10165,23887
260150,202108,3620,8291,3132,7691,92,210,2756,6748,2848,6958
260160,202108,6700,17068,5681,15834,95,303,5157,14489,5252,14792
260170,202108,21393,48957,18182,44622,945,2234,14517,35291,15462,37525
260180,202108,3645,9392,3148,8721,66,226,2729,7453,2795,7679
260190,202108,18732,36951,15829,33555,202,461,14066,29312,14268,29773
260200,202108,11451,26800,9872,24794,527,1034,8248,21134,8775,22168
260210,202108,11758,32674,10005,29838,284,974,7989,23723,8273,24697
260220,202108,11096,25408,10230,24320,175,440,9120,21412,9295,21852
260230,202108,11102,26436,9648,24507,206,519,8160,20477,8366,20996
260240,202108,2850,8329,2490,7642,92,315,1920,5815,2012,6130
260250,202108,2328,5814,2027,5351,117,218,1592,4235,1709,4453
260260,202108,13122,33133,11674,30957,375,1121,9372,24453,9747,25574
260270,202108,4478,10505,3924,9860,99,354,3343,8273,3442,8627
260280,202108,13023,38282,11740,36457,405,1638,10052,30767,10457,32405
260290,202108,42688,104973,36700,96446,3876,10310,25054,65594,28930,75904
260300,202108,9866,26041,8597,24328,180,673,7310,20633,7490,21306
260310,202108,5637,13772,4968,12940,367,782,3810,10170,4177,10952
260320,202108,8034,22612,6818,20562,224,653,5581,16868,5805,17521
260330,202108,2652,7952,2317,7269,60,189,1848,5667,1908,5856
260340,202108,2123,5541,1841,5134,21,84,1618,4420,1639,4504
260345,202108,26763,66847,22362,60552,3376,9608,11865,31476,15241,41084
260350,202108,5827,13180,5032,12279,48,134,4534,10995,4582,11129
260360,202108,2645,6642,2380,6174,40,124,1731,4404,1771,4528
260370,202108,5724,15906,4927,14594,197,574,3831,11280,4028,11854
260380,202108,5177,14807,4439,13605,166,482,3383,10288,3549,10770
260390,202108,4837,14059,3990,12345,222,604,2684,8210,2906,8814
260392,202108,3583,11004,3240,10574,87,510,2695,8786,2782,9296
260400,202108,19576,43724,16883,40240,458,1148,13506,31032,13964,32180
260410,202108,77367,182090,60513,158865,10827,29437,26732,72633,37559,102070
260415,202108,4539,11752,3919,10777,41,160,3287,8886,3328,9046
260420,202108,12761,26312,10850,24205,85,243,10111,22373,10196,22616
260430,202108,2880,8642,2451,7811,131,420,1683,5322,1814,5742
260440,202108,3855,9612,3429,9001,65,204,2944,7614,3009,7818
260450,202108,5898,14473,5262,13647,289,545,4381,11584,4670,12129
260460,202108,5468,15611,4658,14212,476,1587,2839,8532,3315,10119
260470,202108,5004,12951,4219,12051,81,168,3867,11210,3948,11378
260480,202108,4216,10672,3556,9750,302,819,2421,6782,2723,7601
260490,202108,5454,12388,4835,11503,27,120,4425,10362,4452,10482
260500,202108,6239,15131,5334,13873,403,895,3794,10026,4197,10921
260510,202108,10256,24605,8598,22295,90,330,7585,19478,7675,19808
260515,202108,4606,11893,3619,10090,150,357,2508,6793,2658,7150
260520,202108,17169,38824,14958,36043,716,1644,12317,29356,13033,31000
260530,202108,10071,28358,8568,26060,109,506,7425,22311,7534,22817
260540,202108,7401,15907,6538,14825,134,291,5907,13322,6041,13613
260545,202108,73,222,49,164,3,12,21,67,24,79
260550,202108,3265,8647,2641,7637,137,420,1823,5168,1960,5588
260560,202108,6167,15455,5184,14031,113,402,4374,11646,4487,12048
260570,202108,8043,21011,7105,19753,339,972,5771,16088,6110,17060
260580,202108,4603,10740,4139,10133,24,72,3792,9236,3816,9308
260590,202108,7287,15779,6160,14545,217,451,5285,12579,5502,13030
260600,202108,32625,81800,26690,72915,1057,3027,20462,54786,21519,57813
260610,202108,7779,19484,6926,18367,435,1121,5183,13795,5618,14916
260620,202108,17574,43578,15420,40540,1254,3592,11397,29362,12651,32954
260630,202108,2469,6515,2016,5819,41,127,1640,4655,1681,4782
260640,202108,23024,50227,19435,46135,808,1890,15967,37642,16775,39532
260650,202108,6501,16276,5225,14732,515,870,4149,12253,4664,13123
260660,202108,7312,18429,6367,17196,243,759,5462,14529,5705,15288
260670,202108,2347,6002,1926,5331,81,212,1359,3662,1440,3874
260680,202108,30117,70208,25408,63610,1952,4924,17725,43711,19677,48635
260690,202108,3632,9236,3032,8310,69,248,2402,6543,2471,6791
260700,202108,6505,17599,6006,17034,20,69,5827,16601,5847,16670
260710,202108,1421,3606,1203,3283,31,111,951,2589,982,2700
260720,202108,27124,62752,22989,57592,2267,5360,16513,42096,18780,47456
260730,202108,8222,22698,7187,21275,235,737,6063,17750,6298,18487
260740,202108,1363,3825,1145,3469,15,69,903,2797,918,2866
260750,202108,7455,19828,6096,18175,243,485,5314,16378,5557,16863
260760,202108,6112,13732,5263,12746,160,377,4460,10825,4620,11202
260765,202108,8576,23700,7469,22181,356,1290,5378,15652,5734,16942
260770,202108,4046,10008,3350,8864,117,350,2655,6919,2772,7269
260775,202108,5479,14131,4798,13124,170,564,3814,10106,3984,10670
260780,202108,3846,11046,3437,10398,410,1269,2115,6296,2525,7565
260790,202108,126376,276174,104639,248401,15812,36078,64764,154448,80576,190526
260795,202108,3105,7647,2658,7080,91,269,2121,5699,2212,5968
260800,202108,5599,12583,5047,11842,184,478,4399,10012,4583,10490
260805,202108,3786,10321,3210,9341,205,620,2324,6704,2529,7324
260810,202108,6814,17772,6004,16264,439,1060,4470,11940,4909,13000
260820,202108,4666,10518,4154,9929,89,247,3484,8221,3573,8468
260825,202108,3081,8843,2711,8208,111,339,2049,6158,2160,6497
260830,202108,4333,12279,3591,10977,491,1280,2232,7115,2723,8395
260840,202108,4351,10949,3897,10338,232,519,3264,8718,3496,9237
260845,202108,4687,11910,4140,10994,255,697,3107,8083,3362,8780
260850,202108,5366,14120,4485,12494,344,1000,2899,7812,3243,8812
260860,202108,3489,9705,2992,8859,98,303,2417,7005,2515,7308
260870,202108,4603,10851,3949,10055,63,229,3535,8890,3598,9119
260875,202108,7692,18018,6262,15960,538,1285,4348,11228,4886,12513
260880,202108,9897,27258,8622,25120,431,1245,6792,19777,7223,21022
260890,202108,13427,33363,11655,30706,693,1829,8417,21694,9110,23523
260900,202108,5693,15226,4697,13838,293,872,3209,9425,3502,10297
260910,202108,3362,8901,2928,8254,105,286,2305,6465,2410,6751
260915,202108,5147,14888,4498,14126,47,204,4131,12997,4178,13201
260920,202108,3604,8288,3065,7703,122,224,2606,6660,2728,6884
260930,202108,4158,12152,3591,11158,165,567,2772,8406,2937,8973
260940,202108,15466,35801,13456,33033,1133,2718,10015,24276,11148,26994
260950,202108,7514,19336,6074,16909,356,1160,4016,10596,4372,11756
260960,202108,74824,161484,60491,143399,6226,14814,39503,92575,45729,107389
260970,202108,6033,15074,5356,14173,289,574,3962,10801,4251,11375
260980,202108,4732,13381,4152,12664,50,149,3796,11699,3846,11848
260990,202108,19032,49762,16118,45787,838,2263,12645,35668,13483,37931
261000,202108,17190,38900,14499,35544,419,1172,11756,28206,12175,29378
261010,202108,2406,6167,2112,5779,96,206,1813,5012,1909,5218
261020,202108,6718,16994,5844,15594,294,725,4795,12549,5089,13274
261030,202108,4177,11844,3672,10961,115,430,2927,8495,3042,8925
261040,202108,5619,15627,4590,13724,144,493,3536,10283,3680,10776
261050,202108,8374,20569,7597,19435,385,662,6039,15553,6424,16215
261060,202108,14772,35989,12888,33726,258,773,10852,28097,11110,28870
261070,202108,68953,146359,57226,131089,3338,7162,43492,97716,46830,104878
261080,202108,7024,16290,6382,15513,151,319,5901,14347,6052,14666
261090,202108,20325,46436,18066,43511,356,1002,15873,37636,16229,38638
261100,202108,8965,23433,7835,21788,524,1423,5870,16343,6394,17766
261110,202108,71261,192523,59877,172116,7919,23766,35747,101350,43666,125116
261120,202108,3746,9210,3249,8520,72,163,2812,7367,2884,7530
261130,202108,7582,18014,6658,16795,121,348,5886,14709,6007,15057
261140,202108,3856,8671,3440,8126,197,474,2707,6312,2904,6786
261150,202108,5394,13828,4766,12893,88,290,4116,11024,4204,11314
261153,202108,1979,5828,1661,5214,54,169,1117,3531,1171,3700
261160,202108,226031,507898,184173,451265,43788,110182,77533,193902,121321,304084
261170,202108,6727,15616,5931,14527,250,513,4957,12062,5207,12575
261180,202108,9799,23787,8547,22172,504,1161,6214,16362,6718,17523
261190,202108,4774,13451,4291,12679,138,602,3465,9933,3603,10535
261200,202108,3506,7818,3102,7286,198,462,2550,5913,2748,6375
261210,202108,1982,4715,1702,4321,76,187,1407,3520,1483,3707
261220,202108,14565,39323,12258,35232,1418,4258,7315,20638,8733,24896
261230,202108,4193,11644,3514,10732,36,127,2959,9133,2995,9260
261240,202108,5737,13671,5039,12600,331,712,4067,10151,4398,10863
261245,202108,3918,10562,3271,9439,69,305,2632,7314,2701,7619
261247,202108,3120,8948,2603,8036,145,437,1842,5643,1987,6080
261250,202108,24064,53008,20917,49372,2795,5924,14514,35699,17309,41623
261255,202108,4278,12150,3511,10675,130,490,2708,8043,2838,8533
261260,202108,13270,34613,11567,32412,299,1053,10119,28084,10418,29137
261270,202108,4697,11046,4102,10312,197,442,3388,8520,3585,8962
261280,202108,2598,7095,2280,6564,63,212,1815,5073,1878,5285
261290,202108,3023,7649,2524,7089,61,207,2053,5836,2114,6043
261300,202108,13193,35347,11290,32203,481,1655,8552,23766,9033,25421
261310,202108,9457,23035,8115,21237,584,1610,6080,15586,6664,17196
261320,202108,6270,17057,5451,15728,70,269,4670,13316,4740,13585
261330,202108,5881,14141,5304,13393,116,397,4631,11461,4747,11858
261340,202108,4424,11904,3852,11179,123,437,3241,9293,3364,9730
261350,202108,8959,25888,7905,24093,114,451,6429,19397,6543,19848
261360,202108,8455,19707,7140,17849,246,629,5743,13996,5989,14625
261370,202108,25067,60758,21033,55303,2410,5881,13506,36089,15916,41970
261380,202108,4298,12425,3801,11586,420,1351,2557,7728,2977,9079
261390,202108,17491,48204,14761,43874,1161,3686,9900,29126,11061,32812
261400,202108,4790,14662,4192,13388,208,733,3129,9790,3337,10523
261410,202108,10029,24262,8248,21571,362,1030,6664,16989,7026,18019
261420,202108,7690,22124,6943,21218,661,2253,5085,15505,5746,17758
261430,202108,3606,9816,3075,8988,48,190,2597,7472,2645,7662
261440,202108,1515,4389,1267,3931,49,205,908,2710,957,2915
261450,202108,15090,39965,13315,37296,166,563,10999,30953,11165,31516
261460,202108,7980,21080,6994,19568,291,819,5603,15667,5894,16486
261470,202108,4261,10367,3679,9568,32,121,3173,8207,3205,8328
261480,202108,5405,15926,4656,14672,218,765,3618,11230,3836,11995
261485,202108,5228,14288,4547,13256,357,1100,3365,9705,3722,10805
261500,202108,6318,15578,5510,14489,409,891,3803,10461,4212,11352
261510,202108,1949,5652,1696,5240,58,206,1296,4031,1354,4237
261520,202108,2398,7184,2157,6704,61,193,1600,4952,1661,5145
261530,202108,12698,35551,10319,31371,828,2859,5550,16132,6378,18991
261540,202108,8827,24113,7984,22937,1271,3405,4437,13632,5708,17037
261550,202108,3827,9919,3314,9131,256,715,2373,6419,2629,7134
261560,202108,8307,23494,7230,21909,299,985,5685,17209,5984,18194
261570,202108,3607,9555,2871,8360,172,565,1987,5709,2159,6274
261580,202108,7049,18080,6095,16780,91,408,5504,14957,5595,15365
261590,202108,2814,7000,2293,6268,75,227,1733,4698,1808,4925
261600,202108,5546,13265,4719,12078,284,579,3398,8857,3682,9436
261610,202108,2194,6216,1764,5426,124,434,1149,3518,1273,3952
261618,202108,2630,6328,2301,5860,80,183,1861,4704,1941,4887
261620,202108,4303,11874,3913,11297,759,1927,2546,7689,3305,9616
261630,202108,6283,17409,5330,15618,371,1217,3535,9981,3906,11198
261640,202108,38968,84786,33229,77813,1994,3474,25101,60886,27095,64360
261650,202108,4360,10400,3706,9571,178,437,2820,7268,2998,7705
270010,202108,4545,14785,3936,13751,121,670,3189,10839,3310,11509
270020,202108,4060,9899,3565,9278,127,387,3064,7794,3191,8181
270030,202108,35324,93843,29510,84587,3278,9282,20315,58002,23593,67284
270040,202108,11299,28896,9729,27031,382,1132,8198,22680,8580,23812
270050,202108,5695,12919,4847,11961,390,708,4069,10334,4459,11042
270060,202108,2332,5782,1956,5343,175,407,1518,4235,1693,4642
270070,202108,4823,13256,4186,12375,106,380,3528,10244,3634,10624
270080,202108,1499,4014,1269,3630,45,130,986,2734,1031,2864
270090,202108,1832,5438,1646,5083,43,163,1386,4193,1429,4356
270100,202108,5875,14557,5087,13425,206,589,4260,11047,4466,11636
270110,202108,3404,7623,2770,6901,149,287,2201,5779,2350,6066
270120,202108,2713,7357,2357,6872,68,264,1980,5674,2048,5938
270130,202108,5267,13238,4574,12396,163,475,3902,10599,4065,11074
270135,202108,2076,4897,1757,4543,29,96,1622,4160,1651,4256
270140,202108,9911,22825,7972,20154,361,1023,6218,15041,6579,16064
270150,202108,2706,8103,2462,7755,4,21,2321,7297,2325,7318
270160,202108,6226,16576,5319,15538,113,382,4878,14309,4991,14691
270170,202108,3457,9885,2905,9123,162,701,2209,6668,2371,7369
270180,202108,2321,7070,2129,6832,38,183,1931,6130,1969,6313
270190,202108,1800,5062,1598,4819,22,102,1450,4349,1472,4451
270200,202108,2566,7579,2230,7107,96,294,1667,5323,1763,5617
270210,202108,5930,13616,5051,12615,57,197,4669,11509,4726,11706
270220,202108,1706,4279,1359,3782,179,497,859,2358,1038,2855
270230,202108,9791,26099,8187,23651,818,2380,5787,16772,6605,19152
270235,202108,6129,18316,5307,17009,141,457,4452,14185,4593,14642
270240,202108,11600,30451,9567,27678,940,2727,6839,20008,7779,22735
270250,202108,2977,7148,2628,6657,187,423,2127,5405,2314,5828
270255,202108,4618,12919,3655,11206,105,406,2829,8516,2934,8922
270260,202108,5629,16450,5094,15569,95,441,4461,13365,4556,13806
270270,202108,1103,2790,922,2566,106,276,677,1911,783,2187
270280,202108,3968,9398,3180,8424,521,766,2205,6377,2726,7143
270290,202108,7918,24352,7134,23093,117,574,6319,20221,6436,20795
270300,202108,4400,11151,3434,10099,193,445,2670,8094,2863,8539
270310,202108,7222,19685,6209,18136,73,381,5407,15456,5480,15837
270320,202108,5686,16434,4924,14973,321,986,3610,10684,3931,11670
270330,202108,4166,13065,3694,12348,232,915,2928,9739,3160,10654
270340,202108,1663,4285,1433,3979,40,108,1234,3381,1274,3489
270350,202108,1941,4444,1575,4022,127,339,1141,2949,1268,3288
270360,202108,2752,6687,2462,6364,90,178,2270,5920,2360,6098
270370,202108,1454,4359,1325,4127,31,138,1142,3505,1173,3643
270375,202108,3175,7322,2653,6750,22,58,2491,6353,2513,6411
270380,202108,5721,15410,4829,14283,536,1426,3404,10430,3940,11856
270390,202108,1271,3130,1026,2845,13,47,868,2419,881,2466
270400,202108,6778,17047,5708,15476,237,543,4619,12469,4856,13012
270410,202108,4848,13603,4210,12646,135,457,3553,10631,3688,11088
270420,202108,5891,16852,5296,15986,107,455,4632,13731,4739,14186
270430,202108,142683,329610,112162,290655,21042,55945,53938,142496,74980,198441
270440,202108,4880,12797,4239,12014,76,289,3764,10570,3840,10859
270450,202108,7400,19214,6490,18115,283,791,5400,15367,5683,16158
270460,202108,3835,8401,3276,7736,161,300,2945,6997,3106,7297
270470,202108,11451,31041,9995,29005,618,1924,7826,22747,8444,24671
270480,202108,3052,7866,2571,7185,91,304,2106,5779,2197,6083
270490,202108,971,2618,848,2468,50,144,684,1990,734,2134
270500,202108,5056,15030,4495,14092,253,844,3585,11129,3838,11973
270510,202108,5891,15031,4964,13867,377,1210,3711,10048,4088,11258
270520,202108,4287,11744,3409,10290,725,2211,1383,4410,2108,6621
270530,202108,1355,3785,1144,3456,60,161,806,2479,866,2640
270540,202108,2346,6396,2000,5957,56,186,1743,5144,1799,5330
270550,202108,7042,17690,5619,16118,740,1694,3991,12032,4731,13726
270560,202108,3133,7837,2660,7198,173,471,2115,5689,2288,6160
270570,202108,4379,11761,3729,10802,255,645,2950,8594,3205,9239
270580,202108,2335,6479,2110,6163,114,326,1804,5251,1918,5577
270590,202108,1615,4823,1488,4650,14,69,1406,4383,1420,4452
270600,202108,2831,8552,2560,8140,40,193,2286,7186,2326,7379
270610,202108,3729,9561,3231,8900,97,250,2869,7886,2966,8136
270620,202108,1299,3798,1198,3610,25,84,1040,3057,1065,3141
270630,202108,18101,43323,15606,39932,677,1929,13050,32776,13727,34705
270640,202108,5630,15644,4931,14539,168,608,4107,11930,4275,12538
270642,202108,2585,8188,2296,7745,154,614,1748,5806,1902,6420
270644,202108,3821,9311,3158,8458,409,935,2248,6275,2657,7210
270650,202108,3342,9447,2923,8880,306,966,2210,6721,2516,7687
270660,202108,2036,5102,1745,4696,79,247,1335,3542,1414,3789
270670,202108,17248,38499,14409,35034,378,1010,12415,29507,12793,30517
270680,202108,5738,13314,5138,12663,122,177,4811,12018,4933,12195
270690,202108,9680,23316,8119,21343,355,941,6582,17164,6937,18105
270700,202108,543,1582,477,1469,41,117,343,1051,384,1168
270710,202108,5775,16754,5124,15748,278,895,4084,12481,4362,13376
270720,202108,3729,10582,3327,9919,58,277,2960,8668,3018,8945
270730,202108,8460,18111,7400,16984,340,542,5764,14742,6104,15284
270740,202108,2420,6249,2130,5911,90,290,1776,4879,1866,5169
270750,202108,5860,15010,5127,14100,60,242,4579,12499,4639,12741
270760,202108,3488,9501,2950,8772,52,215,2473,7315,2525,7530
270770,202108,21656,52237,17401,46962,2938,6994,10411,29843,13349,36837
270780,202108,1907,4973,1762,4772,57,179,1574,4219,1631,4398
270790,202108,1743,4574,1466,4190,117,334,1097,3125,1214,3459
270800,202108,11376,30173,10271,28606,363,1170,8806,24271,9169,25441
270810,202108,3463,9556,2742,8383,171,581,1935,5820,2106,6401
270820,202108,1670,4841,1422,4451,45,195,1137,3494,1182,3689
270830,202108,5263,12412,4256,11173,159,503,3474,8957,3633,9460
270840,202108,8629,25147,7677,23776,149,696,6710,20380,6859,21076
270850,202108,9171,21309,8094,20045,756,1891,6597,16253,7353,18144
270860,202108,14993,32338,11929,28907,579,1196,9711,23547,10290,24743
270870,202108,2330,6332,1906,5648,266,705,1195,3732,1461,4437
270880,202108,8192,24177,7308,22841,196,799,6129,18854,6325,19653
270890,202108,3171,8346,2667,7633,213,611,1820,5201,2033,5812
270895,202108,3265,9667,2945,9255,67,364,2627,8101,2694,8465
270900,202108,1809,4547,1377,3871,27,72,1087,3032,1114,3104
270910,202108,4160,11636,3608,10779,97,272,3024,8927,3121,9199
270915,202108,10072,27745,8155,24660,660,2210,5615,16580,6275,18790
270920,202108,5815,16632,5282,15789,82,368,4573,13333,4655,13701
270930,202108,17923,40362,13889,35692,1760,3943,9315,25427,11075,29370
270940,202108,6757,17232,5699,15960,181,670,4556,12403,4737,13073
280010,202108,700,1910,564,1634,15,58,404,1074,419,1132
280020,202108,5103,12585,4295,11325,390,978,3000,7931,3390,8909
280030,202108,80416,183374,64259,160841,12678,31501,30512,78904,43190,110405
280040,202108,3031,8119,2644,7538,263,704,1830,5252,2093,5956
280050,202108,4146,11515,3535,10575,670,1972,1919,5778,2589,7750
280060,202108,6664,16448,5276,14368,926,2623,2556,7223,3482,9846
280067,202108,7254,17286,6159,15620,284,692,4561,11433,4845,12125
280070,202108,1898,5581,1761,5361,110,327,1457,4413,1567,4740
280100,202108,4165,10689,3499,9655,356,972,2346,6514,2702,7486
280110,202108,1515,3853,1327,3576,13,49,1195,3150,1208,3199
280120,202108,7743,21715,6876,20339,820,2177,4904,14928,5724,17105
280130,202108,9224,21245,8047,19618,419,1058,6493,15733,6912,16791
280140,202108,5691,13190,5008,12260,271,682,4137,10104,4408,10786
280150,202108,4346,10644,3776,9875,488,1095,2727,7322,3215,8417
280160,202108,1221,3435,1034,3129,93,327,714,2104,807,2431
280170,202108,5340,13639,4793,12953,265,626,3857,10498,4122,11124
280190,202108,1356,2889,1209,2695,50,115,1023,2236,1073,2351
280200,202108,1309,3320,1089,3017,61,195,832,2268,893,2463
280210,202108,17850,42383,15536,39145,1730,4199,9995,25310,11725,29509
280220,202108,1759,4633,1505,4300,47,187,1246,3529,1293,3716
280230,202108,4565,11074,3780,9907,336,673,2605,6988,2941,7661
280240,202108,3426,8936,3047,8368,33,167,2650,7087,2683,7254
280250,202108,956,2213,796,1973,80,201,557,1348,637,1549
280260,202108,2305,5414,2022,5056,38,86,1837,4637,1875,4723
280270,202108,2533,6665,2248,6242,169,419,1798,5021,1967,5440
280280,202108,4241,12262,3771,11565,560,1450,2547,8258,3107,9708
280290,202108,19135,48508,16442,44741,1380,3786,11046,30321,12426,34107
280300,202108,12731,29104,11148,27409,364,773,8121,22136,8485,22909
280310,202108,1432,3626,1199,3245,41,121,903,2396,944,2517
280320,202108,9022,23552,7814,21753,1002,2584,5174,14422,6176,17006
280330,202108,4847,11690,4120,10692,253,681,3026,7871,3279,8552
280340,202108,5691,11747,4723,10685,272,416,4032,9368,4304,9784
280350,202108,26996,61597,23730,57316,1104,2658,18875,44933,19979,47591
280360,202108,5786,15667,5075,14514,681,1946,3047,8903,3728,10849
280370,202108,2267,5359,1885,4735,71,135,1503,3731,1574,3866
280380,202108,1047,2687,884,2475,76,201,598,1708,674,1909
280390,202108,3810,9010,3222,8112,201,403,2521,6419,2722,6822
280400,202108,4018,9752,3492,9048,540,1213,2192,5977,2732,7190
280410,202108,2494,6563,2051,5878,163,458,1289,3633,1452,4091
280420,202108,4429,11489,4083,11054,72,260,3759,10123,3831,10383
280430,202108,2171,5138,1905,4783,67,199,1561,3806,1628,4005
280440,202108,4438,11327,3918,10559,134,426,3337,8769,3471,9195
280445,202108,2438,6058,2186,5638,51,126,1688,4207,1739,4333
280450,202108,10426,24049,9024,22156,1154,2411,5731,14852,6885,17263
280460,202108,7139,16336,6463,15423,443,924,5381,12821,5824,13745
280470,202108,1742,4769,1473,4270,99,294,1070,3051,1169,3345
280480,202108,46085,108190,39806,99376,3385,8594,28078,68765,31463,77359
280490,202108,3868,10795,3284,9779,106,393,2487,7158,2593,7551
280500,202108,1036,2390,894,2203,25,60,761,1849,786,1909
280510,202108,2731,6535,2367,6035,65,215,1876,4659,1941,4874
280520,202108,1782,4289,1563,3990,91,195,1232,3136,1323,3331
280530,202108,2504,6145,2185,5705,214,454,1619,4313,1833,4767
280540,202108,8983,23647,8164,22468,253,776,7151,19498,7404,20274
280550,202108,6719,15331,5566,13726,155,529,4644,11069,4799,11598
280560,202108,7584,20262,7112,19561,113,398,6335,17195,6448,17593
280570,202108,6676,15812,5392,14218,252,700,3944,10545,4196,11245
280580,202108,5927,15048,5173,13959,547,1247,3735,10264,4282,11511
280590,202108,2980,6662,2558,6157,127,426,2012,4626,2139,5052
280600,202108,3868,9724,3445,9138,284,662,2434,6527,2718,7189
280610,202108,2600,6181,2332,5798,138,329,1917,4719,2055,5048
280620,202108,5723,13477,4924,12434,427,894,3488,9181,3915,10075
280630,202108,4063,10808,3741,10377,212,587,3034,8448,3246,9035
280640,202108,2424,6329,2140,6011,49,135,1920,5426,1969,5561
280650,202108,1236,3193,1010,2858,86,279,725,1958,811,2237
280660,202108,3853,8176,3308,7550,285,456,2686,6330,2971,6786
280670,202108,20443,45685,17635,42083,1464,3355,13334,31819,14798,35174
280680,202108,2854,6675,2457,6112,237,433,1750,4467,1987,4900
280690,202108,1002,2356,851,2167,53,125,679,1697,732,1822
280700,202108,1216,2957,1051,2715,22,53,835,2126,857,2179
280710,202108,15813,34640,13408,31908,633,1044,11255,27589,11888,28633
280720,202108,2757,6169,2282,5595,41,135,1701,4324,1742,4459
280730,202108,1116,2807,985,2604,63,170,730,1857,793,2027
280740,202108,14906,34922,12804,31770,930,2275,9248,22511,10178,24786
280750,202108,3756,10183,3254,9317,189,547,2368,6693,2557,7240
280760,202108,6791,17260,5912,15934,658,1562,3812,10694,4470,12256
290010,202108,3241,6703,2116,4976,4,11,1758,3970,1762,3981
290020,202108,5483,14294,4989,13673,350,630,4191,11915,4541,12545
290030,202108,4808,10649,3877,9637,183,400,3258,8230,3441,8630
290035,202108,5371,11345,4443,10159,354,510,3536,8411,3890,8921
290040,202108,4488,10456,3806,9636,142,310,2907,7892,3049,8202
290050,202108,2116,6644,1781,5933,107,422,1238,4023,1345,4445
290060,202108,1417,3199,1043,2638,144,330,644,1651,788,1981
290070,202108,38554,82329,33170,75696,1866,4327,25901,58430,27767,62757
290080,202108,5402,15494,4685,14433,499,1549,3199,10038,3698,11587
290090,202108,2234,4226,1570,3518,18,47,1425,3183,1443,3230
290100,202108,10004,25566,8073,22750,1392,3634,4232,12621,5624,16255
290110,202108,5409,13833,4774,12849,475,1221,3242,8737,3717,9958
290115,202108,4173,11939,3537,10818,282,813,2670,8227,2952,9040
290120,202108,6736,16228,5656,14728,142,418,4832,12385,4974,12803
290130,202108,4923,11621,3831,10184,175,405,2947,7936,3122,8341
290135,202108,4453,10249,3654,8960,152,377,2912,6909,3064,7286
290140,202108,4597,11748,3560,10391,81,293,3034,8834,3115,9127
290150,202108,2660,6513,2270,6042,149,353,1729,4702,1878,5055
290160,202108,3638,7899,3237,7354,239,442,2633,6014,2872,6456
290170,202108,3461,8602,3054,8159,105,230,2722,7398,2827,7628
290180,202108,3087,8241,2556,7378,72,233,2108,6042,2180,6275
290190,202108,4438,11948,3921,11260,97,350,3292,9301,3389,9651
290195,202108,2429,5841,1945,5210,29,106,1667,4446,1696,4552
290200,202108,4307,11660,3473,10247,155,472,2613,7629,2768,8101
290205,202108,3641,9040,3237,8455,187,521,2542,6519,2729,7040
290210,202108,13331,35821,11794,33472,834,2092,9207,26506,10041,28598
290220,202108,3032,7200,2656,6720,113,279,2184,5513,2297,5792
290225,202108,3322,6920,2531,6089,126,213,2169,5299,2295,5512
290230,202108,2638,6699,2414,6427,42,105,2177,5817,2219,5922
290240,202108,3829,9408,3031,8429,67,219,2555,7093,2622,7312
290250,202108,4025,11534,3347,10528,98,283,2750,8831,2848,9114
290260,202108,5589,13356,4711,12095,193,582,3911,9844,4104,10426
290265,202108,3662,10356,2978,9076,228,644,2062,6312,2290,6956
290270,202108,10849,36775,10110,35523,504,2151,8164,28531,8668,30682
290280,202108,6320,18463,5444,16719,285,995,3936,11913,4221,12908
290290,202108,10283,29148,8403,25766,768,2485,5679,17199,6447,19684
290300,202108,4271,11520,3160,9416,165,503,2244,6700,2409,7203
290310,202108,1744,4002,1406,3600,31,131,1186,2964,1217,3095
290320,202108,25612,65055,20466,57358,4324,11718,9939,29533,14263,41251
290323,202108,3832,10344,3321,9551,112,322,2573,7478,2685,7800
290327,202108,4267,11995,3645,10813,281,767,2604,7708,2885,8475
290330,202108,2433,4846,1917,4296,56,71,1678,3868,1734,3939
290340,202108,5975,14366,4537,12635,426,1122,3294,9356,3720,10478
290350,202108,4917,13395,4103,12010,268,728,2893,8537,3161,9265
290360,202108,5121,13098,4485,12280,133,306,3855,10653,3988,10959
290370,202108,5403,12746,3964,10858,208,474,2781,7746,2989,8220
290380,202108,5814,15039,4809,13674,111,241,4113,11895,4224,12136
290390,202108,15051,41928,12502,37870,1395,4025,8020,24733,9415,28758
290395,202108,3070,8460,2464,7432,57,225,1887,5634,1944,5859
290400,202108,3882,10241,3160,9060,104,363,2452,6905,2556,7268
290405,202108,4821,13593,4099,12367,320,969,2769,8533,3089,9502
290410,202108,5861,15474,4496,13316,107,428,3413,9894,3520,10322
290420,202108,3229,8529,2686,7698,89,253,2140,6090,2229,6343
290430,202108,3402,8877,2787,7921,221,656,1954,5434,2175,6090
290440,202108,2995,7163,2174,5887,98,210,1530,4255,1628,4465
290450,202108,3708,8971,2936,7827,117,249,2238,5983,2355,6232
290460,202108,12554,34553,10535,30819,2236,6591,4343,12796,6579,19387
290470,202108,4820,11279,3545,9539,446,1193,1975,5440,2421,6633
290475,202108,6746,19186,5709,17388,66,354,4753,14211,4819,14565
290480,202108,1853,4559,1514,4075,66,214,1087,2785,1153,2999
290485,202108,4761,13427,4182,12624,97,438,3591,10702,3688,11140
290490,202108,9309,21443,8359,20153,468,958,6631,16232,7099,17190
290500,202108,4246,12277,3318,10335,546,1759,1456,4423,2002,6182
290510,202108,3671,8814,3063,8032,58,187,2714,7067,2772,7254
290515,202108,3732,10250,3238,9560,42,133,2928,8782,2970,8915
290520,202108,12034,33409,9375,28367,651,1992,5670,17041,6321,19033
290530,202108,5136,14425,4325,13116,111,449,3663,11027,3774,11476
290540,202108,3468,8892,3121,8515,39,118,2912,7943,2951,8061
290550,202108,4350,11261,3801,10613,12,64,3503,9895,3515,9959
290560,202108,6405,16272,4863,14051,363,1282,3223,8996,3586,10278
290570,202108,45551,109911,40379,103397,2243,5734,32727,83280,34970,89014
290580,202108,8248,23085,7127,21490,649,1757,5211,16220,5860,17977
290590,202108,7154,21633,6018,19629,148,512,4836,15900,4984,16412
290600,202108,19662,53388,17177,49385,797,2140,13678,39440,14475,41580
290610,202108,2660,8006,2088,6834,83,294,1471,4780,1554,5074
290620,202108,6229,17430,5390,16055,200,567,4532,13509,4732,14076
290630,202108,9755,22658,7800,20169,692,1677,5862,15424,6554,17101
290640,202108,2895,7172,2229,6222,118,301,1571,4564,1689,4865
290650,202108,13189,31956,11647,30231,2400,5982,7440,20135,9840,26117
290660,202108,3777,9544,3114,8527,62,166,2347,6596,2409,6762
290670,202108,6940,18537,5886,16862,381,1021,4517,13169,4898,14190
290680,202108,11269,30431,9436,27738,188,918,7827,22643,8015,23561
290682,202108,4880,12333,4239,11478,142,288,3564,9775,3706,10063
290685,202108,3563,7908,2567,6489,224,503,1523,4165,1747,4668
290687,202108,6852,17792,5594,15745,712,1882,3563,10298,4275,12180
290689,202108,2963,7978,2249,6679,192,600,1501,4482,1693,5082
290690,202108,5364,13814,4337,12390,276,843,3166,8909,3442,9752
290700,202108,2811,7190,2492,6790,45,160,2194,5949,2239,6109
290710,202108,8520,23361,7315,21704,223,632,6137,18323,6360,18955
290720,202108,18974,50978,17216,48281,921,2714,13882,38568,14803,41282
290730,202108,7181,16825,6118,15600,312,615,4783,12447,5095,13062
290740,202108,1079,2814,857,2461,25,75,729,2089,754,2164
290750,202108,11770,28295,10201,25822,693,1758,7596,18716,8289,20474
290755,202108,2059,5728,1677,5045,98,272,1152,3513,1250,3785
290760,202108,3863,10991,3179,9732,158,419,2184,6864,2342,7283
290770,202108,2742,8403,2505,8109,46,199,2111,6956,2157,7155
290780,202108,8336,20363,7182,18854,268,523,5558,15024,5826,15547
290790,202108,4935,13183,4292,12245,188,459,3519,10205,3707,10664
290800,202108,7188,14446,5018,11943,281,557,3760,9084,4041,9641
290810,202108,5377,13844,4358,12375,111,320,3321,9659,3432,9979
290820,202108,5074,13245,4571,12549,218,567,3417,9542,3635,10109
290830,202108,4609,10475,4068,9753,27,93,3529,8262,3556,8355
290840,202108,18005,46224,15378,42163,2045,4614,9782,28585,11827,33199
290850,202108,7324,16609,6496,15721,245,483,5633,13762,5878,14245
290860,202108,6249,17451,5423,16510,211,611,4568,14237,4779,14848
290870,202108,4846,13110,3684,10910,192,540,2524,7481,2716,8021
290880,202108,1461,3512,1177,3147,104,242,748,2142,852,2384
290890,202108,9609,19019,8619,17921,155,331,8040,16620,8195,16951
290900,202108,2534,6440,1972,5470,129,285,1199,3345,1328,3630
290910,202108,5345,12429,4059,10515,40,100,3474,8912,3514,9012
290920,202108,5270,13009,4725,12375,106,149,4401,11757,4507,11906
290930,202108,7714,21109,6259,18601,197,747,4869,14121,5066,14868
290940,202108,3708,10266,3132,9437,171,532,2502,7538,2673,8070
290950,202108,1485,3701,1210,3285,72,183,837,2293,909,2476
290960,202108,5885,14579,5235,13766,233,499,4365,11552,4598,12051
290970,202108,3279,9605,2685,8514,99,366,2080,6609,2179,6975
290980,202108,13035,30236,10970,27155,711,1881,7115,17072,7826,18953
290990,202108,9878,25871,8774,24119,274,1022,7372,19655,7646,20677
291000,202108,3470,8729,2691,7742,120,342,2184,6368,2304,6710
291005,202108,15910,38410,14045,36011,1508,3413,10634,27666,12142,31079
291010,202108,3145,9358,2558,8094,143,489,1651,5086,1794,5575
291020,202108,1298,3111,1055,2694,29,86,771,1858,800,1944
291030,202108,2625,6190,1869,4917,119,278,1159,2996,1278,3274
291040,202108,5643,14961,4652,13559,160,520,3667,10686,3827,11206
291050,202108,8366,20589,7181,18994,765,2048,5155,13523,5920,15571
291060,202108,6633,18905,5647,17593,303,1141,4370,13502,4673,14643
291070,202108,16815,43935,14042,39545,384,1223,11456,32013,11840,33236
291072,202108,26381,64486,19248,52698,3222,9014,8799,24035,12021,33049
291075,202108,5638,13533,5090,12717,101,239,4289,10505,4390,10744
291077,202108,1732,4457,1352,3789,72,131,938,2667,1010,2798
291080,202108,120373,285349,95333,250893,25702,68247,29136,83477,54838,151724
291085,202108,5854,14351,4833,12824,168,479,4043,10685,4211,11164
291090,202108,2151,3932,1597,3317,44,73,1338,2748,1382,2821
291100,202108,3309,7072,2286,5866,97,250,1761,4489,1858,4739
291110,202108,6320,18165,5397,16631,292,1011,4220,12632,4512,13643
291120,202108,7995,18925,6754,17366,317,807,5201,13383,5518,14190
291125,202108,2339,4025,1765,3380,87,129,1437,2791,1524,2920
291130,202108,3379,9399,2502,7695,55,256,1890,5597,1945,5853
291140,202108,5022,13160,3635,10654,508,1306,2171,6412,2679,7718
291150,202108,2574,5482,1989,4827,4,16,1896,4607,1900,4623
291160,202108,5185,13971,4310,12727,386,1149,2895,8538,3281,9687
291165,202108,2252,6034,1668,4882,27,109,1204,3391,1231,3500
291170,202108,21500,53387,17893,47415,980,2771,11891,30849,12871,33620
291180,202108,6626,14738,4884,12463,231,546,3861,9856,4092,10402
291185,202108,3160,8155,2779,7562,115,293,2183,5986,2298,6279
291190,202108,8068,19103,6680,17344,265,684,5406,14090,5671,14774
291200,202108,2905,7779,2143,6337,70,217,1374,3888,1444,4105
291210,202108,7405,15395,5490,13211,130,392,4072,9865,4202,10257
291220,202108,4450,12049,4026,11439,249,709,3127,8860,3376,9569
291230,202108,4689,9748,3563,8522,39,89,3243,7809,3282,7898
291240,202108,4201,10655,3550,9568,59,199,3043,8102,3102,8301
291250,202108,3480,10004,2719,8608,143,419,1756,5599,1899,6018
291260,202108,1487,3442,1221,3097,28,85,999,2558,1027,2643
291270,202108,5831,14262,4558,12457,284,774,3396,9331,3680,10105
291280,202108,2783,6502,2057,5478,196,483,1304,3457,1500,3940
291290,202108,5874,15123,4494,13007,356,1057,3049,8790,3405,9847
291300,202108,3966,10473,3133,9100,109,335,2396,6854,2505,7189
291310,202108,5164,13620,4432,12314,171,478,3695,10201,3866,10679
291320,202108,6397,17150,4997,14605,1119,3068,2431,7526,3550,10594
291330,202108,1926,4761,1607,4245,69,177,1227,3158,1296,3335
291340,202108,4464,11205,3587,9720,109,293,2694,7223,2803,7516
291345,202108,3005,8715,2718,8281,100,325,2276,6959,2376,7284
291350,202108,7102,16953,5523,15079,58,165,4808,13320,4866,13485
291360,202108,37842,84754,29774,75188,3013,7052,19467,50870,22480,57922
291370,202108,8427,22349,7420,20759,581,1629,5491,15108,6072,16737
291380,202108,3631,9546,3176,8935,96,345,2682,7481,2778,7826
291390,202108,13571,28453,10461,25032,459,992,8647,20719,9106,21711
291400,202108,14706,35646,12174,31957,1328,3067,7745,21409,9073,24476
291410,202108,3103,7984,2429,6819,33,128,1794,4961,1827,5089
291420,202108,2029,4821,1576,4262,18,70,1406,3787,1424,3857
291430,202108,2801,7691,2411,7045,90,314,1906,5411,1996,5725
291440,202108,6681,18615,5800,17182,322,950,4496,13411,4818,14361
291450,202108,10243,23324,8421,21241,75,122,7475,19331,7550,19453
291460,202108,16295,41930,14271,38959,701,2012,10799,29207,11500,31219
291465,202108,9367,22508,7338,20197,121,529,6357,17351,6478,17880
291470,202108,18363,39569,15304,36064,866,1728,11325,27451,12191,29179
291480,202108,44715,96203,33503,81227,3654,9072,18498,44542,22152,53614
291490,202108,5721,14014,4933,13126,135,411,4456,11820,4591,12231
291500,202108,5234,12381,4395,11277,59,207,4027,10341,4086,10548
291510,202108,4561,10847,3369,9340,38,212,2844,7785,2882,7997
291520,202108,4680,10321,3529,8816,186,486,2736,6780,2922,7266
291530,202108,2418,5311,1729,4431,292,663,989,2766,1281,3429
291535,202108,3542,10176,3075,9331,167,443,2350,7379,2517,7822
291540,202108,2317,5039,1600,4185,84,225,1303,3406,1387,3631
291550,202108,5847,13025,4531,11378,460,918,3015,7838,3475,8756
291560,202108,18994,44117,13861,37376,1606,4036,7869,22375,9475,26411
291570,202108,2431,5634,1906,4992,59,144,1581,4290,1640,4434
291580,202108,6631,16624,5225,14759,269,705,3796,10734,4065,11439
291590,202108,2304,5367,2023,5048,76,237,1816,4447,1892,4684
291600,202108,5546,12594,4280,10687,371,959,2938,7122,3309,8081
291610,202108,5716,14599,5118,13938,59,214,4712,12807,4771,13021
291620,202108,3208,7092,2413,6222,122,292,1859,4910,1981,5202
291630,202108,3564,7615,2669,6480,234,602,1989,4810,2223,5412
291640,202108,17196,40468,13053,34599,1831,4473,6276,17072,8107,21545
291650,202108,9460,23212,8367,21930,566,998,7004,18929,7570,19927
291660,202108,2112,5050,1562,4230,126,379,1030,2627,1156,3006
291670,202108,2101,5419,1758,4918,108,260,1303,3717,1411,3977
291680,202108,4137,9894,3344,8775,318,829,2330,6159,2648,6988
291685,202108,5011,11789,4026,10479,216,427,3075,8243,3291,8670
291690,202108,4274,9224,3001,7393,330,654,2187,5492,2517,6146
291700,202108,9040,25298,7963,23465,334,1060,6500,18831,6834,19891
291710,202108,5459,12504,4090,10626,339,829,2868,7443,3207,8272
291720,202108,4589,13452,3842,11983,695,2182,2130,6602,2825,8784
291730,202108,6529,16101,5629,14918,246,708,4728,12458,4974,13166
291733,202108,2816,7154,2397,6609,61,156,1752,5110,1813,5266
291735,202108,3026,7864,2417,6806,78,167,1855,5223,1933,5390
291740,202108,4106,10420,3017,8378,97,201,2087,5796,2184,5997
291750,202108,20863,48133,16986,42462,1884,4428,10996,28149,12880,32577
291760,202108,10843,30122,8489,26383,2500,8788,2259,6997,4759,15785
291770,202108,7493,19484,6273,17404,282,856,4815,12971,5097,13827
291780,202108,5293,13707,4765,12977,91,288,4169,11255,4260,11543
291790,202108,2778,7482,2520,7152,232,532,1900,5586,2132,6118
291800,202108,31475,76228,23709,64910,4195,10806,10933,31544,15128,42350
291810,202108,10772,25038,9112,23021,379,859,7578,19479,7957,20338
291820,202108,4032,10183,3509,9506,90,255,2851,7742,2941,7997
291830,202108,4731,10728,3861,9555,226,403,3036,7608,3262,8011
291835,202108,6739,19772,5334,17125,459,1505,3514,11459,3973,12964
291840,202108,48921,131366,42587,121619,3980,12048,30484,86446,34464,98494
291845,202108,2733,6768,2171,6085,102,276,1827,5184,1929,5460
291850,202108,4303,11571,3596,10425,143,382,2864,8403,3007,8785
291855,202108,2313,4380,1797,3811,27,62,1643,3480,1670,3542
291860,202108,2345,6000,1630,4641,38,87,1087,2999,1125,3086
291870,202108,1336,3292,900,2537,38,93,617,1725,655,1818
291875,202108,3025,8939,2605,8078,54,218,1934,5817,1988,6035
291880,202108,5819,16079,4968,14672,252,671,3658,10978,3910,11649
291890,202108,1654,3338,1071,2664,156,337,678,1730,834,2067
291900,202108,1404,3175,1075,2691,20,64,861,2100,881,2164
291905,202108,2478,6209,2047,5548,75,257,1598,4172,1673,4429
291910,202108,3128,7571,2631,6970,52,170,2255,6154,2307,6324
291915,202108,7521,20944,6119,18587,191,617,4601,14183,4792,14800
291920,202108,28257,70794,24096,65143,1967,5834,17453,46057,19420,51891
291930,202108,2600,6671,2229,6171,219,599,1547,4340,1766,4939
291940,202108,4068,10042,2748,7857,208,570,1617,4615,1825,5185
291950,202108,9294,27728,7851,25008,279,975,5450,17246,5729,18221
291955,202108,16122,39532,14321,37224,1170,3095,11353,29558,12523,32653
291960,202108,3381,8233,2851,7534,153,306,2249,6147,2402,6453
291970,202108,4747,11582,3972,10634,145,439,3019,8117,3164,8556
291980,202108,10161,27979,8195,24631,1011,2631,5217,16160,6228,18791
291990,202108,2408,6085,1967,5541,23,81,1821,5138,1844,5219
291992,202108,4038,9546,3293,8597,295,629,2592,6963,2887,7592
291995,202108,2246,5860,1837,5207,45,171,1455,4022,1500,4193
292000,202108,2735,6193,2225,5589,82,252,1788,4471,1870,4723
292010,202108,5888,13406,4806,11881,146,368,4055,9845,4201,10213
292020,202108,4862,13398,4077,12040,167,562,3141,9003,3308,9565
292030,202108,2024,5829,1823,5473,106,329,1195,3499,1301,3828
292040,202108,4651,11446,3641,9963,224,517,2763,7744,2987,8261
292045,202108,4267,10660,3186,9084,33,91,2852,8265,2885,8356
292050,202108,6779,18374,5498,16191,252,807,3586,10433,3838,11240
292060,202108,11613,26170,10724,25060,412,884,9465,21858,9877,22742
292070,202108,5871,14858,5124,13982,318,803,4343,11833,4661,12636
292080,202108,3331,8002,2732,7235,65,209,2462,6476,2527,6685
292090,202108,4663,9908,3262,8210,188,431,2492,6316,2680,6747
292100,202108,13036,29911,11209,27656,1700,3935,6637,17125,8337,21060
292105,202108,3779,8978,3290,8324,75,164,2788,7053,2863,7217
292110,202108,6266,14588,4457,11836,874,2395,2249,5946,3123,8341
292120,202108,7256,18077,6011,16013,352,942,4483,11763,4835,12705
292130,202108,3567,8340,2963,7598,132,369,2283,5789,2415,6158
292140,202108,5501,12196,4665,11002,184,405,4003,9410,4187,9815
292145,202108,2625,7027,2200,6309,95,222,1743,5031,1838,5253
292150,202108,15397,39754,13347,36503,261,943,11056,29651,11317,30594
292160,202108,3091,7257,2334,6290,33,80,1904,5410,1937,5490
292170,202108,9026,22888,7582,20608,376,1065,5808,15470,6184,16535
292180,202108,2974,7906,2206,6501,148,430,1392,4030,1540,4460
292190,202108,3033,7807,2586,7156,138,398,1947,5395,2085,5793
292200,202108,9181,21910,6832,18619,1231,3435,3207,9172,4438,12607
292205,202108,3823,10454,3318,9711,56,250,2890,8424,2946,8674
292210,202108,6783,15220,5506,13633,69,268,5018,12320,5087,12588
292220,202108,2282,5162,1988,4733,76,165,1554,3594,1630,3759
292225,202108,3357,9470,2970,8889,53,231,2610,7682,2663,7913
292230,202108,8956,20871,8018,19692,175,540,6944,16789,7119,17329
292240,202108,4917,13865,4339,12845,280,804,3106,9178,3386,9982
292250,202108,6128,15210,5506,14311,368,935,4226,10909,4594,11844
292260,202108,3456,8820,3077,8332,82,210,2685,7279,2767,7489
292265,202108,3566,9344,2995,8490,54,233,2441,6781,2495,7014
292270,202108,4381,9863,3481,8794,123,282,2857,7255,2980,7537
292273,202108,2882,6049,2303,5347,59,97,1666,4155,1725,4252
292275,202108,1658,4260,1306,3794,53,150,986,2905,1039,3055
292280,202108,2715,6236,2181,5623,95,174,1814,4829,1909,5003
292285,202108,2725,6310,2159,5559,80,166,1764,4591,1844,4757
292290,202108,7729,19705,6071,17424,160,523,4994,14312,5154,14835
292300,202108,10505,25632,8272,22686,818,2338,5677,15624,6495,17962
292303,202108,3022,8411,2627,7787,88,185,2180,6546,2268,6731
292305,202108,2317,6148,2141,5911,42,166,1930,5257,1972,5423
292310,202108,7164,17137,6211,15987,108,327,5524,14053,5632,14380
292320,202108,6342,16742,5062,14435,227,724,3779,10507,4006,11231
292330,202108,2766,5964,2248,5383,106,175,1733,4378,1839,4553
292335,202108,5015,12676,4433,11823,239,537,3717,10071,3956,10608
292340,202108,5540,15402,4589,13603,222,617,3371,9956,3593,10573
292350,202108,2596,6904,2165,6314,76,259,1767,5183,1843,5442
292360,202108,5143,13335,4284,11895,234,693,3033,8349,3267,9042
292370,202108,10399,24231,8952,22351,114,365,8326,20577,8440,20942
292380,202108,7001,19197,6255,17876,432,1209,4748,13467,5180,14676
292390,202108,4716,8812,3451,7372,115,209,3021,6450,3136,6659
292400,202108,23003,63469,19827,58501,1898,5439,13632,40619,15530,46058
292405,202108,4664,11030,3932,9887,91,226,3288,8127,3379,8353
292410,202108,2268,5330,1882,4840,67,139,1658,4301,1725,4440
292420,202108,3698,10448,3381,9972,100,397,2954,8539,3054,8936
292430,202108,5060,14711,3849,12507,282,910,2521,8249,2803,9159
292440,202108,8824,27441,8160,26436,108,518,7339,23652,7447,24170
292450,202108,4162,11581,3238,9821,92,329,2541,7666,2633,7995
292460,202108,5409,13859,4471,12353,236,601,3486,9582,3722,10183
292465,202108,2818,6913,2404,6389,93,192,1610,4719,1703,4911
292467,202108,1996,5375,1749,5041,281,676,1173,3556,1454,4232
292470,202108,3101,7653,2403,6585,74,119,1833,5072,1907,5191
292480,202108,6419,14838,5209,13370,71,241,4727,12044,4798,12285
292490,202108,2414,5733,2040,5196,105,192,1626,4197,1731,4389
292500,202108,7136,18302,5702,15918,407,1161,3869,10703,4276,11864
292510,202108,14168,36314,11080,31510,550,1577,7812,22215,8362,23792
292520,202108,7403,18015,6508,16704,420,1120,5131,12996,5551,14116
292525,202108,6226,14422,5131,13201,126,264,4505,11782,4631,12046
292530,202108,31058,79093,24195,67811,5169,14778,10763,30425,15932,45203
292540,202108,4621,8273,3656,7251,126,193,3308,6599,3434,6792
292550,202108,8485,21371,6532,19038,497,1278,4555,14287,5052,15565
292560,202108,4559,11191,3874,10239,121,303,2955,7790,3076,8093
292570,202108,3798,9698,3182,8596,48,159,2714,7155,2762,7314
292575,202108,6958,19548,6382,18793,418,1159,5079,15205,5497,16364
292580,202108,7813,19204,6439,17200,120,340,5467,14447,5587,14787
292590,202108,7590,19795,6394,17684,322,904,5094,13873,5416,14777
292593,202108,2946,7187,2440,6354,74,179,2055,5306,2129,5485
292595,202108,5683,14573,4867,13573,133,412,4156,11531,4289,11943
292600,202108,10982,29306,9491,27083,403,1054,7543,21644,7946,22698
292610,202108,4444,11123,3802,10029,162,368,2947,7834,3109,8202
292620,202108,6548,17573,5411,16193,133,276,4869,14895,5002,15171
292630,202108,9152,21594,7328,18709,809,1988,4547,11788,5356,13776
292640,202108,8615,24295,7468,22416,210,694,5417,16430,5627,17124
292650,202108,4534,11084,4051,10453,107,257,3688,9444,3795,9701
292660,202108,11705,30939,9892,28258,468,1369,7406,21348,7874,22717
292665,202108,2227,6406,1915,5992,70,191,1586,5060,1656,5251
292670,202108,3656,9742,2839,8229,133,383,1909,5428,2042,5811
292680,202108,4155,10554,3286,9067,164,396,2454,6643,2618,7039
292690,202108,2720,6841,1890,5498,199,520,1137,3460,1336,3980
292700,202108,10325,27340,9016,25335,730,1687,6240,18204,6970,19891
292710,202108,2749,7925,2560,7677,48,113,2344,7084,2392,7197
292720,202108,9291,21487,7839,19812,212,533,6279,16194,6491,16727
292730,202108,5095,11335,4652,10661,353,574,3824,9015,4177,9589
292740,202108,329142,775055,284057,711974,37947,94384,180939,451432,218886,545816
292750,202108,6485,16475,5714,15395,231,567,4546,12480,4777,13047
292760,202108,4121,11350,3609,10470,174,512,2733,7855,2907,8367
292770,202108,6740,16783,5446,15009,731,2027,3596,10186,4327,12213
292780,202108,2191,4186,1634,3524,75,165,1314,2724,1389,2889
292790,202108,4106,8523,3111,7441,169,350,2559,6203,2728,6553
292800,202108,11681,28638,9992,26087,341,851,8308,21520,8649,22371
292805,202108,3807,8821,3001,7794,114,299,2383,6162,2497,6461
292810,202108,11402,28248,9121,24718,614,1409,6681,17932,7295,19341
292820,202108,7446,20352,5461,17012,358,1202,3859,11831,4217,13033
292830,202108,3002,6910,2557,6371,86,196,2183,5495,2269,5691
292840,202108,9017,23104,7611,21220,134,441,6690,18440,6824,18881
292850,202108,2545,6474,2133,5891,150,384,1482,4092,1632,4476
292860,202108,16935,36882,15217,34875,392,964,13249,30009,13641,30973
292870,202108,19637,46717,16973,43059,977,2364,11955,29905,12932,32269
292880,202108,11541,30772,9832,28203,260,950,7792,21656,8052,22606
292890,202108,7446,19839,6577,18607,172,654,5780,16257,5952,16911
292895,202108,3237,6631,2432,5460,106,218,1982,4402,2088,4620
292900,202108,2698,7071,2447,6687,47,180,2041,5435,2088,5615
292905,202108,4456,11151,3549,9808,96,298,2723,7440,2819,7738
292910,202108,4807,12884,4397,12314,185,487,3439,9580,3624,10067
292920,202108,9897,26868,9178,25883,272,951,7898,21975,8170,22926
292925,202108,5457,15216,4555,13596,231,631,3249,9695,3480,10326
292930,202108,6647,18892,5758,17313,502,1616,3723,10959,4225,12575
292935,202108,2554,6161,2001,5548,13,63,1801,5021,1814,5084
292937,202108,2909,7210,2527,6727,73,188,2087,5564,2160,5752
292940,202108,3018,7397,2400,6472,228,511,1664,4682,1892,5193
292950,202108,9831,24404,8592,22617,530,1157,6499,17106,7029,18263
292960,202108,5318,12673,4439,11424,140,334,3541,9061,3681,9395
292970,202108,3968,10945,3526,10292,70,270,2958,8685,3028,8955
292975,202108,4454,9447,3954,8891,115,187,3599,8177,3714,8364
292980,202108,3599,8168,2952,7240,71,206,2494,6005,2565,6211
292990,202108,11457,31263,9622,28044,540,1679,7167,20531,7707,22210
293000,202108,2797,6470,2400,5874,47,154,1942,4746,1989,4900
293010,202108,19077,47217,15426,41642,1895,5222,9523,25741,11418,30963
293015,202108,8949,26294,7111,22805,464,1479,4835,15811,5299,17290
293020,202108,10105,28699,9094,27267,124,425,8197,24653,8321,25078
293030,202108,5326,13723,4068,11785,110,305,2803,8377,2913,8682
293040,202108,4648,11622,3897,10563,63,198,3428,9243,3491,9441
293050,202108,23807,55869,20991,51729,1307,3066,15747,38439,17054,41505
293060,202108,3709,9635,3002,8302,235,687,2069,5603,2304,6290
293070,202108,25978,61111,22840,57170,1940,4991,17114,42678,19054,47669
293075,202108,3747,11274,3265,10476,103,462,2708,8650,2811,9112
293076,202108,3661,8686,3327,8297,64,129,2968,7503,3032,7632
293077,202108,6685,17835,5352,15741,480,1483,3276,10203,3756,11686
293080,202108,4901,14091,4194,12872,80,362,3428,10324,3508,10686
293090,202108,3306,9423,2552,8155,221,660,1657,5395,1878,6055
293100,202108,6013,15485,4995,13694,232,573,3942,10795,4174,11368
293105,202108,3922,12116,3424,11102,237,768,2403,7744,2640,8512
293110,202108,2481,6006,2071,5419,68,191,1685,4357,1753,4548
293120,202108,4736,12252,4256,11528,236,456,3503,9662,3739,10118
293130,202108,3862,10340,3367,9709,58,224,2964,8469,3022,8693
293135,202108,31656,72280,23450,61563,3402,9651,11150,29644,14552,39295
293140,202108,2539,5340,2212,4948,57,98,1900,4258,1957,4356
293150,202108,5540,16186,4554,14354,306,973,3149,9971,3455,10944
293160,202108,3783,9242,3226,8638,240,386,2713,7628,2953,8014
293170,202108,5108,10341,4469,9559,105,209,3947,8412,4052,8621
293180,202108,4527,12390,3775,11040,68,264,3031,8660,3099,8924
293190,202108,14628,38620,12888,36145,117,492,11510,32033,11627,32525
293200,202108,9007,21394,7317,18729,209,556,5976,15134,6185,15690
293210,202108,5331,13664,4573,12494,286,745,3548,9711,3834,10456
293220,202108,5328,13130,3915,10818,728,2000,1916,5407,2644,7407
293230,202108,4145,10127,3094,8681,213,601,2180,6212,2393,6813
293240,202108,4660,11946,3760,10497,76,155,2819,8257,2895,8412
293245,202108,3974,10460,3608,9928,154,414,3063,8365,3217,8779
293250,202108,6153,14003,4985,12479,195,495,4101,10245,4296,10740
293260,202108,4932,12583,4071,11240,144,338,2850,7974,2994,8312
293270,202108,7463,16003,5898,14332,447,605,4589,12117,5036,12722
293280,202108,4568,11770,3984,10942,245,583,3086,8623,3331,9206
293290,202108,16089,43982,14262,41139,1641,4735,9755,28283,11396,33018
293300,202108,6003,14203,5178,13002,314,744,3807,9607,4121,10351
293305,202108,4323,10055,3771,9372,71,159,3397,8469,3468,8628
293310,202108,2190,5437,1844,4916,41,121,1475,3870,1516,3991
293315,202108,4291,9820,3533,8703,203,433,2892,7117,3095,7550
293317,202108,2764,6309,2463,5890,169,289,1919,4633,2088,4922
293320,202108,12374,29052,10951,27480,205,564,9923,24758,10128,25322
293325,202108,1833,4403,1428,3871,202,513,893,2476,1095,2989
293330,202108,64957,174835,53014,154294,8661,26080,26045,74836,34706,100916
293340,202108,2259,6220,1859,5519,95,281,1300,3835,1395,4116
293345,202108,3797,9878,3048,8735,415,927,1904,6058,2319,6985
293350,202108,6573,18516,5655,17412,56,274,5157,16071,5213,16345
293360,202108,15195,37783,12946,34792,273,1125,11448,30228,11721,31353
310010,202108,1009,2193,649,1707,40,133,246,608,286,741
310020,202108,2972,7691,2246,6426,441,1339,633,1742,1074,3081
310030,202108,1939,5332,1492,4554,213,717,970,2862,1183,3579
310040,202108,882,2230,695,1910,46,166,432,1077,478,1243
310050,202108,1519,4432,1272,4045,114,454,854,2618,968,3072
310060,202108,3236,8924,2792,8336,81,308,2324,6866,2405,7174
310070,202108,343,772,245,632,12,25,179,459,191,484
310080,202108,706,1860,517,1525,78,247,248,695,326,942
310090,202108,4923,12490,4051,11087,262,761,3045,8214,3307,8975
310100,202108,3668,9749,3104,8845,74,317,2595,7193,2669,7510
310110,202108,4875,12366,3775,10527,675,2050,1834,4894,2509,6944
310120,202108,658,1556,425,1188,49,160,249,638,298,798
310130,202108,371,946,314,861,26,100,239,628,265,728
310140,202108,289,791,203,649,37,138,83,239,120,377
310150,202108,5991,15005,4464,12294,512,1600,2237,5799,2749,7399
310160,202108,9046,21809,6652,17943,1106,3241,2676,7097,3782,10338
310163,202108,1113,3214,893,2791,180,615,279,796,459,1411
310170,202108,9807,24016,7834,21005,663,1768,5521,14829,6184,16597
310180,202108,1972,4671,1436,3824,163,476,855,2210,1018,2686
310190,202108,2837,7958,2327,7058,520,1757,411,1164,931,2921
310200,202108,2050,5812,1532,4833,179,642,745,2283,924,2925
310205,202108,1163,3089,928,2714,122,398,542,1592,664,1990
310210,202108,2606,6897,2142,6069,121,336,1518,4194,1639,4530
310220,202108,1297,3463,1002,2886,86,256,649,1803,735,2059
310230,202108,2293,6145,1840,5317,217,679,1165,3157,1382,3836
310240,202108,1047,3021,887,2749,46,169,615,1828,661,1997
310250,202108,1091,2813,894,2498,16,58,658,1806,674,1864
310260,202108,3330,8363,2225,6430,609,2057,705,1655,1314,3712
310270,202108,2847,6712,2273,5942,86,248,1888,4940,1974,5188
310280,202108,2575,5829,2037,5070,230,598,1277,3067,1507,3665
310285,202108,1898,5886,1579,5317,151,544,973,3270,1124,3814
310290,202108,1240,3164,1031,2809,185,584,567,1389,752,1973
310300,202108,1635,4533,1389,4117,129,464,830,2297,959,2761
310310,202108,329,784,214,588,38,99,103,275,141,374
310320,202108,542,1333,383,1087,17,64,227,615,244,679
310330,202108,498,1152,305,818,43,131,121,281,164,412
310340,202108,8463,21561,6809,18783,923,2497,3409,9595,4332,12092
310350,202108,13342,31510,9257,25013,1433,4124,4510,11687,5943,15811
310360,202108,560,1235,439,1080,15,37,301,727,316,764
310370,202108,1315,3949,1123,3595,206,728,351,1203,557,1931
310375,202108,902,2186,644,1807,93,268,363,1021,456,1289
310380,202108,401,903,221,622,32,94,103,275,135,369
310390,202108,510,1456,409,1266,79,258,140,386,219,644
310400,202108,11686,27863,8605,23195,736,2277,5483,14253,6219,16530
310410,202108,861,2447,566,1906,76,282,229,712,305,994
310420,202108,4888,12305,3476,9758,465,1425,1517,3959,1982,5384
310430,202108,1668,4393,1126,3398,218,716,425,1115,643,1831
310440,202108,694,1788,484,1404,41,150,263,705,304,855
310445,202108,1432,3964,1048,3205,69,200,736,2215,805,2415
310450,202108,4676,11520,3557,9774,146,516,2722,7262,2868,7778
310460,202108,1829,4764,1402,3987,223,687,520,1354,743,2041
310470,202108,3782,8248,2952,7157,280,624,2102,5242,2382,5866
310480,202108,1027,2580,803,2217,93,265,495,1323,588,1588
310490,202108,2913,7742,2295,6745,251,870,1297,3550,1548,4420
310500,202108,1422,3841,1085,3285,178,612,583,1691,761,2303
310510,202108,2215,5650,1516,4383,260,825,599,1720,859,2545
310520,202108,1198,3071,881,2501,142,382,461,1329,603,1711
310530,202108,786,1957,537,1531,70,229,191,450,261,679
310540,202108,3105,8583,2568,7628,503,1611,1181,3306,1684,4917
310550,202108,1311,3205,937,2592,72,250,551,1401,623,1651
310560,202108,15915,40541,11389,32598,1431,4568,5123,13211,6554,17779
310570,202108,1076,2764,854,2457,49,169,650,1840,699,2009
310590,202108,4322,11118,3465,9524,219,660,2051,5304,2270,5964
310600,202108,1427,4042,1168,3510,140,480,628,1774,768,2254
310610,202108,489,1303,319,1026,118,388,50,150,168,538
310620,202108,193143,477203,143112,387864,17281,54253,75224,184882,92505,239135
310630,202108,4832,12818,3754,10700,437,1292,2233,6197,2670,7489
310640,202108,1251,3510,1028,3085,165,552,497,1397,662,1949
310650,202108,2546,6886,1875,5606,149,477,1161,3327,1310,3804
310660,202108,1368,3608,1120,3266,27,85,952,2772,979,2857
310665,202108,1453,3618,1182,3247,19,69,968,2708,987,2777
310670,202108,61671,154206,52166,138242,4601,13693,36166,91226,40767,104919
310680,202108,805,1851,666,1654,18,65,570,1365,588,1430
310690,202108,2145,5329,1570,4389,111,359,955,2517,1066,2876
310700,202108,500,1076,393,943,22,70,312,728,334,798
310710,202108,6020,16523,4402,14111,833,3116,775,2231,1608,5347
310720,202108,1102,2477,861,2174,30,97,660,1603,690,1700
310730,202108,10616,27157,9060,24731,357,1167,6808,18122,7165,19289
310740,202108,6751,17992,4930,14329,669,2179,1983,5169,2652,7348
310750,202108,1314,3073,1003,2629,106,328,564,1349,670,1677
310760,202108,687,1699,478,1381,35,103,262,764,297,867
310770,202108,1133,2987,793,2463,81,300,414,1189,495,1489
310780,202108,4361,10167,3621,9218,78,208,2934,7463,3012,7671
310790,202108,1881,5808,1617,5244,350,1211,275,773,625,1984
310800,202108,2468,7114,1804,5780,340,1330,108,273,448,1603
310810,202108,1352,3244,1119,2870,52,139,809,2005,861,2144
310820,202108,1264,3137,769,2316,162,498,172,544,334,1042
310825,202108,2697,7802,2173,6949,54,296,1783,5527,1837,5823
310830,202108,1992,5415,1463,4417,247,886,614,1726,861,2612
310840,202108,2210,5851,1677,4960,352,1193,461,1171,813,2364
310850,202108,1453,3970,1205,3611,33,152,935,2700,968,2852
310855,202108,3196,8256,2467,7076,165,545,1764,4949,1929,5494
310860,202108,7020,19877,5681,17359,565,1733,3474,10759,4039,12492
310870,202108,993,2330,785,2034,53,123,582,1506,635,1629
310880,202108,1009,2961,808,2560,110,340,455,1422,565,1762
310890,202108,2277,6399,1475,4800,257,904,227,634,484,1538
310900,202108,4030,10989,2809,8346,424,1331,1238,3401,1662,4732
310910,202108,2268,5400,1602,4359,136,438,361,906,497,1344
310920,202108,1955,4952,1488,4265,173,530,895,2515,1068,3045
310925,202108,1008,2620,826,2327,43,146,607,1629,650,1775
310930,202108,5916,14916,4166,12130,808,2329,1875,5752,2683,8081
310940,202108,6956,15881,5628,13976,183,514,4405,10676,4588,11190
310945,202108,1351,3418,1067,2967,179,516,530,1429,709,1945
310950,202108,1965,5714,1314,4270,219,779,376,1028,595,1807
310960,202108,743,1941,416,1250,76,260,82,221,158,481
310970,202108,1179,3418,833,2698,211,740,133,387,344,1127
310980,202108,328,754,195,532,21,63,113,304,134,367
310990,202108,1363,3619,1075,3137,144,440,586,1663,730,2103
311000,202108,3976,10822,2915,9096,702,2278,1183,3641,1885,5919
311010,202108,955,2586,768,2245,191,627,367,1045,558,1672
311020,202108,1194,2960,763,2180,45,133,416,1149,461,1282
311030,202108,1800,4347,1289,3512,265,817,561,1447,826,2264
311040,202108,268,829,222,731,71,245,71,216,142,461
311050,202108,3151,7557,2369,6421,357,1092,1216,3131,1573,4223
311060,202108,3410,8514,2556,6984,336,1034,1044,2610,1380,3644
311070,202108,2441,5861,1784,4865,147,524,1054,2676,1201,3200
311080,202108,1202,2663,971,2308,59,155,756,1711,815,1866
311090,202108,2283,6949,1846,6134,401,1435,590,1928,991,3363
311100,202108,2545,7000,1515,4931,273,994,300,834,573,1828
311110,202108,3765,7579,2118,5278,424,1069,673,1735,1097,2804
311115,202108,1436,3095,1214,2807,71,149,978,2253,1049,2402
311120,202108,7225,18463,5566,15546,810,2512,2123,5228,2933,7740
311130,202108,1939,4979,1471,4326,105,388,876,2493,981,2881
311140,202108,1536,3727,1230,3308,75,231,878,2331,953,2562
311150,202108,1465,4600,1143,3969,167,657,620,2097,787,2754
311160,202108,4019,11244,2880,9155,694,2384,880,2662,1574,5046
311170,202108,925,2294,734,2036,44,122,459,1351,503,1473
311180,202108,1422,3128,916,2395,187,502,379,1001,566,1503
311190,202108,894,2434,678,2019,111,384,271,690,382,1074
311200,202108,2156,5705,1551,4533,283,911,565,1495,848,2406
311205,202108,906,2573,747,2280,41,158,473,1356,514,1514
311210,202108,1051,2992,911,2792,121,324,635,2023,756,2347
311220,202108,779,2084,657,1865,36,119,450,1201,486,1320
311230,202108,8331,24096,6352,20150,1172,3880,2302,7400,3474,11280
311240,202108,1126,2840,879,2491,180,505,394,1129,574,1634
311250,202108,1226,3405,948,2880,179,539,381,1082,560,1621
311260,202108,2850,6783,1843,5047,249,769,826,1990,1075,2759
311265,202108,1332,3384,981,2801,41,151,681,1903,722,2054
311270,202108,3044,8909,2664,8296,137,565,1953,5860,2090,6425
311280,202108,1135,2907,586,1796,89,309,96,245,185,554
311290,202108,1933,5667,1762,5322,121,363,1226,3707,1347,4070
311300,202108,4880,13104,4022,11684,169,603,3221,9174,3390,9777
311310,202108,580,1577,490,1417,31,93,320,892,351,985
311320,202108,3372,9990,2917,9027,312,1136,1518,4274,1830,5410
311330,202108,5637,14105,4474,12246,466,1326,2548,7091,3014,8417
311340,202108,10967,29644,8674,25647,2039,6505,2611,7255,4650,13760
311350,202108,2525,6021,1809,4748,177,485,990,2363,1167,2848
311360,202108,1153,2756,764,2194,201,647,266,757,467,1404
311370,202108,4856,11451,3607,9519,207,681,2369,5854,2576,6535
311380,202108,382,1131,278,914,61,201,133,451,194,652
311390,202108,1811,5367,1451,4873,630,2357,371,1131,1001,3488
311400,202108,1631,4352,1192,3518,228,682,349,916,577,1598
311410,202108,1875,5301,1492,4705,221,781,848,2575,1069,3356
311420,202108,1594,4581,1145,3656,208,753,313,839,521,1592
311430,202108,4443,11365,2973,8535,452,1336,1082,3000,1534,4336
311440,202108,3083,8332,2354,7114,628,2184,485,1356,1113,3540
311450,202108,1857,5413,1350,4469,344,1285,332,926,676,2211
311455,202108,1045,2260,705,1761,147,387,309,789,456,1176
311460,202108,536,1591,355,1200,66,259,78,212,144,471
311470,202108,531,1581,359,1190,83,311,51,157,134,468
311480,202108,1132,2744,925,2425,64,149,708,1865,772,2014
311490,202108,256,743,195,629,31,126,93,265,124,391
311500,202108,485,1157,379,997,20,65,255,644,275,709
311510,202108,3410,8577,2397,6870,301,951,1058,2846,1359,3797
311520,202108,658,1774,579,1629,74,254,329,907,403,1161
311530,202108,8881,20271,5729,15289,1304,3871,1573,3967,2877,7838
311535,202108,854,2286,591,1743,93,282,221,606,314,888
311540,202108,514,1563,458,1460,62,222,331,1025,393,1247
311545,202108,2024,5675,1734,5225,92,308,1341,4002,1433,4310
311547,202108,1552,3781,1351,3478,50,115,1000,2574,1050,2689
311550,202108,2972,7953,2388,6925,336,1091,1044,2838,1380,3929
311560,202108,326,680,209,504,79,182,49,111,128,293
311570,202108,1638,3725,1160,3066,36,103,914,2448,950,2551
311580,202108,2212,4119,1500,3273,181,315,978,2168,1159,2483
311590,202108,543,1388,437,1229,81,257,240,661,321,918
311600,202108,1742,3952,1453,3571,111,289,1143,2754,1254,3043
311610,202108,2329,7140,1941,6382,156,597,1193,3829,1349,4426
311615,202108,3412,9236,2759,8179,105,372,2214,6438,2319,6810
311620,202108,442,1110,376,1031,116,365,198,494,314,859
311630,202108,1373,3713,1133,3235,126,375,694,1939,820,2314
311640,202108,728,1918,586,1699,59,203,302,803,361,1006
311650,202108,2006,4926,1620,4332,196,555,978,2524,1174,3079
311660,202108,2983,8415,2216,6890,320,1100,590,1505,910,2605
311670,202108,1640,4108,1218,3356,153,466,527,1424,680,1890
311680,202108,2268,6191,1726,5207,118,338,1232,3701,1350,4039
311690,202108,626,1317,493,1154,38,74,365,892,403,966
311700,202108,2260,5279,1788,4615,18,88,1522,3834,1540,3922
311710,202108,1571,4446,1157,3716,278,972,389,1253,667,2225
311720,202108,445,1269,355,1111,37,135,183,581,220,716
311730,202108,3663,9284,2435,6907,675,2051,546,1545,1221,3596
311740,202108,947,2393,792,2199,70,175,648,1867,718,2042
311750,202108,4033,11643,3241,10244,354,1204,2009,6113,2363,7317
311760,202108,673,1857,553,1649,67,242,290,757,357,999
311770,202108,2207,6103,1740,5294,292,901,791,2307,1083,3208
311780,202108,1428,3987,1046,3253,151,555,378,1020,529,1575
311783,202108,2347,6155,1913,5440,34,153,1559,4262,1593,4415
311787,202108,868,2428,678,1998,99,321,297,760,396,1081
311790,202108,1550,4149,1021,3162,227,762,290,850,517,1612
311800,202108,5183,15126,4155,12962,842,2745,607,1524,1449,4269
311810,202108,954,2811,752,2460,43,155,513,1650,556,1805
311820,202108,833,1965,622,1650,59,184,398,993,457,1177
311830,202108,8731,24188,6089,18570,1663,5388,779,2307,2442,7695
311840,202108,3835,9319,3107,8290,216,610,2339,6203,2555,6813
311850,202108,380,981,308,851,12,33,207,540,219,573
311860,202108,65243,159999,50505,135022,6401,18611,29529,74667,35930,93278
311870,202108,1946,5056,1372,4055,244,825,586,1570,830,2395
311880,202108,6660,16661,5589,15193,306,687,4187,11679,4493,12366
311890,202108,1757,4120,1357,3567,87,251,956,2382,1043,2633
311900,202108,775,1936,582,1674,49,159,376,1064,425,1223
311910,202108,4196,10490,3167,9138,543,1535,1604,4799,2147,6334
311920,202108,2187,5589,1764,4980,123,298,1115,3275,1238,3573
311930,202108,4117,9342,2982,7771,807,2268,1014,2483,1821,4751
311940,202108,16373,41641,12039,33547,1619,4937,5532,14346,7151,19283
311950,202108,2425,6271,1850,5316,126,397,1144,3311,1270,3708
311960,202108,501,1215,397,1062,28,96,241,581,269,677
311970,202108,432,1359,319,1076,53,221,77,219,130,440
311980,202108,473,1244,253,823,21,70,96,303,117,373
311990,202108,542,1252,341,946,61,204,140,345,201,549
311995,202108,982,2679,525,1629,17,55,76,151,93,206
312000,202108,802,1931,602,1636,55,136,383,1062,438,1198
312010,202108,1020,2708,802,2362,39,132,552,1549,591,1681
312015,202108,1415,3974,1258,3727,43,170,1028,2975,1071,3145
312020,202108,1750,5217,1265,4153,206,712,277,800,483,1512
312030,202108,2094,5015,1809,4703,14,55,1706,4431,1720,4486
312040,202108,862,2488,618,2013,79,261,271,860,350,1121
312050,202108,1234,3707,999,3258,209,831,353,1027,562,1858
312060,202108,946,2237,604,1777,146,440,256,751,402,1191
312070,202108,946,2627,677,2090,30,104,402,1168,432,1272
312080,202108,2802,6768,2136,5793,121,341,1435,3731,1556,4072
312083,202108,953,2384,734,2050,53,181,530,1431,583,1612
312087,202108,2598,6606,2105,5844,55,160,1685,4703,1740,4863
312090,202108,10932,27924,8625,24300,1130,3479,4571,12334,5701,15813
312100,202108,1613,4547,1286,3945,87,330,799,2336,886,2666
312110,202108,1070,3215,885,2850,177,664,333,971,510,1635
312120,202108,1049,2784,722,2214,182,640,215,548,397,1188
312125,202108,1830,4540,1543,4147,98,285,1195,3116,1293,3401
312130,202108,1087,2599,817,2152,71,210,370,892,441,1102
312140,202108,727,2066,599,1808,111,370,270,758,381,1128
312150,202108,485,1313,415,1177,20,61,283,747,303,808
312160,202108,9516,24950,7344,21174,829,2590,3649,10083,4478,12673
312170,202108,916,2365,709,1988,37,129,460,1242,497,1371
312180,202108,1425,3715,1147,3208,150,435,610,1669,760,2104
312190,202108,706,1907,532,1595,72,249,218,619,290,868
312200,202108,4612,12243,3646,10681,738,2057,1689,5063,2427,7120
312210,202108,1418,3080,1037,2544,46,126,788,1886,834,2012
312220,202108,1629,4950,1407,4542,99,340,911,2958,1010,3298
312230,202108,15904,39741,11023,31077,2331,7441,2816,6651,5147,14092
312235,202108,2027,4957,1597,4356,104,321,1142,3011,1246,3332
312240,202108,756,2349,582,1993,108,407,173,570,281,977
312245,202108,2776,6879,2294,6156,52,123,1932,5163,1984,5286
312247,202108,1060,2427,774,2024,111,309,454,1170,565,1479
312250,202108,979,2568,622,1855,75,234,222,634,297,868
312260,202108,981,2565,781,2264,35,134,607,1681,642,1815
312270,202108,752,2038,573,1677,32,120,314,847,346,967
312280,202108,430,1231,337,1070,90,302,56,166,146,468
312290,202108,859,2425,706,2159,124,417,236,671,360,1088
312300,202108,1022,3021,684,2198,163,579,131,346,294,925
312310,202108,991,2867,797,2479,116,395,389,1157,505,1552
312320,202108,2108,5270,1534,4289,335,969,334,924,669,1893
312330,202108,887,2520,724,2181,71,236,454,1327,525,1563
312340,202108,268,669,192,549,33,127,101,241,134,368
312350,202108,262,517,190,439,19,46,131,297,150,343
312352,202108,1598,4712,1411,4364,92,284,843,2805,935,3089
312360,202108,3152,8873,2341,7372,419,1453,840,2438,1259,3891
312370,202108,1984,4959,1630,4365,163,502,1022,2607,1185,3109
312380,202108,2229,4960,1862,4493,8,27,1663,3950,1671,3977
312385,202108,1299,3422,1004,2907,180,554,373,1104,553,1658
312390,202108,1974,5486,1450,4515,203,726,441,1207,644,1933
312400,202108,2981,8248,2499,7445,677,2204,823,2446,1500,4650
312410,202108,12587,33497,10277,29725,1715,5021,5818,16570,7533,21591
312420,202108,3995,10321,3301,9192,626,1881,1729,4650,2355,6531
312430,202108,8144,21145,6690,18596,337,1079,4841,13123,5178,14202
312440,202108,981,3107,804,2721,369,1337,128,394,497,1731
312450,202108,1241,3573,948,3058,262,883,292,991,554,1874
312460,202108,478,1178,344,975,51,140,193,563,244,703
312470,202108,484,1161,300,826,30,92,107,257,137,349
312480,202108,1058,2579,752,2129,86,281,393,1044,479,1325
312490,202108,2306,5343,1839,4691,168,480,1087,2705,1255,3185
312500,202108,1077,2569,891,2321,40,139,658,1690,698,1829
312510,202108,4177,10985,3027,8813,725,2054,751,2195,1476,4249
312520,202108,266,661,203,567,42,132,89,236,131,368
312530,202108,673,1568,572,1453,28,68,456,1207,484,1275
312540,202108,1655,4433,1140,3442,142,449,635,1854,777,2303
312550,202108,818,2113,635,1760,45,143,413,1060,458,1203
312560,202108,1989,5124,1605,4515,72,198,1184,3332,1256,3530
312570,202108,2468,5687,1851,4922,445,1172,808,2272,1253,3444
312580,202108,639,1703,444,1312,57,197,196,519,253,716
312590,202108,1628,4597,1261,3847,75,296,795,2240,870,2536
312595,202108,2113,5910,1755,5327,261,720,1041,3365,1302,4085
312600,202108,1215,2874,710,1896,112,368,123,377,235,745
312610,202108,7345,18178,4945,13810,685,2089,1765,4444,2450,6533
312620,202108,2590,6515,1920,5577,50,165,1531,4534,1581,4699
312630,202108,311,851,218,683,30,113,81,253,111,366
312640,202108,521,1405,368,1145,36,133,169,520,205,653
312650,202108,2138,5229,1498,4069,75,212,1067,2747,1142,2959
312660,202108,1354,3226,1036,2697,100,258,683,1729,783,1987
312670,202108,5173,13183,4322,11852,164,591,3249,8537,3413,9128
312675,202108,1340,3349,1099,3004,56,158,906,2448,962,2606
312680,202108,1440,3941,1243,3627,41,161,1037,2959,1078,3120
312690,202108,3052,6283,2360,5461,41,102,1985,4594,2026,4696
312695,202108,1005,2609,854,2373,49,104,663,1847,712,1951
312700,202108,2129,5468,1560,4447,134,455,927,2501,1061,2956
312705,202108,1482,3431,1279,3139,13,40,1178,2869,1191,2909
312707,202108,1455,4037,1104,3427,71,284,715,2117,786,2401
312710,202108,6759,15299,4111,11220,977,2864,1163,3308,2140,6172
312720,202108,1134,2886,845,2434,93,282,525,1452,618,1734
312730,202108,1683,3878,1192,3211,100,285,707,1851,807,2136
312733,202108,1409,3639,1063,2996,27,96,737,1946,764,2042
312735,202108,772,1977,620,1688,80,213,355,900,435,1113
312737,202108,821,1783,590,1462,60,162,399,965,459,1127
312738,202108,736,1814,532,1475,50,149,312,829,362,978
312740,202108,442,1092,260,786,47,166,61,129,108,295
312750,202108,1614,4523,1201,3745,189,614,531,1565,720,2179
312760,202108,1860,5335,1331,4228,231,754,500,1534,731,2288
312770,202108,46040,108495,29183,79795,5520,16331,10098,26542,15618,42873
312780,202108,2510,7222,2118,6581,237,752,1390,4333,1627,5085
312790,202108,257,590,138,398,1,3,41,87,42,90
312800,202108,5223,14241,4000,11934,824,2594,1614,4608,2438,7202
312810,202108,1568,4144,1053,3292,262,904,384,1092,646,1996
312820,202108,1815,4688,1468,4090,69,221,1087,2960,1156,3181
312825,202108,1419,3216,1238,2982,20,61,1076,2534,1096,2595
312830,202108,2874,7900,1770,5674,324,1172,462,1384,786,2556
312840,202108,1491,3800,1192,3323,68,242,719,1875,787,2117
312850,202108,1020,2378,723,1946,19,70,456,1130,475,1200
312860,202108,1122,2843,770,2307,187,576,180,513,367,1089
312870,202108,6304,16492,3998,12131,608,1962,1049,2898,1657,4860
312880,202108,1508,3699,1163,3127,44,130,689,1881,733,2011
312890,202108,2322,5618,1727,4662,133,330,886,2425,1019,2755
312900,202108,1283,3224,1041,2902,150,465,493,1487,643,1952
312910,202108,1583,2880,866,1949,192,368,322,761,514,1129
312920,202108,1015,2660,713,2179,118,432,272,737,390,1169
312930,202108,2498,5971,1911,5097,398,1064,850,2347,1248,3411
312940,202108,1011,2716,807,2427,60,233,471,1355,531,1588
312950,202108,3161,7619,2127,5981,447,1409,787,2099,1234,3508
312960,202108,1887,4843,1588,4396,85,208,1197,3411,1282,3619
312965,202108,1684,4491,1404,4071,118,314,963,2797,1081,3111
312970,202108,1487,4073,1201,3614,142,499,742,2116,884,2615
312980,202108,25648,68346,20683,59582,4013,12302,9390,25399,13403,37701
312990,202108,527,1270,351,976,56,183,179,445,235,628
313000,202108,488,1372,367,1151,23,105,225,662,248,767
313005,202108,2623,7341,2215,6659,137,373,1588,4721,1725,5094
313010,202108,5466,14402,4352,12641,722,2281,2569,7326,3291,9607
313020,202108,1120,3285,818,2620,131,442,171,485,302,927
313030,202108,1193,2622,812,2090,67,221,544,1330,611,1551
313040,202108,845,2539,696,2245,39,165,426,1302,465,1467
313050,202108,1815,4877,1273,4069,200,774,407,1142,607,1916
313055,202108,1979,5163,1757,4850,86,242,1490,4100,1576,4342
313060,202108,1009,2417,725,1929,140,448,159,386,299,834
313065,202108,1696,4898,1494,4571,41,143,1176,3513,1217,3656
313070,202108,967,2491,743,2118,72,217,439,1209,511,1426
313080,202108,404,1107,299,907,54,182,104,257,158,439
313090,202108,5423,13809,4604,12515,311,960,3183,8543,3494,9503
313100,202108,1355,3454,1041,3002,27,110,793,2233,820,2343
313110,202108,1516,3910,1126,3240,101,349,620,1652,721,2001
313115,202108,2895,7973,2312,6866,267,924,1260,3432,1527,4356
313120,202108,3923,9102,2888,7749,196,582,1945,5220,2141,5802
313130,202108,32898,82287,25007,68055,2456,7620,14324,36580,16780,44200
313140,202108,704,1486,448,1133,26,67,328,827,354,894
313150,202108,1409,3872,1056,3249,319,1054,176,492,495,1546
313160,202108,1273,3119,1000,2716,19,66,769,2018,788,2084
313170,202108,11517,31901,8500,26285,1311,4449,3331,9486,4642,13935
313180,202108,2271,5869,1655,4638,266,697,920,2591,1186,3288
313190,202108,4555,12787,3311,10267,563,1858,1162,3360,1725,5218
313200,202108,1156,3108,1002,2835,14,50,850,2337,864,2387
313210,202108,4070,11217,3340,9928,370,1122,2031,5889,2401,7011
313220,202108,1807,4641,1201,3451,157,504,510,1293,667,1797
313230,202108,3021,8233,2475,7555,45,154,2052,6400,2097,6554
313240,202108,10515,25239,6919,19606,941,3065,3278,8637,4219,11702
313250,202108,6367,18245,4850,14978,888,2717,2138,6350,3026,9067
313260,202108,730,1847,533,1507,65,234,269,682,334,916
313270,202108,5993,14391,4855,12849,521,1228,3424,9316,3945,10544
313280,202108,477,1298,312,961,35,118,129,379,164,497
313290,202108,1017,3072,767,2625,180,690,279,937,459,1627
313300,202108,1695,4427,1258,3675,297,933,342,879,639,1812
313310,202108,1281,3705,1008,3140,151,550,309,823,460,1373
313320,202108,2153,5602,1554,4652,266,904,584,1796,850,2700
313330,202108,4277,10910,3246,9361,143,489,2129,6101,2272,6590
313340,202108,1459,3222,1054,2662,76,209,759,1884,835,2093
313350,202108,3078,8330,2024,5998,224,757,784,1998,1008,2755
313360,202108,1575,3776,1076,2968,161,545,567,1430,728,1975
313370,202108,1580,4261,1286,3697,176,559,589,1545,765,2104
313375,202108,1882,4857,1210,3588,229,732,256,693,485,1425
313380,202108,6609,16188,4807,12950,744,2260,2353,5636,3097,7896
313390,202108,819,2566,714,2385,53,225,479,1539,532,1764
313400,202108,3798,9125,2926,7913,117,332,2256,5998,2373,6330
313410,202108,1409,3519,1068,2932,89,264,734,1937,823,2201
313420,202108,16281,35548,8604,22872,1953,5779,1134,2950,3087,8729
313430,202108,1005,2830,781,2370,112,421,374,981,486,1402
313440,202108,6308,13476,4260,10832,326,860,2829,7192,3155,8052
313450,202108,767,1998,546,1578,92,287,198,490,290,777
313460,202108,2200,6100,1742,5370,340,1183,795,2335,1135,3518
313470,202108,2927,7276,2311,6374,196,537,1582,4425,1778,4962
313480,202108,1076,2996,648,2063,49,177,223,655,272,832
313490,202108,3118,7510,1620,4780,369,1190,405,1161,774,2351
313500,202108,563,1518,412,1199,32,94,173,462,205,556
313505,202108,10450,26963,8910,24867,342,1083,7144,19968,7486,21051
313507,202108,1518,3808,1239,3376,32,131,997,2627,1029,2758
313510,202108,14746,39611,11479,33197,1347,3790,5439,15447,6786,19237
313520,202108,15223,41153,12149,35939,572,1886,9137,26462,9709,28348
313530,202108,579,1677,436,1378,48,174,144,383,192,557
313535,202108,2454,6644,2019,5828,267,694,1250,3636,1517,4330
313540,202108,834,2396,672,2018,118,367,289,784,407,1151
313545,202108,1168,3769,991,3427,120,450,547,1811,667,2261
313550,202108,1856,5468,1544,4743,284,952,832,2459,1116,3411
313560,202108,2840,5401,2130,4539,61,96,1807,3881,1868,3977
313570,202108,1029,2882,843,2556,201,625,340,1014,541,1639
313580,202108,6167,15166,4842,12982,480,1319,2970,7911,3450,9230
313590,202108,1126,3026,907,2704,175,550,458,1450,633,2000
313600,202108,4253,10848,3548,9778,84,289,3038,8229,3122,8518
313610,202108,1102,2670,889,2314,80,232,584,1434,664,1666
313620,202108,5556,14396,4365,12256,477,1544,2598,6987,3075,8531
313630,202108,9153,21503,6541,17623,614,1925,4006,10486,4620,12411
313640,202108,1259,2652,781,2050,122,342,430,1122,552,1464
313650,202108,1732,5069,1368,4460,96,363,883,2909,979,3272
313652,202108,802,2417,720,2260,84,279,488,1480,572,1759
313655,202108,1173,2866,907,2535,55,154,663,1871,718,2025
313657,202108,1192,3091,951,2709,31,111,718,1935,749,2046
313660,202108,1007,2768,820,2445,75,272,529,1511,604,1783
313665,202108,5239,13532,4179,11713,382,1193,2685,7160,3067,8353
313670,202108,52199,125402,34231,95198,4554,13840,16007,41874,20561,55714
313680,202108,1087,2815,902,2510,53,156,622,1690,675,1846
313690,202108,880,2613,648,2157,139,512,194,617,333,1129
313695,202108,1918,4949,1435,4158,105,292,911,2729,1016,3021
313700,202108,3037,9304,2656,8798,240,748,2030,6815,2270,7563
313710,202108,1521,3366,1087,2790,68,179,735,1899,803,2078
313720,202108,6180,16533,4448,12936,607,1861,1870,4978,2477,6839
313730,202108,1457,3121,1075,2630,80,165,710,1771,790,1936
313740,202108,1750,6111,1468,5383,297,1241,289,919,586,2160
313750,202108,2126,5490,1667,4709,284,896,841,2206,1125,3102
313753,202108,2285,5397,1521,4148,155,470,818,2153,973,2623
313760,202108,5846,15687,4532,13151,797,2585,2157,5782,2954,8367
313770,202108,4163,11370,3301,10005,158,460,2498,7692,2656,8152
313780,202108,4181,10739,3105,9001,252,808,966,2899,1218,3707
313790,202108,533,1555,474,1450,53,175,290,863,343,1038
313800,202108,1424,3104,1039,2583,96,261,568,1344,664,1605
313810,202108,1702,4163,1372,3701,46,154,1077,2831,1123,2985
313820,202108,18398,46219,11614,31882,1939,5442,2977,7950,4916,13392
313830,202108,412,1172,292,905,52,184,104,294,156,478
313835,202108,931,2645,770,2361,70,255,425,1215,495,1470
313840,202108,7836,19975,6068,17107,1325,4023,1322,3834,2647,7857
313850,202108,1012,2435,800,2149,138,428,375,906,513,1334
313860,202108,2737,7046,2071,5822,273,898,969,2467,1242,3365
313862,202108,1325,2748,650,1774,39,108,298,811,337,919
313865,202108,2693,6914,2227,6178,88,252,1695,4609,1783,4861
313867,202108,1428,4225,1192,3791,220,693,609,2004,829,2697
313868,202108,1754,5194,1448,4616,44,175,1111,3423,1155,3598
313870,202108,1030,2614,697,2009,92,281,276,722,368,1003
313880,202108,1919,4850,1417,3990,164,520,734,1880,898,2400
313890,202108,2180,4537,1639,3833,28,86,1274,2886,1302,2972
313900,202108,4643,12831,3322,10171,796,2675,840,2270,1636,4945
313910,202108,726,2067,547,1714,96,323,116,368,212,691
313920,202108,3028,8844,2519,7801,483,1496,1270,3964,1753,5460
313925,202108,1660,4080,1343,3541,139,356,919,2408,1058,2764
313930,202108,4888,14044,3967,12409,280,953,2610,8038,2890,8991
313940,202108,9300,26123,6920,22039,676,2606,1745,6298,2421,8904
313950,202108,5521,11855,4193,10240,301,909,2745,6759,3046,7668
313960,202108,5920,13923,3977,10673,730,2207,1261,3071,1991,5278
313970,202108,1582,4135,1331,3721,22,69,862,2358,884,2427
313980,202108,1325,3393,881,2717,140,472,366,1070,506,1542
313990,202108,2000,6130,1466,4961,307,1215,565,1695,872,2910
314000,202108,10326,25552,8538,22561,642,2081,5643,14618,6285,16699
314010,202108,1495,3505,1183,3083,34,107,915,2312,949,2419
314015,202108,2052,5495,1587,4692,176,612,902,2559,1078,3171
314020,202108,538,1424,372,1137,88,321,73,244,161,565
314030,202108,824,2286,645,1954,79,229,326,984,405,1213
314040,202108,604,1626,497,1430,81,264,257,703,338,967
314050,202108,1959,5079,1452,4141,130,433,819,2181,949,2614
314053,202108,1964,5678,1580,4930,315,950,847,2763,1162,3713
314055,202108,2300,5961,1940,5419,41,158,1612,4479,1653,4637
314060,202108,1354,3485,1029,2980,30,93,734,2100,764,2193
314070,202108,4973,13186,3932,11367,724,2078,1798,5138,2522,7216
314080,202108,2207,5558,1531,4419,162,512,681,1782,843,2294
314085,202108,2382,6341,1947,5687,188,557,1194,3527,1382,4084
314090,202108,5055,12973,4340,11921,256,795,2888,8200,3144,8995
314100,202108,3092,7346,2388,6370,37,112,1787,4800,1824,4912
314110,202108,5192,14085,4232,12298,478,1535,2339,6302,2817,7837
314120,202108,737,1686,324,941,54,177,89,246,143,423
314130,202108,669,1754,436,1328,26,93,257,759,283,852
314140,202108,4670,12677,3736,10988,480,1441,1908,5532,2388,6973
314150,202108,1539,3775,1125,3070,63,163,767,2056,830,2219
314160,202108,2362,5924,1733,4789,217,651,764,2100,981,2751
314170,202108,955,2605,780,2267,40,150,518,1402,558,1552
314180,202108,5688,15283,4587,13525,353,1081,2794,8263,3147,9344
314190,202108,646,1577,482,1340,74,236,257,664,331,900
314200,202108,3102,8444,2566,7550,173,533,1777,5118,1950,5651
314210,202108,2159,5456,1711,4663,230,662,776,2052,1006,2714
314220,202108,1521,4036,1154,3411,226,747,451,1227,677,1974
314225,202108,1124,3157,936,2835,71,183,665,2035,736,2218
314230,202108,849,2135,688,1927,77,221,443,1280,520,1501
314240,202108,1126,2944,872,2555,186,567,355,1045,541,1612
314250,202108,499,1389,318,1004,49,139,113,333,162,472
314260,202108,1038,2663,801,2347,152,491,427,1219,579,1710
314270,202108,3356,9240,2761,8318,66,263,2068,6169,2134,6432
314280,202108,3570,8083,2426,6354,260,762,1400,3454,1660,4216
314290,202108,4607,11638,3821,10248,330,885,2604,6842,2934,7727
314300,202108,2095,5774,1364,4229,233,793,473,1312,706,2105
314310,202108,4004,10283,2687,8024,799,2656,410,1050,1209,3706
314315,202108,1004,3161,856,2852,42,173,613,1992,655,2165
314320,202108,3225,8574,2131,6536,364,1226,795,2303,1159,3529
314330,202108,52268,142781,39841,121068,10002,31632,8664,27447,18666,59079
314340,202108,2548,6272,1615,4619,298,980,407,1015,705,1995
314345,202108,1493,4254,1205,3734,134,416,748,2294,882,2710
314350,202108,839,2238,547,1705,120,383,128,329,248,712
314360,202108,560,1613,362,1197,53,181,121,360,174,541
314370,202108,774,2000,624,1779,50,152,416,1156,466,1308
314380,202108,1164,3085,768,2394,171,610,169,501,340,1111
314390,202108,14908,36542,9989,27804,1505,4556,3535,8715,5040,13271
314400,202108,4009,11774,3086,9950,786,2659,1137,3837,1923,6496
314410,202108,2870,7897,2021,6300,253,920,624,2014,877,2934
314420,202108,856,2072,629,1707,33,118,429,1109,462,1227
314430,202108,8222,19314,5786,15341,831,2311,2779,6998,3610,9309
314435,202108,1962,5142,1527,4427,158,472,930,2642,1088,3114
314437,202108,931,2315,670,1896,70,209,350,982,420,1191
314440,202108,637,1790,454,1430,141,494,87,212,228,706
314450,202108,1481,3827,1238,3430,136,403,694,1853,830,2256
314460,202108,3240,9650,2384,7903,578,2051,594,1858,1172,3909
314465,202108,2280,6393,1936,5756,45,148,1511,4387,1556,4535
314467,202108,917,2367,775,2142,18,49,617,1658,635,1707
314470,202108,2438,6747,2015,5908,340,1070,943,2566,1283,3636
314480,202108,7796,21112,5879,17157,908,2946,2363,6064,3271,9010
314490,202108,1135,2887,833,2280,63,186,548,1455,611,1641
314500,202108,1701,4004,1238,3396,313,822,426,1235,739,2057
314505,202108,2139,5063,1754,4523,89,250,1317,3291,1406,3541
314510,202108,2095,5305,1482,4373,294,964,675,1929,969,2893
314520,202108,5439,16067,4181,13578,837,2981,683,1964,1520,4945
314530,202108,5552,17262,4977,16184,302,1167,3710,11792,4012,12959
314535,202108,2636,6649,2153,5953,78,268,1687,4640,1765,4908
314537,202108,1178,3271,909,2837,50,170,662,2024,712,2194
314540,202108,419,1027,292,820,22,65,172,461,194,526
314545,202108,2023,4684,1817,4448,31,80,1592,3981,1623,4061
314550,202108,745,1747,545,1447,33,111,328,798,361,909
314560,202108,4769,13759,3506,11017,479,1726,1329,3663,1808,5389
314570,202108,322,879,234,719,29,97,110,341,139,438
314580,202108,462,1359,369,1177,96,308,123,391,219,699
314585,202108,675,2039,517,1694,53,205,238,757,291,962
314587,202108,2186,5775,1677,4971,312,872,914,2748,1226,3620
314590,202108,4323,11342,3212,9323,400,1290,1507,3995,1907,5285
314600,202108,1982,5244,1202,3780,255,831,136,419,391,1250
314610,202108,9381,22721,6799,18950,952,3140,3140,8908,4092,12048
314620,202108,2337,5319,1860,4719,43,127,1570,3966,1613,4093
314625,202108,1595,4222,1370,3910,26,145,1188,3321,1214,3466
314630,202108,5624,13679,4596,12301,104,397,3816,10139,3920,10536
314640,202108,723,1679,534,1386,62,187,316,758,378,945
314650,202108,849,1944,537,1455,49,155,307,737,356,892
314655,202108,1598,4324,1145,3528,165,477,575,1812,740,2289
314660,202108,338,758,229,571,12,26,150,364,162,390
314670,202108,1683,3737,1171,3004,19,53,800,2010,819,2063
314675,202108,1755,4466,1487,4026,68,199,1177,3112,1245,3311
314690,202108,2114,5673,1598,4916,388,1304,574,1754,962,3058
314700,202108,11375,30484,7658,23502,1322,4401,2814,8301,4136,12702
314710,202108,8385,22954,6163,18327,928,3076,2357,6091,3285,9167
314720,202108,2273,6609,1593,5213,291,1024,363,1095,654,2119
314730,202108,2439,6224,1762,5021,293,901,642,1675,935,2576
314740,202108,3111,8586,2439,7382,325,1014,1248,3667,1573,4681
314750,202108,293,788,223,644,27,90,134,339,161,429
314760,202108,2025,5838,1312,4256,233,841,316,797,549,1638
314770,202108,1116,3161,632,1983,66,213,192,545,258,758
314780,202108,368,890,252,707,38,123,142,353,180,476
314790,202108,12446,32186,8848,25609,1546,5057,3561,9536,5107,14593
314795,202108,1588,4075,1346,3667,28,116,1084,2836,1112,2952
314800,202108,11296,28280,7172,20778,1236,3849,1934,4973,3170,8822
314810,202108,9457,24456,6916,20123,1777,5464,2203,6267,3980,11731
314820,202108,1287,3042,1007,2607,66,212,631,1547,697,1759
314830,202108,1692,4855,1409,4340,201,659,729,2181,930,2840
314840,202108,869,2656,676,2314,48,211,461,1498,509,1709
314850,202108,2317,5042,1876,4496,51,141,1620,3867,1671,4008
314860,202108,3371,9486,2815,8497,146,579,2026,5943,2172,6522
314870,202108,6644,15782,5042,13745,226,625,3763,10421,3989,11046
314875,202108,1900,5514,1683,5226,177,445,1312,4230,1489,4675
314880,202108,860,2050,667,1751,42,115,410,1084,452,1199
314890,202108,445,1303,343,1095,53,182,148,445,201,627
314900,202108,830,2122,638,1789,86,269,294,787,380,1056
314910,202108,1714,4734,1276,4016,197,723,660,1942,857,2665
314915,202108,2213,6418,1861,5795,120,359,1223,3750,1343,4109
314920,202108,508,1307,344,1062,16,42,224,710,240,752
314930,202108,5869,16153,4478,13553,720,2444,1873,5181,2593,7625
314940,202108,428,1010,355,892,38,88,230,558,268,646
314950,202108,580,1424,399,1141,26,85,217,574,243,659
314960,202108,876,2019,669,1685,26,79,489,1162,515,1241
314970,202108,1018,2975,788,2504,127,443,358,1027,485,1470
314980,202108,1656,4127,1259,3544,207,652,644,1758,851,2410
314990,202108,2617,7479,1875,5801,360,1144,410,1153,770,2297
314995,202108,1695,4600,1354,3996,28,109,921,2560,949,2669
315000,202108,1146,2862,823,2364,60,172,536,1522,596,1694
315010,202108,383,1039,296,890,49,173,147,415,196,588
315015,202108,2340,6417,2032,5900,189,632,1360,3871,1549,4503
315020,202108,807,2326,574,1815,60,223,255,754,315,977
315030,202108,623,1622,422,1258,94,293,87,222,181,515
315040,202108,931,2450,762,2157,101,324,478,1291,579,1615
315050,202108,1275,3151,943,2631,52,181,524,1384,576,1565
315053,202108,1178,2995,890,2506,53,149,524,1403,577,1552
315057,202108,1832,5278,1481,4700,141,401,984,3251,1125,3652
315060,202108,619,1821,455,1492,91,298,115,366,206,664
315070,202108,570,1447,410,1176,95,294,133,358,228,652
315080,202108,3243,8610,2535,7327,134,420,1771,4868,1905,5288
315090,202108,829,2438,620,2044,82,301,264,829,346,1130
315100,202108,1392,3965,917,2901,125,470,406,1116,531,1586
315110,202108,2112,4893,1535,4035,137,352,795,2137,932,2489
315120,202108,13143,29718,9749,24691,1166,2675,5518,14462,6684,17137
315130,202108,1712,4587,1431,4115,141,463,611,1632,752,2095
315140,202108,3020,8196,2389,7086,437,1437,1199,3330,1636,4767
315150,202108,4498,10710,3202,8660,434,1372,1553,4097,1987,5469
315160,202108,1877,4521,1276,3579,262,792,577,1571,839,2363
315170,202108,1393,4319,989,3351,204,751,275,877,479,1628
315180,202108,18176,43291,10391,29184,1308,4146,3590,8823,4898,12969
315190,202108,2282,4923,1778,4266,240,575,1229,3002,1469,3577
315200,202108,4169,11433,3076,9558,829,2797,782,2346,1611,5143
315210,202108,9130,23029,6398,17453,673,1983,3285,8081,3958,10064
315213,202108,1141,2956,991,2747,21,74,821,2221,842,2295
315217,202108,2933,8160,2228,6981,76,287,1508,4544,1584,4831
315220,202108,8865,23485,7014,20294,1002,3000,3333,9648,4335,12648
315230,202108,3101,7018,2586,6327,210,332,1817,4829,2027,5161
315240,202108,2506,7101,2086,6386,438,1400,985,3034,1423,4434
315250,202108,14288,37593,10476,30517,1590,4977,4464,12347,6054,17324
315260,202108,917,2447,512,1620,83,261,37,107,120,368
315270,202108,900,2544,660,2092,87,295,232,642,319,937
315280,202108,2935,7243,1847,5321,457,1394,322,917,779,2311
315290,202108,1200,2911,725,2156,184,608,213,618,397,1226
315300,202108,660,1592,473,1328,56,175,275,776,331,951
315310,202108,1274,3466,974,2912,69,223,568,1589,637,1812
315320,202108,674,1938,474,1537,68,245,192,572,260,817
315330,202108,776,2555,443,1669,67,289,153,505,220,794
315340,202108,3031,7213,2153,5906,348,969,1059,2873,1407,3842
315350,202108,1642,4356,1324,3863,155,523,800,2286,955,2809
315360,202108,1809,5161,1402,4349,197,642,609,1737,806,2379
315370,202108,559,1512,449,1309,80,226,207,590,287,816
315380,202108,270,753,197,595,32,112,29,72,61,184
315390,202108,1196,3286,968,2879,124,449,506,1372,630,1821
315400,202108,4202,11086,3326,9541,385,1180,1943,5298,2328,6478
315410,202108,2572,5697,1920,4746,390,1065,405,1037,795,2102
315415,202108,1482,3932,1198,3493,253,858,425,1235,678,2093
315420,202108,1522,4166,1064,3303,186,611,239,693,425,1304
315430,202108,3752,8965,2659,7335,442,1416,1189,3104,1631,4520
315440,202108,1084,2797,858,2427,74,249,506,1329,580,1578
315445,202108,2009,4700,1463,3926,86,265,1096,2898,1182,3163
315450,202108,2373,6328,1940,5615,260,656,1188,3490,1448,4146
315460,202108,40913,109515,33850,97097,4350,14162,19596,52548,23946,66710
315470,202108,681,1838,487,1378,38,123,274,731,312,854
315480,202108,1176,3301,850,2625,142,446,292,867,434,1313
315490,202108,2998,7428,2110,6021,272,792,825,2233,1097,3025
315500,202108,544,1425,343,996,41,142,176,442,217,584
315510,202108,1306,3295,1101,3012,14,52,978,2632,992,2684
315520,202108,1034,2743,850,2449,46,148,663,1862,709,2010
315530,202108,632,1708,507,1488,111,377,273,744,384,1121
315540,202108,1651,4265,1133,3312,90,298,515,1447,605,1745
315550,202108,1905,4948,1255,3758,243,839,329,975,572,1814
315560,202108,6553,19154,5583,17428,320,931,3804,12032,4124,12963
315570,202108,2168,5650,1721,4902,165,514,884,2425,1049,2939
315580,202108,3213,7374,2483,6226,382,1027,953,2254,1335,3281
315590,202108,949,2312,741,1998,53,173,478,1211,531,1384
315600,202108,2606,7803,1838,6300,306,945,895,3292,1201,4237
315610,202108,1027,2522,772,2074,102,341,363,840,465,1181
315620,202108,540,1400,411,1210,48,153,226,668,274,821
315630,202108,1095,2811,831,2334,117,362,408,1049,525,1411
315640,202108,359,868,269,757,28,100,166,445,194,545
315645,202108,1017,2574,710,2076,151,481,191,520,342,1001
315650,202108,1739,4105,1407,3645,44,125,1122,2838,1166,2963
315660,202108,2476,6034,1853,4964,88,265,1340,3448,1428,3713
315670,202108,14539,38520,11146,32470,2029,6193,5169,14331,7198,20524
315680,202108,3295,9147,2457,7580,251,928,1400,4075,1651,5003
315690,202108,3757,9007,2311,6570,491,1383,586,1820,1077,3203
315700,202108,8674,23105,6568,19030,967,2938,2963,8164,3930,11102
315710,202108,1903,4552,1366,3752,53,174,958,2573,1011,2747
315720,202108,4550,12312,3772,10930,175,665,2681,7466,2856,8131
315725,202108,2311,5821,1767,4953,223,591,1066,3141,1289,3732
315727,202108,579,1449,442,1233,52,175,194,506,246,681
315730,202108,612,1822,532,1668,93,332,178,490,271,822
315733,202108,1356,3348,1018,2794,151,468,386,985,537,1453
315737,202108,1206,3276,949,2781,26,99,682,1915,708,2014
315740,202108,826,2253,669,1937,63,204,446,1206,509,1410
315750,202108,1295,3319,1037,2920,90,258,652,1852,742,2110
315760,202108,1192,2749,1038,2541,47,149,862,2057,909,2206
315765,202108,2022,5183,1659,4711,28,103,1472,4158,1500,4261
315770,202108,1045,2813,809,2483,317,1064,162,444,479,1508
315780,202108,31899,84542,26660,75249,1398,4805,18458,49453,19856,54258
315790,202108,3695,11126,3148,10117,306,1025,1935,6371,2241,7396
315800,202108,1361,4484,1023,3662,136,540,378,1174,514,1714
315810,202108,1350,3306,1112,2905,59,177,866,2189,925,2366
315820,202108,2677,6906,2136,6156,195,585,1503,4348,1698,4933
315830,202108,1250,3616,845,2724,88,307,273,740,361,1047
315840,202108,912,2155,646,1690,46,151,345,814,391,965
315850,202108,1233,3475,974,3030,176,568,490,1445,666,2013
315860,202108,505,1405,354,1143,55,194,124,350,179,544
315870,202108,486,1282,388,1123,26,82,271,754,297,836
315880,202108,1153,2859,799,2234,91,273,238,618,329,891
315890,202108,1753,4848,1422,4394,349,1200,710,2166,1059,3366
315895,202108,6518,17248,4888,14090,448,1447,2541,6806,2989,8253
315900,202108,829,2100,712,1934,61,166,525,1394,586,1560
315910,202108,543,1448,457,1318,70,196,300,870,370,1066
315920,202108,1485,3717,844,2511,126,453,277,728,403,1181
315930,202108,1139,2472,778,1959,139,328,349,895,488,1223
315935,202108,908,2663,722,2310,137,457,262,824,399,1281
315940,202108,629,1665,497,1467,66,201,260,740,326,941
315950,202108,1167,3194,965,2865,94,275,738,2193,832,2468
315960,202108,5793,15880,3984,12262,1052,3538,550,1189,1602,4727
315970,202108,600,1564,479,1403,61,180,313,939,374,1119
315980,202108,4425,9330,2475,6189,460,1217,959,2180,1419,3397
315990,202108,3639,9176,2845,7811,328,915,1563,4152,1891,5067
316000,202108,666,1598,511,1372,52,167,274,693,326,860
316010,202108,825,2218,618,1857,58,192,317,854,375,1046
316020,202108,965,2795,772,2420,113,394,422,1234,535,1628
316030,202108,2814,7713,2168,6547,243,742,1375,4238,1618,4980
316040,202108,2686,7478,2000,6182,326,1163,574,1533,900,2696
316045,202108,2123,5359,1954,5154,81,155,1706,4611,1787,4766
316050,202108,414,1120,326,974,50,138,177,496,227,634
316060,202108,706,1693,518,1445,17,68,371,993,388,1061
316070,202108,5629,15145,4596,13236,807,2308,2129,5948,2936,8256
316080,202108,768,2331,600,1992,146,528,93,254,239,782
316090,202108,422,1167,329,988,44,141,168,461,212,602
316095,202108,1348,4082,1051,3337,268,916,381,1135,649,2051
316100,202108,2544,7206,1860,5799,308,1056,712,2005,1020,3061
316105,202108,860,2215,702,1966,44,137,480,1379,524,1516
316110,202108,14299,39643,11958,35740,818,2712,8296,24432,9114,27144
316120,202108,1285,3476,847,2496,127,391,282,654,409,1045
316130,202108,1277,2867,848,2162,68,198,507,1242,575,1440
316140,202108,1269,3318,800,2434,84,277,371,1114,455,1391
316150,202108,2159,4700,1728,4106,211,619,787,1764,998,2383
316160,202108,1056,2768,848,2392,37,123,608,1672,645,1795
316165,202108,894,2132,706,1848,116,345,398,979,514,1324
316170,202108,1268,3064,963,2612,37,110,687,1782,724,1892
316180,202108,1519,4183,1056,3280,155,539,259,724,414,1263
316190,202108,2787,7736,1669,5089,242,778,654,1768,896,2546
316200,202108,3379,9470,2605,8137,549,1824,829,2506,1378,4330
316210,202108,4886,14089,3460,10767,1132,3895,200,480,1332,4375
316220,202108,671,2005,452,1535,87,332,57,224,144,556
316225,202108,1622,3626,1219,2994,49,178,934,2137,983,2315
316230,202108,446,1191,346,1022,58,181,169,495,227,676
316240,202108,5707,16183,4991,14914,367,1175,3770,11103,4137,12278
316245,202108,3295,10092,2992,9586,106,561,2406,7380,2512,7941
316250,202108,11166,26178,8291,21638,1648,4617,3121,8055,4769,12672
316255,202108,2976,8077,2607,7506,109,311,1981,5785,2090,6096
316257,202108,1441,3390,1050,2723,94,260,666,1642,760,1902
316260,202108,2340,5593,1849,4824,218,555,995,2652,1213,3207
316265,202108,1156,3069,904,2638,17,59,685,1956,702,2015
316270,202108,3849,11461,3303,10309,490,1595,1700,5085,2190,6680
316280,202108,3056,8256,2609,7453,340,1046,1416,3900,1756,4946
316290,202108,3679,9933,2980,8627,367,1143,1172,3269,1539,4412
316292,202108,5514,14193,4408,12407,562,1634,2784,7574,3346,9208
316294,202108,887,2579,674,2213,119,462,174,522,293,984
316295,202108,3465,9515,2828,8421,147,543,1987,5636,2134,6179
316300,202108,1049,2877,834,2536,33,110,590,1773,623,1883
316310,202108,819,2158,551,1680,121,423,109,276,230,699
316320,202108,707,1927,554,1692,53,186,268,795,321,981
316330,202108,1114,2815,854,2384,53,164,651,1774,704,1938
316340,202108,1012,2674,754,2211,82,299,417,1156,499,1455
316350,202108,1370,3719,1130,3316,156,461,682,1990,838,2451
316360,202108,646,1690,540,1517,47,143,406,1140,453,1283
316370,202108,5742,14345,4403,12019,598,1881,2107,5140,2705,7021
316380,202108,1775,4224,1400,3680,57,116,967,2561,1024,2677
316390,202108,797,2128,573,1735,238,818,81,208,319,1026
316400,202108,1233,3413,817,2592,104,363,288,812,392,1175
316410,202108,1160,3123,971,2836,56,182,787,2240,843,2422
316420,202108,2012,5373,1756,5046,39,135,1443,4063,1482,4198
316430,202108,904,2285,604,1784,97,330,249,660,346,990
316440,202108,849,2552,678,2251,119,453,196,586,315,1039
316443,202108,567,1550,415,1260,96,332,106,303,202,635
316447,202108,2102,5446,1824,5009,24,78,1600,4340,1624,4418
316450,202108,2229,6504,1714,5444,247,822,969,2994,1216,3816
316460,202108,1306,3281,1066,2910,115,346,701,1824,816,2170
316470,202108,7328,20495,5337,16357,794,2712,2148,5955,2942,8667
316480,202108,202,546,175,510,49,139,75,218,124,357
316490,202108,334,880,235,698,38,116,80,201,118,317
316500,202108,1253,3788,836,2807,175,648,192,591,367,1239
316510,202108,818,2567,654,2242,104,362,334,1154,438,1516
316520,202108,1399,3313,1099,2832,121,384,599,1392,720,1776
316530,202108,1167,2988,844,2411,85,318,443,1128,528,1446
316540,202108,973,2414,780,2121,106,314,425,1058,531,1372
316550,202108,1391,3954,1191,3593,40,148,932,2787,972,2935
316553,202108,4584,13147,3326,10196,444,1498,1363,3684,1807,5182
316555,202108,2748,8150,2471,7774,87,277,2091,6622,2178,6899
316556,202108,535,1296,413,1076,24,67,256,598,280,665
316557,202108,1099,3295,957,3072,312,1092,348,1066,660,2158
316560,202108,347,946,246,795,37,134,98,296,135,430
316570,202108,1403,3891,1168,3473,290,858,388,1212,678,2070
316580,202108,408,847,258,609,33,85,136,300,169,385
316590,202108,1388,3480,973,2686,219,524,454,1245,673,1769
316600,202108,954,2872,818,2598,133,430,416,1325,549,1755
316610,202108,606,1857,495,1681,50,217,298,977,348,1194
316620,202108,2194,5550,1924,5169,85,245,1550,4147,1635,4392
316630,202108,1611,4703,1337,4193,350,1109,505,1759,855,2868
316640,202108,141,366,113,328,16,57,55,134,71,191
316650,202108,1093,3297,879,2965,83,305,552,1863,635,2168
316660,202108,196,466,82,236,10,32,17,35,27,67
316670,202108,1800,4464,1362,3779,340,979,430,1153,770,2132
316680,202108,2355,5899,1744,4753,106,307,1292,3431,1398,3738
316690,202108,1463,4024,1109,3388,185,605,487,1435,672,2040
316695,202108,1052,2987,871,2665,31,112,603,1825,634,1937
316700,202108,412,922,338,839,14,40,272,652,286,692
316710,202108,3319,10405,2610,8951,432,1604,1189,3957,1621,5561
316720,202108,21875,58154,16344,47720,2681,8368,7255,19892,9936,28260
316730,202108,488,1245,392,1071,36,118,202,510,238,628
316740,202108,789,2215,684,2050,76,261,432,1307,508,1568
316750,202108,412,1162,316,986,72,234,129,379,201,613
316760,202108,3558,11131,2986,10015,1137,4174,754,2403,1891,6577
316770,202108,1665,3642,1261,3103,30,82,1022,2572,1052,2654
316780,202108,561,1613,444,1389,161,543,93,262,254,805
316790,202108,762,2026,557,1621,101,325,160,430,261,755
316800,202108,6671,18182,5348,15795,640,2058,2549,7339,3189,9397
316805,202108,1079,2326,870,2097,56,156,678,1636,734,1792
316810,202108,629,1720,453,1390,77,261,255,754,332,1015
316820,202108,324,757,175,492,17,64,76,198,93,262
316830,202108,854,2152,676,1870,75,204,410,1133,485,1337
316840,202108,2883,7204,2293,6236,180,591,1640,4251,1820,4842
316850,202108,2020,5156,1488,4216,230,713,694,1834,924,2547
316860,202108,20596,51308,15133,43125,2250,7443,6989,19230,9239,26673
316870,202108,8323,21944,6229,17967,866,2735,2916,7834,3782,10569
316880,202108,1015,2654,831,2386,141,451,443,1205,584,1656
316890,202108,1196,2637,728,2022,83,298,468,1223,551,1521
316900,202108,2440,6389,1926,5388,393,1163,595,1562,988,2725
316905,202108,521,1530,419,1331,111,382,169,542,280,924
316910,202108,905,2318,551,1696,124,420,51,146,175,566
316920,202108,1850,4449,1320,3664,206,617,684,1845,890,2462
316930,202108,8406,23396,6357,19740,1461,4811,1786,5206,3247,10017
316935,202108,4319,11355,3180,9262,549,1753,1288,3466,1837,5219
316940,202108,6666,19086,5198,16111,739,2492,2240,6421,2979,8913
316950,202108,1985,4497,1542,3895,43,124,1293,3230,1336,3354
316960,202108,5267,11608,3800,9649,362,995,2592,6436,2954,7431
316970,202108,3977,10846,3433,9851,491,1437,1517,4111,2008,5548
316980,202108,709,2086,539,1763,166,606,74,245,240,851
316990,202108,12813,33510,9516,26937,2193,6692,1591,4114,3784,10806
317000,202108,2535,7290,2222,6845,173,426,1650,5174,1823,5600
317005,202108,2646,7202,2106,6132,327,980,1150,3284,1477,4264
317010,202108,25335,58664,16137,44648,2914,8947,6489,18057,9403,27004
317020,202108,64205,150972,38500,106724,6861,20819,12692,32356,19553,53175
317030,202108,697,1805,548,1600,12,43,423,1223,435,1266
317040,202108,11424,28165,8047,22440,1696,5087,2826,8099,4522,13186
317043,202108,913,2004,658,1647,48,124,485,1192,533,1316
317047,202108,1200,2869,832,2286,67,206,540,1428,607,1634
317050,202108,1252,3785,915,3005,118,430,373,1050,491,1480
317052,202108,2447,6601,1964,5835,261,741,1224,3677,1485,4418
317057,202108,2050,4573,1514,3754,30,104,1088,2620,1118,2724
317060,202108,541,1388,338,982,41,126,139,360,180,486
317065,202108,1174,3392,966,2993,61,177,611,1807,672,1984
317070,202108,7639,20871,5602,16967,918,3085,1894,5366,2812,8451
317075,202108,969,2450,726,2048,87,277,378,977,465,1254
317080,202108,6487,14767,4828,12158,1200,3292,1742,4254,2942,7546
317090,202108,4943,13871,4371,12954,292,779,3244,9683,3536,10462
317100,202108,2709,6351,1774,4823,407,1135,653,1758,1060,2893
317103,202108,2336,5923,2000,5449,68,294,1606,4210,1674,4504
317107,202108,1509,3917,1151,3267,70,224,700,1796,770,2020
317110,202108,679,1570,352,1056,64,222,108,331,172,553
317115,202108,1103,3141,943,2843,68,199,623,1881,691,2080
317120,202108,17097,44632,13979,39616,1056,3571,9047,24362,10103,27933
317130,202108,12062,27469,7991,20848,1167,3369,2920,7471,4087,10840
317140,202108,946,2219,740,1905,50,143,509,1333,559,1476
317150,202108,1000,2371,768,2077,31,92,610,1623,641,1715
317160,202108,3693,8613,2471,6705,134,387,1367,3830,1501,4217
317170,202108,1877,4633,1383,3786,172,562,680,1642,852,2204
317180,202108,2051,6212,1506,4916,286,969,395,1167,681,2136
317190,202108,1225,3266,907,2740,206,606,396,1196,602,1802
317200,202108,6294,16416,4695,13250,1003,3028,1152,2962,2155,5990
317210,202108,1228,2911,952,2536,28,104,698,1884,726,1988
317220,202108,285,834,241,753,47,159,111,343,158,502
320010,202108,4877,13844,3831,11726,417,1407,2358,6970,2775,8377
320013,202108,2164,5722,1505,4429,233,690,676,2079,909,2769
320016,202108,3098,7763,2441,6766,204,537,1750,4887,1954,5424
320020,202108,4246,10773,3158,8891,616,1929,1234,3515,1850,5444
320030,202108,1801,4934,1187,3695,217,726,414,1224,631,1950
320035,202108,2001,5308,1641,4702,380,1216,776,2119,1156,3335
320040,202108,4563,12593,3799,11221,515,1586,2124,6001,2639,7587
320050,202108,1794,4028,1550,3686,186,517,924,2118,1110,2635
320060,202108,14297,38054,10611,30584,1607,4969,4905,13116,6512,18085
320070,202108,1707,4609,1223,3651,198,669,483,1296,681,1965
320080,202108,6007,15128,4202,11547,825,2379,1531,3958,2356,6337
320090,202108,9026,23485,5989,17285,1325,4070,2119,5639,3444,9709
320100,202108,3315,8736,2715,7710,429,1293,1446,4100,1875,5393
320110,202108,2229,5087,1558,4028,194,537,838,2058,1032,2595
320115,202108,2131,6558,1823,6049,772,2680,517,1798,1289,4478
320120,202108,25947,64880,18328,51234,2485,7431,8721,22918,11206,30349
320130,202108,52363,140364,43134,123707,5078,15880,25886,71470,30964,87350
320140,202108,3843,10332,2593,7855,364,1286,1092,3191,1456,4477
320150,202108,14869,37714,10680,29839,2568,7902,1544,3838,4112,11740
320160,202108,6673,18046,4962,14795,759,2445,2169,6337,2928,8782
320170,202108,1843,5175,1341,4169,362,1103,482,1617,844,2720
320180,202108,711,2220,569,1946,195,725,147,445,342,1170
320190,202108,3051,9458,2352,7923,582,2104,573,1763,1155,3867
320200,202108,1408,3746,962,2944,215,729,317,937,532,1666
320210,202108,4590,11472,3527,9671,581,1712,1781,4638,2362,6350
320220,202108,3485,8775,2698,7478,373,1127,1527,3970,1900,5097
320225,202108,1448,4413,1034,3441,358,1287,210,681,568,1968
320230,202108,5484,14660,4152,12412,860,2772,1538,4470,2398,7242
320240,202108,17644,43695,13190,36572,3214,9678,3955,10859,7169,20537
320245,202108,3281,9452,2535,7943,850,2833,397,1209,1247,4042
320250,202108,2753,7366,1855,5309,402,1291,607,1487,1009,2778
320255,202108,2015,6104,1729,5578,432,1455,778,2549,1210,4004
320260,202108,1507,4137,910,2821,182,619,224,563,406,1182
320265,202108,2517,7647,2016,6625,847,3002,294,930,1141,3932
320270,202108,2345,6591,1817,5545,455,1518,609,1845,1064,3363
320280,202108,7967,20607,6538,18194,1248,3695,3348,9006,4596,12701
320290,202108,1430,4163,925,2971,237,831,217,648,454,1479
320300,202108,4071,11858,3227,10145,861,2978,960,2819,1821,5797
320305,202108,5440,15038,4192,12597,742,2428,2006,5834,2748,8262
320310,202108,2389,6363,1672,4879,296,925,727,1986,1023,2911
320313,202108,2593,6261,1757,4749,337,998,489,1161,826,2159
320316,202108,1599,4440,1310,3941,211,641,730,2191,941,2832
320320,202108,23684,60547,16841,48668,3863,11567,5874,17011,9737,28578
320330,202108,3067,8152,2384,6921,409,1229,1258,3678,1667,4907
320332,202108,8663,22837,6876,19501,1452,4420,3022,8294,4474,12714
320334,202108,1887,5194,1309,4019,271,986,317,727,588,1713
320335,202108,1635,4664,1154,3562,224,801,320,908,544,1709
320340,202108,5219,12636,4304,11290,522,1452,2488,6599,3010,8051
320350,202108,5711,13734,4041,10788,439,1303,2210,5459,2649,6762
320360,202108,1486,3763,1094,3040,137,380,517,1388,654,1768
320370,202108,2705,8110,1992,6578,597,2126,581,1881,1178,4007
320380,202108,2817,7286,2328,6494,262,785,1433,3904,1695,4689
320390,202108,7807,20393,5738,16298,1175,3574,2274,6009,3449,9583
320400,202108,3477,9616,2560,7672,709,2253,782,2213,1491,4466
320405,202108,5496,13951,4180,11633,578,1768,2182,5836,2760,7604
320410,202108,5042,12739,3792,10706,674,1836,1849,5442,2523,7278
320420,202108,3571,8945,2736,7545,550,1692,863,2241,1413,3933
320425,202108,2287,5404,1742,4481,141,365,1059,2660,1200,3025
320430,202108,3393,8359,2696,7134,380,1048,1618,4105,1998,5153
320435,202108,2271,6958,1746,5831,609,2174,534,1771,1143,3945
320440,202108,1617,4388,1197,3572,188,598,526,1472,714,2070
320450,202108,1903,5317,1486,4535,268,938,677,1920,945,2858
320455,202108,4685,13918,3187,10366,740,2616,789,2274,1529,4890
320460,202108,2255,6496,1626,5179,380,1321,434,1263,814,2584
320465,202108,1455,3939,1097,3264,158,472,576,1745,734,2217
320470,202108,3903,10462,2838,8251,568,1790,774,2029,1342,3819
320480,202108,1979,5085,1601,4449,176,551,1024,2757,1200,3308
320490,202108,24792,61884,18563,51076,3027,8724,8106,22052,11133,30776
320495,202108,1433,3847,1040,3083,248,832,311,840,559,1672
320500,202108,55271,144676,44290,125840,5815,17905,25897,70345,31712,88250
320501,202108,4828,13758,3588,11476,976,3508,1054,3282,2030,6790
320503,202108,2398,6773,1553,5009,448,1558,378,1185,826,2743
320506,202108,2828,8329,2074,6646,630,2173,173,564,803,2737
320510,202108,11562,30345,9420,26705,963,3093,5850,15878,6813,18971
320515,202108,1873,5088,1456,4232,366,1177,474,1296,840,2473
320517,202108,2269,6661,1815,5684,534,1821,574,1756,1108,3577
320520,202108,40384,101750,30434,85005,4785,14791,13378,35611,18163,50402
320530,202108,36349,93041,28862,79900,2378,7700,18472,48041,20850,55741
330010,202108,25326,64171,21067,57251,2243,6708,14601,38359,16844,45067
330015,202108,1458,3487,1153,3049,195,573,659,1675,854,2248
330020,202108,20571,50338,17315,45687,2330,6755,12005,31067,14335,37822
330022,202108,1992,5246,1556,4537,248,705,860,2518,1108,3223
330023,202108,5833,13301,4435,11387,645,1829,2684,6682,3329,8511
330025,202108,7421,16695,4516,11943,937,2732,1140,2802,2077,5534
330030,202108,10809,28160,8287,24157,773,2655,5238,14500,6011,17155
330040,202108,16028,40500,12906,35351,967,3026,9011,23635,9978,26661
330045,202108,90531,207039,74846,187287,5572,13488,59755,148965,65327,162453
330050,202108,2832,7234,2139,6084,386,1188,1127,3033,1513,4221
330060,202108,5604,14212,4395,12076,805,2496,1898,4751,2703,7247
330070,202108,24919,60424,20206,53750,2802,8060,12511,32814,15313,40874
330080,202108,9345,22751,7961,20832,927,2591,5525,14226,6452,16817
330090,202108,3502,7223,2465,5808,145,361,1761,4137,1906,4498
330093,202108,2862,6690,2168,5741,126,350,1651,4338,1777,4688
330095,202108,1465,3929,1158,3386,115,360,682,1862,797,2222
330100,202108,75444,192689,64573,176887,3406,10953,50246,135332,53652,146285
330110,202108,2144,5839,1726,5157,245,794,1025,2954,1270,3748
330115,202108,2644,6220,1863,5013,246,765,1062,2732,1308,3497
330120,202108,3769,8060,2864,6920,206,569,2095,4845,2301,5414
330130,202108,4622,12138,3784,10892,481,1426,2412,6894,2893,8320
330140,202108,4079,10121,3263,8976,366,1144,2229,5930,2595,7074
330150,202108,2414,6194,1873,5341,313,907,954,2640,1267,3547
330160,202108,1416,3748,1050,3102,198,613,551,1549,749,2162
330170,202108,119956,285881,96969,255097,12817,32912,65913,175371,78730,208283
330180,202108,2060,4799,1592,4156,89,259,1123,2858,1212,3117
330185,202108,10725,25798,8979,23400,462,1441,7291,18547,7753,19988
330187,202108,4854,11751,3835,10104,508,1425,2340,6065,2848,7490
330190,202108,37323,86347,31525,78443,1925,5151,25376,62266,27301,67417
330200,202108,17389,42351,14165,38376,2691,6779,8908,25033,11599,31812
330205,202108,2345,5632,1780,4728,122,350,1218,3106,1340,3456
330210,202108,3511,8386,2582,6820,314,878,1369,3425,1683,4303
330220,202108,13259,31685,9496,25475,1736,5245,3796,9372,5532,14617
330225,202108,4139,10069,3161,8611,198,661,2290,6064,2488,6725
330227,202108,17955,42027,15008,38464,631,1626,12828,32619,13459,34245
330230,202108,2265,4841,1496,3860,119,335,867,2220,986,2555
330240,202108,25581,63928,21380,57583,2094,6362,15191,39668,17285,46030
330245,202108,1826,4374,1106,3118,222,604,404,1135,626,1739
330250,202108,41822,102537,34519,91844,5177,14221,22112,58209,27289,72430
330260,202108,5297,12292,4030,10587,298,921,3002,7596,3300,8517
330270,202108,34396,76439,21203,54757,3112,8652,8979,21843,12091,30495
330280,202108,2515,6299,1907,5299,198,602,1150,3060,1348,3662
330285,202108,27112,62234,21469,54230,1209,3614,16520,40298,17729,43912
330290,202108,4234,9917,3422,8844,319,961,2507,6224,2826,7185
330300,202108,6114,13937,4510,11683,328,928,3192,8044,3520,8972
330310,202108,2847,6741,2045,5445,151,333,1375,3657,1526,3990
330320,202108,18427,41620,14283,36464,1677,3863,10199,26518,11876,30381
330330,202108,45574,96062,35567,82614,2861,7314,25883,58486,28744,65800
330340,202108,19264,44106,13892,35896,1939,5746,7395,17723,9334,23469
330350,202108,156193,347926,129430,315540,7432,18747,108077,261221,115509,279968
330360,202108,7649,18180,6531,16834,217,512,5545,14269,5762,14781
330370,202108,5322,14666,4108,12628,925,2892,1728,5484,2653,8376
330380,202108,6018,15234,4589,12790,609,2048,2608,6821,3217,8869
330385,202108,4273,11746,3507,10645,726,2409,1770,5250,2496,7659
330390,202108,28764,74260,22149,63229,2742,9063,13461,36032,16203,45095
330395,202108,3413,8118,2788,7329,148,458,2092,5335,2240,5793
330400,202108,3615,9182,3080,8351,142,506,2346,5992,2488,6498
330410,202108,3557,9072,2565,7394,491,1517,1176,3171,1667,4688
330411,202108,2979,7877,2329,6702,148,497,1628,4469,1776,4966
330412,202108,1707,4641,1398,4138,126,413,925,2604,1051,3017
330414,202108,25662,62440,20940,56015,1441,4126,15930,41828,17371,45954
330415,202108,5037,13116,3825,11000,383,1145,2178,6124,2561,7269
330420,202108,13258,31841,9536,25880,1021,3180,5315,13335,6336,16515
330430,202108,10125,23593,8526,21434,269,845,6921,16898,7190,17743
330440,202108,2900,7358,2214,6219,267,868,1383,3709,1650,4577
330450,202108,1509,4114,1198,3596,149,476,671,1960,820,2436
330452,202108,19149,46906,15341,41034,1733,5260,10136,26027,11869,31287
330455,202108,596113,1367131,466681,1184684,58458,158086,310482,771154,368940,929240
330460,202108,1205,3172,907,2757,155,504,478,1417,633,1921
330470,202108,5583,13346,3975,10869,1141,3236,1122,3106,2263,6342
330475,202108,10356,25572,8378,23037,1200,3810,5474,14571,6674,18381
330480,202108,6238,15670,5232,14204,419,1243,3653,9600,4072,10843
330490,202108,119443,266977,97108,237137,10511,26291,69553,168081,80064,194372
330500,202108,7996,18982,6609,17108,621,1806,4792,12121,5413,13927
330510,202108,44005,104840,32972,89409,4781,14023,20888,55525,25669,69548
330513,202108,1328,3271,1076,2946,199,561,594,1663,793,2224
330515,202108,2655,6890,2131,6159,349,1125,1232,3434,1581,4559
330520,202108,12338,31300,10125,27935,1077,3298,6637,17785,7714,21083
330530,202108,1784,4221,1305,3515,244,711,616,1652,860,2363
330540,202108,2996,7701,2321,6556,596,1703,861,2421,1457,4124
330550,202108,10444,25072,8071,22002,1912,5777,3836,10193,5748,15970
330555,202108,19761,40121,16425,36236,734,1741,13714,30510,14448,32251
330560,202108,4320,11032,3492,9695,543,1510,2080,5642,2623,7152
330570,202108,2819,7474,2409,6881,368,1132,1581,4477,1949,5609
330575,202108,5839,14557,5032,13225,300,887,4077,10390,4377,11277
330580,202108,19671,50351,15525,42997,2350,7079,8223,21521,10573,28600
330590,202108,1544,4006,1275,3657,237,670,785,2313,1022,2983
330600,202108,13436,33781,10869,29668,880,2802,7168,18857,8048,21659
330610,202108,9915,25630,7984,22623,701,2190,5413,15022,6114,17212
330615,202108,2188,5824,1739,5228,322,985,1083,3328,1405,4313
330620,202108,4334,11878,3406,10299,686,2210,1505,4273,2191,6483
330630,202108,26440,64491,20870,55935,1252,3956,15084,38967,16336,42923
350010,202108,2226,5793,1251,3725,250,808,256,567,506,1375
350020,202108,735,1844,419,1244,48,161,142,396,190,557
350030,202108,3679,10006,2798,8509,652,2212,1297,3647,1949,5859
350040,202108,782,2209,447,1489,57,216,136,345,193,561
350050,202108,1498,3610,992,2752,205,636,349,801,554,1437
350055,202108,966,2504,766,2194,85,261,462,1259,547,1520
350060,202108,247,619,144,410,18,61,61,162,79,223
350070,202108,3397,8853,2242,6765,444,1451,766,2051,1210,3502
350075,202108,638,1799,481,1499,171,561,65,211,236,772
350080,202108,683,1759,463,1379,57,191,192,522,249,713
350090,202108,616,1430,374,1021,65,190,158,401,223,591
350100,202108,2478,6403,1748,5140,110,413,1116,3058,1226,3471
350110,202108,506,1232,349,962,18,56,213,575,231,631
350115,202108,1243,3528,1013,3062,162,549,513,1390,675,1939
350120,202108,673,1543,377,1009,36,119,205,480,241,599
350130,202108,3315,8625,2615,7346,461,1319,1277,3381,1738,4700
350140,202108,805,2198,568,1757,46,188,299,841,345,1029
350150,202108,558,1646,450,1438,96,297,134,398,230,695
350160,202108,11899,29775,8139,22841,1035,3262,4818,12770,5853,16032
350170,202108,2552,7028,2116,6101,318,1024,1081,2798,1399,3822
350180,202108,1048,2512,578,1657,86,263,199,519,285,782
350190,202108,2989,8308,2057,6306,343,1199,910,2372,1253,3571
350200,202108,468,1299,357,1088,19,64,233,662,252,726
350210,202108,6251,14266,4294,11234,474,1382,2686,6698,3160,8080
350220,202108,3050,8207,2085,6327,418,1306,700,1921,1118,3227
350230,202108,1014,2526,836,2280,148,431,479,1270,627,1701
350240,202108,673,1896,435,1346,96,309,114,302,210,611
350250,202108,3103,8421,2292,7059,611,2051,663,1985,1274,4036
350260,202108,867,1987,557,1481,56,164,338,855,394,1019
350270,202108,4794,12448,3812,10616,512,1584,2107,5395,2619,6979
350275,202108,2547,6690,2020,5898,297,947,1239,3460,1536,4407
350280,202108,19423,43692,11980,31643,1806,5013,5056,12673,6862,17686
350290,202108,3275,8893,2255,6818,399,1315,912,2555,1311,3870
350300,202108,666,1739,498,1427,57,169,286,760,343,929
350310,202108,992,2756,735,2258,112,400,316,882,428,1282
350315,202108,621,1503,411,1153,24,75,220,557,244,632
350320,202108,16264,40932,12023,33509,2280,7029,4969,12735,7249,19764
350330,202108,14741,35360,10694,27857,1065,3063,6839,16765,7904,19828
350335,202108,396,1095,305,926,37,128,143,409,180,537
350340,202108,1224,3080,763,2239,119,406,327,842,446,1248
350350,202108,770,1893,595,1702,65,213,368,1042,433,1255
350360,202108,1106,3212,841,2677,209,685,277,896,486,1581
350370,202108,710,1750,503,1356,165,420,161,420,326,840
350380,202108,4684,12638,3372,9937,968,2767,887,2678,1855,5445
350390,202108,11400,29153,9018,25205,1557,4601,4689,12489,6246,17090
350395,202108,456,1133,237,722,27,83,87,235,114,318
350400,202108,8534,20455,5975,16296,1502,4376,1642,4383,3144,8759
350410,202108,10696,29101,7902,23808,1522,5059,3158,8750,4680,13809
350420,202108,874,2295,593,1706,90,276,150,370,240,646
350430,202108,729,1901,583,1682,71,227,356,957,427,1184
350440,202108,2138,5215,1736,4629,136,369,1131,2948,1267,3317
350450,202108,6682,18146,5153,15501,1091,3627,2131,5989,3222,9616
350460,202108,1915,4865,1098,3229,162,497,398,1051,560,1548
350470,202108,262,658,206,562,11,36,143,373,154,409
350480,202108,1030,2461,677,1872,129,413,184,415,313,828
350490,202108,2043,5212,1450,4249,320,970,475,1263,795,2233
350500,202108,684,1807,508,1499,63,204,243,668,306,872
350510,202108,1256,3135,943,2588,97,296,578,1498,675,1794
350520,202108,2315,6814,1806,5846,273,983,797,2323,1070,3306
350530,202108,3014,7476,2274,6072,238,730,1350,3328,1588,4058
350535,202108,1547,4103,1334,3808,178,556,834,2311,1012,2867
350540,202108,2094,4764,1561,4005,177,444,995,2466,1172,2910
350550,202108,8763,21341,6094,16910,631,2089,3502,8925,4133,11014
350560,202108,3960,10852,3174,9506,271,875,2076,5994,2347,6869
350570,202108,26264,71530,21400,62404,3614,11676,11265,31285,14879,42961
350580,202108,2164,5665,1343,3996,344,1120,274,670,618,1790
350590,202108,5242,13874,3859,10832,484,1532,2288,5915,2772,7447
350600,202108,36313,83014,22807,59890,3259,9719,10587,25363,13846,35082
350610,202108,7283,19381,5194,15336,788,2570,2565,7077,3353,9647
350620,202108,442,1095,269,823,24,75,152,435,176,510
350630,202108,1562,3898,1147,3187,74,264,753,1931,827,2195
350635,202108,10080,24160,7495,20086,915,2701,4665,11891,5580,14592
350640,202108,954,2516,508,1542,70,200,149,398,219,598
350650,202108,9029,23549,6274,18203,1091,3415,2518,6770,3609,10185
350660,202108,4705,11974,3634,10216,563,1562,1995,5628,2558,7190
350670,202108,1821,4821,1487,4337,176,523,951,2791,1127,3314
350680,202108,1129,2996,779,2366,133,422,323,931,456,1353
350690,202108,1343,3417,954,2763,157,485,500,1416,657,1901
350700,202108,5052,12553,3692,10440,784,2531,1609,4334,2393,6865
350710,202108,3002,8025,2538,7209,439,1432,1352,3508,1791,4940
350715,202108,797,2250,672,2042,86,319,348,958,434,1277
350720,202108,163,425,120,352,18,53,46,117,64,170
350730,202108,651,1754,548,1573,27,94,399,1078,426,1172
350740,202108,1780,4626,1229,3542,202,623,438,1149,640,1772
350745,202108,605,1483,345,1009,30,112,151,397,181,509
350750,202108,10622,27162,8223,23032,1392,4544,3898,9794,5290,14338
350760,202108,15746,38334,11530,31151,2209,6654,5181,12532,7390,19186
350770,202108,1109,2681,673,1921,46,143,413,1139,459,1282
350775,202108,730,1676,503,1345,59,151,251,686,310,837
350780,202108,2481,5883,1783,4887,317,1015,592,1889,909,2904
350790,202108,2134,5592,1371,4151,251,804,378,950,629,1754
350800,202108,3665,10251,3149,9366,247,843,2203,6333,2450,7176
350810,202108,2981,7064,2270,6043,426,1050,1028,2793,1454,3843
350820,202108,984,2271,579,1559,77,233,269,647,346,880
350830,202108,899,2444,518,1614,79,250,153,389,232,639
350840,202108,3482,10003,2648,8455,560,2017,1203,3495,1763,5512
350850,202108,8331,22392,6602,19297,1231,3891,3291,9012,4522,12903
350860,202108,3783,9830,3256,9117,111,397,2525,7002,2636,7399
350870,202108,2679,7358,2005,6282,251,862,1151,3501,1402,4363
350880,202108,1395,3874,1103,3307,282,895,279,780,561,1675
350890,202108,560,1451,360,1035,52,160,134,335,186,495
350900,202108,8240,21624,5474,15935,994,3146,2231,5927,3225,9073
350910,202108,944,2242,812,2045,94,249,588,1449,682,1698
350920,202108,12773,30847,10841,27775,401,1275,8987,22174,9388,23449
350925,202108,4297,11397,3087,9258,551,1799,1504,4157,2055,5956
350930,202108,1529,3923,1073,3050,66,194,671,1857,737,2051
350940,202108,2332,5995,1795,5130,179,586,1134,3074,1313,3660
350945,202108,897,2477,688,2076,106,342,351,983,457,1325
350950,202108,94342,237302,73310,198613,8854,26129,45939,118670,54793,144799
350960,202108,6672,17734,5164,14943,630,2069,3067,8433,3697,10502
350970,202108,3646,9985,2606,8091,743,2535,585,1546,1328,4081
350980,202108,677,1807,543,1555,132,398,249,704,381,1102
350990,202108,1887,5098,1406,4325,318,1100,518,1513,836,2613
350995,202108,848,2592,766,2429,61,226,528,1616,589,1842
351000,202108,2988,7794,2043,6035,381,1168,706,2046,1087,3214
351010,202108,359,877,236,670,28,89,117,317,145,406
351015,202108,880,2592,717,2247,112,388,336,946,448,1334
351020,202108,8960,23940,6846,20340,1506,4422,3144,9193,4650,13615
351030,202108,2983,8642,2385,7471,328,1139,1316,3978,1644,5117
351040,202108,5281,12867,4430,11604,208,641,3644,9291,3852,9932
351050,202108,17289,41417,12618,34293,2328,6706,5874,15704,8202,22410
351060,202108,51156,126121,39440,106388,3792,11363,26897,69830,30689,81193
351070,202108,1392,3390,771,2345,190,628,125,363,315,991
351080,202108,2834,6701,2043,5764,201,671,1384,3716,1585,4387
351090,202108,336,950,248,791,48,158,70,227,118,385
351100,202108,2760,7314,1804,5423,374,1194,516,1558,890,2752
351110,202108,6421,16118,4264,12213,648,2067,1956,5237,2604,7304
351120,202108,760,1956,540,1577,68,215,205,575,273,790
351130,202108,1252,3146,580,1754,101,320,152,412,253,732
351140,202108,2330,6365,1748,5269,336,1148,767,2029,1103,3177
351150,202108,2856,8023,1944,6071,257,899,724,2028,981,2927
351160,202108,1125,3415,824,2731,154,557,202,545,356,1102
351170,202108,1372,3713,1174,3369,79,252,844,2327,923,2579
351190,202108,1052,2881,720,2213,134,406,263,767,397,1173
351200,202108,1663,3896,1247,3301,90,273,888,2211,978,2484
351210,202108,1642,3974,1046,2871,78,251,610,1534,688,1785
351220,202108,3458,9479,2965,8676,283,843,2015,5798,2298,6641
351230,202108,1915,5024,1439,4188,252,833,696,1836,948,2669
351240,202108,2503,6257,1545,4306,340,1031,543,1348,883,2379
351250,202108,1133,2927,673,2015,71,219,262,778,333,997
351260,202108,943,2312,684,1855,149,413,239,605,388,1018
351270,202108,506,1367,387,1125,40,133,192,485,232,618
351280,202108,4026,10315,3122,8638,632,1791,1387,3707,2019,5498
351290,202108,1279,3125,900,2468,120,367,552,1443,672,1810
351300,202108,19697,52084,13805,40936,2303,7451,6257,17543,8560,24994
351310,202108,3621,8659,2765,7345,146,494,2065,5210,2211,5704
351320,202108,982,2761,718,2238,122,415,239,653,361,1068
351330,202108,500,1199,410,1036,21,66,289,650,310,716
351340,202108,6510,18004,5267,15821,1244,3854,2363,7073,3607,10927
351350,202108,12005,29429,9921,26163,908,2562,7335,18787,8243,21349
351360,202108,3951,10290,3255,9267,673,2080,1464,3854,2137,5934
351370,202108,2113,5759,1417,4328,314,1040,433,1194,747,2234
351380,202108,49588,117378,35204,92757,4057,11581,20877,52390,24934,63971
351385,202108,412,1030,169,504,27,76,53,134,80,210
351390,202108,1386,3335,861,2564,115,402,500,1397,615,1799
351400,202108,983,2664,817,2339,99,288,533,1479,632,1767
351410,202108,2729,7410,1971,5958,333,1004,783,2317,1116,3321
351420,202108,498,1179,282,799,35,97,162,420,197,517
351430,202108,984,2577,788,2256,59,168,558,1546,617,1714
351440,202108,3588,9304,2397,6903,427,1288,662,1640,1089,2928
351450,202108,1804,4690,1209,3608,246,826,229,510,475,1336
351460,202108,931,2364,739,2069,143,403,431,1189,574,1592
351470,202108,1250,3107,992,2686,80,277,667,1690,747,1967
351480,202108,2599,7446,2055,6525,362,1278,906,2656,1268,3934
351490,202108,2121,5825,1823,5295,61,246,1502,4222,1563,4468
351492,202108,357,947,295,813,7,21,226,605,233,626
351495,202108,199,504,155,421,16,37,93,252,109,289
351500,202108,40878,97944,31257,82187,4298,11896,19370,48761,23668,60657
351510,202108,13119,31825,9568,25867,1081,3371,6058,15564,7139,18935
351512,202108,502,1312,368,1020,67,195,127,322,194,517
351515,202108,3361,7475,2124,5541,367,1085,603,1641,970,2726
351518,202108,2571,6348,1705,4838,218,699,939,2355,1157,3054
351519,202108,687,1846,427,1336,79,255,69,189,148,444
351520,202108,1358,3324,607,1799,53,182,285,757,338,939
351530,202108,364,945,213,628,36,114,94,232,130,346
351535,202108,1886,4575,1366,3682,217,626,693,1758,910,2384
351540,202108,2739,6702,1854,5115,217,694,827,2002,1044,2696
351550,202108,7505,18360,5104,14038,486,1531,2921,7415,3407,8946
351560,202108,464,1316,360,1110,81,267,106,296,187,563
351565,202108,253,706,203,614,40,132,56,142,96,274
351570,202108,22611,58619,17350,48357,1670,5063,11081,29546,12751,34609
351580,202108,236,596,135,412,15,45,57,179,72,224
351590,202108,519,1161,275,734,23,87,160,379,183,466
351600,202108,1401,3704,1076,3093,124,390,594,1590,718,1980
351610,202108,791,1845,493,1319,30,82,283,710,313,792
351620,202108,24390,63027,17775,51839,2690,8915,8371,22098,11061,31013
351630,202108,30077,76518,24261,66754,2978,8841,15790,41665,18768,50506
351640,202108,18460,47128,14542,40212,1327,4302,9952,26116,11279,30418
351650,202108,377,994,188,596,25,81,55,157,80,238
351660,202108,757,2064,494,1511,77,241,108,282,185,523
351670,202108,6277,16538,4145,11968,886,2535,1689,4545,2575,7080
351680,202108,441,1223,287,892,36,123,79,200,115,323
351685,202108,399,1123,320,998,85,274,105,305,190,579
351690,202108,1163,2874,645,1855,88,292,294,748,382,1040
351700,202108,1347,3302,983,2691,196,551,478,1224,674,1775
351710,202108,801,2108,588,1715,52,177,331,870,383,1047
351720,202108,1504,3808,1008,2947,158,501,422,1129,580,1630
351730,202108,990,2555,820,2296,62,204,514,1368,576,1572
351740,202108,3569,8827,2847,7461,481,1388,1465,3480,1946,4868
351750,202108,1536,3862,931,2795,155,498,397,1115,552,1613
351760,202108,3401,9347,2531,7674,483,1674,1035,2809,1518,4483
351770,202108,1926,5443,1555,4752,260,842,885,2591,1145,3433
351780,202108,1235,3089,746,2188,99,347,292,778,391,1125
351790,202108,1415,3366,1128,2984,174,474,653,1755,827,2229
351800,202108,541,1228,272,721,33,93,107,237,140,330
351810,202108,1111,2869,930,2605,59,147,638,1704,697,1851
351820,202108,2747,7533,1957,6023,491,1653,475,1321,966,2974
351830,202108,4676,12245,3608,10410,289,983,2322,6364,2611,7347
351840,202108,9215,24607,6970,20540,890,2963,3907,10671,4797,13634
351850,202108,1583,4294,1048,3227,150,523,373,968,523,1491
351860,202108,2791,7853,2144,6665,325,1142,1194,3664,1519,4806
351870,202108,24812,61971,18491,51659,4292,12475,7718,21612,12010,34087
351880,202108,143381,358825,108404,299783,21178,65137,55561,144996,76739,210133
351885,202108,954,2507,745,2162,53,192,496,1377,549,1569
351890,202108,879,2252,563,1720,112,366,112,298,224,664
351900,202108,1170,3031,894,2614,119,338,536,1547,655,1885
351905,202108,470,1275,335,1012,29,98,170,453,199,551
351907,202108,22071,56757,17288,48408,1852,5806,11203,29941,13055,35747
351910,202108,1733,4368,1232,3320,78,243,742,1783,820,2026
351920,202108,919,2435,693,1996,106,338,287,748,393,1086
351925,202108,932,2403,715,2016,90,298,375,966,465,1264
351930,202108,3361,9169,3007,8531,539,1556,2045,5703,2584,7259
351940,202108,1126,2833,815,2296,126,383,401,1117,527,1500
351950,202108,1770,3918,1338,3295,66,194,974,2299,1040,2493
351960,202108,5289,13082,3861,10580,853,2482,1722,4401,2575,6883
351970,202108,7567,21662,5995,18967,882,3203,3383,10253,4265,13456
351980,202108,1059,2477,694,1885,91,287,392,962,483,1249
351990,202108,1533,3575,1116,2949,50,181,553,1307,603,1488
352000,202108,2790,7765,2405,6971,256,844,1600,4337,1856,5181
352010,202108,2412,6250,1955,5497,514,1619,433,1237,947,2856
352020,202108,1431,3860,1103,3313,151,521,559,1560,710,2081
352030,202108,6045,15656,4714,13472,811,2510,2442,6717,3253,9227
352040,202108,3612,9230,2560,7174,404,1240,954,2342,1358,3582
352042,202108,3307,7844,2248,6164,370,1154,1136,2956,1506,4110
352044,202108,2155,5585,1288,3962,193,666,263,751,456,1417
352050,202108,13397,34873,8905,26143,2042,6862,1833,4585,3875,11447
352060,202108,759,1997,563,1632,90,289,241,632,331,921
352070,202108,946,1907,613,1472,58,155,329,715,387,870
352080,202108,496,1247,288,834,33,110,97,251,130,361
352090,202108,1565,4514,1303,4020,154,548,635,1776,789,2324
352100,202108,3559,9758,2845,8419,569,1846,1263,3564,1832,5410
352110,202108,653,1843,493,1538,96,313,201,573,297,886
352115,202108,563,1497,469,1345,60,195,281,788,341,983
352120,202108,919,2634,741,2279,72,201,443,1269,515,1470
352130,202108,2147,5828,1441,4151,222,647,606,1624,828,2271
352140,202108,1182,3190,846,2532,141,434,380,1101,521,1535
352150,202108,918,2387,715,2053,80,249,491,1372,571,1621
352160,202108,1042,2521,754,2061,65,221,431,1123,496,1344
352170,202108,3087,8068,2460,6872,268,827,1590,4175,1858,5002
352180,202108,2452,6493,1839,5404,417,1389,565,1458,982,2847
352190,202108,1294,3427,1033,3031,179,465,534,1636,713,2101
352200,202108,329,987,236,800,36,137,82,273,118,410
352210,202108,20988,48228,16452,42155,919,2662,12912,32328,13831,34990
352215,202108,711,1786,594,1606,83,238,351,917,434,1155
352220,202108,23091,55420,16382,43897,2666,7925,8343,20413,11009,28338
352230,202108,15570,43495,12089,37041,2820,9583,4308,12104,7128,21687
352240,202108,10400,26300,7956,22315,1683,5281,3495,9118,5178,14399
352250,202108,24058,65505,19377,57611,2806,8993,12049,35044,14855,44037
352260,202108,5109,12502,3485,9422,509,1570,2018,4907,2527,6477
352265,202108,957,2612,846,2458,88,277,593,1668,681,1945
352270,202108,1471,4327,1096,3538,222,769,384,1159,606,1928
352280,202108,2487,6122,1869,5231,193,636,1127,2947,1320,3583
352290,202108,1269,3551,1025,3093,133,437,553,1508,686,1945
352300,202108,896,2368,619,1799,82,274,329,889,411,1163
352310,202108,43791,114539,32847,95736,7509,22454,14890,43475,22399,65929
352320,202108,6911,17529,5362,14652,715,2195,2983,7319,3698,9514
352330,202108,2365,6081,1812,5302,275,946,1058,2880,1333,3826
352340,202108,6503,16843,4847,13846,741,2407,2483,6512,3224,8919
352350,202108,2315,6414,1815,5318,159,563,1116,3022,1275,3585
352360,202108,1314,3427,1071,2996,80,261,798,2143,878,2404
352370,202108,1133,3129,982,2878,16,67,802,2306,818,2373
352380,202108,859,2277,642,1901,135,408,220,630,355,1038
352390,202108,15403,37309,10548,28810,1676,4992,5774,14866,7450,19858
352400,202108,3677,10060,2996,8796,602,2050,1378,3763,1980,5813
352410,202108,3495,8790,2661,7407,229,767,1656,4393,1885,5160
352420,202108,854,2079,613,1735,117,352,232,608,349,960
352430,202108,8595,20827,6262,16784,1075,3289,3238,8116,4313,11405
352440,202108,19496,51826,14681,42627,3404,10238,5325,14934,8729,25172
352450,202108,796,1905,415,1261,60,201,156,443,216,644
352460,202108,3139,8376,2206,6725,411,1369,949,2706,1360,4075
352470,202108,3469,8699,2656,7403,275,888,1690,4447,1965,5335
352480,202108,4323,10099,2912,7606,402,1245,1440,3284,1842,4529
352490,202108,803,2257,645,1978,103,348,293,837,396,1185
352500,202108,10831,27489,7374,21081,2864,8974,859,1415,3723,10389
352510,202108,4024,10834,3021,9057,558,1799,1463,4214,2021,6013
352520,202108,3012,7672,2339,6564,382,1220,1358,3471,1740,4691
352530,202108,11375,28681,7790,21984,1317,4193,2914,7054,4231,11247
352540,202108,607,1748,451,1420,66,220,164,463,230,683
352550,202108,1040,2812,730,2228,123,437,265,717,388,1154
352560,202108,599,1639,464,1383,69,228,252,688,321,916
352570,202108,2501,6966,1625,5100,366,1249,195,454,561,1703
352580,202108,647,1657,540,1461,44,136,373,961,417,1097
352585,202108,349,923,255,758,20,77,160,429,180,506
352590,202108,13575,35009,9579,27545,2227,7021,4498,11971,6725,18992
352600,202108,1967,5274,1550,4522,141,440,989,2747,1130,3187
352610,202108,2879,7843,2162,6624,417,1443,904,2586,1321,4029
352620,202108,5826,14436,4436,12463,1209,3454,1817,5145,3026,8599
352630,202108,871,2114,652,1805,107,335,310,799,417,1134
352640,202108,3136,7897,2271,6363,229,655,1314,3513,1543,4168
352650,202108,617,1714,427,1308,59,196,165,476,224,672
352660,202108,1127,3238,935,2853,100,327,579,1715,679,2042
352670,202108,10076,26743,6847,20431,1586,5194,2158,5861,3744,11055
352680,202108,3377,9701,2354,7404,373,1369,1095,3040,1468,4409
352690,202108,28447,70043,22375,59909,1256,3988,16185,41513,17441,45501
352700,202108,662,1629,500,1410,132,415,178,493,310,908
352710,202108,5407,13751,3876,10999,908,2801,1629,4279,2537,7080
352720,202108,8422,22203,6609,18896,2253,6671,1975,5267,4228,11938
352725,202108,596,1393,341,941,23,67,181,466,204,533
352730,202108,5646,16287,5120,15113,580,1849,2316,5937,2896,7786
352740,202108,2380,5651,1808,4819,178,551,1097,2744,1275,3295
352750,202108,428,1061,271,779,43,140,112,278,155,418
352760,202108,1794,4866,1400,4101,111,310,803,2358,914,2668
352770,202108,921,2425,645,1897,121,370,261,720,382,1090
352780,202108,671,1861,478,1463,103,282,119,380,222,662
352790,202108,451,1180,332,949,25,78,144,362,169,440
352800,202108,1301,3843,914,2947,231,778,134,349,365,1127
352810,202108,1226,2844,795,2102,142,390,455,1142,597,1532
352820,202108,474,1313,345,1085,67,207,76,229,143,436
352830,202108,607,1523,289,872,25,77,80,197,105,274
352840,202108,4129,11463,3372,10112,990,3274,1227,3465,2217,6739
352850,202108,11396,27314,7933,21747,1990,6009,2758,6740,4748,12749
352860,202108,1104,3011,849,2562,148,475,327,936,475,1411
352870,202108,907,2216,633,1680,55,167,391,986,446,1153
352880,202108,1762,4149,1233,3227,204,553,578,1459,782,2012
352885,202108,318,860,246,740,28,82,144,419,172,501
352890,202108,717,1712,473,1212,49,140,273,607,322,747
352900,202108,18796,48124,12478,35738,2008,6067,5359,14364,7367,20431
352910,202108,424,1107,250,749,24,72,87,223,111,295
352920,202108,2729,6858,2019,5670,116,366,1409,3820,1525,4186
352930,202108,5979,15842,4504,12997,764,2439,2204,5920,2968,8359
352940,202108,23059,60854,16996,48495,2983,9257,8348,22344,11331,31601
352950,202108,586,1526,368,1119,93,291,75,210,168,501
352960,202108,770,2020,457,1383,67,223,128,303,195,526
352965,202108,227,630,144,465,39,124,35,101,74,225
352970,202108,3055,7234,2368,6103,226,639,1597,4017,1823,4656
352980,202108,1383,3576,1089,3141,251,808,557,1556,808,2364
352990,202108,4441,11910,3358,10113,637,2085,1678,4849,2315,6934
353000,202108,501,1336,292,854,42,137,75,170,117,307
353010,202108,2692,6558,1775,4885,330,1061,782,1927,1112,2988
353020,202108,3651,9297,2208,6355,308,985,768,2084,1076,3069
353030,202108,4734,11688,3269,9187,718,2204,951,2507,1669,4711
353040,202108,677,1523,476,1229,107,269,218,553,325,822
353050,202108,5379,14999,3838,11891,701,2331,1758,5200,2459,7531
353060,202108,50234,126181,41656,112570,2702,8606,31608,82511,34310,91117
353070,202108,10328,28831,7591,22991,1305,4354,3371,9279,4676,13633
353080,202108,4431,11853,2933,8979,521,1833,1141,3013,1662,4846
353090,202108,620,1806,498,1560,31,106,319,955,350,1061
353100,202108,304,803,145,452,24,78,41,107,65,185
353110,202108,7686,19795,6176,17686,1362,3999,3040,9116,4402,13115
353120,202108,422,1026,325,870,40,132,168,391,208,523
353130,202108,2689,6176,1698,4488,398,1171,599,1408,997,2579
353140,202108,2784,6789,2028,5532,98,325,1459,3809,1557,4134
353150,202108,1667,4041,1194,3272,250,703,491,1280,741,1983
353160,202108,637,1631,462,1348,57,164,209,559,266,723
353170,202108,546,1424,405,1225,77,248,184,569,261,817
353180,202108,10514,25198,8324,21720,836,2396,6000,15121,6836,17517
353190,202108,3516,9255,2821,7875,369,1099,1637,4261,2006,5360
353200,202108,1855,4853,1052,3251,170,587,320,882,490,1469
353205,202108,420,1238,352,1093,55,177,167,499,222,676
353210,202108,929,2092,606,1578,22,56,429,1085,451,1141
353215,202108,391,1054,308,907,45,144,145,391,190,535
353220,202108,760,1986,496,1451,102,288,92,257,194,545
353230,202108,845,2260,660,1976,178,574,241,661,419,1235
353240,202108,2415,6415,2011,5779,269,882,1218,3351,1487,4233
353250,202108,1304,2907,820,2129,102,297,459,1131,561,1428
353260,202108,1220,2793,680,1909,93,286,321,851,414,1137
353270,202108,723,1846,616,1659,49,148,428,1085,477,1233
353280,202108,697,1855,492,1489,133,403,121,352,254,755
353282,202108,1899,5239,1598,4705,177,563,999,2791,1176,3354
353284,202108,362,809,200,521,19,70,100,225,119,295
353286,202108,178,441,110,332,17,51,38,107,55,158
353290,202108,1519,3985,942,2826,171,504,281,774,452,1278
353300,202108,2177,5703,1610,4606,259,850,727,1836,986,2686
353310,202108,418,1007,304,811,20,67,205,517,225,584
353320,202108,687,1643,582,1501,7,27,507,1296,514,1323
353325,202108,708,2013,494,1539,102,318,172,517,274,835
353330,202108,622,1569,429,1218,57,161,216,562,273,723
353340,202108,3122,8362,2325,6801,448,1455,1145,3084,1593,4539
353350,202108,3891,9653,2756,7503,605,1679,878,2160,1483,3839
353360,202108,679,1864,522,1563,54,170,302,878,356,1048
353370,202108,590,1648,491,1494,45,139,347,1028,392,1167
353380,202108,302,863,249,767,25,79,125,359,150,438
353390,202108,6669,16183,5030,13488,435,1332,3156,7986,3591,9318
353400,202108,495,1311,376,1089,70,231,148,358,218,589
353410,202108,541,1439,407,1201,70,201,228,682,298,883
353420,202108,437,1123,271,787,60,170,24,65,84,235
353430,202108,2295,6175,1789,5253,321,1015,875,2430,1196,3445
353440,202108,69109,182104,50925,147462,7724,24334,28217,76981,35941,101315
353450,202108,378,927,255,717,32,104,122,309,154,413
353460,202108,3354,8898,2488,7309,227,717,1067,2974,1294,3691
353470,202108,8777,22501,6400,18133,1037,3333,2901,7574,3938,10907
353475,202108,1626,4097,1156,3172,163,499,577,1457,740,1956
353480,202108,1648,4344,1323,3795,54,196,959,2659,1013,2855
353490,202108,1131,2915,774,2256,105,347,362,978,467,1325
353500,202108,1095,2558,800,2108,170,462,444,1135,614,1597
353510,202108,861,2499,631,1964,141,446,175,476,316,922
353520,202108,1061,2715,680,2040,71,244,338,916,409,1160
353530,202108,2509,6502,1981,5553,249,796,1089,2822,1338,3618
353540,202108,2173,5755,1792,5149,275,827,1055,2928,1330,3755
353550,202108,6049,15196,4918,13404,747,2112,2861,7488,3608,9600
353560,202108,2415,6328,1849,5480,492,1563,561,1496,1053,3059
353570,202108,606,1558,442,1288,53,174,241,652,294,826
353580,202108,2237,5792,1687,4725,370,1034,752,2045,1122,3079
353590,202108,712,1821,491,1423,82,248,232,683,314,931
353600,202108,1752,4281,1320,3537,159,421,726,1897,885,2318
353610,202108,680,1973,503,1628,90,355,183,536,273,891
353620,202108,2830,7282,2042,5951,378,1224,747,1988,1125,3212
353625,202108,522,1293,356,1007,30,95,214,583,244,678
353630,202108,1428,4203,1203,3741,215,743,527,1504,742,2247
353640,202108,1401,3570,1123,3137,156,435,633,1747,789,2182
353650,202108,7939,20838,6070,17383,672,2101,3567,9620,4239,11721
353657,202108,400,1030,289,850,29,97,129,339,158,436
353660,202108,1328,2776,911,2225,308,774,336,780,644,1554
353670,202108,4201,11419,3262,9612,599,1971,1572,4241,2171,6212
353680,202108,721,1847,534,1583,69,234,319,877,388,1111
353690,202108,424,1100,204,621,23,78,44,110,67,188
353700,202108,2143,5461,1770,4853,118,383,1314,3447,1432,3830
353710,202108,5548,12366,3332,8460,401,1051,1734,3897,2135,4948
353715,202108,446,1179,265,820,5,21,97,284,102,305
353720,202108,2062,5292,1585,4569,233,713,893,2519,1126,3232
353730,202108,4543,11698,3491,9863,453,1507,1934,4985,2387,6492
353740,202108,2097,5404,1484,4348,339,1085,499,1312,838,2397
353750,202108,926,2740,675,2262,141,524,166,521,307,1045
353760,202108,13307,30032,10220,25945,2113,5364,5325,13411,7438,18775
353770,202108,690,2014,418,1369,65,230,48,144,113,374
353780,202108,5715,15134,4596,13102,996,3135,2254,5928,3250,9063
353790,202108,2880,8447,2105,6828,519,1856,430,1207,949,3063
353800,202108,19508,49740,15363,43107,2256,6574,8481,23706,10737,30280
353810,202108,1255,3303,822,2404,114,379,362,999,476,1378
353820,202108,1822,4793,1257,3688,253,821,417,1126,670,1947
353830,202108,673,1668,489,1367,86,250,213,574,299,824
353850,202108,1660,4476,1286,3788,262,779,479,1363,741,2142
353860,202108,2754,7344,2101,6250,470,1599,974,2584,1444,4183
353870,202108,31182,80049,22476,63460,2792,8702,11955,30859,14747,39561
353880,202108,3269,8851,2579,7570,216,724,1564,4388,1780,5112
353890,202108,2944,6243,2131,5065,156,414,1527,3376,1683,3790
353900,202108,768,2118,567,1724,78,269,235,660,313,929
353910,202108,2561,6882,2136,6217,208,688,1484,4227,1692,4915
353920,202108,1945,5260,1406,4235,326,1114,338,832,664,1946
353930,202108,4628,12041,3168,9315,523,1773,1363,3496,1886,5269
353940,202108,1211,3407,849,2680,139,461,281,797,420,1258
353950,202108,3358,8923,2570,7459,508,1579,1333,3620,1841,5199
353960,202108,849,2161,597,1683,117,318,222,600,339,918
353970,202108,665,1554,496,1296,41,122,348,888,389,1010
353980,202108,16792,41551,13142,35325,783,2468,9620,24711,10403,27179
353990,202108,979,2368,601,1685,110,327,274,725,384,1052
354000,202108,2612,6161,1466,4048,322,912,253,660,575,1572
354010,202108,359,917,254,746,52,159,130,371,182,530
354020,202108,3842,10086,3058,8524,640,1950,1383,3489,2023,5439
354025,202108,738,2021,501,1560,71,249,141,407,212,656
354030,202108,524,1132,286,752,61,169,136,333,197,502
354040,202108,831,1890,540,1429,29,89,399,1015,428,1104
354050,202108,955,2667,680,2170,144,510,229,677,373,1187
354060,202108,3553,9842,2510,7643,458,1529,1030,2804,1488,4333
354070,202108,3905,10005,2639,7546,433,1422,1204,2964,1637,4386
354075,202108,2856,7949,2282,6910,312,1013,1328,3930,1640,4943
354080,202108,1368,3704,912,2817,178,576,277,774,455,1350
354085,202108,456,928,364,810,0,0,278,567,278,567
354090,202108,1698,4681,1465,4212,77,236,1144,3216,1221,3452
354100,202108,20382,53845,14117,43074,3000,9841,5445,16437,8445,26278
354105,202108,1458,3635,1023,2861,125,359,493,1296,618,1655
354110,202108,455,1266,328,1021,56,167,111,339,167,506
354120,202108,1402,3716,961,2788,195,613,318,806,513,1419
354130,202108,5501,14311,3666,10811,884,2756,203,383,1087,3139
354140,202108,20147,48976,13800,37386,2170,6555,6189,15287,8359,21842
354150,202108,3005,7027,2303,5934,458,1229,943,2379,1401,3608
354160,202108,2907,8259,2201,6866,576,1953,672,1895,1248,3848
354165,202108,703,2038,539,1714,83,306,281,830,364,1136
354170,202108,1944,5290,1622,4694,107,347,986,2708,1093,3055
354180,202108,395,1084,288,864,47,144,131,354,178,498
354190,202108,1589,4379,1118,3411,71,238,558,1607,629,1845
354200,202108,902,2151,690,1829,68,206,456,1134,524,1340
354210,202108,916,2387,750,2117,51,162,519,1371,570,1533
354220,202108,3267,8611,2488,7096,353,1098,1337,3583,1690,4681
354230,202108,807,1964,652,1779,33,109,484,1278,517,1387
354240,202108,1787,4863,1198,3690,198,655,386,1065,584,1720
354250,202108,648,1564,405,1143,90,276,114,297,204,573
354260,202108,8334,21636,6368,18249,1205,3744,2876,7855,4081,11599
354270,202108,1043,3081,851,2708,175,543,335,1037,510,1580
354280,202108,828,2015,704,1835,59,185,481,1156,540,1341
354290,202108,950,2971,800,2666,123,406,414,1422,537,1828
354300,202108,3649,10489,3087,9463,760,2350,1319,3990,2079,6340
354310,202108,737,2161,609,1915,147,491,237,687,384,1178
354320,202108,1011,2420,670,1858,101,313,263,642,364,955
354323,202108,518,1209,323,853,53,120,137,344,190,464
354325,202108,1554,4554,1086,3491,182,586,342,1035,524,1621
354330,202108,9793,24335,6721,18222,797,2421,4015,10112,4812,12533
354340,202108,35221,86927,24383,68153,3320,10510,13663,36309,16983,46819
354350,202108,1233,3108,975,2687,138,395,580,1525,718,1920
354360,202108,639,1612,386,1199,82,254,88,273,170,527
354370,202108,1031,2865,831,2553,121,402,502,1489,623,1891
354380,202108,679,1754,484,1437,86,342,134,307,220,649
354390,202108,14528,34502,9678,26077,1610,4667,4610,11629,6220,16296
354400,202108,1576,4965,1226,4150,200,738,457,1522,657,2260
354410,202108,6496,16855,4964,13894,905,2785,2453,6387,3358,9172
354420,202108,1539,3913,1147,3226,142,426,698,1858,840,2284
354425,202108,2819,6761,2003,5349,449,1229,815,2158,1264,3387
354430,202108,1579,4165,1230,3626,109,347,751,2116,860,2463
354440,202108,628,1608,418,1193,69,220,182,470,251,690
354450,202108,452,1168,264,809,35,112,88,228,123,340
354460,202108,887,2207,596,1697,83,244,304,853,387,1097
354470,202108,476,1178,332,907,24,78,168,400,192,478
354480,202108,1317,2920,852,2182,76,185,538,1316,614,1501
354490,202108,836,2425,615,1945,110,364,272,800,382,1164
354500,202108,2225,6054,1796,5396,536,1669,427,1316,963,2985
354510,202108,745,2044,606,1785,44,139,352,942,396,1081
354515,202108,365,1015,266,815,39,137,110,323,149,460
354520,202108,7212,19363,5106,14922,672,2266,2832,7658,3504,9924
354530,202108,4530,12669,3523,10714,901,2723,1182,3727,2083,6450
354540,202108,1377,3562,1011,2926,210,631,376,1070,586,1701
354550,202108,619,1591,489,1346,67,202,282,740,349,942
354560,202108,2345,5592,1275,3551,158,449,657,1687,815,2136
354570,202108,1280,3154,520,1440,92,254,67,175,159,429
354580,202108,8628,22451,5688,16833,858,2748,2867,8131,3725,10879
354600,202108,2069,5273,1630,4498,178,550,1071,2810,1249,3360
354610,202108,464,1183,275,811,24,72,142,405,166,477
354620,202108,492,1336,311,989,40,159,129,375,169,534
354625,202108,315,837,188,599,29,93,37,89,66,182
354630,202108,2211,6411,1790,5589,604,1944,348,1007,952,2951
354640,202108,3415,9601,2577,7933,360,1234,1078,3057,1438,4291
354650,202108,909,2340,738,2064,63,175,472,1297,535,1472
354660,202108,3740,8678,2010,5814,185,636,927,2437,1112,3073
354670,202108,1096,2975,770,2311,146,470,292,808,438,1278
354680,202108,5610,14275,4236,12076,908,2748,2157,6197,3065,8945
354690,202108,507,1550,367,1237,77,284,112,346,189,630
354700,202108,944,2479,679,1971,79,251,366,969,445,1220
354710,202108,524,1373,371,1070,47,146,159,386,206,532
354720,202108,299,720,140,409,62,181,24,72,86,253
354730,202108,10204,28306,7818,23740,1002,3331,4516,13160,5518,16491
354740,202108,316,850,131,436,13,51,25,71,38,122
354750,202108,2812,7118,1858,5345,255,797,825,2100,1080,2897
354760,202108,2250,5867,1601,4674,343,1081,552,1420,895,2501
354765,202108,374,992,160,499,18,64,41,113,59,177
354770,202108,2530,6160,1861,4983,298,846,895,2237,1193,3083
354780,202108,58486,144756,44865,118589,3872,11724,29896,74073,33768,85797
354790,202108,1023,2770,796,2402,74,243,497,1437,571,1680
354800,202108,2633,6655,2066,5791,508,1438,913,2438,1421,3876
354805,202108,1391,3159,966,2543,113,288,553,1367,666,1655
354810,202108,663,1915,398,1362,51,197,109,341,160,538
354820,202108,978,2737,686,2186,103,369,190,477,293,846
354830,202108,490,1169,310,848,57,166,97,252,154,418
354840,202108,937,2316,578,1589,59,171,308,778,367,949
354850,202108,21449,54645,15033,43363,1570,5124,9195,25177,10765,30301
354860,202108,1791,4899,1121,3518,173,594,339,953,512,1547
354870,202108,61580,153592,47732,128248,4661,13718,30656,77756,35317,91474
354880,202108,6024,14679,2997,8385,327,1050,1196,2748,1523,3798
354890,202108,16170,40198,12515,34083,1666,5070,7261,19202,8927,24272
354900,202108,419,1031,271,767,60,187,77,162,137,349
354910,202108,6081,15743,3775,11565,851,2767,765,2174,1616,4941
354920,202108,531,1392,268,868,29,104,62,172,91,276
354925,202108,314,881,186,595,25,87,48,133,73,220
354930,202108,388,928,256,701,23,69,128,322,151,391
354940,202108,2448,7090,1773,5626,586,2008,411,1176,997,3184
354950,202108,1564,3927,1255,3508,54,198,948,2524,1002,2722
354960,202108,940,2479,706,2125,77,252,376,1061,453,1313
354970,202108,4359,11830,3415,10230,361,1229,2201,6360,2562,7589
354980,202108,34791,81517,23809,62786,2411,7550,14796,36297,17207,43847
354990,202108,71201,176663,53480,144383,4052,12740,35648,90136,39700,102876
354995,202108,2938,6447,2215,5507,143,409,1658,3978,1801,4387
355000,202108,1656,4041,1244,3435,212,674,603,1507,815,2181
355010,202108,3983,10579,2447,7350,798,2456,342,1040,1140,3496
355020,202108,3745,10207,2764,8494,525,1819,1181,3397,1706,5216
355030,202108,1433668,3481669,1047684,2743011,150619,433100,545453,1314728,696072,1747828
355040,202108,3131,7506,2429,6596,260,728,1784,4815,2044,5543
355050,202108,1054,2346,782,1969,178,513,325,727,503,1240
355060,202108,6410,16898,4676,13727,724,2468,2395,6376,3119,8844
355070,202108,10180,25324,8299,22339,965,2966,5302,13352,6267,16318
355080,202108,963,2716,618,2073,127,460,92,251,219,711
355090,202108,1239,3435,972,2983,207,667,394,1134,601,1801
355100,202108,22876,58661,17814,51170,2697,8201,10863,30792,13560,38993
355110,202108,886,2397,638,2013,162,577,95,271,257,848
355120,202108,758,1950,544,1630,48,151,263,771,311,922
355130,202108,851,1873,443,1135,33,107,279,653,312,760
355140,202108,2020,4460,1702,4027,89,234,1416,3265,1505,3499
355150,202108,4407,11401,3509,9839,376,1180,2277,6106,2653,7286
355160,202108,2262,6065,1634,4960,394,1305,408,1141,802,2446
355170,202108,11558,28526,9042,24335,1540,4467,4862,12665,6402,17132
355180,202108,2943,7645,2089,6231,391,1301,855,2327,1246,3628
355190,202108,1912,4935,1495,4270,398,1123,735,2234,1133,3357
355200,202108,838,2553,708,2339,198,708,288,914,486,1622
355210,202108,3124,8400,2412,6936,430,1375,1176,3161,1606,4536
355220,202108,48626,126083,38707,107232,7792,22978,17496,44847,25288,67825
355230,202108,1203,3009,651,1922,116,341,234,641,350,982
355240,202108,26364,68526,18571,53125,2208,6864,10391,27790,12599,34654
355250,202108,39028,102181,29171,83327,7319,21870,11124,30406,18443,52276
355255,202108,674,1664,374,1126,56,183,132,391,188,574
355260,202108,1590,3773,1121,3013,130,416,655,1632,785,2048
355270,202108,1184,3438,913,2893,201,672,350,1003,551,1675
355280,202108,32695,81497,23515,64559,2914,8657,12458,32032,15372,40689
355290,202108,931,2489,723,2132,140,396,319,908,459,1304
355300,202108,1356,3924,1078,3390,184,625,401,1178,585,1803
355310,202108,961,2621,717,2218,100,299,406,1274,506,1573
355320,202108,534,1385,399,1138,73,233,160,375,233,608
355330,202108,3036,7604,2345,6422,121,421,1793,4678,1914,5099
355340,202108,4291,9452,3275,8106,400,912,2025,5117,2425,6029
355350,202108,1370,3841,1021,3181,196,646,391,1168,587,1814
355360,202108,1237,3123,948,2681,123,384,555,1525,678,1909
355365,202108,375,960,200,652,47,150,26,83,73,233
355370,202108,5589,14124,4315,12080,1029,2631,1828,5670,2857,8301
355380,202108,2958,7811,2237,6509,371,1201,832,2089,1203,3290
355385,202108,1495,3862,1233,3485,106,360,796,2052,902,2412
355390,202108,842,2260,607,1758,130,409,237,613,367,1022
355395,202108,2039,5482,1443,4305,236,742,513,1344,749,2086
355400,202108,9484,26454,7509,22576,1716,5863,2828,7555,4544,13418
355410,202108,23634,64235,14690,45689,2840,9654,4123,12398,6963,22052
355420,202108,636,1995,533,1808,138,504,140,443,278,947
355430,202108,3811,9555,2863,7841,601,1649,1336,3608,1937,5257
355440,202108,779,2098,481,1475,79,247,141,400,220,647
355450,202108,3328,8495,2239,6382,347,1069,989,2557,1336,3626
355460,202108,519,1241,325,923,46,162,161,408,207,570
355465,202108,445,1143,345,984,44,138,196,543,240,681
355470,202108,1148,2919,666,1968,171,560,193,497,364,1057
355475,202108,350,811,286,725,14,33,217,535,231,568
355480,202108,4137,11208,3364,10050,459,1593,2189,6362,2648,7955
355490,202108,960,2513,545,1660,42,137,281,779,323,916
355495,202108,837,2298,606,1909,64,252,225,625,289,877
355500,202108,7059,17819,4308,12556,633,2007,1587,4249,2220,6256
355510,202108,1427,3417,915,2564,126,387,380,952,506,1339
355520,202108,377,849,186,540,33,95,63,186,96,281
355530,202108,396,925,148,437,13,47,57,151,70,198
355535,202108,523,1387,396,1184,75,279,185,509,260,788
355540,202108,11146,27261,9149,24473,1186,3498,6190,15982,7376,19480
355550,202108,636,1834,525,1621,60,205,295,842,355,1047
355560,202108,1191,3017,672,2024,152,527,28,77,180,604
355570,202108,268,733,139,447,26,87,31,80,57,167
355580,202108,1230,2931,770,2154,139,464,289,708,428,1172
355590,202108,179,449,138,384,15,47,86,229,101,276
355600,202108,1593,3856,1056,2949,164,490,383,1080,547,1570
355610,202108,1858,4502,1229,3415,134,412,662,1722,796,2134
355620,202108,5222,13585,3915,11028,390,1315,2241,5782,2631,7097
355630,202108,2489,6668,1759,5322,256,816,915,2663,1171,3479
355635,202108,900,2604,668,2145,111,387,204,586,315,973
355640,202108,3303,8957,2263,6875,456,1446,671,1998,1127,3444
355645,202108,4260,11778,3119,9777,452,1545,1683,5097,2135,6642
355650,202108,6620,17639,5112,14880,1298,3968,1536,3949,2834,7917
355660,202108,1433,3628,999,2857,167,501,288,823,455,1324
355670,202108,3964,10475,2698,7671,315,1045,1397,3506,1712,4551
355680,202108,2937,7901,1378,4297,332,1127,97,283,429,1410
355690,202108,804,2318,521,1760,125,469,12,22,137,491
355695,202108,261,732,154,484,13,58,32,72,45,130
355700,202108,7765,21733,6387,18718,964,3079,3605,9918,4569,12997
355710,202108,9496,22162,6289,16340,840,2469,3143,7211,3983,9680
355715,202108,500,1331,274,830,58,187,46,119,104,306
355720,202108,1491,4140,1177,3585,169,547,654,1883,823,2430
355730,202108,954,2577,783,2268,123,396,404,1088,527,1484
410010,202108,1322,3625,1019,2995,192,608,256,718,448,1326
410020,202108,1066,3143,813,2572,274,812,174,560,448,1372
410030,202108,1616,4319,1382,3957,196,589,760,2218,956,2807
410040,202108,13393,36349,9811,29605,2132,6894,3052,8474,5184,15368
410045,202108,835,2222,605,1768,90,287,231,608,321,895
410050,202108,2366,5871,1638,4618,252,796,611,1597,863,2393
410060,202108,2169,6006,1681,5069,366,1156,523,1499,889,2655
410070,202108,2048,5090,1527,4159,230,715,601,1453,831,2168
410080,202108,1385,3648,979,2913,271,842,202,599,473,1441
410090,202108,1151,2894,975,2620,111,275,551,1570,662,1845
410100,202108,1986,5608,1305,4012,190,665,123,365,313,1030
410105,202108,504,1252,290,840,31,88,107,289,138,377
410110,202108,3423,8446,2415,6561,306,892,1139,2914,1445,3806
410115,202108,589,1497,424,1207,52,154,167,432,219,586
410120,202108,2762,7438,2382,6887,468,1438,1315,3691,1783,5129
410130,202108,1291,3431,1118,3110,206,651,588,1519,794,2170
410140,202108,17045,40824,11317,30664,2012,5967,3084,7588,5096,13555
410150,202108,17140,39759,8794,23679,1476,4388,2150,5149,3626,9537
410160,202108,3023,8235,2412,7164,540,1709,805,2381,1345,4090
410165,202108,706,1862,578,1607,62,193,337,875,399,1068
410170,202108,3002,7651,1994,5529,426,1284,121,353,547,1637
410180,202108,15312,42004,11786,34922,1638,5308,6071,16703,7709,22011
410185,202108,440,1273,316,960,57,181,89,237,146,418
410190,202108,2234,5499,1619,4416,328,931,423,1079,751,2010
410200,202108,5972,13383,3291,8783,524,1579,443,1134,967,2713
410210,202108,3334,8214,2168,6157,355,1138,727,1753,1082,2891
410220,202108,557,1434,365,1081,55,171,86,243,141,414
410230,202108,1844,4849,1411,3997,212,644,601,1542,813,2186
410240,202108,5388,13893,3683,10583,733,2342,518,1316,1251,3658
410250,202108,2637,6237,1955,5153,142,446,959,2457,1101,2903
410260,202108,1911,4716,1187,3371,157,453,558,1524,715,1977
410270,202108,495,1300,353,1046,46,157,142,410,188,567
410275,202108,655,1822,465,1416,79,259,184,515,263,774
410280,202108,2439,6329,1616,4727,202,677,669,1787,871,2464
410290,202108,3507,9610,2425,7342,702,2088,582,1760,1284,3848
410300,202108,711,1737,565,1514,58,175,277,681,335,856
410302,202108,353,901,205,624,15,48,99,296,114,344
410304,202108,1323,3378,1101,2966,118,339,691,1787,809,2126
410305,202108,1775,4209,1243,3448,106,332,806,2149,912,2481
410310,202108,2677,7348,2167,6400,300,989,1145,3291,1445,4280
410315,202108,654,1533,405,1136,145,412,97,278,242,690
410320,202108,1081,2964,729,2254,107,380,125,355,232,735
410322,202108,660,1713,349,1004,40,123,149,373,189,496
410330,202108,1585,3800,1093,2884,181,498,312,814,493,1312
410335,202108,887,2342,676,1948,97,297,279,741,376,1038
410337,202108,856,2086,595,1583,82,231,209,495,291,726
410340,202108,526,1471,353,1056,27,80,162,398,189,478
410345,202108,2556,6545,1378,4017,259,771,385,961,644,1732
410347,202108,759,1939,561,1571,55,190,181,508,236,698
410350,202108,1666,4032,1196,3261,145,426,578,1451,723,1877
410360,202108,4419,10811,3370,8983,502,1394,1442,3738,1944,5132
410370,202108,14335,37962,9291,26274,1066,3257,3937,9733,5003,12990
410380,202108,1713,4232,1251,3412,192,554,407,1000,599,1554
410390,202108,2795,6868,1869,5253,375,1181,630,1565,1005,2746
410395,202108,946,2642,764,2271,159,473,290,883,449,1356
410400,202108,6980,17799,5319,14690,724,2121,2776,7216,3500,9337
410405,202108,907,2058,635,1663,105,318,300,726,405,1044
410410,202108,1349,3500,1264,3368,149,464,808,2232,957,2696
410420,202108,11605,31008,8781,25400,1327,4287,3734,9668,5061,13955
410425,202108,3471,9552,2382,7332,383,1274,860,2392,1243,3666
410430,202108,13663,33670,9626,26374,1419,4256,3561,9034,4980,13290
410440,202108,2380,6923,2037,6295,317,1093,1061,3189,1378,4282
410442,202108,2452,7213,1943,6092,483,1571,524,1533,1007,3104
410445,202108,2320,6550,1687,5335,328,1173,276,952,604,2125
410450,202108,1539,3750,1147,3141,214,625,440,1145,654,1770
410460,202108,2278,5586,1686,4568,185,531,816,2096,1001,2627
410465,202108,2877,8191,2274,7050,408,1328,775,2229,1183,3557
410470,202108,2175,5855,1530,4708,392,1389,210,701,602,2090
410480,202108,39210,92807,21432,61465,3193,10191,4883,11847,8076,22038
410490,202108,11692,31681,8435,25057,1460,4624,3451,9546,4911,14170
410500,202108,1950,4987,1323,3817,266,856,347,864,613,1720
410510,202108,1883,4649,1270,3520,243,647,385,1064,628,1711
410520,202108,3111,9606,2736,8851,950,3164,818,2719,1768,5883
410530,202108,1672,3983,785,2167,99,287,210,472,309,759
410540,202108,2937,7816,2038,6013,318,1020,867,2418,1185,3438
410550,202108,7890,20687,5280,15122,877,2747,1440,3560,2317,6307
410560,202108,1552,4015,1153,3200,241,730,388,924,629,1654
410570,202108,2690,7153,1937,5827,539,1927,200,595,739,2522
410580,202108,27327,69624,19980,56361,3382,10293,9102,23922,12484,34215
410590,202108,1601,4508,1118,3393,149,493,338,858,487,1351
410600,202108,1845,4825,1427,4029,334,921,423,1258,757,2179
410610,202108,736,1874,558,1547,63,205,256,643,319,848
410620,202108,2600,7234,1742,5267,381,1229,240,695,621,1924
410630,202108,2620,6702,1721,4932,295,1009,380,865,675,1874
410640,202108,4992,11524,3432,8835,722,2136,419,1095,1141,3231
410645,202108,1132,3126,925,2866,268,858,439,1368,707,2226
410650,202108,2444,6511,1684,5005,320,1020,614,1666,934,2686
410655,202108,935,2224,655,1723,23,62,336,841,359,903
410657,202108,638,1699,387,1156,51,160,113,280,164,440
410660,202108,3594,8959,2120,5799,367,1019,654,1645,1021,2664
410670,202108,1053,2582,644,1818,133,364,199,511,332,875
410680,202108,2661,7814,1834,5772,417,1319,270,884,687,2203
410685,202108,548,1386,411,1156,102,322,152,384,254,706
410690,202108,138681,331189,93711,249436,13970,42289,38112,89334,52082,131623
410700,202108,2564,6399,2125,5720,391,1068,978,2564,1369,3632
410710,202108,913,2273,599,1694,114,338,241,618,355,956
410712,202108,678,1870,564,1663,104,343,269,740,373,1083
410715,202108,875,2488,550,1765,64,206,224,682,288,888
410720,202108,3427,8573,2754,7356,410,1302,749,1943,1159,3245
410725,202108,1155,2796,676,1904,139,417,93,219,232,636
410730,202108,731,1924,575,1636,118,386,125,358,243,744
410740,202108,919,2538,675,2072,84,288,272,828,356,1116
410750,202108,1845,4567,1473,3894,232,661,690,1745,922,2406
410752,202108,385,940,208,599,28,83,98,263,126,346
410753,202108,349,1024,244,783,41,148,53,155,94,303
410754,202108,1122,2840,927,2548,67,160,631,1811,698,1971
410755,202108,593,1511,423,1182,52,152,198,500,250,652
410760,202108,3772,9641,2734,7762,653,2136,637,1651,1290,3787
410765,202108,15137,41385,11821,34885,1992,6352,2871,7391,4863,13743
410770,202108,1102,2563,777,2021,72,192,391,1013,463,1205
410773,202108,1325,3460,1161,3212,116,355,750,2011,866,2366
410775,202108,1558,3790,1366,3510,59,177,929,2315,988,2492
410780,202108,662,1626,446,1217,69,194,134,343,203,537
410785,202108,741,1889,563,1588,90,284,179,504,269,788
410790,202108,905,2512,751,2224,181,573,65,136,246,709
410800,202108,3541,7783,2848,6792,51,152,1864,4301,1915,4453
410810,202108,458,1197,345,981,36,107,134,323,170,430
410820,202108,975,2692,521,1551,102,314,87,219,189,533
410830,202108,42412,100126,29359,78574,5589,16729,11577,28928,17166,45657
410832,202108,1058,2721,848,2354,90,281,510,1331,600,1612
410840,202108,9106,22581,5407,15596,983,3074,1422,3788,2405,6862
410845,202108,1196,2926,925,2513,169,473,377,1006,546,1479
410850,202108,2297,6434,2008,5911,323,999,956,2753,1279,3752
410855,202108,789,1944,505,1394,57,157,244,613,301,770
410860,202108,4613,11091,3616,9475,270,849,2246,5538,2516,6387
410865,202108,1500,4267,1290,3872,127,411,748,2304,875,2715
410870,202108,1274,3359,1038,2966,98,286,671,1898,769,2184
410880,202108,4813,12548,3345,9876,518,1558,507,1582,1025,3140
410890,202108,1053,2902,808,2434,171,577,249,701,420,1278
410895,202108,1032,3205,871,2865,265,950,212,661,477,1611
410900,202108,890,2358,630,1855,104,314,149,368,253,682
410910,202108,423,978,261,671,12,39,141,323,153,362
410920,202108,895,2146,647,1745,83,247,322,838,405,1085
410930,202108,1756,4439,1207,3475,276,926,213,585,489,1511
410940,202108,23733,63196,17274,51835,3471,11398,5527,16113,8998,27511
410950,202108,1977,5708,1778,5417,69,202,1452,4412,1521,4614
410960,202108,8090,19484,5638,15461,1229,3736,2247,6089,3476,9825
410965,202108,1209,2992,826,2280,79,240,495,1327,574,1567
410970,202108,4249,11203,3016,8839,664,2305,425,1018,1089,3323
410975,202108,1408,3377,1067,2853,122,364,509,1304,631,1668
410980,202108,8021,19636,5215,14637,574,1765,2326,5908,2900,7673
410990,202108,1449,3436,984,2700,192,610,382,1012,574,1622
411000,202108,693,1827,489,1454,63,213,152,381,215,594
411005,202108,495,1217,295,794,50,149,98,222,148,371
411007,202108,2366,6451,1886,5610,447,1406,640,1854,1087,3260
411010,202108,4315,12727,3395,10867,827,2881,374,1083,1201,3964
411020,202108,2431,6727,1964,5901,547,1693,509,1513,1056,3206
411030,202108,795,1916,566,1467,46,150,304,696,350,846
411040,202108,1037,2606,556,1573,70,216,173,405,243,621
411050,202108,2043,6248,1672,5443,387,1363,255,697,642,2060
411060,202108,2128,5598,1379,4041,269,883,266,736,535,1619
411065,202108,438,1104,285,806,35,107,121,327,156,434
411070,202108,7805,19385,6153,16662,755,2233,3204,8402,3959,10635
411080,202108,1847,4896,1545,4394,380,1261,337,914,717,2175
411090,202108,831,2178,546,1621,46,161,155,428,201,589
411095,202108,2821,6527,1569,4250,198,552,389,980,587,1532
411100,202108,1260,3206,884,2527,87,284,314,906,401,1190
411110,202108,653,1678,310,942,35,105,21,49,56,154
411120,202108,1367,3674,1130,3242,306,1026,255,665,561,1691
411125,202108,5438,15588,4843,14511,1105,3248,2264,7128,3369,10376
411130,202108,756,1983,543,1587,104,276,183,594,287,870
411140,202108,2334,7011,1960,6246,595,2011,506,1604,1101,3615
411150,202108,4095,10240,2748,7503,498,1588,251,490,749,2078
411155,202108,1021,2585,634,1855,95,271,283,777,378,1048
411160,202108,374,848,255,670,26,74,69,185,95,259
411170,202108,779,2236,600,1840,134,433,216,626,350,1059
411180,202108,5820,15107,4559,12947,674,2059,2212,5882,2886,7941
411190,202108,1904,4803,1400,3873,202,602,557,1398,759,2000
411200,202108,5043,13460,3650,10889,862,2875,818,2107,1680,4982
411210,202108,3409,7542,2312,5758,408,1112,794,1870,1202,2982
411220,202108,916,2299,646,1788,148,456,179,459,327,915
411230,202108,878,2311,638,1859,136,419,209,588,345,1007
411240,202108,1670,3930,1142,2999,133,409,557,1331,690,1740
411250,202108,2311,6033,1678,4895,318,1097,504,1380,822,2477
411260,202108,335,841,225,627,23,69,98,236,121,305
411270,202108,2083,5443,1541,4374,209,625,748,1963,957,2588
411275,202108,1516,3457,1051,2698,140,438,506,1195,646,1633
411280,202108,1352,3628,926,2819,231,722,128,364,359,1086
411290,202108,861,2224,541,1600,70,206,262,761,332,967
411295,202108,1307,3262,933,2544,113,325,417,1066,530,1391
411300,202108,1083,2680,710,1957,73,229,321,759,394,988
411310,202108,912,2059,703,1774,83,211,307,767,390,978
411320,202108,5707,14437,4159,11682,613,1838,1825,4624,2438,6462
411325,202108,1428,3982,1200,3580,227,641,631,1959,858,2600
411330,202108,3431,9120,2508,7437,557,1795,749,2241,1306,4036
411340,202108,860,2313,520,1569,86,266,143,399,229,665
411342,202108,1103,2636,619,1683,103,289,206,516,309,805
411345,202108,1158,2922,884,2477,63,187,640,1799,703,1986
411350,202108,3003,7906,1946,5770,457,1474,331,860,788,2334
411360,202108,752,1787,539,1457,75,221,202,503,277,724
411370,202108,62648,152206,45716,123257,3319,10551,27186,67844,30505,78395
411373,202108,1454,3625,1176,3214,114,343,631,1742,745,2085
411375,202108,1142,2837,829,2255,129,361,327,869,456,1230
411380,202108,1197,2722,814,2007,47,126,504,1145,551,1271
411390,202108,1549,4202,1210,3462,196,602,477,1184,673,1786
411400,202108,2441,5880,1825,4734,156,487,984,2388,1140,2875
411410,202108,2787,7602,2057,6077,430,1389,463,1276,893,2665
411420,202108,4522,10836,2443,6901,320,1018,467,975,787,1993
411430,202108,3707,9832,2814,8180,559,1764,985,2621,1544,4385
411435,202108,419,1142,270,835,58,177,88,243,146,420
411440,202108,2635,7211,2108,6217,438,1391,676,1890,1114,3281
411450,202108,2524,6686,1906,5645,242,711,1047,3151,1289,3862
411460,202108,4486,11390,2832,8239,419,1408,550,1421,969,2829
411470,202108,825,2063,611,1657,106,325,241,570,347,895
411480,202108,5361,13965,3918,11288,648,2226,1530,3942,2178,6168
411490,202108,1681,4289,1292,3643,147,480,556,1394,703,1874
411500,202108,1349,3548,915,2628,150,463,180,416,330,879
411510,202108,2405,5963,1936,5190,334,1052,547,1489,881,2541
411520,202108,34310,82928,20454,56140,2310,7265,8190,19923,10500,27188
411530,202108,997,2554,602,1801,97,323,91,226,188,549
411535,202108,528,1519,343,1083,43,156,99,280,142,436
411540,202108,2694,6516,1868,5037,121,390,1018,2686,1139,3076
411545,202108,932,2663,782,2401,71,226,500,1543,571,1769
411550,202108,745,1854,547,1490,79,226,109,325,188,551
411560,202108,2047,5497,1178,3642,140,488,58,135,198,623
411570,202108,7452,17053,5037,13453,1130,3258,936,2521,2066,5779
411573,202108,790,2109,658,1879,103,296,301,839,404,1135
411575,202108,2122,5671,1587,4597,274,844,425,1172,699,2016
411580,202108,5030,11521,3056,8472,417,1405,552,1329,969,2734
411585,202108,639,1885,305,978,59,181,55,169,114,350
411590,202108,421,1129,310,908,42,121,154,417,196,538
411600,202108,336,830,206,620,35,105,66,189,101,294
411605,202108,1605,3717,1044,2839,140,487,516,1379,656,1866
411610,202108,2691,6203,1910,4840,66,222,1322,3122,1388,3344
411620,202108,2810,7381,2387,6729,372,1107,1319,3704,1691,4811
411630,202108,848,2126,531,1546,67,234,199,514,266,748
411640,202108,472,1206,323,894,42,126,100,237,142,363
411650,202108,218,623,145,463,29,99,29,72,58,171
411660,202108,941,2388,686,1924,56,160,273,716,329,876
411670,202108,1511,3557,1031,2659,112,302,536,1268,648,1570
411680,202108,1483,3919,1110,3181,175,575,463,1271,638,1846
411690,202108,4116,10249,3094,8496,679,1846,814,2414,1493,4260
411695,202108,658,1932,451,1399,46,156,191,543,237,699
411700,202108,1804,4561,1196,3404,258,750,194,531,452,1281
411705,202108,2064,6112,1750,5565,314,919,1022,3478,1336,4397
411710,202108,2070,5158,1419,3949,313,873,333,874,646,1747
411720,202108,1111,2543,793,1989,137,361,313,754,450,1115
411721,202108,1036,2528,778,2053,136,340,233,608,369,948
411722,202108,924,2441,541,1592,96,308,187,457,283,765
411725,202108,1255,3439,837,2617,193,652,167,499,360,1151
411727,202108,1570,4292,1024,3132,223,681,129,364,352,1045
411729,202108,684,1642,384,1050,44,148,141,338,185,486
411730,202108,5530,14368,4282,11964,786,2375,1964,5338,2750,7713
411740,202108,538,1365,283,814,74,196,57,150,131,346
411745,202108,835,2356,581,1788,66,230,147,359,213,589
411750,202108,5825,15137,4261,12080,555,1691,2039,5425,2594,7116
411760,202108,7043,18442,5449,15724,1666,5001,1032,3371,2698,8372
411770,202108,3179,9027,2310,7126,507,1678,404,1103,911,2781
411780,202108,2735,7551,2373,6899,676,2053,790,2352,1466,4405
411790,202108,2973,7070,1695,4788,330,1054,413,997,743,2051
411800,202108,1104,3144,796,2408,129,431,150,395,279,826
411810,202108,1649,4196,1227,3368,213,610,524,1323,737,1933
411820,202108,12255,34170,9995,30271,2341,7613,4405,12891,6746,20504
411830,202108,573,1406,426,1140,84,248,69,190,153,438
411840,202108,12793,33434,8864,25373,1415,4351,2543,6504,3958,10855
411845,202108,616,1718,362,1130,50,183,90,242,140,425
411850,202108,7643,19154,5204,14886,1234,3890,1004,2600,2238,6490
411860,202108,725,1970,520,1546,80,243,118,301,198,544
411870,202108,604,1732,425,1329,86,297,98,291,184,588
411880,202108,2383,5767,1729,4740,231,698,682,1769,913,2467
411885,202108,1157,2985,840,2409,129,435,254,647,383,1082
411890,202108,1455,3812,1040,3044,178,587,106,295,284,882
411900,202108,824,2243,519,1590,113,366,102,290,215,656
411910,202108,1095,3195,800,2580,180,672,306,893,486,1565
411915,202108,16011,38832,11066,29901,1551,4631,4708,11453,6259,16084
411920,202108,1216,3441,1006,3019,210,728,376,1035,586,1763
411925,202108,511,1332,365,1063,76,226,152,415,228,641
411930,202108,5061,15013,4248,13521,1841,6361,284,1094,2125,7455
411940,202108,3393,9770,2639,8168,618,1934,868,2442,1486,4376
411950,202108,15149,40143,12534,35819,1551,5031,7558,20584,9109,25615
411960,202108,6256,16270,4930,13647,846,2502,2041,5411,2887,7913
411965,202108,488,1330,354,1066,51,170,154,425,205,595
411970,202108,1231,2729,955,2361,185,433,407,1154,592,1587
411980,202108,1522,3656,1096,2962,277,737,396,1059,673,1796
411990,202108,39454,101399,25444,76165,4515,14908,9046,25432,13561,40340
411995,202108,4089,9811,3134,8327,874,2544,792,2009,1666,4553
412000,202108,1888,4331,1296,3333,34,111,894,2130,928,2241
412010,202108,643,1931,482,1577,77,261,129,365,206,626
412015,202108,560,1558,451,1360,69,212,251,757,320,969
412020,202108,466,1288,298,933,44,164,122,345,166,509
412030,202108,620,1732,456,1434,68,214,157,487,225,701
412033,202108,987,2564,704,2001,84,244,260,629,344,873
412035,202108,753,2016,482,1527,58,203,250,758,308,961
412040,202108,679,1796,381,1170,58,168,50,142,108,310
412050,202108,1636,4055,1113,3087,247,764,248,688,495,1452
412060,202108,7529,21400,6241,18855,1591,5451,1732,5010,3323,10461
412065,202108,641,1749,470,1405,98,318,107,316,205,634
412070,202108,1257,3217,986,2691,129,382,379,934,508,1316
412080,202108,2366,6389,1649,4971,239,760,502,1355,741,2115
412085,202108,328,784,116,353,11,33,24,58,35,91
412090,202108,6399,16174,4684,13037,1064,3135,1716,4793,2780,7928
412100,202108,1770,4666,1334,3861,428,1407,298,889,726,2296
412110,202108,875,2301,597,1747,80,253,190,534,270,787
412120,202108,2126,5944,1620,4985,326,1116,421,1085,747,2201
412125,202108,685,1914,464,1439,78,243,103,315,181,558
412130,202108,844,2069,576,1578,94,257,142,400,236,657
412135,202108,647,1700,306,914,48,160,96,244,144,404
412140,202108,1800,4293,1217,3286,187,618,256,650,443,1268
412150,202108,2909,7375,2472,6620,363,1116,1487,3755,1850,4871
412160,202108,909,2774,508,1689,65,241,65,170,130,411
412170,202108,4494,12092,3768,10922,691,2254,1585,4207,2276,6461
412175,202108,1346,3758,1125,3389,239,763,468,1395,707,2158
412180,202108,1730,4708,1269,3856,155,539,563,1577,718,2116
412190,202108,3465,8539,2549,6953,306,893,1079,2923,1385,3816
412200,202108,1855,5333,1277,4042,308,1053,183,544,491,1597
412210,202108,674,1584,423,1156,55,167,167,410,222,577
412215,202108,3495,9274,2657,7647,637,1796,1073,3354,1710,5150
412217,202108,1032,2647,859,2335,43,116,607,1582,650,1698
412220,202108,5746,15903,4714,14039,1310,3789,1433,4593,2743,8382
412230,202108,2778,7977,2182,6839,342,1222,525,1394,867,2616
412240,202108,7809,19890,4986,14330,854,2634,1473,3774,2327,6408
412250,202108,2089,5292,1531,4221,349,1007,302,750,651,1757
412260,202108,1311,3403,979,2732,154,437,287,758,441,1195
412265,202108,952,2534,750,2180,160,477,293,812,453,1289
412270,202108,1073,2897,693,2095,86,290,267,728,353,1018
412280,202108,424,1148,331,989,83,256,90,255,173,511
412290,202108,1072,2695,747,2120,108,333,248,644,356,977
412300,202108,1702,4380,1192,3485,253,776,265,803,518,1579
412310,202108,756,2136,580,1771,106,369,175,490,281,859
412320,202108,813,2057,520,1465,47,160,147,403,194,563
412330,202108,1645,4301,1132,3351,239,747,380,1152,619,1899
412340,202108,1251,3350,824,2427,96,326,114,319,210,645
412350,202108,3106,8019,2020,5866,360,1135,355,922,715,2057
412360,202108,268,721,193,562,7,33,124,337,131,370
412370,202108,877,2457,595,1856,116,401,74,220,190,621
412380,202108,1587,4269,1126,3358,281,870,116,388,397,1258
412382,202108,497,1193,330,924,39,137,147,337,186,474
412385,202108,2254,6060,1846,5286,591,1589,575,1827,1166,3416
412390,202108,2602,6143,2080,5336,349,913,730,1857,1079,2770
412395,202108,724,2037,521,1575,71,201,226,686,297,887
412400,202108,963,2496,694,1977,128,406,203,557,331,963
412402,202108,2351,5700,1644,4550,431,1203,216,644,647,1847
412405,202108,3219,8377,2104,6305,509,1768,127,345,636,2113
412410,202108,6482,16493,4750,13681,772,2577,1564,4167,2336,6744
412420,202108,559,1388,371,1010,27,81,180,416,207,497
412430,202108,613,1528,327,941,34,104,134,359,168,463
412440,202108,2872,7542,1928,5786,433,1373,402,1220,835,2593
412450,202108,514,1451,345,1039,39,119,36,82,75,201
412460,202108,1134,2887,885,2468,166,499,385,1032,551,1531
412470,202108,1592,4899,1310,4279,292,1012,284,909,576,1921
412480,202108,1111,2889,751,2135,121,377,262,654,383,1031
412490,202108,1369,3294,1092,2799,143,368,543,1301,686,1669
412500,202108,2056,5102,1552,4181,319,885,435,1055,754,1940
412510,202108,1984,5911,1358,4360,314,1082,172,486,486,1568
412520,202108,1321,3300,737,2093,165,442,100,283,265,725
412530,202108,721,1894,520,1487,75,243,118,333,193,576
412535,202108,844,2167,574,1648,106,337,112,264,218,601
412540,202108,1210,3022,878,2430,85,300,294,851,379,1151
412545,202108,711,1822,493,1390,83,256,137,369,220,625
412550,202108,35393,92569,25323,72687,3887,12050,10440,27202,14327,39252
412555,202108,304,781,206,575,20,60,69,154,89,214
412560,202108,4996,14049,3795,11307,645,2154,1156,3399,1801,5553
412570,202108,4659,11487,2712,7769,483,1596,342,999,825,2595
412575,202108,1062,2644,848,2283,115,345,450,1131,565,1476
412580,202108,1493,3798,1066,3011,73,237,590,1583,663,1820
412590,202108,411,1072,229,701,30,96,24,66,54,162
412600,202108,1720,4523,1308,3720,178,557,619,1640,797,2197
412610,202108,876,2279,626,1745,74,222,286,686,360,908
412620,202108,1285,3314,986,2867,182,603,306,820,488,1423
412625,202108,8986,23446,5539,16615,738,2459,334,940,1072,3399
412627,202108,1174,3245,762,2392,141,489,207,639,348,1128
412630,202108,2954,8477,2143,6753,385,1264,614,1738,999,3002
412635,202108,415,1110,284,832,32,103,93,218,125,321
412640,202108,1067,2775,619,1835,76,234,174,450,250,684
412650,202108,1744,4634,1379,3910,223,704,537,1320,760,2024
412660,202108,2584,6604,1867,5245,245,734,650,1638,895,2372
412665,202108,412,1016,321,850,68,187,134,348,202,535
412667,202108,1868,4798,1369,3838,188,570,587,1564,775,2134
412670,202108,896,2080,576,1561,110,334,148,371,258,705
412680,202108,2155,5637,1500,4391,181,611,529,1336,710,1947
412690,202108,1184,3075,856,2453,148,468,305,816,453,1284
412700,202108,1985,5153,1659,4647,209,643,906,2483,1115,3126
412710,202108,6004,17096,4457,13800,814,2791,1179,3145,1993,5936
412720,202108,1209,3459,928,2860,139,448,227,572,366,1020
412730,202108,2626,6753,1842,5214,309,990,715,1857,1024,2847
412740,202108,1993,5468,1372,4221,213,752,190,588,403,1340
412750,202108,4139,10635,3361,9524,270,881,2207,5963,2477,6844
412760,202108,3027,8079,2518,7217,466,1497,1342,3601,1808,5098
412770,202108,10915,27651,5953,17861,789,2540,1279,3182,2068,5722
412780,202108,1222,3183,927,2654,199,622,345,945,544,1567
412785,202108,2219,5175,1574,4110,148,400,1056,2700,1204,3100
412788,202108,1457,4034,1195,3581,332,988,454,1318,786,2306
412790,202108,1383,3617,800,2446,112,388,247,648,359,1036
412795,202108,1296,3300,706,2110,95,307,128,347,223,654
412796,202108,2240,6294,1849,5596,369,1199,604,1671,973,2870
412800,202108,3812,9143,2656,7022,285,883,1297,3024,1582,3907
412810,202108,12647,31914,8284,23193,995,3244,3273,8078,4268,11322
412820,202108,6345,17207,4502,13489,1072,3433,1282,3780,2354,7213
412830,202108,358,1007,260,798,39,111,69,198,108,309
412840,202108,1941,4726,1397,3689,143,423,682,1630,825,2053
412850,202108,2867,7371,2100,6077,309,966,893,2497,1202,3463
412853,202108,1552,3855,1295,3413,172,501,680,1588,852,2089
412855,202108,1355,3483,827,2392,120,393,214,549,334,942
412860,202108,771,1885,523,1487,79,242,269,710,348,952
412862,202108,673,1645,458,1281,98,282,169,438,267,720
412863,202108,1287,3820,1145,3561,259,832,521,1620,780,2452
412865,202108,722,1949,527,1553,151,463,119,373,270,836
412870,202108,875,2234,634,1839,177,564,143,468,320,1032
412880,202108,881,2361,588,1777,99,338,113,309,212,647
420005,202108,429,1242,258,845,27,85,121,401,148,486
420010,202108,3333,8055,2239,6227,125,373,1646,4627,1771,5000
420020,202108,440,1350,291,966,46,178,68,161,114,339
420030,202108,99,348,63,255,17,75,20,76,37,151
420040,202108,526,1558,327,1112,67,251,28,70,95,321
420050,202108,718,1607,480,1197,75,204,284,634,359,838
420055,202108,161,490,83,300,20,89,23,73,43,162
420060,202108,107,287,66,190,5,15,15,35,20,50
420070,202108,739,2173,551,1782,110,357,218,689,328,1046
420075,202108,82,202,42,123,7,26,13,19,20,45
420080,202108,381,1056,298,864,70,229,121,336,191,565
420090,202108,419,1279,267,919,62,228,47,136,109,364
420100,202108,1287,3269,1080,2956,63,189,867,2335,930,2524
420110,202108,258,817,232,758,41,142,123,389,164,531
420120,202108,604,1611,410,1197,59,197,212,542,271,739
420125,202108,363,1093,254,851,62,234,88,271,150,505
420127,202108,315,806,124,367,15,48,48,131,63,179
420130,202108,3714,10021,2832,8581,403,1431,1344,3713,1747,5144
420140,202108,3845,10143,2804,8339,753,2526,505,1517,1258,4043
420150,202108,678,1708,472,1361,46,153,282,780,328,933
420160,202108,190,449,66,206,8,28,18,54,26,82
420165,202108,156,431,94,298,21,64,30,84,51,148
420170,202108,293,909,199,666,28,106,66,187,94,293
420180,202108,170,536,108,379,18,63,28,86,46,149
420190,202108,208,628,126,425,26,97,50,157,76,254
420195,202108,1539,3873,1155,3268,286,950,307,760,593,1710
420200,202108,5176,12302,3206,8679,414,1347,1384,3223,1798,4570
420205,202108,1911,5042,1286,3768,184,568,683,1993,867,2561
420207,202108,1981,5056,1255,3670,205,675,531,1435,736,2110
420208,202108,323,910,185,643,56,204,41,120,97,324
420209,202108,154,480,98,306,15,52,49,138,64,190
420210,202108,3374,8477,2351,6818,360,1199,1204,3311,1564,4510
420213,202108,788,2378,670,2152,143,494,337,1065,480,1559
420215,202108,211,631,149,493,41,154,39,122,80,276
420220,202108,288,825,175,579,28,112,79,236,107,348
420230,202108,5349,14219,4104,11902,574,1810,2230,6156,2804,7966
420240,202108,14659,40091,9444,28060,1133,3843,4560,11777,5693,15620
420243,202108,400,1101,328,964,48,164,211,590,259,754
420245,202108,1508,3804,1121,3143,83,285,703,1853,786,2138
420250,202108,456,1241,387,1127,52,172,236,650,288,822
420253,202108,473,1139,335,939,34,97,193,540,227,637
420257,202108,159,405,101,304,13,50,55,162,68,212
420260,202108,1133,2898,833,2489,112,393,560,1639,672,2032
420270,202108,560,1442,292,848,41,134,118,317,159,451
420280,202108,1287,3759,1015,3187,175,617,409,1213,584,1830
420285,202108,123,270,58,166,7,34,22,42,29,76
420287,202108,450,1031,328,864,83,228,124,328,207,556
420290,202108,4998,13953,3863,11427,532,1772,2256,6181,2788,7953
420300,202108,7592,21137,4439,13674,761,2593,1447,3855,2208,6448
420310,202108,811,1849,425,1165,41,128,237,610,278,738
420315,202108,791,2175,540,1745,90,316,251,790,341,1106
420320,202108,5386,14239,3878,11769,1048,3498,1006,2834,2054,6332
420325,202108,334,933,239,743,33,105,101,292,134,397
420330,202108,989,2830,626,2063,104,383,193,584,297,967
420340,202108,940,2567,706,2154,151,466,146,400,297,866
420350,202108,1205,3046,896,2505,67,225,634,1733,701,1958
420360,202108,2987,8061,1615,5109,286,991,119,364,405,1355
420370,202108,1197,3100,984,2757,76,258,720,1943,796,2201
420380,202108,4461,11549,3009,8893,600,1881,1184,3307,1784,5188
420390,202108,1079,2604,751,1950,127,383,309,576,436,959
420395,202108,1181,3294,818,2566,127,444,131,298,258,742
420400,202108,1014,2769,709,2150,111,390,314,891,425,1281
420410,202108,587,1529,455,1260,31,92,329,897,360,989
420415,202108,290,842,215,681,51,175,85,285,136,460
420417,202108,599,1735,467,1471,126,417,178,568,304,985
420419,202108,139,493,111,427,40,161,9,37,49,198
420420,202108,11955,30541,8044,23449,2081,6896,2369,6240,4450,13136
420425,202108,639,1696,436,1270,35,116,221,617,256,733
420430,202108,3163,8340,1885,5585,409,1276,629,1704,1038,2980
420435,202108,260,670,138,438,18,63,70,215,88,278
420440,202108,707,1880,437,1319,127,408,132,367,259,775
420445,202108,260,628,171,469,31,83,77,195,108,278
420450,202108,756,2182,546,1727,90,359,203,548,293,907
420455,202108,2041,4858,1485,4031,228,655,716,1869,944,2524
420460,202108,9433,24767,7133,20540,969,3164,3731,10221,4700,13385
420470,202108,587,1520,313,969,58,212,57,148,115,360
420475,202108,67,178,26,85,6,21,2,6,8,27
420480,202108,5281,12831,3262,9512,603,1934,1201,3444,1804,5378
420490,202108,367,1013,264,801,53,185,103,298,156,483
420500,202108,1363,3682,882,2806,136,492,407,1267,543,1759
420510,202108,155,429,78,251,12,49,18,48,30,97
420515,202108,77,209,50,146,7,34,18,47,25,81
420517,202108,763,2071,646,1849,66,194,426,1227,492,1421
420519,202108,307,739,219,610,19,62,136,380,155,442
420520,202108,277,735,143,474,18,61,10,31,28,92
420530,202108,812,2340,556,1778,76,297,225,624,301,921
420535,202108,233,681,95,324,15,56,37,122,52,178
420540,202108,39237,92756,26075,70723,3616,11039,9780,22994,13396,34033
420543,202108,215,630,163,512,17,53,84,241,101,294
420545,202108,1270,3744,961,3072,164,586,347,978,511,1564
420550,202108,3618,9461,2377,7383,362,1327,1058,3302,1420,4629
420555,202108,305,866,217,682,22,76,129,389,151,465
420560,202108,394,966,262,768,46,147,158,459,204,606
420570,202108,2467,6447,1923,5444,309,998,901,2440,1210,3438
420580,202108,1829,4658,1307,3845,292,917,423,1268,715,2185
420590,202108,2788,7409,1688,5043,279,978,475,1101,754,2079
420600,202108,1081,3045,846,2617,96,365,512,1496,608,1861
420610,202108,361,1039,235,756,55,175,83,279,138,454
420620,202108,777,1893,521,1477,115,337,196,552,311,889
420630,202108,919,2758,674,2165,76,275,402,1214,478,1489
420640,202108,489,1307,247,819,75,248,38,121,113,369
420650,202108,3694,9619,2325,6789,326,1042,932,2364,1258,3406
420660,202108,428,1090,273,761,58,165,57,142,115,307
420665,202108,673,1735,441,1345,72,239,195,533,267,772
420670,202108,1243,3407,789,2462,125,479,284,753,409,1232
420675,202108,188,510,114,366,19,79,56,166,75,245
420680,202108,310,702,161,495,29,96,79,230,108,326
420690,202108,868,2554,548,1817,76,300,150,435,226,735
420700,202108,2669,6922,2033,5871,204,642,1249,3504,1453,4146
420710,202108,1035,2878,800,2374,76,288,497,1318,573,1606
420720,202108,1171,3211,849,2656,141,477,452,1334,593,1811
420730,202108,3204,8259,2398,6930,390,1256,1286,3547,1676,4803
420740,202108,495,1450,273,964,55,213,19,75,74,288
420750,202108,1960,5578,1267,3998,211,777,518,1489,729,2266
420757,202108,84,203,38,112,4,6,17,53,21,59
420760,202108,312,899,170,522,31,108,51,139,82,247
420765,202108,459,1300,220,717,26,88,103,320,129,408
420768,202108,1368,3773,1193,3491,137,394,892,2606,1029,3000
420770,202108,442,1221,207,723,25,100,68,223,93,323
420775,202108,269,788,186,599,34,119,70,190,104,309
420780,202108,928,2610,557,1751,108,370,91,257,199,627
420785,202108,199,518,141,398,14,50,71,165,85,215
420790,202108,1029,3034,767,2507,115,437,437,1355,552,1792
420800,202108,663,1631,349,1012,68,227,155,423,223,650
420810,202108,1468,4410,1198,3880,312,1168,472,1304,784,2472
420820,202108,12972,31981,9425,26242,1632,5042,4448,11479,6080,16521
420830,202108,4506,11587,3376,9574,574,1721,1488,4064,2062,5785
420840,202108,484,1425,234,858,56,202,19,78,75,280
420845,202108,2573,6424,1628,4731,306,1063,683,1860,989,2923
420850,202108,1089,3405,678,2329,110,404,148,448,258,852
420860,202108,369,937,212,657,34,112,56,151,90,263
420870,202108,781,2169,580,1771,150,509,217,592,367,1101
420880,202108,1074,3181,827,2671,162,622,317,925,479,1547
420890,202108,8279,22205,5188,15843,703,2318,1812,4904,2515,7222
420895,202108,175,503,110,334,28,87,36,110,64,197
420900,202108,1542,3773,940,2725,119,418,437,1106,556,1524
420910,202108,32315,84081,20751,61983,2974,10065,8549,22469,11523,32534
420915,202108,507,1804,375,1425,54,200,207,800,261,1000
420917,202108,433,1057,197,527,33,89,95,258,128,347
420920,202108,80,219,36,123,2,5,6,22,8,27
420930,202108,16815,43003,12020,34613,2015,6446,5447,14790,7462,21236
420940,202108,3204,7719,1943,5566,424,1375,420,969,844,2344
420945,202108,134,381,106,323,19,65,46,127,65,192
420950,202108,355,1016,202,658,27,110,57,165,84,275
420960,202108,1066,2570,756,2047,119,371,346,837,465,1208
420970,202108,2384,6385,1667,5086,452,1422,485,1484,937,2906
420980,202108,275,906,237,826,109,391,59,212,168,603
420985,202108,323,906,172,583,43,165,46,136,89,301
420990,202108,316,980,183,654,29,109,41,144,70,253
421000,202108,563,1665,414,1340,88,311,97,269,185,580
421003,202108,469,1101,159,461,3,8,17,39,20,47
421005,202108,67,197,51,173,12,42,22,74,34,116
421010,202108,3338,9019,2397,7268,456,1554,672,1770,1128,3324
421020,202108,378,1158,299,1016,43,174,148,475,191,649
421030,202108,792,2310,606,1942,165,590,215,629,380,1219
421040,202108,640,1530,396,1156,30,102,243,695,273,797
421050,202108,1044,2761,688,1988,134,423,272,700,406,1123
421055,202108,178,481,103,309,16,51,61,166,77,217
421060,202108,677,1928,483,1515,85,303,242,698,327,1001
421070,202108,661,1959,416,1348,67,237,165,499,232,736
421080,202108,522,1478,427,1299,41,150,252,747,293,897
421085,202108,376,1046,149,501,14,44,28,75,42,119
421090,202108,273,702,152,428,12,43,50,123,62,166
421100,202108,788,1746,339,999,76,252,86,197,162,449
421105,202108,1571,4184,1096,3278,170,542,530,1505,700,2047
421110,202108,1123,2883,922,2614,41,133,641,1899,682,2032
421120,202108,1053,3118,754,2466,117,426,217,606,334,1032
421125,202108,298,762,214,611,72,235,77,187,149,422
421130,202108,4927,14067,4052,12358,906,3145,2065,5899,2971,9044
421140,202108,343,925,212,641,38,113,78,214,116,327
421145,202108,442,1195,283,851,68,213,84,221,152,434
421150,202108,636,1732,423,1311,65,234,185,518,250,752
421160,202108,518,1406,388,1155,56,189,238,662,294,851
421165,202108,228,671,140,456,30,100,52,162,82,262
421170,202108,1081,2932,917,2662,139,389,565,1688,704,2077
421175,202108,980,2396,592,1789,109,376,264,770,373,1146
421180,202108,393,1027,218,675,38,143,102,282,140,425
421185,202108,320,812,219,609,21,71,129,342,150,413
421187,202108,278,852,175,594,29,95,58,195,87,290
421189,202108,359,1027,279,870,43,147,116,337,159,484
421190,202108,11479,30617,7909,23820,1351,4346,3052,8436,4403,12782
421200,202108,705,1970,587,1770,92,332,340,961,432,1293
421205,202108,190,502,138,419,24,87,65,182,89,269
421210,202108,1084,2702,615,1895,116,369,226,679,342,1048
421220,202108,1382,4049,1076,3418,229,803,361,1043,590,1846
421223,202108,319,871,198,645,45,143,95,309,140,452
421225,202108,839,2425,714,2218,114,420,440,1332,554,1752
421227,202108,665,1861,431,1369,75,260,200,650,275,910
421230,202108,580,1488,374,1105,73,246,142,409,215,655
421240,202108,290,834,141,484,16,67,27,82,43,149
421250,202108,2131,5263,1512,4272,153,480,926,2510,1079,2990
421260,202108,215,669,48,174,9,39,5,14,14,53
421265,202108,687,1787,608,1672,18,46,523,1431,541,1477
421270,202108,345,912,146,498,30,103,42,138,72,241
421280,202108,2026,5279,1538,4482,208,726,883,2436,1091,3162
421290,202108,971,2598,502,1519,103,326,105,290,208,616
421300,202108,278,711,132,423,13,54,19,55,32,109
421310,202108,190,536,129,415,27,89,65,202,92,291
421315,202108,233,600,155,442,44,118,40,123,84,241
421320,202108,638,1996,340,1131,35,100,33,59,68,159
421330,202108,600,1754,433,1401,91,334,114,335,205,669
421335,202108,351,1055,282,933,60,217,117,374,177,591
421340,202108,1413,3829,1022,3130,167,594,498,1393,665,1987
421350,202108,1538,3919,1017,3017,192,627,392,1100,584,1727
421360,202108,2270,5982,1358,4128,255,904,512,1335,767,2239
421370,202108,737,2331,455,1584,76,287,138,406,214,693
421380,202108,840,2163,721,1978,91,287,427,1119,518,1406
421390,202108,167,447,64,219,13,40,25,71,38,111
421400,202108,347,1069,254,850,51,196,128,398,179,594
421410,202108,174,489,82,298,22,87,21,67,43,154
421415,202108,183,524,125,377,23,82,35,79,58,161
421420,202108,561,1513,455,1313,53,178,275,773,328,951
421430,202108,99,308,72,239,7,23,17,53,24,76
421440,202108,626,1666,374,1192,67,207,156,476,223,683
421450,202108,469,1336,270,893,30,110,38,135,68,245
421460,202108,355,1062,194,718,14,54,22,61,36,115
421470,202108,299,818,188,589,30,93,64,220,94,313
421480,202108,2781,7356,1861,5516,336,1166,756,2058,1092,3224
421490,202108,118,403,72,273,11,39,13,41,24,80
421500,202108,2126,6124,1430,4657,346,1318,346,972,692,2290
421505,202108,299,812,248,740,31,115,166,471,197,586
421507,202108,430,1187,242,793,52,193,85,248,137,441
421510,202108,362,1008,236,699,35,109,123,340,158,449
421520,202108,498,1312,311,895,31,89,171,442,202,531
421530,202108,288,833,159,539,23,97,32,81,55,178
421535,202108,381,1001,244,763,38,146,140,417,178,563
421540,202108,310,739,172,523,28,95,55,152,83,247
421545,202108,623,1820,462,1534,100,404,224,689,324,1093
421550,202108,2097,5452,1690,4842,325,968,943,2687,1268,3655
421555,202108,169,513,68,241,6,22,8,14,14,36
421560,202108,86,286,57,213,10,42,19,64,29,106
421565,202108,914,2324,615,1858,150,514,188,543,338,1057
421567,202108,428,1303,282,913,84,299,86,240,170,539
421568,202108,328,961,226,716,39,145,87,261,126,406
421569,202108,154,434,73,233,9,28,43,140,52,168
421570,202108,1305,3515,918,2713,192,630,291,775,483,1405
421575,202108,295,846,223,655,30,99,108,291,138,390
421580,202108,4354,11624,2799,8419,387,1358,1104,2822,1491,4180
421590,202108,166,489,122,393,28,99,45,139,73,238
421600,202108,587,1540,393,1134,72,240,141,347,213,587
421605,202108,740,1920,535,1588,97,252,271,865,368,1117
421610,202108,1043,2785,704,2147,116,391,225,666,341,1057
421620,202108,3818,10003,2345,7321,437,1603,744,2155,1181,3758
421625,202108,130,361,64,196,10,27,19,57,29,84
421630,202108,2607,6739,1695,5001,286,1012,634,1553,920,2565
421635,202108,264,696,185,537,14,44,118,313,132,357
421640,202108,670,1791,487,1518,108,379,198,603,306,982
421650,202108,2473,6709,1695,5279,358,1285,561,1535,919,2820
421660,202108,10604,29033,7502,23018,1087,3752,3446,9608,4533,13360
421670,202108,760,2128,541,1619,93,312,251,719,344,1031
421680,202108,1102,2894,853,2475,151,476,519,1397,670,1873
421690,202108,1360,3823,934,2937,164,561,320,1002,484,1563
421700,202108,528,1535,370,1185,78,275,126,384,204,659
421710,202108,198,636,100,344,21,75,26,81,47,156
421715,202108,117,307,94,259,21,58,51,138,72,196
421720,202108,1960,5262,1173,3575,290,936,303,800,593,1736
421725,202108,260,628,143,426,21,64,70,186,91,250
421730,202108,402,1113,235,676,31,94,127,339,158,433
421740,202108,761,2133,512,1603,112,381,159,449,271,830
421750,202108,880,2069,429,1240,91,282,169,445,260,727
421755,202108,168,467,93,286,15,55,42,115,57,170
421760,202108,1006,2612,692,2042,126,400,239,598,365,998
421770,202108,2375,6178,1707,5025,451,1284,587,1858,1038,3142
421775,202108,213,551,129,390,15,49,56,157,71,206
421780,202108,831,2407,545,1800,106,394,231,685,337,1079
421790,202108,868,2323,493,1614,104,355,206,652,310,1007
421795,202108,176,485,124,360,22,69,39,104,61,173
421800,202108,2676,7079,1951,5751,232,783,1130,3154,1362,3937
421810,202108,641,1737,437,1354,45,166,251,762,296,928
421820,202108,972,2810,598,1899,107,380,204,539,311,919
421825,202108,1372,3714,1218,3482,100,312,899,2506,999,2818
421830,202108,1996,5742,1625,5060,337,1117,628,1918,965,3035
421835,202108,234,566,157,444,35,121,60,152,95,273
421840,202108,207,644,146,508,22,85,33,99,55,184
421850,202108,377,1040,219,727,53,204,54,135,107,339
421860,202108,304,829,173,562,24,88,63,180,87,268
421870,202108,4586,11332,3375,9090,486,1568,1808,4278,2294,5846
421875,202108,294,853,122,371,17,52,32,80,49,132
421880,202108,676,1886,465,1428,97,323,134,395,231,718
421885,202108,230,633,147,445,35,111,47,121,82,232
421890,202108,853,2494,632,2055,100,386,353,1090,453,1476
421895,202108,402,1008,345,933,38,106,234,669,272,775
421900,202108,1037,2719,793,2220,95,300,402,1012,497,1312
421910,202108,317,912,197,635,27,108,47,124,74,232
421915,202108,371,1037,218,684,48,148,43,122,91,270
421917,202108,578,1320,331,1008,113,364,87,286,200,650
421920,202108,368,1101,264,898,99,346,80,272,179,618
421930,202108,2611,6500,1408,4225,281,966,511,1315,792,2281
421935,202108,402,1229,321,1057,60,201,188,606,248,807
421940,202108,372,1071,177,565,27,92,36,91,63,183
421950,202108,3117,7711,1788,5192,342,1078,470,1197,812,2275
421960,202108,180,438,96,280,14,54,31,66,45,120
421970,202108,1901,4824,1189,3376,223,742,487,1202,710,1944
421985,202108,301,821,188,589,22,77,73,215,95,292
422000,202108,1950,4938,1593,4392,144,471,1105,2994,1249,3465
430003,202108,576,1523,381,1176,67,219,172,528,239,747
430005,202108,267,698,170,526,24,81,85,253,109,334
430010,202108,1742,4098,1385,3552,239,603,875,2229,1114,2832
430020,202108,589,1335,443,1141,48,146,295,726,343,872
430030,202108,937,2185,513,1424,124,385,163,411,287,796
430040,202108,10520,24406,6388,17324,1653,4759,979,2750,2632,7509
430045,202108,462,1146,328,901,25,79,221,594,246,673
430047,202108,232,499,93,251,22,55,26,73,48,128
430050,202108,869,2183,514,1470,104,318,137,370,241,688
430055,202108,278,670,139,382,17,56,73,172,90,228
430057,202108,82,171,29,80,8,27,6,14,14,41
430060,202108,17947,46643,13940,40363,2727,8336,6675,19026,9402,27362
430063,202108,809,2228,659,1925,130,382,356,1039,486,1421
430064,202108,1128,2981,831,2391,201,605,361,1009,562,1614
430066,202108,96,192,68,150,7,16,52,110,59,126
430070,202108,731,1864,127,415,21,84,21,49,42,133
430080,202108,900,2198,548,1515,88,292,294,685,382,977
430085,202108,924,2007,548,1407,98,261,244,611,342,872
430087,202108,825,1946,688,1767,61,163,489,1243,550,1406
430090,202108,514,1349,199,638,19,78,51,145,70,223
430100,202108,880,2076,530,1424,94,282,165,384,259,666
430105,202108,1264,3237,848,2525,124,424,407,1153,531,1577
430107,202108,182,521,102,314,20,61,26,71,46,132
430110,202108,2266,5562,1678,4697,305,903,804,2179,1109,3082
430120,202108,1243,3568,828,2539,137,419,369,1120,506,1539
430130,202108,3552,7892,2605,6576,839,2177,469,1449,1308,3626
430140,202108,1011,2551,721,2032,165,433,368,1026,533,1459
430150,202108,573,1453,312,934,71,222,88,268,159,490
430155,202108,245,617,118,350,20,59,23,57,43,116
430160,202108,20795,47033,16358,40918,1790,4799,10061,24724,11851,29523
430163,202108,3263,7456,2303,5956,79,260,1744,4409,1823,4669
430165,202108,310,762,98,304,11,26,14,39,25,65
430170,202108,976,2544,347,1168,59,205,41,118,100,323
430175,202108,663,1900,564,1691,128,376,274,822,402,1198
430180,202108,666,1592,507,1320,67,159,316,837,383,996
430185,202108,686,1703,354,1009,98,251,51,140,149,391
430187,202108,776,1653,567,1392,68,180,341,839,409,1019
430190,202108,1439,3642,1146,3192,240,705,534,1431,774,2136
430192,202108,125,329,42,121,5,15,9,21,14,36
430195,202108,417,1203,61,209,5,19,7,14,12,33
430200,202108,1063,3057,844,2666,283,929,229,754,512,1683
430205,202108,457,1161,409,1075,13,46,364,929,377,975
430210,202108,6203,15753,4181,11518,675,1991,1262,2769,1937,4760
430215,202108,312,796,200,578,35,103,74,214,109,317
430220,202108,667,1634,209,680,23,78,50,133,73,211
430222,202108,199,539,146,432,17,55,50,144,67,199
430223,202108,265,669,204,569,15,36,121,331,136,367
430225,202108,16,32,10,23,0,0,7,16,7,16
430230,202108,2005,5310,1651,4767,139,450,1217,3447,1356,3897
430235,202108,375,1019,236,726,36,121,56,146,92,267
430237,202108,514,1177,384,968,16,45,296,727,312,772
430240,202108,1370,3125,774,2104,80,257,406,999,486,1256
430245,202108,725,1962,565,1665,124,386,296,880,420,1266
430250,202108,946,2241,682,1833,232,668,47,113,279,781
430258,202108,141,377,102,295,7,17,56,158,63,175
430260,202108,700,1800,481,1388,56,181,278,810,334,991
430265,202108,221,630,149,490,28,87,53,182,81,269
430270,202108,3010,7216,2377,6245,363,1033,1482,3774,1845,4807
430280,202108,5204,11907,3642,9298,684,1774,1636,4108,2320,5882
430290,202108,2289,5142,1873,4664,64,185,1584,3857,1648,4042
430300,202108,10546,25617,7965,21249,1179,3464,4330,11096,5509,14560
430310,202108,12515,30222,8541,23040,1060,3155,4272,10734,5332,13889
430320,202108,1041,2574,579,1679,57,169,342,979,399,1148
430330,202108,713,1697,429,1142,77,210,164,402,241,612
430340,202108,606,1413,396,1070,64,161,233,623,297,784
430350,202108,8251,20023,6312,16710,690,1989,3991,10018,4681,12007
430355,202108,307,812,116,371,16,53,15,42,31,95
430360,202108,870,2050,581,1548,107,327,241,593,348,920
430367,202108,337,721,191,480,31,98,109,250,140,348
430370,202108,536,1403,223,655,30,87,60,142,90,229
430380,202108,712,1706,340,1022,76,265,95,270,171,535
430390,202108,3351,7912,2063,5608,410,1249,302,586,712,1835
430400,202108,1028,2173,784,1848,65,174,461,1049,526,1223
430410,202108,548,1272,381,1004,55,140,241,629,296,769
430420,202108,2669,6964,2046,5682,415,1239,1053,2759,1468,3998
430430,202108,572,1421,261,788,58,164,59,183,117,347
430435,202108,1567,3880,1208,3303,200,595,644,1740,844,2335
430440,202108,3945,10455,3120,9076,281,905,2006,5785,2287,6690
430450,202108,6921,16756,5517,14301,1070,2965,2631,6534,3701,9499
430460,202108,35893,87926,26815,73190,4247,12761,13972,36444,18219,49205
430461,202108,230,597,74,224,14,49,28,65,42,114
430462,202108,286,764,163,511,31,99,47,140,78,239
430463,202108,6426,16387,4732,13311,896,2837,2222,5900,3118,8737
430465,202108,454,1132,358,949,62,184,224,570,286,754
430466,202108,4439,10889,3504,9416,748,2087,1705,4341,2453,6428
430467,202108,510,1198,356,961,49,161,197,481,246,642
430468,202108,1310,3160,1044,2778,77,236,739,1910,816,2146
430469,202108,576,1531,83,248,11,32,19,40,30,72
430470,202108,5733,14478,3822,11087,1085,3428,959,2606,2044,6034
430471,202108,556,1534,454,1350,68,209,268,769,336,978
430480,202108,676,1870,434,1342,57,187,102,268,159,455
430485,202108,174,442,64,189,21,58,7,22,28,80
430490,202108,393,1001,219,650,21,79,112,285,133,364
430495,202108,397,1054,261,797,40,126,111,319,151,445
430500,202108,1009,2540,704,2025,225,689,197,521,422,1210
430510,202108,28057,70680,20101,55719,3162,9802,9444,24040,12606,33842
430511,202108,348,973,138,439,16,54,19,56,35,110
430512,202108,1004,2193,783,1868,171,418,301,721,472,1139
430513,202108,803,1960,375,1069,59,183,177,461,236,644
430515,202108,383,1058,279,847,36,105,153,461,189,566
430517,202108,1221,3535,919,2854,155,472,490,1527,645,1999
430520,202108,1371,3365,743,2053,133,393,173,427,306,820
430530,202108,1000,2456,415,1231,69,203,116,334,185,537
430535,202108,3628,9107,2628,7290,363,1041,1331,3551,1694,4592
430537,202108,393,1207,342,1092,19,54,272,874,291,928
430540,202108,617,1460,338,971,64,180,157,452,221,632
430543,202108,967,1649,587,1224,62,133,228,563,290,696
430544,202108,765,2106,527,1588,127,386,164,485,291,871
430545,202108,2513,6204,1875,5251,306,872,1042,2928,1348,3800
430550,202108,349,972,256,776,49,154,98,281,147,435
430558,202108,117,269,55,149,7,14,20,55,27,69
430560,202108,283,643,140,403,23,76,48,126,71,202
430570,202108,861,2084,623,1660,104,322,309,744,413,1066
430580,202108,835,2049,596,1689,161,484,244,704,405,1188
430583,202108,199,492,37,114,4,12,10,22,14,34
430585,202108,232,559,124,341,19,58,50,116,69,174
430587,202108,201,533,150,441,21,68,61,166,82,234
430590,202108,1386,3295,1146,2938,69,203,928,2329,997,2532
430593,202108,21,64,15,43,2,4,6,17,8,21
430595,202108,441,1094,130,416,13,48,19,44,32,92
430597,202108,457,1136,238,691,23,69,72,168,95,237
430600,202108,2012,5107,855,2420,126,368,206,541,332,909
430605,202108,1327,3383,967,2729,108,334,486,1314,594,1648
430607,202108,589,1317,458,1120,30,75,325,780,355,855
430610,202108,5875,13434,3934,10540,1051,3254,891,2273,1942,5527
430613,202108,299,686,89,257,11,30,24,56,35,86
430620,202108,664,1587,495,1281,73,217,294,678,367,895
430630,202108,427,1161,121,385,21,67,30,76,51,143
430632,202108,454,1158,200,580,32,87,81,223,113,310
430635,202108,578,1311,437,1072,47,123,323,780,370,903
430637,202108,463,1084,351,916,36,107,238,596,274,703
430640,202108,1121,2948,751,2197,111,322,300,822,411,1144
430642,202108,374,1010,275,798,47,138,138,371,185,509
430645,202108,154,361,60,159,11,32,19,41,30,73
430650,202108,1731,4726,1368,4125,403,1193,553,1827,956,3020
430655,202108,288,710,180,501,27,87,91,222,118,309
430660,202108,5363,13316,4106,11275,856,2467,1852,5003,2708,7470
430670,202108,655,1549,500,1293,44,115,287,758,331,873
430673,202108,543,1209,233,639,37,104,89,225,126,329
430675,202108,242,703,54,196,7,23,12,39,19,62
430676,202108,5321,12795,4244,11176,529,1472,2664,6882,3193,8354
430680,202108,1066,2768,620,1849,167,508,138,386,305,894
430690,202108,2857,7561,2249,6467,760,2320,637,1752,1397,4072
430692,202108,219,664,172,585,13,42,128,448,141,490
430693,202108,966,2481,590,1752,109,381,158,442,267,823
430695,202108,413,1021,256,715,34,86,131,351,165,437
430697,202108,412,1028,320,886,67,162,168,505,235,667
430700,202108,7836,18754,4846,13274,939,2767,1210,2957,2149,5724
430705,202108,406,944,201,569,19,52,84,217,103,269
430710,202108,1732,3588,1210,2907,149,404,731,1698,880,2102
430720,202108,742,1761,379,1117,44,128,196,565,240,693
430730,202108,1021,2726,712,2131,93,275,379,1099,472,1374
430740,202108,670,1778,352,1126,59,191,94,303,153,494
430745,202108,355,948,233,693,55,185,74,189,129,374
430750,202108,1511,3719,1020,2859,333,966,360,986,693,1952
430755,202108,456,1107,294,786,28,87,159,389,187,476
430760,202108,2100,5081,1613,4344,313,927,778,1988,1091,2915
430770,202108,6636,16226,5167,14009,611,1899,3346,8712,3957,10611
430780,202108,1962,4777,1219,3514,194,617,554,1538,748,2155
430781,202108,478,1312,285,867,64,180,84,231,148,411
430783,202108,350,793,209,575,23,66,128,328,151,394
430786,202108,36,128,26,99,5,20,4,16,9,36
430790,202108,4688,11163,3313,8793,342,1068,2042,5025,2384,6093
430800,202108,775,1737,585,1462,43,104,383,952,426,1056
430805,202108,361,906,238,656,11,37,164,433,175,470
430807,202108,534,1296,291,836,33,103,138,363,171,466
430810,202108,739,1732,322,928,40,137,127,319,167,456
430820,202108,1218,3247,747,2332,124,396,227,671,351,1067
430825,202108,268,655,90,245,11,26,32,82,43,108
430830,202108,1751,4786,1414,4144,111,318,987,2853,1098,3171
430840,202108,1077,2548,732,1984,114,292,463,1278,577,1570
430843,202108,182,430,86,229,8,24,33,74,41,98
430845,202108,486,1131,321,867,49,139,156,396,205,535
430850,202108,2304,5862,1572,4473,242,745,583,1708,825,2453
430860,202108,907,2103,432,1199,52,170,202,470,254,640
430865,202108,531,1325,378,1065,99,283,108,304,207,587
430870,202108,586,1545,260,826,41,146,75,206,116,352
430880,202108,1510,3361,1033,2633,167,423,560,1391,727,1814
430885,202108,171,444,92,292,6,17,55,173,61,190
430890,202108,1023,2466,686,1903,51,210,146,375,197,585
430900,202108,3159,6788,2209,5449,169,522,1498,3464,1667,3986
430905,202108,887,2157,572,1560,100,299,248,644,348,943
430910,202108,2180,5787,1653,4719,253,830,770,1909,1023,2739
430912,202108,510,1412,358,1103,34,99,224,703,258,802
430915,202108,501,1480,376,1232,135,422,103,357,238,779
430920,202108,23420,58689,18137,49912,2273,6826,11040,29630,13313,36456
430925,202108,91,203,39,114,4,12,19,54,23,66
430930,202108,10803,24935,7098,19289,1321,3566,3019,8554,4340,12120
430940,202108,964,2461,594,1696,122,364,212,551,334,915
430950,202108,838,1842,545,1348,38,122,359,812,397,934
430955,202108,390,1011,107,297,25,68,31,65,56,133
430957,202108,168,561,154,533,20,72,104,357,124,429
430960,202108,1375,3190,791,2142,156,440,329,845,485,1285
430965,202108,1586,3723,1224,3157,69,179,925,2433,994,2612
430970,202108,371,881,201,556,27,87,102,248,129,335
430975,202108,509,1457,390,1184,73,239,203,586,276,825
430980,202108,392,874,226,598,26,80,105,246,131,326
430990,202108,562,1574,371,1135,53,167,164,498,217,665
430995,202108,559,1401,426,1188,58,169,241,653,299,822
431000,202108,1395,3257,597,1712,117,363,44,108,161,471
431010,202108,2375,6189,1607,4833,330,1051,468,1261,798,2312
431020,202108,7853,16914,4706,12254,933,2808,1720,3907,2653,6715
431030,202108,361,974,177,587,34,129,25,77,59,206
431033,202108,3944,9014,2593,6916,538,1478,977,2594,1515,4072
431036,202108,341,745,73,216,8,27,21,48,29,75
431040,202108,901,2224,579,1673,66,216,294,780,360,996
431041,202108,446,1021,318,824,27,63,188,490,215,553
431043,202108,320,793,189,556,39,130,93,261,132,391
431046,202108,107,279,44,133,5,12,9,25,14,37
431050,202108,1371,3262,972,2617,192,554,435,1196,627,1750
431053,202108,690,1755,389,1149,72,230,125,321,197,551
431055,202108,601,1420,491,1246,60,135,352,892,412,1027
431057,202108,228,649,128,415,26,84,36,109,62,193
431060,202108,5741,14031,3883,10925,860,2650,1160,3130,2020,5780
431065,202108,408,996,297,813,40,121,152,408,192,529
431070,202108,426,1126,254,759,54,176,77,214,131,390
431075,202108,222,627,132,422,32,111,37,119,69,230
431080,202108,598,1594,419,1218,66,217,155,428,221,645
431085,202108,800,2045,509,1397,56,157,272,730,328,887
431087,202108,408,1110,330,954,24,71,226,656,250,727
431090,202108,412,950,163,489,24,80,43,133,67,213
431100,202108,3450,7413,2356,6008,274,707,1307,3345,1581,4052
431110,202108,1436,3252,983,2464,225,587,416,939,641,1526
431112,202108,641,1692,526,1482,45,155,365,967,410,1122
431113,202108,412,1076,343,948,59,174,182,486,241,660
431115,202108,972,2696,763,2314,79,303,487,1381,566,1684
431120,202108,2721,6949,1897,5417,485,1516,484,1290,969,2806
431123,202108,369,998,250,741,57,151,131,401,188,552
431125,202108,978,2717,788,2352,274,807,280,887,554,1694
431127,202108,199,530,65,213,8,28,11,33,19,61
431130,202108,3023,7490,2267,6275,328,1004,1270,3423,1598,4427
431140,202108,5936,13817,3629,9525,430,1205,1610,3697,2040,4902
431142,202108,531,1353,400,1133,46,132,248,704,294,836
431150,202108,1054,2743,766,2222,138,440,346,968,484,1408
431160,202108,669,1865,437,1350,87,289,126,377,213,666
431162,202108,534,1303,322,914,37,119,167,421,204,540
431164,202108,179,414,44,138,8,25,8,25,16,50
431170,202108,452,1218,322,953,98,296,92,266,190,562
431171,202108,666,1536,546,1379,129,279,299,795,428,1074
431173,202108,419,1063,313,907,76,258,140,381,216,639
431175,202108,1340,3057,850,2233,133,344,331,832,464,1176
431177,202108,829,2165,647,1883,112,395,420,1157,532,1552
431179,202108,338,727,103,290,16,45,28,74,44,119
431180,202108,2218,5553,1389,3939,316,918,433,1164,749,2082
431190,202108,599,1506,271,776,33,90,84,204,117,294
431198,202108,397,1101,319,954,89,283,108,333,197,616
431200,202108,373,926,89,242,16,47,12,33,28,80
431205,202108,218,590,117,372,36,117,34,118,70,235
431210,202108,633,1497,514,1336,138,370,218,587,356,957
431213,202108,259,682,195,563,9,31,103,290,112,321
431215,202108,618,1464,295,853,27,85,139,375,166,460
431217,202108,159,401,110,309,15,47,60,151,75,198
431220,202108,540,1378,336,981,33,115,188,504,221,619
431225,202108,1512,3504,1163,2940,122,319,792,1996,914,2315
431230,202108,696,1929,562,1645,85,246,330,943,415,1189
431235,202108,150,380,19,68,2,4,4,19,6,23
431237,202108,337,1038,269,879,47,177,131,399,178,576
431238,202108,33,94,27,81,4,14,13,31,17,45
431240,202108,4741,11326,3779,9842,425,1266,2422,5946,2847,7212
431242,202108,260,660,226,604,42,118,135,346,177,464
431244,202108,346,832,174,490,22,80,68,161,90,241
431245,202108,1332,3040,847,2214,63,175,476,1200,539,1375
431247,202108,280,695,172,477,30,95,78,184,108,279
431250,202108,1765,4290,1301,3666,283,801,658,2003,941,2804
431260,202108,276,733,175,546,24,89,60,186,84,275
431261,202108,263,778,209,682,16,57,117,361,133,418
431262,202108,346,965,180,577,13,37,116,375,129,412
431265,202108,1614,3741,663,1892,80,263,218,535,298,798
431267,202108,247,606,161,428,6,21,117,287,123,308
431270,202108,2876,6355,1544,4123,328,875,504,1403,832,2278
431275,202108,114,319,64,203,22,66,11,36,33,102
431280,202108,239,641,78,248,5,18,13,31,18,49
431290,202108,352,1024,231,729,41,132,39,102,80,234
431295,202108,69,165,20,57,3,8,4,10,7,18
431300,202108,291,761,60,185,8,22,20,53,28,75
431301,202108,297,830,67,214,10,30,6,20,16,50
431303,202108,632,1594,385,1090,23,80,177,449,200,529
431306,202108,2354,5492,1450,3996,196,602,628,1542,824,2144
431308,202108,25,76,22,70,10,34,10,31,20,65
431310,202108,554,1471,386,1115,50,142,179,482,229,624
431320,202108,661,1791,367,1169,62,185,98,278,160,463
431330,202108,1749,4079,895,2523,147,471,361,901,508,1372
431333,202108,220,575,120,354,19,55,46,117,65,172
431335,202108,36,106,19,70,4,10,0,0,4,10
431337,202108,2699,6886,2048,5837,309,1029,1239,3371,1548,4400
431339,202108,422,1073,315,886,88,253,114,313,202,566
431340,202108,19112,45757,13455,36300,1958,5887,6559,16464,8517,22351
431342,202108,422,942,310,762,29,55,247,609,276,664
431344,202108,392,988,238,700,11,34,127,367,138,401
431346,202108,230,559,85,262,13,42,22,57,35,99
431349,202108,711,1781,430,1180,86,236,182,486,268,722
431350,202108,4318,10740,3257,8957,403,1280,1843,4825,2246,6105
431360,202108,572,1327,287,787,89,249,65,179,154,428
431365,202108,2096,4745,1660,4157,120,339,1276,3148,1396,3487
431370,202108,4694,11032,3438,9040,642,1785,1752,4665,2394,6450
431380,202108,847,2219,691,1976,48,145,483,1378,531,1523
431390,202108,2669,6452,1698,4752,150,499,898,2207,1048,2706
431395,202108,1382,3281,1005,2719,188,533,521,1415,709,1948
431400,202108,316,880,180,571,35,108,37,112,72,220
431402,202108,918,1997,683,1644,86,201,468,1121,554,1322
431403,202108,200,548,153,450,26,78,66,187,92,265
431405,202108,4938,12632,3845,10819,602,1874,2001,5305,2603,7179
431406,202108,549,1516,388,1169,73,210,192,595,265,805
431407,202108,486,1282,346,987,70,225,190,509,260,734
431410,202108,18044,43817,12421,34159,1636,5174,6796,17274,8432,22448
431413,202108,234,631,58,188,6,19,11,36,17,55
431415,202108,704,1680,452,1262,74,253,226,565,300,818
431417,202108,574,1257,382,951,59,170,207,496,266,666
431420,202108,1642,3607,1239,3058,148,370,742,1789,890,2159
431430,202108,573,1437,287,867,43,139,89,238,132,377
431440,202108,30832,70321,21531,56027,3384,9623,8997,21612,12381,31235
431442,202108,139,395,70,236,12,46,9,27,21,73
431445,202108,387,1075,105,331,13,36,13,34,26,70
431446,202108,263,747,194,611,30,115,95,284,125,399
431447,202108,776,1992,434,1266,88,265,134,391,222,656
431449,202108,789,2027,488,1412,89,241,179,533,268,774
431450,202108,2316,4669,1807,3955,71,169,1434,3060,1505,3229
431454,202108,39,129,32,110,8,25,11,35,19,60
431455,202108,590,1371,296,775,36,98,147,345,183,443
431460,202108,2956,6932,2040,5331,533,1455,507,1328,1040,2783
431470,202108,1418,3890,1045,3111,179,537,445,1336,624,1873
431475,202108,243,651,58,193,4,14,10,24,14,38
431477,202108,399,1021,242,704,41,110,98,262,139,372
431478,202108,222,583,50,155,9,24,4,9,13,33
431480,202108,3508,8473,2816,7422,701,1840,1391,3686,2092,5526
431490,202108,110267,254101,84029,214499,5497,16663,61803,151281,67300,167944
431500,202108,497,1255,371,1023,65,191,196,512,261,703
431505,202108,254,607,173,483,12,40,123,339,135,379
431507,202108,334,778,135,394,45,142,33,86,78,228
431510,202108,1673,4158,1127,3105,271,790,379,1053,650,1843
431513,202108,229,497,124,321,11,22,75,191,86,213
431514,202108,117,291,88,241,4,13,59,151,63,164
431515,202108,472,1161,352,952,83,224,198,502,281,726
431517,202108,56,166,45,136,5,15,22,64,27,79
431520,202108,395,982,165,503,15,55,74,195,89,250
431530,202108,4902,10414,2913,7389,599,1476,997,2573,1596,4049
431531,202108,215,509,135,360,19,44,55,139,74,183
431532,202108,555,1270,342,890,64,189,152,377,216,566
431535,202108,245,643,112,347,22,73,25,67,47,140
431540,202108,1804,5647,1671,5463,56,207,1357,4461,1413,4668
431545,202108,366,923,74,218,7,22,22,60,29,82
431550,202108,2173,5388,1562,4261,252,724,779,2041,1031,2765
431555,202108,677,1520,401,1060,34,99,230,601,264,700
431560,202108,24485,57210,16460,44756,3220,8975,5779,16463,8999,25438
431570,202108,4403,10503,3709,9496,430,1202,2659,6560,3089,7762
431575,202108,305,712,242,621,73,160,110,296,183,456
431580,202108,599,1540,386,1121,45,148,207,572,252,720
431590,202108,612,1656,461,1359,88,268,178,525,266,793
431595,202108,367,988,246,732,44,127,95,262,139,389
431600,202108,1496,3445,1066,2809,208,601,465,1181,673,1782
431610,202108,1425,3519,972,2710,153,405,483,1377,636,1782
431620,202108,489,1229,229,645,40,117,88,221,128,338
431630,202108,1333,3230,645,1848,94,274,250,679,344,953
431640,202108,6427,14782,5441,13534,480,1256,4115,10268,4595,11524
431642,202108,607,1420,371,973,41,99,161,395,202,494
431643,202108,385,927,181,513,16,42,52,151,68,193
431645,202108,1875,4090,1479,3570,51,159,1216,2888,1267,3047
431647,202108,307,732,97,280,8,17,25,62,33,79
431650,202108,128,339,89,278,7,23,42,119,49,142
431660,202108,888,2293,424,1316,59,216,110,294,169,510
431670,202108,1204,2821,729,1961,122,342,348,866,470,1208
431673,202108,234,601,89,302,6,23,13,31,19,54
431675,202108,405,1037,106,362,9,31,18,56,27,87
431680,202108,8243,20361,6043,16391,1303,3652,2658,7004,3961,10656
431690,202108,25255,60498,17275,46396,3178,9111,7636,20120,10814,29231
431695,202108,189,459,112,329,21,68,56,147,77,215
431697,202108,471,1089,364,927,51,128,217,559,268,687
431700,202108,1379,3457,1128,3012,184,440,651,1764,835,2204
431710,202108,13824,31831,9789,26111,1432,4105,5299,14121,6731,18226
431720,202108,6842,16426,4136,11378,982,2810,847,2121,1829,4931
431725,202108,27,75,21,65,3,10,9,24,12,34
431730,202108,4081,9413,2563,7070,554,1589,851,2514,1405,4103
431740,202108,5374,12372,3581,9433,883,2700,971,2232,1854,4932
431750,202108,7748,19604,5866,16628,1387,4093,2204,6204,3591,10297
431755,202108,330,872,81,261,12,28,12,33,24,61
431760,202108,5496,12155,3776,9441,414,1155,2359,5601,2773,6756
431770,202108,1990,4482,1527,3871,116,285,1128,2813,1244,3098
431775,202108,202,511,102,316,21,69,15,37,36,106
431780,202108,2220,5293,1449,3908,228,670,602,1566,830,2236
431790,202108,791,2080,544,1600,93,258,240,724,333,982
431795,202108,276,674,136,407,29,83,34,98,63,181
431800,202108,8405,19494,5272,14627,1236,4105,490,1412,1726,5517
431805,202108,284,672,77,257,10,40,10,20,20,60
431810,202108,3375,7708,2112,5455,390,1033,913,2271,1303,3304
431820,202108,2160,5628,1679,4859,467,1444,606,1794,1073,3238
431830,202108,9092,19505,6714,16303,1751,5027,1530,3644,3281,8671
431840,202108,2711,6806,2181,5971,308,878,1420,3858,1728,4736
431842,202108,517,1274,181,547,25,86,75,203,100,289
431843,202108,335,870,246,694,30,88,121,330,151,418
431844,202108,202,536,71,233,16,59,21,75,37,134
431845,202108,507,1314,357,1020,40,111,206,583,246,694
431846,202108,281,710,241,652,12,32,212,575,224,607
431848,202108,153,379,80,230,10,31,18,38,28,69
431849,202108,407,985,82,241,9,24,13,26,22,50
431850,202108,4225,11102,3249,9220,723,2237,1114,3051,1837,5288
431860,202108,648,1499,353,943,55,159,205,527,260,686
431861,202108,94,260,58,180,9,28,19,60,28,88
431862,202108,470,1453,390,1314,74,272,199,640,273,912
431870,202108,21577,53011,17321,46467,1835,5576,10949,28143,12784,33719
431880,202108,4009,10117,2856,8089,400,1310,1422,3800,1822,5110
431890,202108,4693,11611,2946,8285,806,2448,513,1607,1319,4055
431900,202108,978,2399,633,1786,93,287,323,853,416,1140
431910,202108,777,1811,290,785,38,112,88,204,126,316
431912,202108,493,1301,384,1112,77,238,218,630,295,868
431915,202108,1124,2612,885,2239,29,84,688,1712,717,1796
431920,202108,1256,2833,1039,2552,35,74,881,2157,916,2231
431930,202108,688,1776,475,1381,175,487,161,491,336,978
431935,202108,85,221,61,173,16,46,13,34,29,80
431936,202108,314,867,179,536,34,104,84,232,118,336
431937,202108,142,350,92,251,10,24,40,88,50,112
431940,202108,3118,7169,1836,4860,153,442,1006,2544,1159,2986
431950,202108,1937,4921,1547,4285,358,1039,673,1800,1031,2839
431960,202108,2992,7105,2245,5782,585,1610,665,1672,1250,3282
431970,202108,397,988,172,496,36,112,39,89,75,201
431971,202108,86,210,38,115,4,16,8,17,12,33
431973,202108,486,1543,394,1358,42,133,278,966,320,1099
431975,202108,108,216,21,63,2,7,6,17,8,24
431980,202108,964,2475,745,2118,141,437,376,1014,517,1451
431990,202108,5870,13785,4170,11354,434,1436,2331,6088,2765,7524
432000,202108,12165,28236,8945,23312,1887,5039,4208,10900,6095,15939
432010,202108,2709,6257,1822,4767,322,885,785,1875,1107,2760
432020,202108,1790,4598,1101,3127,228,690,369,1002,597,1692
432023,202108,539,1280,272,762,35,100,120,302,155,402
432026,202108,948,2594,697,2106,182,536,207,640,389,1176
432030,202108,380,921,230,625,17,53,133,341,150,394
432032,202108,341,852,235,640,24,71,136,337,160,408
432035,202108,663,1828,579,1689,166,458,255,797,421,1255
432040,202108,1097,2570,422,1281,55,187,173,468,228,655
432045,202108,155,437,99,317,19,59,37,123,56,182
432050,202108,561,1340,418,1100,76,209,191,507,267,716
432055,202108,561,1492,369,1141,127,401,66,188,193,589
432057,202108,184,493,145,391,9,22,74,188,83,210
432060,202108,432,1026,135,412,32,106,34,96,66,202
432065,202108,205,563,149,445,35,109,55,170,90,279
432067,202108,733,2062,624,1824,57,187,462,1298,519,1485
432070,202108,1721,4291,1186,3290,206,649,511,1281,717,1930
432080,202108,4992,11346,3781,9519,594,1738,1799,4289,2393,6027
432085,202108,381,994,279,835,59,189,132,391,191,580
432090,202108,2234,5412,1311,3654,229,672,599,1571,828,2243
432100,202108,990,2426,488,1446,103,325,84,206,187,531
432110,202108,2091,5373,1449,4240,335,1084,186,486,521,1570
432120,202108,3149,8238,2503,7192,437,1390,1171,3191,1608,4581
432130,202108,2647,6493,2195,5826,634,1707,941,2542,1575,4249
432132,202108,180,513,109,353,20,66,54,155,74,221
432135,202108,1012,2323,678,1761,62,169,473,1217,535,1386
432140,202108,1698,4883,1300,4090,174,586,804,2503,978,3089
432143,202108,1402,3621,1071,3113,65,208,709,2038,774,2246
432145,202108,1772,4599,1135,3304,170,509,366,907,536,1416
432146,202108,104,292,75,246,26,93,24,71,50,164
432147,202108,486,1291,290,892,101,309,64,192,165,501
432149,202108,448,1071,231,642,26,71,100,245,126,316
432150,202108,3380,8268,2516,6789,486,1406,1123,2946,1609,4352
432160,202108,5386,13594,3926,11274,874,2831,1330,3662,2204,6493
432162,202108,229,493,34,94,7,25,10,20,17,45
432163,202108,129,299,26,69,0,0,5,6,5,6
432166,202108,659,1788,521,1516,103,345,190,477,293,822
432170,202108,1594,4187,1103,3290,201,663,458,1275,659,1938
432180,202108,3145,7314,1716,4667,296,850,670,1591,966,2441
432183,202108,377,1067,266,824,58,201,87,248,145,449
432185,202108,833,2120,485,1446,43,141,237,664,280,805
432190,202108,2021,4775,1403,3807,135,420,871,2238,1006,2658
432195,202108,865,2167,587,1667,132,345,228,670,360,1015
432200,202108,3544,8621,2572,7112,350,1009,1540,4229,1890,5238
432210,202108,406,1063,256,771,48,164,114,295,162,459
432215,202108,614,1767,559,1686,45,109,425,1307,470,1416
432218,202108,251,613,120,332,13,41,57,137,70,178
432220,202108,3714,8549,2647,6822,514,1316,1270,3284,1784,4600
432225,202108,101,278,76,229,12,34,45,136,57,170
432230,202108,758,1759,408,1116,43,117,184,455,227,572
432232,202108,483,1177,308,883,62,185,110,283,172,468
432234,202108,272,686,126,368,18,45,22,59,40,104
432235,202108,44,124,18,56,5,17,4,12,9,29
432237,202108,308,786,273,730,12,23,226,597,238,620
432240,202108,16573,39488,12177,33645,916,2473,7878,22758,8794,25231
432250,202108,5644,15647,4196,12794,1052,3332,1758,5345,2810,8677
432252,202108,429,1023,278,745,32,89,150,373,182,462
432253,202108,876,2575,586,1856,146,500,50,138,196,638
432254,202108,699,1620,205,595,33,84,43,120,76,204
432255,202108,103,258,58,168,4,11,28,74,32,85
432260,202108,5117,12788,3795,10343,1021,2866,1369,3589,2390,6455
432270,202108,1981,5266,1604,4565,477,1463,430,1166,907,2629
432280,202108,1469,3581,777,2244,101,326,277,658,378,984
432285,202108,142,427,22,67,2,6,3,7,5,13
432290,202108,346,943,198,601,64,201,39,89,103,290
432300,202108,26960,66100,20307,55515,2546,7935,12453,32565,14999,40500
432310,202108,854,2214,617,1782,65,191,409,1183,474,1374
432320,202108,201,462,81,243,8,28,28,74,36,102
432330,202108,229,502,73,223,11,27,12,41,23,68
432335,202108,159,445,57,196,6,24,14,46,20,70
432340,202108,320,773,143,446,14,45,41,122,55,167
432345,202108,751,1626,644,1501,15,38,544,1245,559,1283
432350,202108,337,851,180,552,31,90,65,209,96,299
432360,202108,233,686,44,149,4,12,13,43,17,55
432370,202108,299,728,203,566,16,54,140,377,156,431
432375,202108,482,1174,363,944,88,232,157,402,245,634
432377,202108,161,496,35,121,3,14,7,14,10,28
432380,202108,1889,4955,1300,3893,194,618,675,1977,869,2595
500020,202108,2821,7050,2119,5915,207,658,1341,3620,1548,4278
500025,202108,1201,2915,755,2079,78,211,392,1049,470,1260
500060,202108,8280,22917,5677,17523,693,2258,3307,10353,4000,12611
500070,202108,4622,11476,3285,9224,589,1701,1461,4146,2050,5847
500080,202108,1686,4027,1033,2849,195,611,395,953,590,1564
500085,202108,2035,5028,1430,3987,361,1045,639,1691,1000,2736
500090,202108,2199,5647,1493,4432,217,695,489,1559,706,2254
500100,202108,3734,9344,2845,7905,428,1318,1463,3816,1891,5134
500110,202108,8605,21428,5673,16839,1111,3625,1751,6052,2862,9677
500124,202108,2161,6080,1727,5379,302,830,896,2975,1198,3805
500150,202108,1400,3072,902,2368,139,396,391,977,530,1373
500190,202108,5148,13146,3309,9584,647,1863,891,2463,1538,4326
500200,202108,2680,6163,1854,4787,171,445,1141,2844,1312,3289
500210,202108,4854,11230,3441,9375,987,2585,1466,4150,2453,6735
500215,202108,1439,3865,1052,3180,100,341,601,1800,701,2141
500220,202108,2955,7943,2019,6226,348,1112,707,2117,1055,3229
500230,202108,2111,4767,1609,4081,196,482,1084,2708,1280,3190
500240,202108,4176,11949,3002,9528,434,1470,1273,4116,1707,5586
500260,202108,3409,7172,2219,5583,290,746,1231,2974,1521,3720
500270,202108,142644,329640,87830,238625,13380,40035,34764,87457,48144,127492
500280,202108,1462,3605,986,2868,179,537,448,1305,627,1842
500290,202108,3819,9121,2285,6427,336,1075,737,1781,1073,2856
500295,202108,3772,8925,2432,6580,410,1228,998,2354,1408,3582
500310,202108,1022,2058,704,1665,96,209,378,912,474,1121
500315,202108,4015,10649,3228,9495,246,736,2360,7050,2606,7786
500320,202108,20267,52931,14031,42701,3572,11167,4568,15093,8140,26260
500325,202108,5275,11456,3631,9212,400,998,2262,5781,2662,6779
500330,202108,6916,15356,4538,11950,372,1037,2386,6542,2758,7579
500345,202108,2107,5064,1411,3978,298,886,513,1418,811,2304
500348,202108,2438,6163,1822,5115,229,694,1073,3026,1302,3720
500350,202108,1354,3611,754,2319,92,277,303,904,395,1181
500370,202108,28239,70828,20358,58118,2392,7842,11047,30843,13439,38685
500375,202108,2591,6652,1747,4963,265,829,617,1574,882,2403
500380,202108,3481,8554,2427,6785,704,2122,436,1248,1140,3370
500390,202108,655,1362,404,1049,56,168,238,594,294,762
500400,202108,1615,4025,1067,2981,187,575,356,893,543,1468
500410,202108,2495,5944,1744,4840,181,471,992,2893,1173,3364
500430,202108,2746,6620,1889,5377,263,833,796,2410,1059,3243
500440,202108,1349,3239,834,2425,132,416,285,882,417,1298
500450,202108,1624,3955,972,2809,140,435,268,702,408,1137
500460,202108,3699,9670,2213,6749,355,1226,648,1893,1003,3119
500470,202108,2537,6668,1581,4744,418,1374,336,888,754,2262
500480,202108,2139,6493,1802,5971,166,524,1341,4531,1507,5055
500490,202108,1135,2569,668,1862,119,399,178,501,297,900
500500,202108,4344,11230,2803,8731,777,2852,308,993,1085,3845
500510,202108,730,1813,482,1360,40,110,299,826,339,936
500515,202108,1725,4416,1336,3792,173,536,773,2079,946,2615
500520,202108,3427,9886,2649,8516,675,2128,1065,3752,1740,5880
500525,202108,971,2745,767,2447,63,221,503,1598,566,1819
500540,202108,4725,12103,2768,8564,635,2492,233,647,868,3139
500560,202108,5616,14924,4523,13564,294,858,3675,11238,3969,12096
500568,202108,4555,9806,2796,7215,719,1815,870,2368,1589,4183
500570,202108,8247,18804,5281,13900,833,2422,2284,5553,3117,7975
500580,202108,3225,8297,2354,6773,578,1686,977,2842,1555,4528
500600,202108,3475,8570,2491,7011,552,1605,1019,2941,1571,4546
500620,202108,8228,21067,5558,16063,1028,3114,2308,6352,3336,9466
500625,202108,548,1458,361,1087,64,196,90,250,154,446
500627,202108,789,2002,481,1467,92,298,133,383,225,681
500630,202108,7542,16702,4234,11318,833,2432,1197,3150,2030,5582
500635,202108,3043,9356,2332,8418,159,572,1594,6355,1753,6927
500640,202108,1747,3781,1175,3028,43,124,808,2049,851,2173
500660,202108,19497,48092,13307,39109,3870,12983,3432,10368,7302,23351
500690,202108,2636,6930,1696,5341,446,1592,348,1108,794,2700
500710,202108,3112,8048,2348,6747,608,1864,738,1955,1346,3819
500720,202108,5132,12686,3416,9817,757,2303,1093,3188,1850,5491
500730,202108,1127,2732,615,1794,117,332,139,422,256,754
500740,202108,4791,11228,3214,8783,455,1299,1559,4132,2014,5431
500750,202108,1046,2597,727,2056,87,222,306,821,393,1043
500755,202108,979,2486,564,1718,100,334,125,344,225,678
500769,202108,5436,13141,3080,8739,553,1684,436,1124,989,2808
500770,202108,1435,3824,962,3021,169,598,309,944,478,1542
500780,202108,1227,2901,777,2167,149,485,213,533,362,1018
500790,202108,7085,18520,5393,15635,1131,3529,2407,6969,3538,10498
500793,202108,2087,5200,1501,4207,354,1063,506,1297,860,2360
500795,202108,2734,6668,2194,5989,122,297,1723,4964,1845,5261
500797,202108,791,1982,517,1493,156,458,141,424,297,882
500800,202108,3492,7744,2154,5749,613,1950,292,844,905,2794
500830,202108,18671,45711,12856,35247,2683,7766,4509,11719,7192,19485
500840,202108,1446,3464,929,2487,127,334,385,975,512,1309
510010,202108,1873,4148,1282,3407,112,239,920,2471,1032,2710
510020,202108,4189,10262,2227,6430,385,1214,615,1553,1000,2767
510025,202108,6908,16344,4285,12221,597,1847,1937,5301,2534,7148
510030,202108,3081,6605,2071,5147,335,828,1037,2477,1372,3305
510035,202108,1250,3229,800,2523,121,401,427,1460,548,1861
510040,202108,2458,5361,1831,4557,198,451,1119,2939,1317,3390
510050,202108,2259,4589,1530,3675,205,515,997,2392,1202,2907
510060,202108,1370,3373,862,2472,149,463,232,600,381,1063
510080,202108,1428,3610,958,2868,196,619,443,1234,639,1853
510100,202108,693,1583,495,1278,66,172,277,690,343,862
510120,202108,282,511,161,368,11,22,120,275,131,297
510125,202108,2069,5114,1629,4468,150,531,918,2347,1068,2878
510130,202108,1590,3913,1091,3120,224,666,372,1091,596,1757
510140,202108,3148,7885,2122,6594,778,2730,711,2219,1489,4949
510160,202108,1787,4536,1330,3947,143,399,987,3012,1130,3411
510170,202108,4950,12695,3684,10657,850,2551,1522,4361,2372,6912
510180,202108,15149,33204,9892,25770,2051,5862,3313,9521,5364,15383
510185,202108,1803,4612,1159,3691,464,1513,241,1032,705,2545
510190,202108,2096,5880,1342,4616,362,1378,240,898,602,2276
510250,202108,18057,44318,13341,37237,2446,7119,6628,19122,9074,26241
510260,202108,1843,7796,1536,7274,243,1253,951,4911,1194,6164
510263,202108,3287,9111,2032,6510,328,1158,396,1101,724,2259
510267,202108,5461,15327,3090,9990,510,1770,452,1244,962,3014
510268,202108,1265,3112,959,2628,124,338,579,1559,703,1897
510269,202108,1038,2752,639,1991,140,497,222,635,362,1132
510270,202108,3105,8573,2115,6834,341,1254,844,2706,1185,3960
510279,202108,1815,4601,1090,3345,170,568,399,1131,569,1699
510285,202108,1150,2960,758,2285,215,742,194,517,409,1259
510300,202108,3785,9343,2802,8034,409,1177,1644,4974,2053,6151
510305,202108,1463,3982,912,2937,179,615,208,765,387,1380
510310,202108,965,2315,659,1824,176,502,200,575,376,1077
510320,202108,3741,9072,2591,7155,554,1696,547,1496,1101,3192
510325,202108,4368,12573,3154,10345,874,3075,860,2862,1734,5937
510330,202108,2644,7857,1768,6327,304,1110,625,2624,929,3734
510335,202108,4995,14168,3784,12231,561,1924,2055,6745,2616,8669
510336,202108,447,1249,326,1064,44,142,173,631,217,773
510337,202108,1448,4103,920,3167,337,1283,192,677,529,1960
510340,202108,96068,210877,62939,163659,14343,43194,20212,49947,34555,93141
510343,202108,1134,2918,742,2218,114,395,340,956,454,1351
510345,202108,1284,3598,965,2964,160,484,419,1276,579,1760
510350,202108,3125,7783,2133,6145,450,1310,947,2734,1397,4044
510360,202108,2073,4123,1287,3212,74,120,904,2444,978,2564
510370,202108,1766,4907,1316,4187,179,627,781,2565,960,3192
510380,202108,576,1388,327,973,52,181,134,397,186,578
510385,202108,1216,4013,910,3449,86,380,603,2361,689,2741
510390,202108,1323,3365,889,2848,277,888,270,1048,547,1936
510395,202108,737,1599,502,1258,26,60,323,861,349,921
510410,202108,4883,13074,3548,10802,674,2127,1792,5747,2466,7874
510420,202108,2557,5198,1716,4097,111,263,1161,2779,1272,3042
510450,202108,577,1394,333,958,80,235,50,148,130,383
510452,202108,853,2377,633,1971,75,239,381,1156,456,1395
510454,202108,994,2689,767,2305,84,239,486,1536,570,1775
510455,202108,984,2624,688,2065,125,408,261,713,386,1121
510460,202108,1875,4644,1378,3894,146,469,840,2269,986,2738
510480,202108,5009,11740,3390,8862,585,1694,1370,3388,1955,5082
510490,202108,1750,4407,1309,3858,249,705,780,2353,1029,3058
510500,202108,1587,3826,967,2858,195,607,277,798,472,1405
510510,202108,3743,10430,2706,8642,624,2236,886,2958,1510,5194
510515,202108,5393,13457,3539,10204,743,2439,1098,2787,1841,5226
510517,202108,1176,3195,874,2699,266,931,164,458,430,1389
510520,202108,2331,4610,1282,3303,107,284,601,1695,708,1979
510523,202108,1297,2991,909,2408,159,429,557,1489,716,1918
510525,202108,7823,20919,5788,16962,894,2804,2759,7636,3653,10440
510530,202108,560,1435,414,1221,27,90,275,800,302,890
510550,202108,2339,6776,1705,5693,345,1211,808,2710,1153,3921
510558,202108,2391,6282,1747,5286,241,681,813,2716,1054,3397
510560,202108,1585,4462,977,3287,180,656,227,822,407,1478
510562,202108,5956,14639,4342,11895,982,2830,1520,4486,2502,7316
510590,202108,3013,7432,2214,6383,150,434,1621,4804,1771,5238
510600,202108,1467,3223,980,2519,158,395,495,1255,653,1650
510610,202108,2653,6248,1787,5127,197,606,1087,3125,1284,3731
510615,202108,2799,6756,1960,5454,294,896,1136,3173,1430,4069
510617,202108,1032,3094,812,2747,80,312,568,1980,648,2292
510618,202108,1229,3228,876,2654,190,629,399,1172,589,1801
510619,202108,804,2001,482,1429,71,200,94,249,165,449
510620,202108,1470,3277,681,1983,171,595,34,69,205,664
510621,202108,1619,4245,974,3031,216,735,267,736,483,1471
510622,202108,4962,13493,3376,10225,1093,3600,453,1279,1546,4879
510623,202108,2763,6804,2019,5629,467,1423,673,1878,1140,3301
510624,202108,1649,4179,815,2636,97,350,173,506,270,856
510625,202108,3133,7463,1744,5029,292,953,418,1218,710,2171
510626,202108,1506,3613,949,2730,236,784,204,600,440,1384
510627,202108,635,1611,349,1060,82,280,88,279,170,559
510628,202108,1500,3394,996,2740,229,662,382,1037,611,1699
510629,202108,1669,4602,1189,3741,204,698,403,1282,607,1980
510630,202108,3496,9453,2066,6765,461,1620,374,1366,835,2986
510631,202108,589,1392,427,1152,17,37,323,910,340,947
510637,202108,3810,8810,2706,7212,628,1861,846,2295,1474,4156
510642,202108,5535,15347,4219,13383,936,3306,1968,6245,2904,9551
510645,202108,1048,2018,647,1526,190,409,263,663,453,1072
510650,202108,7257,18051,5712,16359,670,1706,3800,12267,4470,13973
510665,202108,1844,3955,1169,2900,252,586,424,1157,676,1743
510670,202108,433,916,249,653,30,83,132,351,162,434
510675,202108,6413,17297,4412,13650,1186,4052,837,2453,2023,6505
510677,202108,2191,5494,1508,4491,205,709,817,2387,1022,3096
510680,202108,711,1785,402,1212,71,242,99,247,170,489
510682,202108,1568,4395,1137,3699,374,1383,292,876,666,2259
510685,202108,496,1401,349,1109,53,170,181,579,234,749
510700,202108,4111,9625,2874,7950,250,744,2179,6021,2429,6765
510704,202108,11198,26078,7514,19883,1731,4904,1830,4701,3561,9605
510706,202108,2206,6379,1523,5256,311,1108,759,2843,1070,3951
510710,202108,2823,6863,1825,4977,415,1176,563,1479,978,2655
510715,202108,631,1332,453,1100,28,72,265,628,293,700
510718,202108,2401,5415,1423,4091,350,980,561,1940,911,2920
510719,202108,462,961,272,709,27,80,158,384,185,464
510720,202108,878,2007,593,1589,116,342,271,700,387,1042
510724,202108,868,2310,601,1812,80,257,322,924,402,1181
510726,202108,1065,1937,580,1348,68,166,282,664,350,830
510729,202108,625,1446,288,824,33,107,78,243,111,350
510730,202108,3005,7095,2052,5664,239,764,1082,2865,1321,3629
510735,202108,1113,3059,863,2719,74,261,651,2035,725,2296
510740,202108,1026,2485,660,1819,111,307,323,865,434,1172
510757,202108,489,1545,383,1380,113,444,138,464,251,908
510760,202108,45129,97472,27257,70553,5514,16233,8573,20364,14087,36597
510770,202108,4337,9611,2980,7911,194,468,2068,5756,2262,6224
510774,202108,347,863,246,709,39,113,127,379,166,492
510775,202108,655,1707,412,1305,91,312,79,236,170,548
510776,202108,568,1360,402,1079,74,211,166,429,240,640
510777,202108,1601,4117,1150,3537,139,452,784,2405,923,2857
510779,202108,791,2057,596,1739,57,146,360,1128,417,1274
510780,202108,3904,9854,2898,8392,682,1910,1241,4079,1923,5989
510785,202108,2020,5164,1180,3677,339,1112,180,671,519,1783
510787,202108,2832,7887,1874,5930,527,1759,166,515,693,2274
510788,202108,597,1358,411,1080,66,176,190,571,256,747
510790,202108,19038,47638,12132,35456,2843,9132,1887,5046,4730,14178
510792,202108,9702,26241,6008,19128,1212,4295,1005,2918,2217,7213
510794,202108,1234,3298,881,2706,297,1009,156,412,453,1421
510795,202108,9025,23029,6023,17735,1285,4165,1627,4665,2912,8830
510800,202108,1628,4091,1069,3161,318,963,134,376,452,1339
510805,202108,1559,4245,1103,3424,224,779,428,1218,652,1997
510810,202108,645,1286,421,991,120,282,144,375,264,657
510820,202108,794,1482,448,1052,23,66,250,592,273,658
510830,202108,915,2117,694,1843,34,71,543,1513,577,1584
510835,202108,592,1413,396,1131,45,143,249,690,294,833
510840,202108,59644,123948,40829,101049,7962,18428,19967,54434,27929,72862
510850,202108,1915,4569,1174,3424,378,1278,139,345,517,1623
510860,202108,2429,6185,1527,4707,462,1715,176,507,638,2222
510880,202108,769,2095,584,1767,146,476,185,560,331,1036
510885,202108,673,1570,438,1229,88,255,130,386,218,641
510890,202108,737,2088,554,1767,143,491,240,755,383,1246
510895,202108,1336,3370,880,2616,156,555,393,1097,549,1652
520005,202108,3005,7541,2325,6677,682,1965,882,3023,1564,4988
520010,202108,2486,6813,1771,5457,396,1364,587,1633,983,2997
520013,202108,3293,8105,2154,6066,503,1419,597,1851,1100,3270
520015,202108,525,1273,379,1066,91,252,150,450,241,702
520017,202108,1260,3106,926,2604,226,651,381,1042,607,1693
520020,202108,444,968,340,847,24,75,275,670,299,745
520025,202108,34427,93765,29296,86650,3149,9675,20661,61202,23810,70877
520030,202108,5870,14451,4741,12917,300,856,3502,9495,3802,10351
520050,202108,418,980,253,685,17,45,158,443,175,488
520055,202108,1894,4440,1228,3190,162,352,659,1724,821,2076
520060,202108,1565,4101,1145,3366,262,901,291,818,553,1719
520080,202108,1860,4756,1421,4161,247,729,683,2221,930,2950
520082,202108,969,2385,737,2011,77,220,378,1074,455,1294
520085,202108,952,2374,735,2039,133,396,356,973,489,1369
520090,202108,891,1736,624,1445,83,145,444,1091,527,1236
520110,202108,38609,101842,26748,82024,7512,26345,2659,7437,10171,33782
520120,202108,209,499,122,356,12,37,49,147,61,184
520130,202108,4041,9508,3124,8084,641,1712,1293,3385,1934,5097
520140,202108,42814,111450,29442,88607,10072,32965,3599,11301,13671,44266
520145,202108,622,1385,425,1111,78,222,230,555,308,777
520150,202108,648,1501,485,1302,72,204,252,679,324,883
520160,202108,852,1955,596,1533,107,262,220,614,327,876
520170,202108,4891,9804,3237,7921,184,537,2475,6014,2659,6551
520180,202108,2481,6500,2004,5806,330,1055,1104,3137,1434,4192
520215,202108,1762,4163,1246,3382,278,788,438,1144,716,1932
520235,202108,704,1558,449,1183,44,130,234,609,278,739
520250,202108,1548,3849,1101,3132,326,990,268,869,594,1859
520260,202108,841,1910,537,1438,97,251,208,569,305,820
520280,202108,824,1891,641,1616,118,289,321,860,439,1149
520310,202108,1020,2172,657,1632,144,405,244,645,388,1050
520320,202108,1783,4675,1347,3964,170,513,766,2282,936,2795
520330,202108,4715,12002,3541,10078,524,1727,1791,4955,2315,6682
520340,202108,2539,5456,1559,4121,170,404,927,2560,1097,2964
520350,202108,2824,6634,2016,5449,557,1606,795,2169,1352,3775
520355,202108,1934,5197,1376,4103,436,1371,210,529,646,1900
520357,202108,769,1817,560,1504,42,92,404,1127,446,1219
520360,202108,732,1871,562,1591,137,412,178,515,315,927
520380,202108,1459,3582,889,2561,116,339,388,1058,504,1397
520390,202108,1076,2354,641,1796,188,588,192,578,380,1166
520393,202108,623,1402,401,1059,59,160,169,429,228,589
520396,202108,884,2199,741,1987,36,107,548,1456,584,1563
520400,202108,1649,3953,1266,3438,137,410,903,2434,1040,2844
520410,202108,2172,4635,1417,3517,181,502,761,1766,942,2268
520420,202108,385,868,306,748,21,54,244,570,265,624
520425,202108,1555,3766,858,2418,227,693,147,407,374,1100
520430,202108,2357,5267,1360,3737,233,751,59,156,292,907
520440,202108,2956,7058,1756,4928,420,1290,429,1139,849,2429
520450,202108,12502,29040,8519,23177,2612,7870,1798,5111,4410,12981
520455,202108,720,1939,519,1624,142,456,135,465,277,921
520460,202108,1050,2394,825,2108,78,172,654,1712,732,1884
520465,202108,829,2053,677,1849,60,183,516,1374,576,1557
520470,202108,2143,5296,1625,4615,474,1418,618,1903,1092,3321
520480,202108,893,2413,617,1952,183,597,155,481,338,1078
520485,202108,1578,4474,1287,4064,175,544,852,2670,1027,3214
520490,202108,4112,11036,3084,9402,876,2801,1280,4033,2156,6834
520495,202108,1615,3505,1229,2982,63,151,976,2384,1039,2535
520500,202108,1401,3575,993,2831,187,566,470,1338,657,1904
520505,202108,784,1696,548,1403,61,155,365,939,426,1094
520510,202108,7609,18556,5150,14825,1025,3334,1686,4992,2711,8326
520520,202108,1219,2963,913,2495,204,606,346,938,550,1544
520530,202108,2365,6389,1759,5325,367,1200,822,2549,1189,3749
520540,202108,3043,7796,1996,5792,363,1141,537,1470,900,2611
520545,202108,1101,2748,855,2350,193,474,360,1047,553,1521
520547,202108,956,2477,773,2181,159,469,405,1118,564,1587
520549,202108,14749,37920,12292,34438,1452,4290,8429,23340,9881,27630
520551,202108,4617,12147,3830,10992,404,1324,2711,7628,3115,8952
520552,202108,838,2102,686,1907,150,397,369,1113,519,1510
520570,202108,553,1234,361,933,84,180,128,383,212,563
520580,202108,2285,5041,1697,4359,174,467,1171,3003,1345,3470
520590,202108,1308,3181,894,2504,255,731,269,757,524,1488
520620,202108,8299,21777,6523,19150,1471,4461,3126,9388,4597,13849
520630,202108,824,2065,595,1675,69,206,267,748,336,954
520640,202108,2453,5880,1855,4870,420,1097,787,2146,1207,3243
520650,202108,1027,2239,727,1823,120,307,373,997,493,1304
520660,202108,559,1342,298,876,46,146,83,255,129,401
520670,202108,950,2524,796,2309,60,184,541,1544,601,1728
520680,202108,742,1856,570,1573,95,258,300,844,395,1102
520690,202108,310,714,211,566,68,171,59,172,127,343
520710,202108,422,1011,301,817,17,44,200,528,217,572
520725,202108,1488,3468,1017,2695,115,360,641,1643,756,2003
520735,202108,807,1934,535,1480,114,283,208,621,322,904
520740,202108,2464,5365,1881,4658,346,775,1004,2764,1350,3539
520750,202108,685,1620,473,1285,77,218,219,578,296,796
520753,202108,1243,3363,940,2778,165,512,373,1032,538,1544
520760,202108,1285,2802,1109,2594,29,56,1013,2403,1042,2459
520780,202108,1541,3570,1111,2965,125,320,577,1547,702,1867
520790,202108,3577,8315,2511,6612,361,952,1321,3617,1682,4569
520800,202108,17085,43036,13335,37508,1813,5200,8029,23227,9842,28427
520810,202108,1327,2741,1007,2379,153,349,656,1674,809,2023
520815,202108,569,1724,427,1420,82,280,117,405,199,685
520830,202108,1910,4008,1349,3363,89,192,1067,2647,1156,2839
520840,202108,2798,7314,2273,6630,841,2732,620,1909,1461,4641
520850,202108,705,1702,520,1433,148,483,162,447,310,930
520860,202108,7196,18886,5288,15685,1315,4198,1947,5628,3262,9826
520870,202108,116013,265345,78728,208835,16033,45696,29285,75871,45318,121567
520880,202108,7441,20923,5701,17750,1196,3900,2096,6511,3292,10411
520890,202108,4370,10044,3011,7952,489,1441,1427,3650,1916,5091
520910,202108,4721,11624,3029,8737,678,2151,766,2108,1444,4259
520915,202108,731,1997,450,1379,88,291,146,414,234,705
520920,202108,4620,10139,3286,8498,481,1249,1617,4480,2098,5729
520929,202108,696,1626,535,1402,51,113,302,845,353,958
520940,202108,978,2545,763,2239,50,113,582,1715,632,1828
520945,202108,522,1120,382,939,14,34,258,624,272,658
520960,202108,1110,2570,865,2213,266,623,374,1040,640,1663
520970,202108,2685,7115,2108,6197,447,1506,549,1754,996,3260
520980,202108,784,1863,575,1583,94,259,244,655,338,914
520990,202108,3063,7921,2458,7159,332,897,1645,4902,1977,5799
520993,202108,1180,2723,814,2150,135,396,425,1086,560,1482
520995,202108,2408,5988,1800,5147,267,785,709,2128,976,2913
521000,202108,9009,23254,5916,17535,1092,3359,1661,4836,2753,8195
521010,202108,3677,9428,2742,7792,267,759,1586,4487,1853,5246
521015,202108,797,1957,558,1531,40,127,352,924,392,1051
521020,202108,3606,8937,2127,6095,563,1788,199,597,762,2385
521030,202108,549,1188,383,938,47,98,220,566,267,664
521040,202108,7828,18781,5779,15575,1251,3455,2322,6546,3573,10001
521056,202108,951,2447,739,2137,245,686,199,659,444,1345
521060,202108,1005,2651,732,2129,143,442,271,780,414,1222
521080,202108,1131,2395,584,1552,85,251,258,611,343,862
521090,202108,3203,8407,2128,6266,512,1661,249,765,761,2426
521100,202108,1844,4140,1360,3461,228,539,827,2168,1055,2707
521120,202108,4695,11050,3480,9528,199,504,1691,5445,1890,5949
521130,202108,1028,2276,587,1539,20,52,292,821,312,873
521140,202108,1417,3576,1054,2934,101,289,568,1566,669,1855
521150,202108,12685,27341,7931,20585,1379,4098,3628,9661,5007,13759
521160,202108,679,1377,470,1085,78,150,282,654,360,804
521170,202108,1075,2470,788,2042,71,199,479,1200,550,1399
521180,202108,7765,20721,6347,18304,1078,3298,3261,9179,4339,12477
521190,202108,10964,26556,6482,19187,1574,4962,1354,4245,2928,9207
521200,202108,720,1702,505,1367,50,139,316,855,366,994
521205,202108,648,1558,495,1319,21,60,381,972,402,1032
521210,202108,749,1909,435,1269,75,231,100,229,175,460
521220,202108,3710,8733,2469,6835,369,1129,1091,3028,1460,4157
521225,202108,397,833,286,707,61,141,163,418,224,559
521230,202108,1386,3432,1212,3219,359,962,603,1743,962,2705
521250,202108,32072,82272,25014,72074,8885,26288,7381,23178,16266,49466
521260,202108,549,1253,409,1044,69,171,223,565,292,736
521270,202108,1868,4508,1632,4234,93,200,1272,3327,1365,3527
521280,202108,1794,4749,1346,4008,311,1001,554,1678,865,2679
521290,202108,526,1175,367,974,47,140,229,593,276,733
521295,202108,1157,2462,906,2195,73,127,759,1900,832,2027
521300,202108,1939,4692,1518,4095,288,724,900,2550,1188,3274
521305,202108,729,1669,525,1385,84,202,300,815,384,1017
521308,202108,4933,12761,3440,10018,307,890,2063,5867,2370,6757
521310,202108,8820,22153,6177,17658,1162,3641,2753,7532,3915,11173
521340,202108,417,958,300,783,25,65,203,531,228,596
521350,202108,2076,5160,1591,4443,144,458,1122,3048,1266,3506
521370,202108,1244,3111,753,2282,211,739,92,310,303,1049
521375,202108,1340,3247,912,2582,198,562,266,851,464,1413
521377,202108,1564,3253,1154,2752,127,209,887,2266,1014,2475
521380,202108,6386,16584,4114,12404,442,1426,1047,3384,1489,4810
521385,202108,700,1631,534,1419,54,128,297,856,351,984
521390,202108,716,1740,496,1413,146,468,153,465,299,933
521400,202108,2819,6368,2254,5704,246,573,1570,4100,1816,4673
521405,202108,1399,3521,1000,2822,152,444,524,1464,676,1908
521410,202108,795,2101,598,1766,97,277,302,938,399,1215
521440,202108,1197,2888,884,2428,279,853,272,737,551,1590
521450,202108,4000,11612,2887,9427,774,2496,636,2297,1410,4793
521460,202108,5676,14457,4007,11547,1169,3535,1106,3242,2275,6777
521470,202108,719,1847,459,1354,64,174,173,517,237,691
521480,202108,414,1012,260,734,61,159,83,232,144,391
521483,202108,2385,5556,1653,4468,331,934,704,1912,1035,2846
521486,202108,1836,4317,1389,3696,98,209,963,2609,1061,2818
521487,202108,414,971,292,808,49,132,155,443,204,575
521490,202108,932,2430,701,2055,37,132,487,1382,524,1514
521500,202108,2237,5392,1682,4579,99,331,1197,3157,1296,3488
521520,202108,754,1723,547,1426,89,218,238,647,327,865
521523,202108,12365,36341,10144,32854,2661,9255,2952,9845,5613,19100
521525,202108,1097,2453,837,2103,78,199,594,1482,672,1681
521530,202108,2342,5910,1435,4116,296,851,393,1113,689,1964
521540,202108,841,2094,583,1683,84,261,265,797,349,1058
521550,202108,1640,4100,918,2654,165,534,227,671,392,1205
521560,202108,4805,11999,3270,9917,685,2084,1437,4799,2122,6883
521565,202108,685,1592,517,1350,83,201,298,779,381,980
521570,202108,3532,9506,2415,7336,477,1726,148,465,625,2191
521580,202108,506,1199,303,852,42,126,108,273,150,399
521590,202108,691,1563,508,1309,78,219,308,771,386,990
521600,202108,453,1173,294,870,31,75,135,398,166,473
521630,202108,1732,3708,1094,2807,228,631,362,910,590,1541
521640,202108,2058,4678,1337,3616,249,696,471,1269,720,1965
521645,202108,575,1457,370,1089,118,333,78,222,196,555
521680,202108,1194,3467,901,2926,235,849,175,588,410,1437
521690,202108,552,1309,458,1191,61,171,287,741,348,912
521710,202108,3332,8082,2154,6155,362,1183,634,1641,996,2824
521720,202108,2365,5252,1558,4070,238,625,831,2192,1069,2817
521730,202108,3710,10006,2863,8595,747,2650,816,2039,1563,4689
521740,202108,4060,10219,3063,8772,786,2442,883,2609,1669,5051
521760,202108,15462,40716,12004,35524,2724,8800,4575,14586,7299,23386
521770,202108,3205,7440,2118,5726,590,1738,503,1425,1093,3163
521800,202108,6824,17669,4952,14631,1081,3249,2015,6512,3096,9761
521805,202108,846,1755,575,1412,152,357,248,660,400,1017
521810,202108,676,1565,491,1317,78,198,288,802,366,1000
521830,202108,5632,15228,4482,13465,283,1013,3295,9707,3578,10720
521839,202108,829,1933,598,1555,87,258,357,847,444,1105
521850,202108,6234,13950,3920,10556,869,2444,690,1921,1559,4365
521860,202108,1591,4179,1098,3275,178,576,369,1041,547,1617
521870,202108,702,1905,497,1516,97,340,125,327,222,667
521878,202108,714,1789,507,1391,54,172,286,710,340,882
521880,202108,19277,46466,13162,36920,3414,10027,4422,12531,7836,22558
521890,202108,3263,8315,2170,6370,568,1820,465,1233,1033,3053
521900,202108,1502,3471,832,2414,241,683,71,208,312,891
521910,202108,1352,2777,927,2279,104,245,515,1368,619,1613
521920,202108,519,1343,372,1097,59,201,181,511,240,712
521925,202108,783,1980,564,1639,88,276,306,877,394,1153
521930,202108,5591,13176,3676,10305,975,2575,1313,4208,2288,6783
521935,202108,1091,2554,743,1961,71,199,421,1061,492,1260
521940,202108,1350,2863,858,2190,184,533,361,889,545,1422
521945,202108,674,1738,523,1483,98,280,276,807,374,1087
521950,202108,779,1848,537,1473,115,325,230,622,345,947
521960,202108,745,1883,501,1431,49,158,275,737,324,895
521970,202108,2597,6221,2031,5538,168,440,1534,4276,1702,4716
521971,202108,786,1832,551,1465,151,369,141,384,292,753
521973,202108,1530,3843,1269,3494,66,141,1032,2866,1098,3007
521975,202108,12241,31524,9971,28395,1754,5048,6040,17354,7794,22402
521980,202108,2599,5961,1997,5167,153,380,1502,3995,1655,4375
521990,202108,1132,3113,916,2739,187,595,373,1096,560,1691
522000,202108,2766,7034,2174,6295,389,1147,1210,3698,1599,4845
522005,202108,335,786,244,647,50,141,113,297,163,438
522010,202108,4304,10305,3083,8342,598,1755,1231,3230,1829,4985
522015,202108,1068,2721,781,2277,244,677,282,871,526,1548
522020,202108,5661,13113,3668,10015,760,2240,1359,3892,2119,6132
522026,202108,834,2171,541,1647,91,300,169,469,260,769
522028,202108,494,1194,338,929,78,232,110,302,188,534
522040,202108,3482,7563,2520,6281,257,725,1770,4306,2027,5031
522045,202108,18135,49010,13414,40730,3078,10001,3750,11100,6828,21101
522050,202108,1223,3095,837,2420,172,556,304,788,476,1344
522060,202108,3011,7730,2114,6268,218,633,1177,3610,1395,4243
522068,202108,1860,4607,1479,4150,110,274,1187,3382,1297,3656
522070,202108,709,1656,583,1476,13,34,504,1254,517,1288
522100,202108,743,1851,510,1496,72,230,258,722,330,952
522108,202108,1124,2612,885,2281,52,121,717,1820,769,1941
522119,202108,1757,4126,1368,3617,191,521,784,2148,975,2669
522130,202108,434,1076,308,905,32,85,210,644,242,729
522140,202108,20970,53515,14714,42445,3467,10669,4230,11609,7697,22278
522145,202108,807,1953,559,1584,159,439,214,621,373,1060
522150,202108,1113,2659,784,2123,207,568,218,610,425,1178
522155,202108,1104,2731,854,2356,175,418,482,1400,657,1818
522157,202108,662,1472,540,1325,23,62,438,1093,461,1155
522160,202108,6087,15394,3940,11510,1033,3242,337,1078,1370,4320
522170,202108,2630,6610,1969,5642,288,837,1131,3305,1419,4142
522180,202108,589,1371,370,957,62,170,93,257,155,427
522185,202108,20436,48951,14429,40765,5342,16680,3056,9288,8398,25968
522190,202108,771,1778,523,1361,104,265,203,524,307,789
522200,202108,1690,4663,1143,3650,244,842,226,688,470,1530
522205,202108,1782,4110,1334,3490,161,433,771,2028,932,2461
522220,202108,1337,3166,992,2662,123,314,594,1653,717,1967
522230,202108,1282,3116,1041,2776,191,602,554,1430,745,2032
530010,202108,186865,493892,153119,444217,21589,68039,93143,264856,114732,332895
110001,202107,4113,11241,2750,8705,606,2063,1024,3317,1630,5380
110002,202107,13599,34460,9925,28317,2666,8089,2685,7784,5351,15873
110003,202107,613,1806,458,1485,116,388,125,381,241,769
110004,202107,12598,31875,8506,24800,1716,5397,2555,7439,4271,12836
110005,202107,2582,6582,1802,5327,360,1132,484,1566,844,2698
110006,202107,1780,4914,1098,3479,173,604,230,702,403,1306
110007,202107,1326,3321,842,2511,263,819,206,762,469,1581
110008,202107,3542,9275,2630,7954,318,894,1695,5564,2013,6458
110009,202107,4435,12125,2868,9299,591,2051,1135,3714,1726,5765
110010,202107,8212,24920,6074,20885,1200,4149,2946,11095,4146,15244
110011,202107,7317,19067,4947,14812,1611,5139,659,2050,2270,7189
110012,202107,16129,39668,9715,28583,2089,6730,864,2727,2953,9457
110013,202107,5422,15352,3784,12080,1490,5067,420,1496,1910,6563
110014,202107,4098,10540,2783,8052,521,1618,1249,3516,1770,5134
110015,202107,5913,14886,3607,10533,742,2398,938,2472,1680,4870
110018,202107,3918,9712,2297,6890,402,1405,589,1796,991,3201
110020,202107,77437,180923,56033,151994,12528,35028,22433,67765,34961,102793
110025,202107,5391,12791,3633,9831,663,1947,1677,4490,2340,6437
110026,202107,539,1336,388,1114,87,289,154,469,241,758
110028,202107,7308,18045,4469,13025,1021,3295,612,1776,1633,5071
110029,202107,1594,3835,940,2698,194,576,357,1071,551,1647
110030,202107,13188,29925,8147,22467,1707,5452,1296,3973,3003,9425
110032,202107,3409,9344,2063,6532,664,2091,367,1282,1031,3373
110033,202107,3654,11131,2781,9560,976,3381,704,2737,1680,6118
110034,202107,3372,7774,2228,6210,683,2166,707,2158,1390,4324
110037,202107,1687,4890,1254,4121,294,965,566,1930,860,2895
110040,202107,3011,8140,2166,6612,554,1840,691,2035,1245,3875
110045,202107,5032,14140,3666,11646,942,3219,1190,3954,2132,7173
110050,202107,1841,4921,1291,3959,443,1535,199,587,642,2122
110060,202107,917,2672,620,1971,168,581,128,389,296,970
110070,202107,1582,4840,1137,3852,323,1164,247,784,570,1948
110080,202107,6611,15081,4995,13159,873,2150,3063,8708,3936,10858
110090,202107,615,1640,424,1297,83,266,140,428,223,694
110092,202107,1291,3641,901,2906,170,554,426,1498,596,2052
110094,202107,2933,8558,2140,7004,855,3010,236,805,1091,3815
110100,202107,1750,5064,1376,4348,381,1279,542,1757,923,3036
110110,202107,1811,4831,1298,4011,462,1479,249,886,711,2365
110120,202107,1343,3782,1025,3171,225,756,368,1123,593,1879
110130,202107,2937,7180,1704,4853,118,347,174,429,292,776
110140,202107,2179,6243,1511,4894,329,1121,491,1618,820,2739
110143,202107,1386,3732,981,2934,289,870,173,531,462,1401
110145,202107,906,2331,565,1701,126,379,224,705,350,1084
110146,202107,512,1281,361,1046,72,178,178,555,250,733
110147,202107,772,1976,496,1449,61,202,196,494,257,696
110148,202107,786,2149,465,1509,123,463,62,195,185,658
110149,202107,3284,8631,2209,6905,739,2431,479,1611,1218,4042
110150,202107,2871,6926,1828,5392,516,1700,440,1554,956,3254
110155,202107,764,2183,538,1649,116,392,187,522,303,914
110160,202107,1516,4537,1102,3629,302,1034,269,906,571,1940
110170,202107,2177,5484,1378,4018,229,713,732,2061,961,2774
110175,202107,1868,5206,1292,4060,206,667,498,1648,704,2315
110180,202107,1501,3984,1053,3098,138,441,564,1624,702,2065
120001,202107,3437,9823,2802,8883,446,1476,1754,5690,2200,7166
120005,202107,1989,7412,1813,7164,148,613,1443,5838,1591,6451
120010,202107,5490,15860,4664,14656,409,1203,3474,11259,3883,12462
120013,202107,2237,7484,1970,7165,403,1400,1261,4913,1664,6313
120017,202107,2623,8057,2289,7561,372,1224,1418,4983,1790,6207
120020,202107,15760,58419,14508,56056,966,4126,11688,45442,12654,49568
120025,202107,3226,8784,2594,8035,329,1007,1846,5902,2175,6909
120030,202107,6537,25465,6058,24584,403,1939,4703,19315,5106,21254
120032,202107,1827,7828,1744,7680,91,558,1489,6445,1580,7003
120033,202107,4282,15367,4027,14920,94,542,3536,12945,3630,13487
120034,202107,2791,9829,2390,9145,89,513,2006,7574,2095,8087
120035,202107,3904,14786,3699,14432,281,1280,3074,11978,3355,13258
120038,202107,2765,8616,2339,7930,485,1681,1298,4489,1783,6170
120039,202107,2066,8714,1937,8468,105,651,1577,6859,1682,7510
120040,202107,46254,139949,39457,129139,4980,17147,25384,83982,30364,101129
120042,202107,3454,12391,3211,11949,124,625,2742,10109,2866,10734
120043,202107,1505,5935,1362,5722,39,238,1244,5223,1283,5461
120045,202107,6237,15857,5388,14905,135,519,4881,13352,5016,13871
120050,202107,9525,33729,8731,32517,364,1803,7370,27555,7734,29358
120060,202107,9656,37555,8831,36356,337,2100,7718,31562,8055,33662
120070,202107,3330,10325,2884,9730,255,830,2113,7389,2368,8219
120080,202107,4497,13847,3996,13117,447,1462,2957,9961,3404,11423
130002,202107,3338,12302,2987,11781,155,522,2626,10598,2781,11120
130006,202107,2562,9164,2133,8422,200,751,1598,6430,1798,7181
130008,202107,2787,9565,2477,9121,57,286,2168,7999,2225,8285
130010,202107,4048,11610,3408,10890,82,200,3114,10135,3196,10335
130014,202107,3509,9888,2714,8642,450,1443,1670,5438,2120,6881
130020,202107,3023,11372,2703,10887,96,556,2286,9180,2382,9736
130030,202107,10999,33802,10045,32701,346,802,9035,30080,9381,30882
130040,202107,4367,12385,3612,11397,330,876,2842,9261,3172,10137
130050,202107,7777,27873,6508,26220,179,803,5892,24067,6071,24870
130060,202107,7933,30500,6796,29040,384,1997,5718,24460,6102,26457
130063,202107,6673,21454,5956,20663,191,828,5439,18940,5630,19768
130068,202107,3991,13372,3360,12509,182,956,2600,9589,2782,10545
130070,202107,7950,21592,6540,20064,311,791,5384,17226,5695,18017
130080,202107,7536,26236,6599,25172,237,1202,5681,22101,5918,23303
130083,202107,2863,9095,2549,8711,152,566,2123,7426,2275,7992
130090,202107,3633,11060,3224,10566,44,187,2895,9692,2939,9879
130100,202107,8245,24458,6983,23146,112,228,6522,22258,6634,22486
130110,202107,8690,24377,7120,22447,1066,2673,5073,17414,6139,20087
130115,202107,5271,16373,4531,15536,103,332,4025,14050,4128,14382
130120,202107,14242,49848,12531,47597,1053,4311,10156,39080,11209,43391
130130,202107,5764,17436,4412,15647,395,1404,3183,11491,3578,12895
130140,202107,7445,25519,6519,24462,187,1001,5722,21612,5909,22613
130150,202107,3790,13892,3565,13641,63,394,3306,12691,3369,13085
130160,202107,5451,18660,4686,17694,299,1049,3972,15452,4271,16501
130165,202107,3317,12297,3113,12053,119,504,2814,11015,2933,11519
130170,202107,11987,34014,9676,31348,719,2366,7828,26001,8547,28367
130180,202107,4566,14653,4337,14396,42,196,4188,13891,4230,14087
130185,202107,19248,46348,15745,42606,1177,1962,12951,37677,14128,39639
130190,202107,19505,62852,15701,57286,1573,5534,11359,43180,12932,48714
130195,202107,2547,9017,2053,8348,78,361,1718,7007,1796,7368
130200,202107,2794,7519,2277,6858,84,290,1956,5881,2040,6171
130210,202107,1398,5145,1262,4983,99,564,1035,3968,1134,4532
130220,202107,2388,7891,2024,7440,56,247,1787,6671,1843,6918
130230,202107,5064,19767,4411,18851,193,1148,3865,16490,4058,17638
130240,202107,12849,37549,10454,34449,144,804,9491,31324,9635,32128
130250,202107,26986,79062,23144,74748,1581,4326,18856,63439,20437,67765
130255,202107,4815,15455,4183,14366,131,529,3440,11857,3571,12386
130260,202107,264927,718679,215472,649433,58227,184631,97701,309509,155928,494140
130270,202107,10185,34745,8428,32045,1464,5265,5311,21429,6775,26694
130280,202107,3667,14411,3378,14089,79,401,3162,13325,3241,13726
130290,202107,14173,45256,12386,43027,642,2224,10623,37690,11265,39914
130300,202107,5060,16820,4565,16162,143,749,4005,14176,4148,14925
130310,202107,6642,21416,5752,20292,259,1106,4970,17567,5229,18673
130320,202107,3525,11333,2927,10548,370,1267,2163,8107,2533,9374
130330,202107,4794,14992,3858,13880,213,893,3287,11888,3500,12781
130340,202107,24902,73890,21467,70010,1490,3713,18113,61366,19603,65079
130350,202107,4124,14593,3719,14088,144,705,3286,12425,3430,13130
130353,202107,7660,20220,6135,18300,764,2128,4416,13762,5180,15890
130356,202107,5453,16814,4519,15380,822,2679,2681,9789,3503,12468
130360,202107,3095,9976,2664,9396,78,315,2383,8406,2461,8721
130370,202107,5878,23125,5069,22000,314,1684,4046,17651,4360,19335
130380,202107,7442,30645,6918,29896,384,2117,5904,25364,6288,27481
130390,202107,6262,25342,5587,24239,534,2501,4421,19369,4955,21870
130395,202107,2492,7725,2139,7171,185,594,1677,5706,1862,6300
130400,202107,2885,8667,2473,8132,87,230,2224,7469,2311,7699
130406,202107,11146,37869,9323,35671,1755,6566,6150,24777,7905,31343
130410,202107,4583,15601,3926,14525,1107,4253,1825,7010,2932,11263
130420,202107,14496,48766,12071,45752,949,4182,9349,35885,10298,40067
130423,202107,4592,13922,4025,13276,192,720,3542,11640,3734,12360
130426,202107,2802,11095,2601,10855,57,304,2413,10157,2470,10461
130430,202107,4444,12188,3831,11392,197,640,3327,9851,3524,10491
130440,202107,5255,15852,4424,14860,77,323,4119,13916,4196,14239
140002,202107,2424,6949,2120,6585,101,349,1771,5616,1872,5965
140005,202107,3389,9314,2947,8801,134,336,2510,7745,2644,8081
140010,202107,56176,147501,45048,131107,10993,33880,18789,56229,29782,90109
140015,202107,3954,11443,3359,10723,230,677,2903,9502,3133,10179
140017,202107,5074,13283,4454,12501,317,740,3673,10664,3990,11404
140020,202107,5351,15207,4620,14269,253,970,3801,11679,4054,12649
140023,202107,2596,7526,2131,6865,201,642,1627,5364,1828,6006
140028,202107,2003,5113,1693,4726,77,245,1370,3833,1447,4078
140030,202107,5555,13851,4949,13156,324,589,4368,11997,4692,12586
140040,202107,2716,10286,2512,10019,83,509,2310,9075,2393,9584
140045,202107,2680,9725,2230,9106,394,1335,1404,6398,1798,7733
140047,202107,6466,17998,5399,16478,584,1823,3886,12068,4470,13891
140050,202107,1464,4220,1238,3901,117,339,933,3063,1050,3402
140060,202107,1772,4524,1542,4202,112,283,1266,3524,1378,3807
140070,202107,1939,9932,1875,9806,108,769,1605,8287,1713,9056
150010,202107,46151,114579,41643,108793,996,2193,37338,97735,38334,99928
150013,202107,2053,5069,1714,4703,148,266,1362,3996,1510,4262
150020,202107,14625,43279,13491,41804,1851,4731,10478,34046,12329,38777
150030,202107,8900,33143,8086,32159,502,1949,6993,28282,7495,30231
150034,202107,4469,10497,3678,9534,252,563,3064,8139,3316,8702
150040,202107,16633,42490,14640,40284,1254,1842,12317,36803,13571,38645
150050,202107,7276,24517,6649,23700,121,505,6151,22144,6272,22649
150060,202107,22787,60567,18372,54068,2668,7964,12021,36134,14689,44098
150070,202107,7243,26093,6357,25038,232,1006,5718,22779,5950,23785
150080,202107,94822,210230,77962,187149,19815,52301,19896,59174,39711,111475
150085,202107,8274,23147,7526,22274,116,333,7058,21071,7174,21404
150090,202107,10392,36384,9805,35267,776,2598,7947,28989,8723,31587
150095,202107,6038,16688,5283,15770,263,504,4596,14231,4859,14735
150100,202107,2916,9996,2575,9442,214,656,2020,7655,2234,8311
150110,202107,4449,17929,4135,17576,175,773,3811,16351,3986,17124
150120,202107,8277,25347,7844,24841,278,673,6978,22770,7256,23443
150125,202107,811,2027,592,1734,100,358,364,1039,464,1397
150130,202107,23472,65709,20188,60741,3968,10566,12262,40048,16230,50614
150140,202107,274777,614080,231788,555869,35067,79619,133210,333033,168277,412652
150145,202107,4410,13525,3713,12421,1048,3290,1698,6514,2746,9804
150150,202107,17217,42453,15002,39700,732,1961,12453,32977,13185,34938
150157,202107,3684,9776,2932,8795,321,909,2031,6434,2352,7343
150160,202107,3287,9026,3058,8698,461,1162,2048,6041,2509,7203
150170,202107,25637,80440,22487,75201,4061,12571,13723,49225,17784,61796
150172,202107,5247,13875,4203,12430,294,715,3155,9715,3449,10430
150175,202107,1714,5221,1426,4693,236,806,847,2825,1083,3631
150178,202107,10872,28291,8975,26108,316,627,7920,23612,8236,24239
150180,202107,23257,79402,21014,76860,1338,3490,18322,69474,19660,72964
150190,202107,7046,22503,6535,21885,187,738,5940,19886,6127,20624
150195,202107,5435,16661,5102,16152,205,675,4553,14415,4758,15090
150200,202107,5972,17312,5454,16740,57,144,5158,15946,5215,16090
150210,202107,27666,92288,25923,90067,1516,4700,21711,78078,23227,82778
150215,202107,8896,24422,7720,22657,1302,3722,4596,13992,5898,17714
150220,202107,13070,35688,11409,33343,1132,2992,7873,23687,9005,26679
150230,202107,13119,36178,11626,34182,1288,3288,7956,24578,9244,27866
150240,202107,34017,91517,28319,82041,7018,20905,10515,30630,17533,51535
150250,202107,4357,16178,4050,15837,584,2225,3182,12747,3766,14972
150260,202107,2789,8769,2510,8353,127,382,2055,6943,2182,7325
150270,202107,9340,25853,6590,20934,2042,6843,1527,5227,3569,12070
150275,202107,7091,21946,6452,21051,225,772,5581,18211,5806,18983
150276,202107,2440,6316,2102,5910,257,619,1405,4457,1662,5076
150277,202107,5352,13587,4257,12312,381,1006,3147,9752,3528,10758
150280,202107,7207,28031,6951,27625,395,1471,6051,24359,6446,25830
150285,202107,3331,11545,2925,10909,241,865,2145,8235,2386,9100
150290,202107,10529,28165,9493,27059,346,626,8531,25063,8877,25689
150293,202107,9676,23228,7510,20432,1076,2821,4607,13252,5683,16073
150295,202107,7831,20634,5664,17658,1807,5979,1875,6849,3682,12828
150300,202107,2442,7106,2209,6819,34,116,2037,6327,2071,6443
150304,202107,4388,12537,3624,11378,613,1738,2279,7634,2892,9372
150307,202107,6178,19424,5679,18603,273,890,4592,15176,4865,16066
150309,202107,6615,18935,5321,16764,876,2697,3064,10135,3940,12832
150310,202107,7519,29385,7180,28989,195,1006,6430,26245,6625,27251
150320,202107,9437,25454,8611,24258,366,1070,6735,18941,7101,20011
150330,202107,14148,44183,13067,42537,1248,3608,9817,33346,11065,36954
150340,202107,2602,7500,2310,7066,345,978,1588,5032,1933,6010
150345,202107,8719,24304,7831,23142,420,1288,6750,20002,7170,21290
150350,202107,9233,22806,8446,21789,673,1181,6995,18597,7668,19778
150360,202107,24705,66059,19720,59840,2214,4917,13797,45443,16011,50360
150370,202107,11428,33461,9384,30698,1067,2815,6782,24112,7849,26927
150375,202107,3798,15032,3441,14531,194,884,2996,12807,3190,13691
150380,202107,11569,28746,9547,26108,110,402,8513,23236,8623,23638
150390,202107,7861,30999,7040,29737,1080,3845,5019,22684,6099,26529
150400,202107,6849,23835,6560,23309,223,725,5822,20828,6045,21553
150405,202107,9442,24253,8238,22823,506,1000,6688,19197,7194,20197
150410,202107,2020,6106,1720,5602,270,708,1072,3714,1342,4422
150420,202107,40797,110141,31355,96444,8420,27075,11049,39743,19469,66818
150430,202107,8729,24608,7935,23593,901,1824,6193,19451,7094,21275
150440,202107,5973,18131,5406,17362,935,2623,3580,12273,4515,14896
150442,202107,28174,64141,23333,58262,2458,5809,16286,41554,18744,47363
150445,202107,6632,19645,5810,18429,201,613,5050,16098,5251,16711
150450,202107,5372,22142,4967,21605,380,1824,4203,18345,4583,20169
150460,202107,8533,27703,7770,26734,224,821,6703,23883,6927,24704
150470,202107,21465,55442,19150,52819,334,950,18063,49820,18397,50770
150475,202107,5269,15872,4506,14745,579,1660,3275,11179,3854,12839
150480,202107,14174,43895,12709,41758,2313,6395,8489,30175,10802,36570
150490,202107,8537,29309,7799,28390,340,1203,6754,24859,7094,26062
150495,202107,5524,18128,5266,17786,97,452,4827,16230,4924,16682
150497,202107,2862,8929,2304,7975,494,1740,1223,4555,1717,6295
150500,202107,3408,8490,3022,7949,281,678,2293,6034,2574,6712
150503,202107,5080,12712,3479,10641,987,3226,1098,3863,2085,7089
150506,202107,11009,31492,9203,29046,1903,5288,5691,20032,7594,25320
150510,202107,10019,35626,8690,33226,1371,4808,5575,22697,6946,27505
150520,202107,7751,28829,7434,28439,159,895,6804,25945,6963,26840
150530,202107,12478,41765,10757,39317,1313,3766,7891,30747,9204,34513
150540,202107,5178,13584,4438,12492,286,703,3682,10423,3968,11126
150543,202107,7276,19292,5959,17654,436,1250,4650,14436,5086,15686
150548,202107,10326,31800,9262,30329,225,879,8252,27133,8477,28012
150549,202107,2019,5779,1721,5361,47,154,1443,4543,1490,4697
150550,202107,21515,61449,17833,55473,4603,14383,7211,24163,11814,38546
150553,202107,33727,92109,26743,80091,7572,22776,10432,32671,18004,55447
150555,202107,2061,5320,1615,4624,191,418,1079,3288,1270,3706
150560,202107,1981,5756,1761,5345,309,853,1014,3236,1323,4089
150563,202107,2692,7833,2224,7034,429,1374,1245,4014,1674,5388
150565,202107,4655,14434,4157,13661,94,385,3490,11557,3584,11942
150570,202107,6719,20213,6265,19602,410,1091,5298,16900,5708,17991
150580,202107,10711,41129,9135,39380,555,2750,7306,33086,7861,35836
150590,202107,8473,28581,7250,27129,145,840,6652,24841,6797,25681
150600,202107,9765,31860,9087,31050,206,793,8456,29058,8662,29851
150610,202107,2989,8380,2668,7885,101,337,2270,6663,2371,7000
150611,202107,3410,9110,3043,8617,99,306,2700,7624,2799,7930
150613,202107,14179,37774,10726,32051,1910,6023,5411,16078,7321,22101
150616,202107,3703,10028,2691,8330,585,1872,1166,3621,1751,5493
150618,202107,7199,20149,5867,18130,569,1701,3708,12085,4277,13786
150619,202107,6957,18689,5741,17025,262,623,4820,14571,5082,15194
150620,202107,6928,22597,5962,20990,644,2096,4041,14736,4685,16832
150630,202107,6703,17226,6127,16528,303,752,5338,14457,5641,15209
150635,202107,5098,13608,4272,12297,591,1560,2761,8182,3352,9742
150640,202107,2307,6719,2104,6464,39,100,1963,6108,2002,6208
150650,202107,11788,31662,10199,29168,2866,7766,4476,14094,7342,21860
150655,202107,5784,16443,5236,15645,193,569,4559,13656,4752,14225
150658,202107,4640,12974,3585,11301,684,2245,1873,6232,2557,8477
150660,202107,5951,16467,5272,15533,614,1653,3586,10864,4200,12517
150670,202107,9305,20507,7408,18370,698,1293,5966,15605,6664,16898
150680,202107,71932,204526,55573,178942,13287,41482,24099,88753,37386,130235
150690,202107,2870,6864,2463,6406,95,177,2178,5823,2273,6000
150700,202107,6219,18014,5549,17152,381,893,4385,14066,4766,14959
150710,202107,3835,12588,3474,12021,296,965,2616,9287,2912,10252
150715,202107,5185,14324,4247,12917,286,768,3373,10476,3659,11244
150720,202107,6997,24148,6505,23421,434,1524,5404,19844,5838,21368
150730,202107,12728,37383,10861,34702,1189,3883,8122,26677,9311,30560
150740,202107,4178,11272,3655,10461,324,759,2743,8076,3067,8835
150745,202107,5179,14298,4160,12821,662,2095,2827,8909,3489,11004
150746,202107,1800,5106,1628,4870,74,167,1365,4156,1439,4323
150747,202107,5181,15479,4587,14562,691,1826,3155,10631,3846,12457
150750,202107,3841,11680,3208,10708,219,765,2457,8461,2676,9226
150760,202107,11986,34735,10853,33151,1558,4218,7532,23996,9090,28214
150770,202107,6754,23357,6313,22866,215,522,5734,21518,5949,22040
150775,202107,1040,2753,822,2477,129,416,495,1502,624,1918
150780,202107,4565,13758,4051,13149,151,396,3647,12173,3798,12569
150790,202107,6130,16578,5264,15647,299,722,3856,13259,4155,13981
150795,202107,14985,44152,12985,41148,2992,8880,7414,25053,10406,33933
150796,202107,4026,9461,3504,8866,238,482,2934,7622,3172,8104
150797,202107,4264,12564,3683,11763,179,399,3097,10192,3276,10591
150800,202107,13711,42058,12308,40208,1567,4696,9046,30798,10613,35494
150803,202107,7605,22933,7092,22158,434,1075,6047,19254,6481,20329
150805,202107,3674,10893,3119,10103,278,828,2352,7850,2630,8678
150808,202107,6281,17605,4625,14877,1695,6001,698,2613,2393,8614
150810,202107,21489,54634,16301,48414,3220,9710,8252,27577,11472,37287
150812,202107,5762,15511,5078,14420,429,1288,3851,10737,4280,12025
150815,202107,10068,28486,8405,26538,673,2009,6933,22346,7606,24355
150820,202107,12162,32424,10319,30150,1192,2803,7696,23944,8888,26747
150830,202107,12496,43731,11557,42593,487,1745,9874,37922,10361,39667
150835,202107,2643,8152,2272,7560,330,1089,1465,4914,1795,6003
150840,202107,8021,21747,6471,19340,1007,3310,3747,11045,4754,14355
160005,202107,1248,3295,1100,3112,66,215,930,2649,996,2864
160010,202107,2473,6513,2305,6331,19,98,2235,6074,2254,6172
160015,202107,2933,8216,2595,7810,70,210,2394,7255,2464,7465
160020,202107,2196,6743,1914,6392,168,471,1478,5196,1646,5667
160021,202107,1274,4595,1174,4471,52,263,936,3633,988,3896
160023,202107,1365,4582,1206,4314,154,501,812,3115,966,3616
160025,202107,1855,5551,1743,5425,13,42,1688,5269,1701,5311
160027,202107,8949,24703,7975,23462,698,1899,6318,19039,7016,20938
160030,202107,79515,217357,64519,197182,13603,38831,33808,114824,47411,153655
160040,202107,5987,19739,5460,19080,76,303,5119,18026,5195,18329
160050,202107,5033,14586,3933,13144,1448,4638,1392,5882,2840,10520
160053,202107,4033,11968,3631,11475,297,787,2916,9655,3213,10442
160055,202107,966,2741,932,2703,29,86,857,2506,886,2592
160060,202107,26847,67147,21936,61620,1434,3695,16887,50422,18321,54117
160070,202107,2665,9947,2376,9504,202,751,1859,7759,2061,8510
160080,202107,3426,10568,3029,10124,23,125,2856,9608,2879,9733
170025,202107,667,1693,482,1414,87,237,240,768,327,1005
170030,202107,1297,3790,1005,3289,165,499,461,1576,626,2075
170035,202107,1509,3826,1108,3205,77,239,716,2060,793,2299
170040,202107,1978,5361,1573,4787,104,338,1009,3149,1113,3487
170070,202107,1968,4518,1403,3801,91,274,830,2362,921,2636
170100,202107,2500,7020,2070,6316,246,651,1268,4039,1514,4690
170105,202107,739,2083,513,1606,150,430,152,502,302,932
170110,202107,1020,2959,790,2540,102,341,433,1346,535,1687
170130,202107,1331,3827,970,3148,170,586,490,1592,660,2178
170190,202107,1473,3985,1093,3386,301,1027,326,1077,627,2104
170200,202107,2119,4934,1398,3772,216,578,556,1516,772,2094
170210,202107,26183,69301,19854,58830,6045,19538,2999,9702,9044,29240
170215,202107,1363,3567,1091,3194,43,174,872,2543,915,2717
170220,202107,6040,18195,5026,16369,1387,4347,1802,6675,3189,11022
170230,202107,1273,3635,939,2987,270,884,164,565,434,1449
170240,202107,2690,7304,2146,6439,138,439,1558,4602,1696,5041
170255,202107,4079,11454,2957,9477,614,1927,1248,4166,1862,6093
170270,202107,963,2307,655,1860,59,155,375,1063,434,1218
170290,202107,2964,8533,2575,8017,150,406,2008,6495,2158,6901
170300,202107,2101,5491,1700,4894,196,496,1151,3421,1347,3917
170305,202107,680,1799,574,1631,82,230,288,845,370,1075
170307,202107,995,3221,815,2887,98,346,474,1702,572,2048
170310,202107,1635,4001,1169,3276,169,498,562,1606,731,2104
170320,202107,1069,2738,803,2312,79,232,504,1491,583,1723
170330,202107,939,2809,849,2678,42,173,706,2170,748,2343
170360,202107,563,1460,399,1202,22,76,270,765,292,841
170370,202107,1298,3367,938,2769,255,717,281,911,536,1628
170380,202107,1894,5269,1435,4563,86,288,837,2771,923,3059
170382,202107,564,1631,471,1478,28,116,354,1070,382,1186
170384,202107,1658,5631,1363,5081,278,1003,688,2698,966,3701
170386,202107,1023,2736,637,2001,71,258,233,696,304,954
170388,202107,634,1739,446,1425,64,221,209,669,273,890
170389,202107,1077,3248,880,2919,52,192,631,2152,683,2344
170390,202107,1820,4026,1372,3493,32,72,1155,3015,1187,3087
170410,202107,605,1663,444,1379,22,86,294,878,316,964
170460,202107,397,1030,326,922,42,118,216,622,258,740
170510,202107,970,2642,710,2195,42,152,456,1310,498,1462
170550,202107,6750,17526,4976,14700,1349,4292,1057,3387,2406,7679
170555,202107,1447,3783,1139,3309,98,263,537,1671,635,1934
170560,202107,1066,2888,813,2540,74,208,509,1709,583,1917
170600,202107,1326,3508,1074,3153,282,702,488,1623,770,2325
170610,202107,1638,4222,1189,3551,85,263,738,2190,823,2453
170625,202107,444,1156,297,869,42,110,115,331,157,441
170650,202107,1268,3662,1006,3231,114,380,617,2020,731,2400
170700,202107,3476,10072,2624,8436,514,1653,1144,3731,1658,5384
170710,202107,1512,3859,1180,3346,168,479,713,2059,881,2538
170720,202107,1791,4410,1365,3729,318,857,646,1831,964,2688
170730,202107,1121,2948,844,2494,128,305,456,1437,584,1742
170740,202107,2156,6912,1860,6380,163,620,1335,4562,1498,5182
170755,202107,910,2419,639,1972,93,295,259,807,352,1102
170765,202107,1171,2988,828,2445,150,435,346,1082,496,1517
170770,202107,1937,5358,1568,4796,149,466,1064,3281,1213,3747
170820,202107,3442,10139,2695,8793,539,1767,1220,4189,1759,5956
170825,202107,1045,2371,857,2128,101,226,618,1557,719,1783
170830,202107,1417,3703,1156,3301,235,608,683,2054,918,2662
170900,202107,2838,8642,2392,8002,217,609,1869,6443,2086,7052
170930,202107,3846,10351,2932,8657,669,2098,911,2725,1580,4823
170950,202107,11495,31224,8029,25027,2122,7558,865,2956,2987,10514
170980,202107,479,1242,371,1066,33,101,242,676,275,777
171050,202107,1686,5175,1465,4800,53,229,1216,3959,1269,4188
171070,202107,1388,3837,1193,3553,322,892,514,1839,836,2731
171090,202107,1095,2678,859,2351,93,264,536,1443,629,1707
171110,202107,589,1553,414,1234,79,216,179,507,258,723
171150,202107,1085,2635,688,1968,72,233,425,1203,497,1436
171180,202107,799,2119,529,1612,103,286,224,691,327,977
171190,202107,1913,6152,1666,5726,258,917,1025,3648,1283,4565
171195,202107,818,2520,655,2214,72,280,410,1365,482,1645
171200,202107,632,1712,474,1454,113,374,169,510,282,884
171215,202107,395,1072,326,962,30,99,214,601,244,700
171240,202107,815,2587,646,2283,27,147,441,1528,468,1675
171245,202107,746,2107,584,1795,49,164,378,1121,427,1285
171250,202107,1021,2706,750,2297,137,443,350,1093,487,1536
171270,202107,507,1731,397,1497,92,350,161,656,253,1006
171280,202107,904,2638,727,2320,68,226,448,1468,516,1694
171320,202107,4123,11316,3220,9740,651,1844,1199,3893,1850,5737
171330,202107,2836,7682,2191,6540,515,1535,926,2891,1441,4426
171360,202107,1470,4115,1166,3669,95,286,823,2703,918,2989
171370,202107,729,1793,559,1556,46,122,391,1100,437,1222
171380,202107,1511,3980,1267,3650,153,415,844,2576,997,2991
171395,202107,1039,2722,720,2153,64,203,458,1336,522,1539
171420,202107,2035,5779,1478,4681,265,820,650,2137,915,2957
171430,202107,1092,3115,920,2799,50,151,642,1888,692,2039
171488,202107,2433,6928,1938,6125,313,1009,1010,3244,1323,4253
171500,202107,995,2456,745,2073,71,175,498,1409,569,1584
171510,202107,847,2652,734,2441,43,167,537,1770,580,1937
171515,202107,498,1225,375,1048,43,128,226,599,269,727
171525,202107,762,2029,578,1744,36,114,366,1078,402,1192
171550,202107,355,992,272,863,39,147,147,438,186,585
171570,202107,1150,3389,973,3084,131,401,575,1907,706,2308
171575,202107,1786,4759,1161,3649,130,422,506,1601,636,2023
171610,202107,5929,16145,4390,13521,885,3075,1108,3749,1993,6824
171620,202107,2666,7360,2266,6784,102,396,1872,5574,1974,5970
171630,202107,1060,2645,821,2324,85,233,580,1693,665,1926
171650,202107,2113,5845,1637,5065,398,1325,473,1646,871,2971
171660,202107,2431,5998,1681,4768,208,529,966,2780,1174,3309
171665,202107,1269,3506,1003,3075,184,620,479,1475,663,2095
171670,202107,1969,5162,1497,4382,231,717,733,2184,964,2901
171700,202107,1230,3393,899,2791,109,317,490,1542,599,1859
171720,202107,814,2052,644,1794,58,168,465,1282,523,1450
171750,202107,1358,3730,931,2929,216,714,128,496,344,1210
171780,202107,1251,3121,925,2655,80,245,645,1832,725,2077
171790,202107,1443,4546,1174,4003,176,592,568,1972,744,2564
171800,202107,741,1957,565,1704,66,229,323,963,389,1192
171820,202107,11815,32415,8767,27226,2103,6810,2358,8023,4461,14833
171830,202107,1608,4984,1373,4585,126,475,880,2962,1006,3437
171840,202107,788,2051,610,1776,21,62,397,1162,418,1224
171845,202107,668,1600,507,1366,46,166,331,855,377,1021
171850,202107,958,3045,811,2722,73,287,563,1849,636,2136
171855,202107,1084,3241,926,2949,58,170,602,1885,660,2055
171865,202107,441,1299,371,1189,58,189,201,613,259,802
171870,202107,846,2279,597,1830,74,209,307,959,381,1168
171875,202107,1345,3766,1085,3361,35,153,830,2536,865,2689
171880,202107,1244,3592,1091,3391,41,112,868,2770,909,2882
171884,202107,946,2634,703,2207,139,468,253,829,392,1297
171886,202107,1437,3787,1042,3165,280,971,227,703,507,1674
171888,202107,729,2005,505,1598,27,106,313,951,340,1057
171889,202107,413,1213,301,1004,70,256,111,356,181,612
171890,202107,1211,3341,884,2818,158,480,499,1606,657,2086
171900,202107,569,1896,433,1585,76,242,176,684,252,926
172000,202107,603,1733,504,1563,64,189,270,827,334,1016
172010,202107,1026,3431,885,3163,73,283,554,1987,627,2270
172015,202107,385,1287,288,1094,49,176,124,489,173,665
172020,202107,2871,7795,2516,7337,156,460,1853,5663,2009,6123
172025,202107,720,1959,538,1663,46,160,380,1168,426,1328
172030,202107,1282,3710,1079,3381,66,198,811,2543,877,2741
172049,202107,1353,3183,907,2572,183,456,438,1388,621,1844
172065,202107,1462,3655,1156,3267,96,203,916,2774,1012,2977
172080,202107,2397,6967,1948,6184,117,376,1297,4127,1414,4503
172085,202107,485,1302,313,944,60,174,110,312,170,486
172090,202107,4150,10147,3236,8948,136,350,2472,6947,2608,7297
172093,202107,481,1407,345,1163,20,96,203,651,223,747
172097,202107,702,1788,485,1414,63,188,213,609,276,797
172100,202107,50967,123134,36831,101292,6164,18375,13946,39132,20110,57507
172110,202107,1649,5813,1420,5459,111,446,1078,4273,1189,4719
172120,202107,5233,15024,4108,13189,514,1697,2274,7526,2788,9223
172125,202107,402,1068,309,921,24,79,187,530,211,609
172130,202107,639,1542,499,1314,18,67,357,866,375,933
172208,202107,2657,6270,2127,5590,239,465,1496,4116,1735,4581
172210,202107,2744,6790,2110,5987,290,881,1242,3717,1532,4598
210005,202107,19329,53925,14525,46094,4046,13297,5573,18575,9619,31872
210010,202107,1957,5966,1771,5744,73,282,1552,5064,1625,5346
210015,202107,3342,9838,2954,9336,150,441,2457,7827,2607,8268
210020,202107,7424,17391,6337,16127,92,263,5833,14912,5925,15175
210030,202107,4680,15331,4315,14782,317,1125,3560,12344,3877,13469
210040,202107,1950,4458,1734,4199,57,130,1478,3499,1535,3629
210043,202107,6086,17222,5177,15938,385,1163,4080,12743,4465,13906
210047,202107,6625,20300,5432,18721,134,651,4706,16248,4840,16899
210050,202107,2236,7378,1781,6539,196,736,1204,4513,1400,5249
210055,202107,1936,6081,1757,5809,54,199,1516,5040,1570,5239
210060,202107,7507,27072,6690,25640,730,2747,4552,18083,5282,20830
210070,202107,7195,19976,6692,19308,37,156,6349,18267,6386,18423
210080,202107,4320,14327,4104,14093,37,213,3797,13128,3834,13341
210083,202107,5732,16013,4774,14986,104,291,4449,14143,4553,14434
210087,202107,3027,8180,2600,7615,112,294,2156,6375,2268,6669
210090,202107,9245,28451,8642,27408,611,1437,7208,23321,7819,24758
210095,202107,6675,21084,6101,20359,302,1082,5086,17459,5388,18541
210100,202107,6772,20654,6011,19406,489,1565,4520,14764,5009,16329
210110,202107,2938,9257,2706,8976,55,284,2434,8054,2489,8338
210120,202107,23734,62941,19647,57703,1994,4482,13312,42073,15306,46555
210125,202107,4461,11932,3877,11243,778,1808,2625,8227,3403,10035
210130,202107,4382,11192,3635,10266,161,328,3082,8822,3243,9150
210135,202107,1598,4394,1339,3995,81,174,1090,3346,1171,3520
210140,202107,20035,51207,15473,45357,3047,8212,8464,26678,11511,34890
210150,202107,4446,10435,3954,9767,185,359,3340,8229,3525,8588
210160,202107,17386,48941,14961,45924,1343,4032,10576,34073,11919,38105
210170,202107,15740,47306,14639,45912,895,2189,12700,40614,13595,42803
210173,202107,2310,8768,2161,8512,96,549,1866,7280,1962,7829
210177,202107,3511,9562,3044,8982,250,604,2503,7713,2753,8317
210180,202107,1446,3816,1256,3587,24,63,1140,3268,1164,3331
210190,202107,5508,14428,4654,13284,85,279,4005,11344,4090,11623
210193,202107,1377,3921,1206,3651,37,112,887,2754,924,2866
210197,202107,2142,6489,1970,6256,154,442,1619,5271,1773,5713
210200,202107,7899,24937,7027,23513,404,1433,5591,18755,5995,20188
210203,202107,7162,20877,6084,19443,345,1107,4901,16013,5246,17120
210207,202107,4011,9587,3096,8589,162,324,2557,7294,2719,7618
210210,202107,8058,25714,7348,24720,141,787,6305,21059,6446,21846
210215,202107,2539,7922,2177,7384,114,543,1635,5482,1749,6025
210220,202107,6264,21327,5902,20794,139,923,5219,18047,5358,18970
210230,202107,5363,15695,4872,14968,498,1195,3971,12603,4469,13798
210232,202107,11495,35172,9433,32036,1765,5808,5599,20560,7364,26368
210235,202107,3410,10251,3009,9670,155,571,2516,8122,2671,8693
210237,202107,3088,9559,2657,9048,27,134,2477,8444,2504,8578
210240,202107,2631,8081,2424,7738,70,228,2026,6383,2096,6611
210250,202107,5962,17590,5431,16925,62,331,4975,15472,5037,15803
210255,202107,2645,7896,2257,7230,264,842,1498,4785,1762,5627
210260,202107,5535,16276,4871,15312,276,865,4096,12949,4372,13814
210270,202107,5083,13705,4537,13016,83,346,4080,11618,4163,11964
210275,202107,3487,8813,3033,8250,97,251,2506,6827,2603,7078
210280,202107,5778,15995,4658,14304,247,889,3519,10677,3766,11566
210290,202107,7572,19482,6782,18506,108,302,6346,17357,6454,17659
210300,202107,32695,88857,26723,80277,2653,8284,17623,55455,20276,63739
210310,202107,3164,7897,2792,7357,119,244,2445,6515,2564,6759
210312,202107,2834,6905,2527,6577,20,76,2410,6240,2430,6316
210315,202107,3086,8416,2659,7939,94,243,2337,7163,2431,7406
210317,202107,4220,13080,3812,12601,93,452,3434,11302,3527,11754
210320,202107,19418,57099,17762,54945,355,1507,15834,48837,16189,50344
210325,202107,3719,10364,3182,9671,116,324,2745,8589,2861,8913
210330,202107,24598,67586,19724,61421,5182,14349,10227,36431,15409,50780
210340,202107,10419,29634,9279,28128,705,1980,7195,22450,7900,24430
210350,202107,9150,26069,8045,24729,128,420,7212,22292,7340,22712
210355,202107,4288,14010,3793,13239,96,443,3220,11313,3316,11756
210360,202107,14118,42921,12568,40659,517,2171,9578,30491,10095,32662
210370,202107,11140,24601,8604,21931,250,407,7855,20515,8105,20922
210375,202107,3297,8660,2496,7537,736,2342,871,2913,1607,5255
210380,202107,5512,13896,4746,12985,262,621,4002,11077,4264,11698
210390,202107,2811,9143,2606,8798,109,442,2247,7553,2356,7995
210400,202107,4541,13601,4023,12987,127,369,3575,11765,3702,12134
210405,202107,7033,18476,5694,16600,1124,2911,3160,9991,4284,12902
210407,202107,2070,6586,1754,6042,75,285,1390,4753,1465,5038
210408,202107,2657,9603,2485,9357,147,634,1979,7510,2126,8144
210409,202107,3919,13142,3563,12655,99,491,2982,10727,3081,11218
210410,202107,3581,10451,3054,9593,130,470,2434,7556,2564,8026
210420,202107,3902,12201,3506,11498,207,578,2926,9757,3133,10335
210430,202107,2276,6611,2016,6276,106,285,1699,5394,1805,5679
210440,202107,4442,11761,3854,11026,80,230,3500,9988,3580,10218
210450,202107,2389,6998,2057,6526,104,329,1680,5340,1784,5669
210455,202107,4538,11596,3449,10221,922,2753,1619,5111,2541,7864
210460,202107,3799,10683,3216,9927,61,226,2815,8676,2876,8902
210462,202107,1728,5096,1464,4671,42,152,1176,3784,1218,3936
210465,202107,2763,7938,2404,7435,79,351,1943,5880,2022,6231
210467,202107,5995,18635,5226,17642,294,1039,4329,14866,4623,15905
210470,202107,2004,5280,1490,4548,111,245,1113,3566,1224,3811
210480,202107,16876,48371,13998,44841,1304,3452,10056,35347,11360,38799
210490,202107,3688,9125,2988,8174,67,166,2550,6969,2617,7135
210500,202107,6425,24196,5914,23339,397,1776,4839,19049,5236,20825
210510,202107,5952,19392,5192,18575,105,471,4671,16943,4776,17414
210515,202107,3769,10997,3266,10416,191,640,2656,8701,2847,9341
210520,202107,2540,7296,2278,6953,67,240,1943,5872,2010,6112
210530,202107,52444,127899,40502,110392,6784,21831,12106,40296,18890,62127
210535,202107,3390,10857,3122,10463,134,461,2647,8955,2781,9416
210540,202107,15140,42539,12599,39013,1600,4342,8657,28378,10257,32720
210542,202107,6810,15481,5390,13923,520,1014,4184,11567,4704,12581
210545,202107,2256,6896,2127,6693,38,151,1898,5916,1936,6067
210547,202107,3639,12766,3241,12028,263,938,2485,9441,2748,10379
210550,202107,6106,18262,4811,16197,331,1245,3385,11731,3716,12976
210560,202107,3800,11275,3366,10583,130,367,2826,8873,2956,9240
210565,202107,1500,4721,1252,4366,57,291,970,3395,1027,3686
210570,202107,10691,28733,9502,27287,306,775,8289,24363,8595,25138
210580,202107,3034,7998,2429,7209,143,343,1640,5132,1783,5475
210590,202107,4345,12812,3779,12096,61,313,3381,10778,3442,11091
210592,202107,2675,7774,2443,7404,21,96,2109,6332,2130,6428
210594,202107,2549,6777,1961,5865,106,308,1447,4494,1553,4802
210596,202107,2706,9254,2422,8735,169,563,1923,7080,2092,7643
210598,202107,1876,5288,1733,5075,55,165,1530,4463,1585,4628
210600,202107,3092,8186,2539,7403,146,377,1873,5559,2019,5936
210610,202107,2840,7654,2435,7170,56,211,2098,6179,2154,6390
210620,202107,2894,7445,2390,6830,76,192,2126,6133,2202,6325
210630,202107,3109,10136,2839,9684,108,471,2348,7931,2456,8402
210632,202107,4542,13990,4039,13276,219,867,3237,10570,3456,11437
210635,202107,1748,6149,1656,5989,100,331,1354,5012,1454,5343
210637,202107,2567,8331,2214,7825,132,564,1658,5986,1790,6550
210640,202107,4627,16252,4339,15923,58,265,3983,14668,4041,14933
210650,202107,7514,21144,6816,20245,141,412,6098,18199,6239,18611
210660,202107,8210,23990,7334,22576,249,1001,6227,18835,6476,19836
210663,202107,2758,7640,2517,7359,180,356,2045,6301,2225,6657
210667,202107,2018,6405,1809,6097,66,221,1591,5456,1657,5677
210670,202107,4985,16157,4532,15451,114,484,3999,13623,4113,14107
210675,202107,5188,13757,4436,12803,340,774,3524,10630,3864,11404
210680,202107,4741,11243,4003,10381,96,159,3637,9556,3733,9715
210690,202107,7658,23215,6388,21811,237,948,5611,19415,5848,20363
210700,202107,2810,7734,2218,6871,158,418,1582,5133,1740,5551
210710,202107,5038,15273,4447,14458,100,496,3946,12690,4046,13186
210720,202107,3103,9797,2749,9355,57,314,2440,8241,2497,8555
210725,202107,1317,4308,1140,4034,47,164,790,2921,837,3085
210730,202107,1222,3101,1031,2835,48,121,886,2431,934,2552
210735,202107,4795,13611,4089,12703,207,535,3481,11162,3688,11697
210740,202107,5300,13723,4571,12884,87,227,3919,11081,4006,11308
210745,202107,4468,12026,4145,11616,111,285,3754,10504,3865,10789
210750,202107,23761,60405,20590,56383,2315,5518,13836,40428,16151,45946
210760,202107,5990,15563,5047,14563,69,149,4751,13894,4820,14043
210770,202107,6211,15726,5369,14755,55,219,5064,13853,5119,14072
210780,202107,7647,23384,6658,21755,635,1733,5075,16996,5710,18729
210790,202107,4366,13579,3940,13030,216,473,3227,11232,3443,11705
210800,202107,4916,13053,4214,12126,87,326,3741,10673,3828,10999
210805,202107,4048,14341,3855,14062,119,559,3394,12376,3513,12935
210810,202107,4909,14129,4479,13572,337,775,3635,11428,3972,12203
210820,202107,7010,19751,5879,17954,701,2148,3477,11022,4178,13170
210825,202107,6931,20947,6248,20044,314,866,5302,17405,5616,18271
210830,202107,7980,21941,7262,21093,350,807,6336,18828,6686,19635
210840,202107,3181,8323,2865,7912,42,125,2562,7010,2604,7135
210845,202107,6527,17380,5824,16612,40,134,5550,15960,5590,16094
210850,202107,5927,19659,4913,18133,225,1041,3891,14408,4116,15449
210860,202107,21736,53919,18074,49409,1150,2638,14153,40961,15303,43599
210870,202107,7577,19110,6042,17367,219,493,5313,15458,5532,15951
210880,202107,4267,12901,3819,12350,193,683,3032,9842,3225,10525
210890,202107,3959,11274,3572,10826,361,879,2753,8723,3114,9602
210900,202107,4710,13383,3663,11469,1453,4895,514,1882,1967,6777
210905,202107,2050,5473,1712,5045,52,94,1551,4692,1603,4786
210910,202107,7177,21454,5937,19454,707,2348,3921,12977,4628,15325
210920,202107,3206,10445,2782,9885,67,377,2491,8763,2558,9140
210923,202107,1625,4622,1379,4235,84,236,1014,3140,1098,3376
210927,202107,5160,16330,4518,15561,467,1518,3356,12050,3823,13568
210930,202107,2477,8305,2172,7718,147,530,1653,5879,1800,6409
210940,202107,4079,11365,3790,11031,106,410,3477,10012,3583,10422
210945,202107,6917,19204,6193,18354,256,667,5187,15841,5443,16508
210950,202107,5271,14398,4051,12711,584,1374,2658,9188,3242,10562
210955,202107,1577,4793,1360,4440,333,1024,712,2500,1045,3524
210960,202107,9129,26541,7913,24717,1498,4306,4937,16325,6435,20631
210970,202107,1392,4122,1120,3664,91,265,837,2728,928,2993
210975,202107,1813,5484,1635,5202,94,307,1303,4180,1397,4487
210980,202107,10019,23291,8778,22006,103,238,8271,20860,8374,21098
210990,202107,16766,45775,13029,40909,718,2241,9581,31373,10299,33614
211000,202107,14895,42308,12416,39239,1061,3047,9254,30845,10315,33892
211003,202107,5804,16780,4856,15631,126,471,4192,13821,4318,14292
211010,202107,6460,22470,5764,21576,112,513,5134,19510,5246,20023
211020,202107,8271,23511,7160,22243,245,817,6074,19486,6319,20303
211023,202107,2051,6493,1904,6307,97,309,1600,5309,1697,5618
211027,202107,3204,9844,3038,9590,234,587,2556,8264,2790,8851
211030,202107,3877,10520,3466,10014,270,657,2727,8156,2997,8813
211040,202107,4764,16641,4416,16051,105,614,3976,14337,4081,14951
211050,202107,9100,23378,8285,22318,80,282,7612,20498,7692,20780
211060,202107,6965,20888,6324,20019,164,642,5575,17652,5739,18294
211065,202107,2335,6213,1945,5730,83,209,1615,4874,1698,5083
211070,202107,8257,24924,7065,23157,504,1543,5638,18727,6142,20270
211080,202107,1334,3608,1071,3193,31,159,851,2411,882,2570
211085,202107,2134,5788,1808,5351,97,202,1505,4684,1602,4886
211090,202107,3180,8695,2860,8333,30,138,2654,7711,2684,7849
211100,202107,6834,17061,6311,16439,37,120,5878,15407,5915,15527
211102,202107,3241,10578,2965,10170,192,770,2470,8395,2662,9165
211105,202107,2422,7416,2023,6716,148,499,1469,4841,1617,5340
211107,202107,4914,15102,4173,14012,155,592,3258,11461,3413,12053
211110,202107,6151,16260,4818,14235,359,971,3591,10788,3950,11759
211120,202107,45411,109332,37199,99750,5807,14035,23277,67085,29084,81120
211125,202107,2099,6182,1774,5683,46,152,1499,4829,1545,4981
211130,202107,181858,427210,155493,393309,24040,55666,78421,223079,102461,278745
211140,202107,5089,14660,4459,13866,233,580,3730,11779,3963,12359
211150,202107,9616,25501,8089,23536,375,918,6754,19920,7129,20838
211153,202107,2462,7096,1966,6482,281,918,1265,4399,1546,5317
211157,202107,1179,3630,987,3283,32,132,720,2394,752,2526
211160,202107,4354,11827,3428,10524,132,451,2628,7975,2760,8426
211163,202107,1603,5111,1453,4892,40,165,1280,4333,1320,4498
211167,202107,1613,4897,1505,4740,28,95,1386,4362,1414,4457
211170,202107,6563,15879,6092,15340,72,143,5762,14496,5834,14639
211172,202107,2627,6986,2265,6450,99,281,1816,5072,1915,5353
211174,202107,2901,8279,2626,7972,29,145,2469,7461,2498,7606
211176,202107,4316,12028,3371,10640,151,612,2726,8565,2877,9177
211178,202107,5101,11193,4373,10421,19,78,4221,9985,4240,10063
211180,202107,4118,13384,3811,12937,213,739,3126,10695,3339,11434
211190,202107,3116,9020,2648,8333,31,168,2369,7397,2400,7565
211195,202107,1437,3938,1226,3619,129,245,955,2977,1084,3222
211200,202107,2205,6207,1766,5587,207,584,1207,3904,1414,4488
211210,202107,6335,19170,5715,18349,326,1164,4717,15124,5043,16288
211220,202107,38552,94903,31792,86655,3453,8404,23079,64931,26532,73335
211223,202107,5388,13946,4427,12666,409,1100,3163,9156,3572,10256
211227,202107,1773,5684,1589,5420,61,258,1242,4286,1303,4544
211230,202107,7964,22142,6993,20681,380,855,5728,17368,6108,18223
211240,202107,8044,25129,7631,24601,205,844,7006,22452,7211,23296
211245,202107,7107,17677,6301,16830,80,199,6070,16210,6150,16409
211250,202107,13380,41435,12093,39633,883,2966,9568,31520,10451,34486
211260,202107,8182,26014,7274,24819,228,915,6461,22225,6689,23140
211270,202107,10362,32647,8851,30623,353,1593,7173,25070,7526,26663
211280,202107,12509,33856,11241,32259,840,1929,9274,27631,10114,29560
211285,202107,1903,6001,1699,5723,132,459,1283,4446,1415,4905
211290,202107,7614,22432,6882,21469,218,737,5885,18418,6103,19155
211300,202107,7823,22263,6863,20713,263,808,5594,16713,5857,17521
211400,202107,11853,32654,9705,29728,1061,3143,6444,20920,7505,24063
220005,202107,1909,4788,1735,4552,35,106,1487,3837,1522,3943
220010,202107,1501,4222,1234,3749,22,91,956,2882,978,2973
220020,202107,3891,10261,3328,9486,132,421,2772,7861,2904,8282
220025,202107,2254,5055,1937,4598,30,69,1612,3722,1642,3791
220027,202107,1322,3231,1129,2973,20,62,973,2523,993,2585
220030,202107,3445,8467,3221,8175,93,224,2815,7080,2908,7304
220040,202107,7379,21892,6468,20181,1558,4409,3256,10826,4814,15235
220045,202107,1512,4499,1251,4072,23,116,1043,3344,1066,3460
220050,202107,4769,12769,4058,11855,55,261,3737,10799,3792,11060
220060,202107,2441,5031,2088,4624,27,63,1977,4368,2004,4431
220070,202107,2472,6106,2109,5580,76,132,1758,4677,1834,4809
220080,202107,754,2102,651,1955,20,62,557,1672,577,1734
220090,202107,1778,4217,1494,3812,13,39,1232,3264,1245,3303
220095,202107,666,1600,623,1556,40,67,545,1399,585,1466
220100,202107,1454,3855,1173,3416,42,134,954,2696,996,2830
220105,202107,2104,6305,1848,5822,112,364,1407,4431,1519,4795
220110,202107,3432,9414,3134,8913,34,166,2811,7891,2845,8057
220115,202107,2790,7865,2574,7586,80,227,2328,6850,2408,7077
220117,202107,1456,3383,1154,2971,5,22,974,2455,979,2477
220120,202107,13358,34787,12232,33400,77,237,11491,31346,11568,31583
220130,202107,1163,2996,987,2755,8,40,897,2463,905,2503
220140,202107,2176,4424,1845,4040,96,228,1617,3515,1713,3743
220150,202107,6548,18860,5975,17879,116,467,5081,14989,5197,15456
220155,202107,1223,3415,979,2979,38,107,703,2111,741,2218
220157,202107,1086,2596,919,2343,23,68,732,1816,755,1884
220160,202107,2918,7930,2510,7197,33,128,2050,5761,2083,5889
220170,202107,1659,4239,1418,3885,17,77,1260,3407,1277,3484
220173,202107,2261,6089,1748,5156,45,130,1426,4102,1471,4232
220177,202107,2062,5719,1959,5605,8,27,1935,5532,1943,5559
220180,202107,1144,2701,928,2344,5,19,738,1752,743,1771
220190,202107,7184,17479,6133,16047,356,927,4685,12563,5041,13490
220191,202107,1626,4741,1477,4494,78,253,1051,3164,1129,3417
220192,202107,2113,5468,1554,4488,27,79,1257,3589,1284,3668
220194,202107,1753,4905,1559,4596,49,178,1290,3767,1339,3945
220196,202107,2088,5284,1899,5003,32,119,1653,4285,1685,4404
220198,202107,1296,3492,1102,3241,7,16,1019,3033,1026,3049
220200,202107,5280,15025,4611,14157,71,284,3981,12234,4052,12518
220202,202107,2208,6128,1897,5626,22,107,1633,4761,1655,4868
220205,202107,2550,7207,2278,6707,50,185,1933,5610,1983,5795
220207,202107,791,2354,661,2132,57,190,441,1438,498,1628
220208,202107,1738,5167,1450,4636,172,589,877,2778,1049,3367
220209,202107,1609,4531,1402,4165,26,97,1157,3400,1183,3497
220210,202107,1823,4298,1585,3936,11,43,1389,3358,1400,3401
220211,202107,1672,4128,1532,3939,16,55,1339,3449,1355,3504
220213,202107,1851,4787,1601,4364,18,58,1308,3471,1326,3529
220217,202107,2312,6547,2169,6382,48,85,2009,6035,2057,6120
220220,202107,10928,27608,9149,24973,653,1464,6206,17908,6859,19372
220225,202107,1006,2628,826,2394,4,27,778,2229,782,2256
220230,202107,5699,14099,4879,12967,154,341,4204,11274,4358,11615
220240,202107,3107,8782,2818,8309,110,358,2325,6819,2435,7177
220245,202107,1835,4117,1401,3589,13,50,1275,3297,1288,3347
220250,202107,3040,8326,2672,7862,12,56,2502,7338,2514,7394
220253,202107,1630,4317,1466,4046,57,167,1242,3369,1299,3536
220255,202107,2001,4569,1723,4188,30,125,1505,3540,1535,3665
220260,202107,4556,13437,3987,12417,171,563,3143,9782,3314,10345
220265,202107,1388,4249,1253,4081,31,145,1061,3392,1092,3537
220270,202107,6053,19341,5729,18759,181,852,4798,15241,4979,16093
220271,202107,1512,3837,1323,3572,23,70,1158,3110,1181,3180
220272,202107,1781,5054,1588,4702,47,136,1199,3467,1246,3603
220273,202107,1278,3564,1070,3186,40,154,825,2406,865,2560
220275,202107,2363,5386,1883,4737,37,57,1663,4222,1700,4279
220277,202107,2242,5466,1918,5008,42,97,1603,4133,1645,4230
220280,202107,1711,3888,1421,3518,17,53,1218,2995,1235,3048
220285,202107,1477,3649,1270,3406,9,34,1180,3145,1189,3179
220290,202107,6823,18459,5423,16497,338,1044,3979,12478,4317,13522
220300,202107,2038,5719,1663,5231,31,153,1399,4377,1430,4530
220310,202107,3103,8109,2451,7355,36,162,2092,6251,2128,6413
220320,202107,3140,8945,2428,7641,58,269,1905,5841,1963,6110
220323,202107,1682,4744,1313,4167,55,171,1075,3367,1130,3538
220325,202107,1263,3686,1091,3404,24,112,909,2781,933,2893
220327,202107,1619,4398,1415,4078,33,129,1173,3289,1206,3418
220330,202107,4682,10868,3985,10032,56,174,3610,9038,3666,9212
220335,202107,1690,5028,1525,4809,31,91,1360,4319,1391,4410
220340,202107,1938,4986,1499,4264,54,157,1019,2820,1073,2977
220342,202107,1209,3435,1081,3242,56,170,850,2548,906,2718
220345,202107,3176,7033,2438,5995,17,45,2209,5419,2226,5464
220350,202107,3392,8441,2721,7460,136,355,1942,5394,2078,5749
220360,202107,1249,3167,990,2738,16,43,791,2179,807,2222
220370,202107,8770,24998,7991,23761,162,572,6919,20413,7081,20985
220375,202107,1656,4602,1476,4383,2,7,1408,4206,1410,4213
220380,202107,1522,3532,1256,3168,14,32,1106,2778,1120,2810
220385,202107,858,2001,707,1742,6,15,617,1506,623,1521
220390,202107,10812,27125,8344,23392,2022,5483,3024,9475,5046,14958
220400,202107,1559,3604,1195,3047,23,70,921,2262,944,2332
220410,202107,1195,3231,981,2865,45,120,799,2316,844,2436
220415,202107,844,2123,711,1909,24,59,570,1516,594,1575
220420,202107,2056,5623,1666,4895,59,162,1264,3664,1323,3826
220430,202107,2641,6738,2434,6447,55,165,2134,5576,2189,5741
220435,202107,1822,4601,1567,4230,40,124,1313,3471,1353,3595
220440,202107,2411,7342,2045,6785,71,319,1755,5720,1826,6039
220450,202107,2545,6516,2066,5923,50,159,1775,5105,1825,5264
220455,202107,1315,4007,1254,3921,6,35,1132,3534,1138,3569
220460,202107,1034,2473,963,2386,31,68,831,2044,862,2112
220465,202107,2421,7259,2131,6812,181,526,1580,5197,1761,5723
220470,202107,3643,9796,3294,9244,130,289,2671,7462,2801,7751
220480,202107,2895,7249,2337,6374,241,492,1500,4203,1741,4695
220490,202107,2524,6190,2186,5770,25,115,1905,4959,1930,5074
220500,202107,3087,7514,2679,6891,98,215,2100,5347,2198,5562
220510,202107,2658,7211,2136,6288,81,200,1693,5042,1774,5242
220515,202107,1703,4015,1578,3840,40,64,1372,3341,1412,3405
220520,202107,5083,12945,4604,12274,92,243,4012,10659,4104,10902
220525,202107,1449,3492,1253,3250,8,35,1152,2973,1160,3008
220527,202107,1335,3616,1155,3359,16,61,993,2930,1009,2991
220530,202107,1440,3532,1251,3290,30,87,1143,2994,1173,3081
220535,202107,811,2177,759,2107,30,75,613,1706,643,1781
220540,202107,3275,10231,3060,9821,134,444,2580,8265,2714,8709
220545,202107,1484,4302,1378,4136,57,217,1169,3463,1226,3680
220550,202107,8774,26545,7820,24878,455,1492,5960,18822,6415,20314
220551,202107,1443,3949,1282,3693,27,96,1049,2971,1076,3067
220552,202107,1680,4725,1377,4190,19,99,1119,3301,1138,3400
220553,202107,1810,4535,1491,4113,57,97,1220,3489,1277,3586
220554,202107,936,2349,690,1958,53,122,464,1312,517,1434
220555,202107,2566,7054,2226,6629,33,118,1861,5709,1894,5827
220556,202107,1230,3479,1073,3183,39,152,797,2284,836,2436
220557,202107,1740,5154,1449,4516,92,321,1042,3167,1134,3488
220558,202107,1423,3656,1121,3234,17,66,967,2764,984,2830
220559,202107,1848,4439,1572,4017,15,35,1286,3326,1301,3361
220560,202107,1790,3978,1475,3581,45,83,1328,3266,1373,3349
220570,202107,7553,21723,6899,20803,498,1337,5479,16792,5977,18129
220580,202107,7065,18705,6442,17717,102,266,5813,15964,5915,16230
220585,202107,2127,6487,1742,5798,40,103,1434,4814,1474,4917
220590,202107,1414,3739,1171,3383,90,227,838,2483,928,2710
220595,202107,2668,7094,2420,6760,17,76,2170,6019,2187,6095
220600,202107,1450,3153,1230,2892,73,90,1046,2530,1119,2620
220605,202107,1633,4689,1403,4278,17,94,1150,3408,1167,3502
220610,202107,2849,8128,2673,7862,25,121,2508,7341,2533,7462
220620,202107,8113,24329,7461,23451,143,723,6806,21188,6949,21911
220630,202107,388,1120,301,963,24,80,203,637,227,717
220635,202107,1813,5361,1627,4975,38,174,1282,3805,1320,3979
220640,202107,2453,6740,2087,6219,67,259,1703,5031,1770,5290
220650,202107,2155,5772,1852,5314,29,95,1512,4328,1541,4423
220660,202107,2593,8044,2207,7405,66,321,1855,6132,1921,6453
220665,202107,1281,3777,1086,3456,27,137,916,2851,943,2988
220667,202107,1670,5008,1508,4717,62,214,1225,3820,1287,4034
220669,202107,1687,4917,1618,4811,47,184,1448,4223,1495,4407
220670,202107,2244,5692,1800,5076,18,69,1561,4397,1579,4466
220672,202107,3301,7948,2678,7193,84,281,2389,6330,2473,6611
220675,202107,1337,3543,1195,3286,32,84,981,2682,1013,2766
220680,202107,2798,7405,2671,7231,119,226,2419,6669,2538,6895
220690,202107,1618,4190,1429,3907,60,176,1125,3073,1185,3249
220695,202107,931,2527,865,2409,20,57,755,2094,775,2151
220700,202107,10573,24959,8587,22274,341,829,6582,16993,6923,17822
220710,202107,938,2482,691,2028,29,79,526,1508,555,1587
220720,202107,2147,5017,1931,4733,16,60,1697,4110,1713,4170
220730,202107,1353,3675,1154,3351,15,68,985,2800,1000,2868
220735,202107,1010,2266,798,1946,27,73,655,1548,682,1621
220740,202107,1391,3528,1118,3170,33,78,936,2702,969,2780
220750,202107,3938,9745,3467,9081,169,390,3058,8031,3227,8421
220755,202107,1399,3301,1164,2954,19,64,972,2415,991,2479
220760,202107,3160,8427,2777,7916,59,170,2533,7271,2592,7441
220770,202107,24537,70695,20836,64484,6094,19786,7263,23640,13357,43426
220775,202107,1206,2943,1069,2771,8,27,1030,2654,1038,2681
220777,202107,1638,4090,1260,3520,35,84,963,2715,998,2799
220779,202107,1284,3290,1114,3043,20,67,982,2656,1002,2723
220780,202107,5851,14220,5061,13048,211,601,4083,10339,4294,10940
220785,202107,1501,3293,1319,3061,7,21,1262,2911,1269,2932
220790,202107,10368,28818,9344,27352,163,684,7885,22878,8048,23562
220793,202107,944,2450,758,2132,7,10,633,1805,640,1815
220795,202107,1428,3601,1252,3364,23,69,1103,2967,1126,3036
220800,202107,18777,40547,15999,36932,587,1251,12535,28903,13122,30154
220810,202107,3092,8417,2610,7582,40,114,2166,6231,2206,6345
220820,202107,5148,13088,4483,12113,236,521,3487,9449,3723,9970
220830,202107,7390,19171,6631,18109,257,751,5486,14771,5743,15522
220840,202107,12423,36904,10404,32849,2282,6839,4911,16191,7193,23030
220850,202107,3217,9679,2898,9286,45,220,2588,8311,2633,8531
220855,202107,716,1761,626,1642,21,58,564,1473,585,1531
220860,202107,1072,2612,936,2404,14,60,854,2158,868,2218
220865,202107,2484,6451,1923,5463,66,252,1416,3894,1482,4146
220870,202107,3141,8378,2611,7690,26,123,2408,7081,2434,7204
220880,202107,5420,12569,4671,11641,70,246,4292,10593,4362,10839
220885,202107,1441,4203,1196,3801,64,201,932,3024,996,3225
220887,202107,1594,3353,1338,3029,13,28,1239,2793,1252,2821
220890,202107,1426,4240,1248,3980,45,150,1039,3368,1084,3518
220900,202107,2048,4805,1708,4371,31,72,1499,3829,1530,3901
220910,202107,1578,4186,1329,3818,61,155,1085,3156,1146,3311
220915,202107,997,2607,804,2258,17,56,616,1654,633,1710
220920,202107,1458,4428,1264,4176,55,211,1046,3489,1101,3700
220930,202107,1815,4742,1528,4335,21,61,1424,4030,1445,4091
220935,202107,1117,3176,909,2731,21,89,590,1677,611,1766
220937,202107,1540,3961,1325,3622,21,73,1070,2877,1091,2950
220940,202107,1608,4355,1285,3791,27,85,1006,2930,1033,3015
220945,202107,469,1569,399,1422,16,85,302,1055,318,1140
220950,202107,1439,3275,954,2532,20,56,758,1944,778,2000
220955,202107,1652,4111,1371,3632,26,65,1180,3089,1206,3154
220960,202107,817,2044,613,1703,27,76,437,1167,464,1243
220965,202107,1822,4893,1581,4542,17,104,1367,3853,1384,3957
220970,202107,2028,4691,1493,3908,24,56,1258,3264,1282,3320
220975,202107,695,1924,595,1799,11,62,533,1566,544,1628
220980,202107,1174,3243,1043,3065,33,116,874,2554,907,2670
220985,202107,1317,3306,1143,3055,55,127,930,2444,985,2571
220987,202107,1480,4302,1306,3997,55,182,1058,3225,1113,3407
220990,202107,1736,4717,1532,4414,14,80,1313,3732,1327,3812
220995,202107,1152,3330,956,2971,31,94,717,2235,748,2329
220997,202107,2395,7174,2211,6874,41,172,1972,6067,2013,6239
221000,202107,4556,12261,4019,11478,82,344,3458,9781,3540,10125
221005,202107,1511,3849,1381,3630,15,69,1200,3062,1215,3131
221010,202107,1276,2794,1003,2460,16,48,875,2110,891,2158
221020,202107,1550,4678,1435,4468,20,72,1101,3400,1121,3472
221030,202107,1709,4054,1461,3751,19,52,1274,3326,1293,3378
221035,202107,1549,3920,1358,3667,21,29,1210,3341,1231,3370
221037,202107,724,1911,602,1703,9,25,439,1185,448,1210
221038,202107,539,1480,421,1275,12,38,285,859,297,897
221039,202107,890,2383,757,2165,24,102,613,1694,637,1796
221040,202107,4314,12308,3770,11351,184,516,3013,9136,3197,9652
221050,202107,3982,10217,3525,9643,68,199,3177,8696,3245,8895
221060,202107,8916,24418,7406,21951,335,786,5914,17774,6249,18560
221062,202107,1147,3626,991,3367,36,154,798,2695,834,2849
221063,202107,1095,2912,942,2691,49,132,750,2130,799,2262
221065,202107,2697,6787,2368,6220,15,49,2086,5409,2101,5458
221070,202107,3495,10525,2827,9129,300,929,1727,5698,2027,6627
221080,202107,3555,8578,2922,7641,59,191,2410,6200,2469,6391
221090,202107,1443,3599,1187,3198,8,28,1014,2684,1022,2712
221093,202107,1414,3878,1288,3636,136,350,879,2456,1015,2806
221095,202107,883,2288,752,2090,8,21,638,1748,646,1769
221097,202107,880,2208,664,1824,22,54,497,1297,519,1351
221100,202107,121745,317157,101550,283194,10129,29948,66053,179083,76182,209031
221110,202107,9991,29371,9167,28293,130,629,8236,25237,8366,25866
221120,202107,4877,13265,4348,12435,159,444,3775,10849,3934,11293
221130,202107,5665,14165,4308,11610,811,2020,2176,5916,2987,7936
221135,202107,1786,4437,1597,4189,36,92,1432,3768,1468,3860
221140,202107,1370,3123,1154,2854,10,33,1047,2551,1057,2584
221150,202107,1117,2758,876,2346,22,99,678,1698,700,1797
221160,202107,753,1831,665,1719,28,38,534,1402,562,1440
221170,202107,1022,2866,938,2713,9,35,824,2347,833,2382
230010,202107,3104,7985,2565,7085,32,102,2122,5734,2154,5836
230015,202107,3141,9909,2783,9187,150,534,1970,6518,2120,7052
230020,202107,13129,40823,12312,39591,361,1370,10528,33781,10889,35151
230030,202107,13203,32294,11087,29550,236,611,9666,25806,9902,26417
230040,202107,4600,11614,3808,10326,40,183,3204,8565,3244,8748
230050,202107,2778,8459,2124,6969,330,1026,949,3051,1279,4077
230060,202107,2419,6495,1941,5647,28,116,1537,4391,1565,4507
230070,202107,4221,10683,3394,9147,213,600,2403,6388,2616,6988
230075,202107,9021,28838,8260,27520,577,2068,6428,21357,7005,23425
230080,202107,3087,6441,2352,5546,5,12,2153,5098,2158,5110
230090,202107,4513,10804,3829,9739,197,458,3061,7750,3258,8208
230100,202107,18863,47254,16533,44182,1416,3545,11768,31819,13184,35364
230110,202107,12940,37633,10847,33600,1727,5259,5642,17667,7369,22926
230120,202107,7970,20679,6980,19110,534,1255,5132,14263,5666,15518
230125,202107,3217,8397,2609,7436,92,283,2011,5657,2103,5940
230130,202107,5686,17255,4622,14959,395,1328,2990,9583,3385,10911
230140,202107,3469,10267,2956,9213,82,338,2267,6906,2349,7244
230150,202107,1669,4885,1374,4245,216,581,798,2557,1014,3138
230160,202107,6615,16770,5719,15414,131,407,4793,12741,4924,13148
230170,202107,6604,18258,5430,15918,344,883,3854,11227,4198,12110
230180,202107,1673,4579,1418,4086,18,79,1156,3228,1174,3307
230185,202107,4561,12559,3864,11409,294,886,2825,8379,3119,9265
230190,202107,14210,40362,11943,36203,1351,4139,7054,21262,8405,25401
230195,202107,5546,15804,5027,14856,398,1143,3746,11092,4144,12235
230200,202107,5117,13858,4298,12353,154,442,3306,9349,3460,9791
230205,202107,4391,12327,3848,11525,231,650,2895,8664,3126,9314
230210,202107,10366,24433,8758,22301,383,1078,6837,17178,7220,18256
230220,202107,14219,35196,12485,32736,601,1540,10280,26710,10881,28250
230230,202107,7105,20429,6356,18930,429,1216,4725,14059,5154,15275
230240,202107,13015,34509,11249,31497,267,1120,9301,25436,9568,26556
230250,202107,9125,24903,8457,23878,231,768,6855,18780,7086,19548
230260,202107,15046,43429,13019,39906,2175,6226,6980,22146,9155,28372
230270,202107,7877,20597,6057,17229,573,1550,3849,11105,4422,12655
230280,202107,20718,54361,17004,48204,439,1685,13420,36699,13859,38384
230290,202107,5080,13698,4190,12041,232,560,3200,9182,3432,9742
230300,202107,4955,12869,4485,12238,88,237,3957,10786,4045,11023
230310,202107,4784,13366,4062,12078,124,484,2934,8539,3058,9023
230320,202107,8022,22680,6733,20361,198,801,5210,15420,5408,16221
230330,202107,4858,12875,3869,11026,117,361,2945,8176,3062,8537
230340,202107,3913,11732,3359,10612,222,738,2376,7399,2598,8137
230350,202107,18355,49197,16015,45787,799,2550,10935,31461,11734,34011
230360,202107,3051,7832,2418,6729,122,325,1696,4652,1818,4977
230365,202107,3136,7595,2592,6796,50,222,2218,5728,2268,5950
230370,202107,60993,163748,52074,150810,6926,20217,32410,94475,39336,114692
230380,202107,6440,17436,5097,14999,108,402,3815,10945,3923,11347
230390,202107,3526,10096,3059,9341,79,299,2396,7233,2475,7532
230393,202107,3498,9886,2787,8444,67,344,2179,6339,2246,6683
230395,202107,5882,15821,5091,14510,375,1016,3545,10134,3920,11150
230400,202107,5498,14886,4903,13924,70,337,3978,11015,4048,11352
230410,202107,13927,40676,11541,36358,911,3039,7862,24840,8773,27879
230420,202107,30082,80258,24552,70914,2858,8423,14048,40169,16906,48592
230423,202107,4911,14168,4304,12992,122,435,3463,10323,3585,10758
230425,202107,5829,17433,5319,16406,455,1418,3768,11556,4223,12974
230426,202107,2922,7417,2148,5942,28,94,1635,4414,1663,4508
230427,202107,1915,5227,1379,4134,84,252,884,2554,968,2806
230428,202107,10001,26014,8578,23909,1335,3542,4844,13553,6179,17095
230430,202107,5045,13896,3987,12072,160,515,2979,8914,3139,9429
230435,202107,6261,15866,5214,14050,722,1751,3068,8402,3790,10153
230440,202107,434400,1046557,362852,943431,32614,89259,242115,619471,274729,708730
230445,202107,4358,11365,3504,9872,194,518,2401,6604,2595,7122
230450,202107,3680,10303,3210,9625,226,809,2358,6886,2584,7695
230460,202107,2172,5946,1883,5494,47,188,1596,4621,1643,4809
230465,202107,4334,11765,3659,10492,114,385,2775,7663,2889,8048
230470,202107,11586,37365,10398,35187,879,3209,7301,24451,8180,27660
230480,202107,1497,4250,1248,3807,56,222,931,2734,987,2956
230490,202107,2678,7287,2278,6538,163,517,1454,3937,1617,4454
230495,202107,5824,16865,5150,15667,461,1504,3336,10117,3797,11621
230500,202107,9539,29911,8480,28012,241,956,6922,22893,7163,23849
230510,202107,1692,4822,1336,4092,164,530,719,2157,883,2687
230520,202107,4834,13026,4178,11895,347,874,2901,8312,3248,9186
230523,202107,15757,45503,12570,38846,2775,8493,3146,10405,5921,18898
230526,202107,3830,10635,3280,9727,195,493,2389,7189,2584,7682
230530,202107,5536,16992,4661,15291,319,1098,3360,10884,3679,11982
230533,202107,4724,10796,3865,9467,115,274,3219,7774,3334,8048
230535,202107,5307,14576,4498,13220,312,897,2998,8912,3310,9809
230540,202107,16288,43604,13965,40179,279,979,11586,33135,11865,34114
230550,202107,21876,56101,17631,49030,1490,4165,11482,31738,12972,35903
230560,202107,8117,19676,6615,17332,60,233,5687,14777,5747,15010
230565,202107,3154,8581,2651,7661,112,417,2037,5770,2149,6187
230570,202107,3463,8719,2958,8020,86,217,2427,6583,2513,6800
230580,202107,11467,28792,9851,26505,395,983,8098,21795,8493,22778
230590,202107,9278,25600,7755,22866,447,1435,5773,16521,6220,17956
230600,202107,3894,9616,3083,8237,91,219,2104,5681,2195,5900
230610,202107,6819,18449,6051,17173,450,1198,4776,13510,5226,14708
230620,202107,2170,5708,1695,4808,100,309,1070,2926,1170,3235
230625,202107,8613,23348,7272,20970,1918,5752,2341,6981,4259,12733
230630,202107,11412,32215,9969,29486,1259,3437,6230,18743,7489,22180
230640,202107,27793,82701,25161,78556,1125,4259,20217,62310,21342,66569
230650,202107,5446,14226,4618,12823,115,411,3793,10280,3908,10691
230655,202107,9390,31228,8836,30285,666,2207,7053,24512,7719,26719
230660,202107,6200,18072,5056,16072,128,673,4099,12770,4227,13443
230670,202107,6389,14778,4660,12065,123,369,3732,9405,3855,9774
230680,202107,2768,7361,2323,6577,118,292,1667,4751,1785,5043
230690,202107,7367,21194,6334,19201,389,1337,4084,12161,4473,13498
230700,202107,10660,26466,8651,22831,403,888,6374,16607,6777,17495
230710,202107,7002,21657,6145,19840,697,2082,4008,13010,4705,15092
230720,202107,1913,5535,1578,4888,107,293,1104,3358,1211,3651
230725,202107,4367,12404,3925,11641,391,1242,2426,7107,2817,8349
230730,202107,59819,155558,47115,136742,10645,32696,14540,45589,25185,78285
230740,202107,6246,17020,5302,15516,135,404,4232,12385,4367,12789
230750,202107,8627,22499,7196,20137,166,510,5744,15700,5910,16210
230760,202107,11322,29186,9821,26941,481,1508,7446,19922,7927,21430
230763,202107,5167,13520,4323,12043,110,469,3500,9431,3610,9900
230765,202107,42430,111806,35264,100398,5186,15216,18464,51790,23650,67006
230770,202107,26049,62543,21820,57041,2135,5492,14780,38755,16915,44247
230780,202107,6618,22587,5979,21094,882,2917,3415,12481,4297,15398
230790,202107,3184,8756,2861,8240,101,393,2215,6179,2316,6572
230800,202107,8478,26186,7445,24122,1042,3438,4231,13618,5273,17056
230810,202107,11207,33315,10066,31483,362,1293,7868,24261,8230,25554
230820,202107,3625,11362,2995,10001,249,954,1842,5842,2091,6796
230830,202107,7721,20621,6593,18768,122,484,5440,15077,5562,15561
230835,202107,4347,10097,3370,8583,92,250,2714,6817,2806,7067
230837,202107,3196,9448,2857,8876,107,406,2290,6986,2397,7392
230840,202107,9646,27385,8282,25049,1036,2820,5641,17323,6677,20143
230850,202107,10017,28136,8415,25033,365,1150,6143,18052,6508,19202
230860,202107,5609,13675,4654,12315,58,180,4113,10805,4171,10985
230870,202107,16534,39678,14251,35940,404,1084,11664,28889,12068,29973
230880,202107,2170,6403,1988,6111,42,214,1582,4731,1624,4945
230890,202107,4576,14425,4175,13655,320,1102,3072,9957,3392,11059
230900,202107,3126,8712,2710,7941,160,536,1881,5358,2041,5894
230910,202107,3243,8501,2621,7549,58,257,2118,6103,2176,6360
230920,202107,4880,13313,4105,12084,103,384,3270,9427,3373,9811
230930,202107,6915,18703,5807,16763,278,748,4088,11784,4366,12532
230940,202107,8432,20791,7322,19129,204,461,6146,16010,6350,16471
230945,202107,6707,18759,5747,16961,288,987,4088,11785,4376,12772
230950,202107,6342,15641,5607,14649,117,258,4816,12672,4933,12930
230960,202107,13945,38965,12228,35778,2168,6144,5858,17242,8026,23386
230970,202107,14161,36580,11855,33050,1631,4364,7023,19713,8654,24077
230980,202107,2786,7873,2452,7288,334,918,1562,4809,1896,5727
230990,202107,1717,4700,1417,4118,61,227,1009,2809,1070,3036
231000,202107,2629,6888,2135,5919,90,204,1577,4285,1667,4489
231010,202107,3772,8576,2970,7220,24,86,2600,6153,2624,6239
231020,202107,8274,24762,7392,23115,1224,3447,4369,14154,5593,17601
231025,202107,7827,20746,6810,19097,726,1914,4804,13653,5530,15567
231030,202107,7521,21820,5923,18509,1012,2922,3009,9572,4021,12494
231040,202107,2981,8334,2596,7642,120,350,2043,5922,2163,6272
231050,202107,12088,30041,9886,26210,631,1519,7424,19340,8055,20859
231060,202107,2962,8206,2610,7648,55,157,2183,6409,2238,6566
231070,202107,8199,23130,7056,21132,627,1895,4769,14148,5396,16043
231080,202107,4014,11123,3400,10131,140,527,2571,7501,2711,8028
231085,202107,7098,16561,5654,14891,216,480,4449,11795,4665,12275
231090,202107,4636,11800,3426,9506,100,376,2332,6206,2432,6582
231095,202107,2315,6742,1843,5746,171,515,1212,3779,1383,4294
231100,202107,3320,9338,2723,8208,131,428,2038,6093,2169,6521
231110,202107,3759,10664,3435,10075,130,447,2594,7481,2724,7928
231120,202107,2409,6778,2003,6081,79,272,1460,4393,1539,4665
231123,202107,1964,4980,1651,4446,91,197,1187,3221,1278,3418
231126,202107,5624,15090,4617,13214,289,761,3314,9408,3603,10169
231130,202107,22382,55069,18588,50362,1068,3165,13858,37086,14926,40251
231135,202107,4257,11786,3538,10406,180,548,2505,7295,2685,7843
231140,202107,16878,46508,13629,40962,651,2280,9695,28511,10346,30791
231150,202107,6133,16177,4616,13323,647,1907,1976,5891,2623,7798
231160,202107,6445,19228,5747,17970,808,2406,3268,10550,4076,12956
231170,202107,4555,12766,3817,11393,243,744,2670,7740,2913,8484
231180,202107,14887,41027,12177,35473,2860,8124,4688,13951,7548,22075
231190,202107,4086,11195,3360,9899,68,249,2599,7509,2667,7758
231195,202107,5293,15253,4428,13536,275,879,3199,9737,3474,10616
231200,202107,7872,24015,6897,22071,175,846,5475,17007,5650,17853
231210,202107,5034,14333,4293,13112,151,519,3317,9927,3468,10446
231220,202107,12864,32089,10166,27135,501,1315,7447,19307,7948,20622
231230,202107,9247,29133,8171,27149,555,2035,5949,19871,6504,21906
231240,202107,11803,33641,10394,31023,1668,4744,6196,18833,7864,23577
231250,202107,2193,5483,1447,3866,112,315,862,2224,974,2539
231260,202107,3363,9178,2932,8493,279,735,1974,5897,2253,6632
231270,202107,6475,16604,5202,14517,154,557,3933,10684,4087,11241
231280,202107,1790,5427,1641,5161,88,248,1233,3873,1321,4121
231290,202107,38537,112464,32071,99680,5453,16666,14675,45276,20128,61942
231300,202107,4208,11322,3312,9569,158,511,2278,6418,2436,6929
231310,202107,7764,19320,6186,16466,542,1415,4202,10926,4744,12341
231320,202107,7862,21219,6154,18238,87,376,4870,14226,4957,14602
231325,202107,2559,6407,2106,5746,170,320,1472,4157,1642,4477
231330,202107,9950,28564,8288,25296,1610,4511,4351,14043,5961,18554
231335,202107,5779,15024,4917,13676,61,269,4339,11929,4400,12198
231340,202107,18646,55200,16831,52028,1189,3584,12686,39515,13875,43099
231350,202107,16096,43369,14697,41362,233,807,13248,36988,13481,37795
231355,202107,4479,13007,4042,12194,224,693,3173,9471,3397,10164
231360,202107,7880,23047,6832,21245,299,977,5418,16816,5717,17793
231370,202107,2219,5995,1775,5201,37,109,1352,3943,1389,4052
231375,202107,4362,13388,3984,12778,116,498,3344,10611,3460,11109
231380,202107,6142,16336,5551,15530,189,439,4529,12829,4718,13268
231390,202107,3512,9948,3166,9370,108,392,2365,6804,2473,7196
231395,202107,4267,12028,3553,10899,296,908,2302,7056,2598,7964
231400,202107,9914,28001,8306,25080,251,1062,6309,18647,6560,19709
231410,202107,15081,45709,13782,43585,659,2076,11124,35112,11783,37188
240010,202107,2651,6774,2063,5740,220,597,1204,3311,1424,3908
240020,202107,13041,35498,10890,31710,645,2191,7177,20651,7822,22842
240030,202107,3097,7203,2766,6715,110,292,2390,5749,2500,6041
240040,202107,848,2399,722,2163,30,111,493,1423,523,1534
240050,202107,3434,9005,2769,7806,48,131,2118,5864,2166,5995
240060,202107,1423,3740,1161,3269,21,71,948,2616,969,2687
240070,202107,2238,6260,2017,5794,200,575,1458,4096,1658,4671
240080,202107,2983,7895,2417,6907,66,227,1818,5120,1884,5347
240090,202107,2304,5609,1879,4909,17,48,1568,4046,1585,4094
240100,202107,10543,25239,8409,21498,188,537,6642,16403,6830,16940
240110,202107,4610,12872,3861,11508,177,633,2833,8259,3010,8892
240120,202107,3446,9351,2800,8557,190,606,2004,6254,2194,6860
240130,202107,3811,7695,3147,6843,31,72,2874,6187,2905,6259
240140,202107,1794,5329,1543,4841,163,562,1041,3234,1204,3796
240145,202107,6756,18387,5501,16243,851,2552,3139,9390,3990,11942
240150,202107,989,2791,869,2550,48,143,671,1928,719,2071
240160,202107,1482,4376,1243,3930,38,154,940,2975,978,3129
240165,202107,999,2663,832,2347,21,85,697,1920,718,2005
240170,202107,2725,7089,2293,6332,225,621,1512,4126,1737,4747
240180,202107,3048,8888,2430,7639,564,1700,1044,3493,1608,5193
240185,202107,1271,3856,1174,3687,54,190,986,3075,1040,3265
240190,202107,1089,3113,937,2865,19,79,793,2441,812,2520
240200,202107,11223,27862,8924,24005,929,2610,5035,13315,5964,15925
240210,202107,3384,8161,2744,7133,22,109,2315,5818,2337,5927
240220,202107,7437,22008,6690,20855,316,1312,5339,16422,5655,17734
240230,202107,5928,14804,4739,12862,226,551,3705,10126,3931,10677
240240,202107,1843,5239,1202,3771,117,375,408,1152,525,1527
240250,202107,3083,7844,2686,7296,70,209,2310,6219,2380,6428
240260,202107,13984,40942,12109,37816,1734,5046,7358,24251,9092,29297
240270,202107,2396,6957,2102,6463,113,335,1536,4873,1649,5208
240280,202107,1761,4366,1474,3902,61,143,1159,3044,1220,3187
240290,202107,1195,3436,973,2950,25,104,690,1979,715,2083
240300,202107,2372,5930,1707,4730,75,218,1055,2870,1130,3088
240310,202107,8588,22421,6754,19170,882,2629,3424,9537,4306,12166
240320,202107,2127,5647,1544,4520,31,128,1165,3266,1196,3394
240325,202107,32497,84655,25977,73484,4241,12265,12045,33952,16286,46217
240330,202107,1841,4912,1412,4103,56,182,977,2719,1033,2901
240340,202107,2012,4555,1640,4003,57,128,1347,3232,1404,3360
240350,202107,2289,5647,2045,5373,38,95,1851,4885,1889,4980
240360,202107,9874,26378,8745,24628,940,2556,5976,17113,6916,19669
240370,202107,2046,5138,1586,4224,62,164,1124,2910,1186,3074
240375,202107,949,2338,790,2063,26,87,626,1574,652,1661
240380,202107,2266,6369,1690,5107,145,401,963,2893,1108,3294
240390,202107,1079,2538,776,1981,24,43,500,1192,524,1235
240400,202107,1552,3685,1192,3074,33,109,851,2063,884,2172
240410,202107,602,1732,493,1522,42,144,314,922,356,1066
240420,202107,4744,16027,4201,14855,455,1836,2563,8898,3018,10734
240430,202107,3554,8874,2948,7829,171,511,2202,5664,2373,6175
240440,202107,2575,5581,2189,5044,144,274,1751,4068,1895,4342
240450,202107,4665,12377,3675,10564,356,1027,2127,5904,2483,6931
240460,202107,3110,8472,2762,7910,236,702,2167,6197,2403,6899
240470,202107,3663,10893,2759,9008,635,1927,1181,4129,1816,6056
240480,202107,607,1612,410,1181,33,85,194,535,227,620
240485,202107,2260,6110,1827,5352,120,333,1249,3679,1369,4012
240490,202107,1657,4151,1300,3503,84,180,934,2556,1018,2736
240500,202107,2215,5887,1917,5367,112,294,1524,4291,1636,4585
240510,202107,1737,4526,1506,4177,82,257,1195,3274,1277,3531
240520,202107,1570,3655,1199,3158,82,189,873,2385,955,2574
240530,202107,2341,6256,2103,5888,98,283,1742,4806,1840,5089
240540,202107,2385,5784,2097,5344,64,108,1804,4642,1868,4750
240550,202107,732,1973,660,1834,14,60,567,1524,581,1584
240560,202107,3322,8450,2807,7768,274,655,2028,5774,2302,6429
240570,202107,2893,7405,1949,5372,302,807,684,1786,986,2593
240580,202107,8004,23240,7083,21552,587,1653,5588,17217,6175,18870
240590,202107,808,1946,714,1797,8,24,571,1404,579,1428
240600,202107,1870,4942,1378,3943,43,121,924,2550,967,2671
240610,202107,4323,11279,3709,10193,114,340,2877,7753,2991,8093
240615,202107,1290,3263,1040,2827,115,297,703,1886,818,2183
240620,202107,1865,5088,1608,4662,110,270,1274,3711,1384,3981
240630,202107,2091,5757,1883,5404,134,266,1340,4020,1474,4286
240640,202107,984,2572,782,2238,27,93,576,1618,603,1711
240650,202107,4152,11424,3559,10225,240,656,2648,7538,2888,8194
240660,202107,3090,7794,2746,7361,52,151,2493,6695,2545,6846
240670,202107,2529,6923,2038,5925,147,430,1328,3779,1475,4209
240680,202107,1654,4314,1345,3795,66,182,1002,2768,1068,2950
240690,202107,1073,2592,843,2213,15,61,678,1706,693,1767
240700,202107,2538,7187,2069,6319,78,254,1576,4757,1654,5011
240710,202107,16728,42090,14070,37644,1693,4417,9000,23929,10693,28346
240720,202107,5303,12754,4575,11740,442,1108,3348,8547,3790,9655
240725,202107,1170,3240,891,2713,38,114,599,1769,637,1883
240730,202107,2348,6367,1874,5443,52,166,1429,4088,1481,4254
240740,202107,1928,5105,1552,4365,51,181,1138,3046,1189,3227
240750,202107,2197,7032,1864,6332,237,835,1041,3587,1278,4422
240760,202107,1729,3852,1247,3137,72,96,961,2477,1033,2573
240770,202107,3279,8932,2769,8196,123,420,2249,6593,2372,7013
240780,202107,4686,12910,3868,11556,540,1580,2361,7267,2901,8847
240790,202107,910,2496,754,2205,16,68,571,1612,587,1680
240800,202107,50804,118417,39550,101628,5121,13137,20852,53572,25973,66709
240810,202107,93928,236285,79826,213465,8526,23525,52763,138511,61289,162036
240820,202107,5977,17321,5170,15866,700,2077,3191,9980,3891,12057
240830,202107,8854,24772,7852,23302,236,911,6503,19106,6739,20017
240840,202107,1122,2732,895,2373,25,63,646,1654,671,1717
240850,202107,1460,3888,1035,2983,61,171,576,1605,637,1776
240860,202107,1383,3586,1041,2978,12,52,807,2202,819,2254
240870,202107,1107,2751,837,2301,143,408,447,1260,590,1668
240880,202107,1282,3982,1128,3686,73,300,860,2737,933,3037
240890,202107,4545,12191,3493,10240,457,1442,1792,5024,2249,6466
240895,202107,2957,8843,2723,8471,200,579,2219,7049,2419,7628
240910,202107,3587,9385,3040,8429,51,170,2492,6769,2543,6939
240920,202107,1031,2610,826,2291,96,194,457,1360,553,1554
240930,202107,3754,8341,3093,7533,236,342,2249,5869,2485,6211
240933,202107,1704,4146,1440,3771,37,140,1259,3243,1296,3383
240940,202107,6176,15033,4825,12708,569,1456,2774,7181,3343,8637
240950,202107,1118,3243,973,2976,28,113,786,2339,814,2452
240960,202107,694,2106,623,1964,22,64,486,1514,508,1578
240970,202107,1905,4846,1529,4206,59,211,1248,3339,1307,3550
240980,202107,3379,9851,2985,9156,101,445,2435,7322,2536,7767
240990,202107,2697,7333,2381,6745,236,735,1700,4637,1936,5372
241000,202107,958,2466,753,2102,28,68,564,1544,592,1612
241010,202107,2900,8953,2634,8393,171,601,1938,6111,2109,6712
241020,202107,2226,5745,1692,4708,97,264,1156,3111,1253,3375
241025,202107,1823,5103,1460,4450,39,161,1068,3188,1107,3349
241030,202107,2513,7766,2026,6735,241,789,1273,4265,1514,5054
241040,202107,2327,7156,2028,6636,80,371,1590,5157,1670,5528
241050,202107,1416,3894,1160,3423,33,120,848,2426,881,2546
241060,202107,796,2179,695,1974,33,92,484,1336,517,1428
241070,202107,699,1831,598,1666,13,36,467,1257,480,1293
241080,202107,1136,3182,873,2650,28,90,626,1875,654,1965
241090,202107,2010,5775,1641,5140,50,224,1286,3974,1336,4198
241100,202107,1231,3329,943,2754,67,187,608,1737,675,1924
241105,202107,952,2842,783,2532,239,767,262,866,501,1633
241110,202107,1020,2781,764,2251,39,105,513,1465,552,1570
241120,202107,7789,21712,6578,19608,876,2522,3960,12167,4836,14689
241140,202107,3449,8938,2668,7402,141,392,1938,5261,2079,5653
241142,202107,808,2144,599,1753,28,87,353,989,381,1076
241150,202107,6168,15474,5466,14367,173,418,4419,11511,4592,11929
241160,202107,1213,3243,959,2781,146,432,586,1649,732,2081
241170,202107,1412,3503,1194,3126,34,105,979,2473,1013,2578
241180,202107,1084,2727,812,2210,96,263,392,1071,488,1334
241190,202107,1199,3068,1001,2674,14,61,739,1894,753,1955
241200,202107,20546,52116,17775,47620,2715,7186,10393,27783,13108,34969
241210,202107,1488,3855,1071,3042,105,315,614,1705,719,2020
241220,202107,9446,26583,8282,24659,1718,5084,4072,12531,5790,17615
241230,202107,2989,7761,2646,7234,118,327,2177,5909,2295,6236
241240,202107,1284,3515,825,2530,79,248,330,1018,409,1266
241250,202107,5782,16131,4638,14017,157,642,3431,9992,3588,10634
241255,202107,2397,7186,2119,6629,129,437,1598,4916,1727,5353
241260,202107,5086,12913,4057,11232,102,359,3229,8763,3331,9122
241270,202107,1690,4832,1411,4306,110,343,1001,3066,1111,3409
241280,202107,2256,5516,1939,4951,68,161,1641,4130,1709,4291
241290,202107,3414,8243,2514,6801,75,220,1963,5189,2038,5409
241300,202107,1572,4089,1272,3577,33,103,864,2366,897,2469
241310,202107,2204,5331,1901,4903,21,56,1651,4307,1672,4363
241320,202107,962,3063,826,2805,84,338,535,1804,619,2142
241330,202107,1817,4566,1431,4053,16,88,1256,3527,1272,3615
241335,202107,3453,9383,3032,8623,121,369,2474,6951,2595,7320
241340,202107,1606,4413,1259,3716,236,756,542,1523,778,2279
241350,202107,2225,5984,1943,5482,114,305,1506,4233,1620,4538
241355,202107,1361,3603,1115,3135,12,30,852,2361,864,2391
241360,202107,2094,5325,1577,4300,40,105,1169,3109,1209,3214
241370,202107,1429,3804,1115,3160,54,155,793,2184,847,2339
241380,202107,715,1888,554,1591,77,194,275,807,352,1001
241390,202107,2743,7922,2440,7474,197,520,1849,5800,2046,6320
241400,202107,3681,10011,3266,9389,153,496,2615,7465,2768,7961
241410,202107,2507,7283,2038,6322,305,973,1103,3437,1408,4410
241415,202107,1730,4931,1443,4383,50,171,1066,3185,1116,3356
241420,202107,2505,7475,2168,6916,437,1514,1186,3775,1623,5289
241430,202107,633,1667,445,1276,15,44,290,795,305,839
241440,202107,8050,23839,7198,22351,343,1129,5730,17804,6073,18933
241445,202107,1236,2994,1083,2791,37,71,933,2502,970,2573
241450,202107,2904,6840,2436,6109,370,773,1627,4234,1997,5007
241460,202107,4034,10628,3255,9036,210,528,2219,6049,2429,6577
241470,202107,1433,3749,1180,3370,24,80,972,2775,996,2855
241475,202107,1278,3458,1013,2956,21,95,768,2132,789,2227
241480,202107,3092,9389,2538,8190,770,2475,808,2910,1578,5385
241490,202107,682,1569,536,1365,19,39,413,1038,432,1077
241500,202107,810,2219,730,2120,4,11,685,2008,689,2019
250010,202107,2675,7811,2242,6922,53,190,1645,4974,1698,5164
250020,202107,1710,4420,1245,3540,59,106,881,2516,940,2622
250030,202107,7117,19067,6281,17769,562,1542,4650,13089,5212,14631
250040,202107,4258,12412,3695,11399,309,935,2662,8110,2971,9045
250050,202107,3679,9642,3324,9180,91,329,2804,7724,2895,8053
250053,202107,1251,3382,1145,3217,83,209,845,2384,928,2593
250057,202107,706,2347,657,2273,9,40,598,2097,607,2137
250060,202107,5707,14450,5141,13750,283,700,4275,11547,4558,12247
250070,202107,4153,11256,3489,10125,25,94,2826,8021,2851,8115
250073,202107,795,2051,646,1820,12,24,513,1429,525,1453
250077,202107,2368,6044,1801,5135,54,172,1399,3937,1453,4109
250080,202107,5291,12586,4473,11564,58,206,3969,10126,4027,10332
250090,202107,3527,8234,3073,7634,57,140,2656,6495,2713,6635
250100,202107,3708,10928,3329,10249,155,493,2609,7895,2764,8388
250110,202107,4946,13629,4466,12953,262,897,3469,9918,3731,10815
250115,202107,751,1852,553,1550,12,49,421,1158,433,1207
250120,202107,1907,5416,1593,4901,23,116,1270,3872,1293,3988
250130,202107,5727,15255,4834,13985,65,339,4139,11812,4204,12151
250135,202107,1242,3350,1082,3081,15,49,953,2719,968,2768
250140,202107,2353,6667,2187,6466,105,378,1894,5593,1999,5971
250150,202107,4818,14650,4311,13794,130,516,3467,10934,3597,11450
250153,202107,1401,3640,1158,3283,38,95,913,2573,951,2668
250157,202107,1904,5371,1715,5031,59,200,1381,3991,1440,4191
250160,202107,3985,9657,3174,8573,43,143,2772,7495,2815,7638
250170,202107,1904,4844,1713,4576,24,86,1490,3925,1514,4011
250180,202107,21353,49793,18262,45890,712,2070,14584,35753,15296,37823
250190,202107,4223,10959,3555,9990,312,897,2526,6979,2838,7876
250200,202107,2082,5290,1776,4884,71,176,1477,4103,1548,4279
250205,202107,892,2691,770,2506,9,39,630,2030,639,2069
250210,202107,1576,4654,1429,4428,54,225,1138,3466,1192,3691
250215,202107,1660,4372,1387,3990,79,235,800,2350,879,2585
250220,202107,671,1832,532,1618,24,82,354,1065,378,1147
250230,202107,1733,3817,1215,3053,20,56,973,2396,993,2452
250240,202107,2469,7187,2176,6667,32,144,1876,5664,1908,5808
250250,202107,4697,12758,4105,11913,90,271,3495,10211,3585,10482
250260,202107,1712,4696,1448,4240,54,124,1140,3335,1194,3459
250270,202107,1228,3653,1118,3516,57,201,847,2744,904,2945
250280,202107,3604,9423,3216,8873,150,341,2539,7058,2689,7399
250290,202107,1555,4064,1334,3744,17,51,1069,2975,1086,3026
250300,202107,5593,14577,5026,13914,151,645,4264,11440,4415,12085
250310,202107,1210,3318,1007,2977,36,115,761,2236,797,2351
250320,202107,12740,27794,10994,25808,254,662,9917,22999,10171,23661
250330,202107,2428,6547,2046,6016,186,427,1577,4747,1763,5174
250340,202107,1179,2915,1041,2739,13,34,952,2497,965,2531
250350,202107,4281,11777,3768,10896,218,460,2953,8846,3171,9306
250355,202107,2092,6112,1877,5826,26,132,1694,5252,1720,5384
250360,202107,1829,4893,1642,4644,37,123,1391,3890,1428,4013
250370,202107,14193,35218,11805,31645,223,740,10022,26455,10245,27195
250375,202107,1219,3086,980,2801,5,18,923,2656,928,2674
250380,202107,1674,4189,1538,4018,33,116,1361,3460,1394,3576
250390,202107,1906,4759,1608,4302,72,187,1294,3436,1366,3623
250400,202107,70996,171758,52561,143592,14449,42804,13901,40498,28350,83302
250403,202107,1831,4980,1639,4757,63,314,1297,3584,1360,3898
250407,202107,1383,3238,1073,2791,104,209,672,1910,776,2119
250410,202107,684,1773,584,1610,7,15,484,1302,491,1317
250415,202107,1933,5266,1685,4880,29,130,1450,4176,1479,4306
250420,202107,1235,3325,1108,3151,26,87,1004,2837,1030,2924
250430,202107,6377,15468,5415,14211,155,431,4445,11442,4600,11873
250435,202107,1597,4417,1285,3894,9,43,981,2925,990,2968
250440,202107,4729,12240,4100,11453,74,169,3634,10154,3708,10323
250450,202107,1842,4809,1519,4366,33,110,1247,3609,1280,3719
250460,202107,7417,19767,6597,18575,392,1127,5251,14766,5643,15893
250470,202107,1567,4006,1292,3578,50,156,1026,2789,1076,2945
250480,202107,4041,10820,3432,10085,38,121,3030,8990,3068,9111
250485,202107,751,1651,560,1385,50,82,389,949,439,1031
250490,202107,5283,12290,4705,11632,159,441,4186,10174,4345,10615
250500,202107,2060,5591,1840,5214,65,183,1495,4243,1560,4426
250510,202107,5566,13715,4805,12707,75,155,4193,11197,4268,11352
250520,202107,1914,5036,1635,4648,104,312,1202,3394,1306,3706
250523,202107,2219,5435,1949,5081,70,267,1629,4103,1699,4370
250527,202107,1701,4268,1528,4076,24,63,1353,3629,1377,3692
250530,202107,656,1649,564,1515,16,41,496,1334,512,1375
250535,202107,1427,4038,1285,3778,23,91,1035,2955,1058,3046
250540,202107,3144,6950,2622,6369,80,143,2305,5718,2385,5861
250550,202107,796,2503,703,2321,20,65,524,1715,544,1780
250560,202107,1796,4877,1579,4568,37,129,1340,3800,1377,3929
250570,202107,2766,8006,2371,7295,81,267,1849,5625,1930,5892
250580,202107,1080,2762,949,2581,42,148,803,2130,845,2278
250590,202107,886,2327,787,2185,19,54,660,1820,679,1874
250600,202107,8258,21164,6873,19339,244,732,5516,15420,5760,16152
250610,202107,3007,8390,2688,7920,107,379,2230,6508,2337,6887
250620,202107,863,2193,741,1988,17,44,530,1410,547,1454
250625,202107,2456,6995,2192,6563,40,191,1873,5472,1913,5663
250630,202107,10694,28605,8753,25303,931,2703,5640,15965,6571,18668
250640,202107,3644,9615,3263,9114,77,291,2858,7883,2935,8174
250650,202107,1000,2368,843,2155,14,37,736,1855,750,1892
250660,202107,1682,4093,1345,3634,43,102,1102,2906,1145,3008
250670,202107,2412,7340,2197,6967,37,157,1919,5974,1956,6131
250680,202107,6014,13695,5380,12986,51,193,5023,11949,5074,12142
250690,202107,6883,15331,5791,13982,109,234,5098,12261,5207,12495
250700,202107,4429,12291,3856,11426,537,1527,2501,7521,3038,9048
250710,202107,4445,12591,3878,11779,275,832,2831,8637,3106,9469
250720,202107,2884,7553,2588,7133,28,139,2324,6348,2352,6487
250730,202107,4257,11091,3733,10401,106,407,3137,8505,3243,8912
250740,202107,2022,4889,1671,4433,99,218,1301,3491,1400,3709
250750,202107,110749,265383,94221,242312,7390,19846,68941,174324,76331,194170
250760,202107,2435,6071,2130,5580,67,176,1743,4457,1810,4633
250770,202107,4135,12175,3706,11602,447,1276,2592,8349,3039,9625
250780,202107,1804,4752,1520,4248,63,192,1183,3240,1246,3432
250790,202107,2598,7429,2253,6915,93,376,1653,4955,1746,5331
250800,202107,2492,6465,2187,5975,102,197,1765,4897,1867,5094
250810,202107,1320,3384,1106,3083,39,73,919,2617,958,2690
250820,202107,2002,5483,1840,5306,28,113,1667,4781,1695,4894
250830,202107,6123,17965,5019,15726,269,969,3361,10242,3630,11211
250840,202107,773,2419,668,2216,17,63,502,1680,519,1743
250850,202107,1831,5283,1639,4939,31,123,1362,4014,1393,4137
250855,202107,1053,2923,910,2696,56,177,704,2079,760,2256
250860,202107,3349,9657,2765,8677,460,1456,1563,4995,2023,6451
250870,202107,1054,2841,899,2591,41,132,724,2063,765,2195
250880,202107,1650,4183,1371,3771,86,246,1046,2868,1132,3114
250890,202107,10635,26519,9398,24899,432,1414,7548,19234,7980,20648
250900,202107,3085,8075,2669,7354,97,216,2246,6146,2343,6362
250905,202107,2594,6987,2397,6717,37,125,2204,6174,2241,6299
250910,202107,6331,15181,5240,13952,64,187,4598,12297,4662,12484
250915,202107,2193,5000,1536,4292,26,53,1345,3852,1371,3905
250920,202107,3658,9075,3220,8413,272,611,2477,6472,2749,7083
250930,202107,2361,6216,2125,5912,44,190,1843,4999,1887,5189
250933,202107,1230,3554,1093,3310,25,103,868,2571,893,2674
250937,202107,744,1985,623,1788,21,70,490,1426,511,1496
250939,202107,1898,4830,1662,4532,58,139,1306,3568,1364,3707
250940,202107,4111,10732,3609,10075,22,71,3234,9038,3256,9109
250950,202107,1787,4517,1442,4066,26,96,1172,3250,1198,3346
250960,202107,1138,3300,1001,3081,26,122,824,2460,850,2582
250970,202107,8406,21307,7390,19681,210,629,6089,15924,6299,16553
250980,202107,2433,6374,2202,6044,24,107,1927,5165,1951,5272
250990,202107,2104,6226,1766,5654,60,232,1318,4180,1378,4412
251000,202107,2072,5768,1674,5081,32,133,1369,4133,1401,4266
251010,202107,2755,7502,2502,7112,23,82,2243,6389,2266,6471
251020,202107,1667,4487,1494,4214,30,126,1293,3580,1323,3706
251030,202107,1067,2771,876,2439,52,129,585,1628,637,1757
251040,202107,1895,5141,1599,4646,27,121,1337,3852,1364,3973
251050,202107,1069,2889,900,2568,45,147,643,1762,688,1909
251060,202107,1111,2323,843,1989,11,32,647,1507,658,1539
251065,202107,495,1325,379,1109,8,23,264,748,272,771
251070,202107,757,1910,632,1729,7,27,543,1444,550,1471
251080,202107,19294,47917,15624,42421,2245,6217,9333,25775,11578,31992
251090,202107,2922,8212,2467,7418,58,174,1946,5828,2004,6002
251100,202107,832,2599,735,2410,24,84,579,1835,603,1919
251110,202107,1792,4640,1518,4161,70,152,1152,3168,1222,3320
251120,202107,7857,21105,6624,19606,316,1033,5178,15427,5494,16460
251130,202107,3979,8684,3500,8148,51,142,3196,7385,3247,7527
251140,202107,4423,12065,3936,11385,69,270,3274,9375,3343,9645
251150,202107,2710,7670,2472,7284,67,291,2117,6088,2184,6379
251160,202107,2245,6413,1940,5965,27,118,1675,5059,1702,5177
251170,202107,1663,4368,1458,4105,20,65,1305,3644,1325,3709
251180,202107,2701,7071,2212,6384,148,411,1553,4505,1701,4916
251190,202107,4536,11637,4100,11143,37,193,3735,9961,3772,10154
251200,202107,4475,12773,3940,12098,73,290,3470,10686,3543,10976
251203,202107,1001,3145,913,2940,21,85,688,2153,709,2238
251207,202107,1145,3029,868,2589,17,71,604,1762,621,1833
251210,202107,7994,19621,6547,17668,330,683,4908,13604,5238,14287
251220,202107,1303,3015,975,2587,72,142,717,1981,789,2123
251230,202107,4825,13141,4163,11968,116,364,3282,9230,3398,9594
251240,202107,3720,10132,3124,9128,174,445,2314,6738,2488,7183
251250,202107,10980,28752,9621,26455,676,1846,7174,19228,7850,21074
251260,202107,517,1408,468,1329,13,53,374,1029,387,1082
251270,202107,4363,13345,3909,12723,109,417,3187,10591,3296,11008
251272,202107,1337,3620,1220,3465,59,194,1013,2822,1072,3016
251274,202107,925,2532,741,2200,60,190,483,1379,543,1569
251275,202107,1242,3451,1053,3142,29,116,829,2404,858,2520
251276,202107,1348,3634,1171,3396,23,115,958,2693,981,2808
251278,202107,624,1668,562,1576,40,106,432,1223,472,1329
251280,202107,2292,6087,2086,5783,52,138,1756,4840,1808,4978
251290,202107,6365,14285,5785,13588,173,468,5111,11709,5284,12177
251300,202107,898,2599,810,2465,9,46,686,2076,695,2122
251310,202107,2875,7911,2505,7355,33,171,2083,5994,2116,6165
251315,202107,1805,5465,1636,5138,125,338,1217,3822,1342,4160
251320,202107,1664,4359,1223,3594,28,94,917,2649,945,2743
251330,202107,2142,4944,1772,4509,25,73,1580,4054,1605,4127
251335,202107,1130,3132,1012,2954,22,95,890,2548,912,2643
251340,202107,3833,8962,3065,7956,129,328,2355,6131,2484,6459
251350,202107,1089,3041,992,2881,30,91,813,2338,843,2429
251360,202107,1896,5184,1529,4659,10,58,1264,3858,1274,3916
251365,202107,775,2028,607,1706,5,14,486,1347,491,1361
251370,202107,25430,65491,21742,60291,3214,8717,12488,35916,15702,44633
251380,202107,1303,3532,1110,3207,13,77,953,2690,966,2767
251385,202107,782,1965,606,1652,22,58,449,1187,471,1245
251390,202107,6580,18710,5810,17510,535,1576,3857,11773,4392,13349
251392,202107,1015,2710,857,2471,27,106,675,1914,702,2020
251394,202107,645,1809,521,1595,34,99,370,1133,404,1232
251396,202107,667,1794,565,1611,16,44,392,1095,408,1139
251398,202107,1040,2567,736,2040,17,55,549,1490,566,1545
251400,202107,1338,3088,1051,2701,22,79,857,2134,879,2213
251410,202107,1587,3666,1279,3230,21,79,1082,2632,1103,2711
251420,202107,2025,5188,1664,4760,36,117,1336,3784,1372,3901
251430,202107,1597,4735,1436,4457,32,146,1237,3823,1269,3969
251440,202107,1114,3060,902,2668,42,95,697,2108,739,2203
251445,202107,1581,4331,1457,4158,31,93,1251,3526,1282,3619
251450,202107,4452,12969,3980,12244,80,290,3321,10148,3401,10438
251455,202107,887,2640,811,2501,17,68,653,1970,670,2038
251460,202107,982,2735,841,2519,15,46,692,2083,707,2129
251465,202107,472,1336,405,1211,7,28,305,885,312,913
251470,202107,1212,3267,915,2670,76,227,527,1480,603,1707
251480,202107,1042,2677,854,2348,13,47,662,1744,675,1791
251490,202107,1975,5071,1577,4517,78,208,1167,3381,1245,3589
251500,202107,2028,5556,1862,5349,37,135,1685,4827,1722,4962
251510,202107,2745,8014,2295,7134,122,398,1575,4789,1697,5187
251520,202107,1065,2678,825,2248,72,179,532,1416,604,1595
251530,202107,15096,35498,12172,31875,86,456,10823,27884,10909,28340
251540,202107,3130,8662,2810,8094,67,233,2388,6791,2455,7024
251550,202107,3991,9092,3195,8130,135,212,2630,6812,2765,7024
251560,202107,565,1702,504,1608,54,183,352,1090,406,1273
251570,202107,972,2689,796,2343,21,93,637,1827,658,1920
251580,202107,2006,4736,1806,4456,34,120,1555,3700,1589,3820
251590,202107,1642,3950,1388,3652,68,163,1149,2989,1217,3152
251593,202107,952,2745,855,2579,91,276,549,1655,640,1931
251597,202107,2140,5930,1920,5639,20,103,1723,4995,1743,5098
251600,202107,6501,17193,5671,15931,202,557,4641,12904,4843,13461
251610,202107,3177,8992,2752,8209,245,650,1870,5708,2115,6358
251615,202107,1335,3232,1074,2839,22,63,870,2227,892,2290
251620,202107,19693,44115,15112,38518,78,264,13079,33646,13157,33910
251630,202107,4934,11286,3964,9944,204,494,2967,7399,3171,7893
251640,202107,2300,6022,2056,5652,21,94,1844,4964,1865,5058
251650,202107,4029,10656,3496,9962,131,381,2935,8376,3066,8757
251660,202107,3641,10619,3220,9897,57,238,2683,8137,2740,8375
251670,202107,4214,11543,3725,10844,38,181,3357,9714,3395,9895
251675,202107,708,1880,639,1797,92,228,437,1263,529,1491
251680,202107,2638,6723,2208,6166,43,130,1819,5123,1862,5253
251690,202107,3172,8792,2704,7995,75,219,2066,6079,2141,6298
251700,202107,2268,6156,1890,5692,40,155,1604,4744,1644,4899
251710,202107,811,2044,573,1568,35,111,340,874,375,985
251720,202107,1352,3752,1097,3319,19,82,855,2505,874,2587
251740,202107,610,1685,486,1451,41,148,325,932,366,1080
260005,202107,30466,63603,25143,56783,1832,3985,19129,42470,20961,46455
260010,202107,10604,27141,8768,24210,476,1341,5209,14486,5685,15827
260020,202107,7009,16048,5903,14474,64,278,5045,12145,5109,12423
260030,202107,7034,17585,5929,15991,126,372,4843,12980,4969,13352
260040,202107,7883,19455,6647,17706,415,1076,4873,13167,5288,14243
260050,202107,14259,36398,11877,33771,221,679,10912,31201,11133,31880
260060,202107,4325,10270,3715,9314,291,579,2795,7193,3086,7772
260070,202107,11011,26940,9440,24711,320,1043,7670,19570,7990,20613
260080,202107,6587,14901,5730,13765,115,338,4817,11400,4932,11738
260090,202107,4806,12096,4293,11393,383,995,3238,8637,3621,9632
260100,202107,3030,8066,2550,7353,33,169,2144,6088,2177,6257
260105,202107,5103,13749,4579,13043,119,389,3896,10959,4015,11348
260110,202107,22692,62038,20220,58465,851,2799,16811,47972,17662,50771
260120,202107,14803,38319,12501,34957,1441,3872,8061,22902,9502,26774
260130,202107,3255,8057,2881,7519,234,552,2140,5533,2374,6085
260140,202107,13073,28992,11259,26857,494,1318,9561,22458,10055,23776
260150,202107,3610,8301,3122,7702,92,216,2746,6752,2838,6968
260160,202107,6681,17057,5667,15831,94,301,5144,14484,5238,14785
260170,202107,21242,48709,18072,44439,935,2208,14447,35204,15382,37412
260180,202107,3623,9368,3128,8699,68,235,2712,7439,2780,7674
260190,202107,18568,36737,15682,33361,197,450,13948,29162,14145,29612
260200,202107,11381,26720,9815,24728,515,1035,8207,21084,8722,22119
260210,202107,11701,32584,9952,29749,287,999,7958,23683,8245,24682
260220,202107,11023,25317,10165,24240,172,442,9065,21342,9237,21784
260230,202107,11047,26345,9615,24455,198,514,8146,20446,8344,20960
260240,202107,2830,8294,2475,7616,89,304,1914,5815,2003,6119
260250,202107,2298,5797,2009,5348,116,222,1569,4204,1685,4426
260260,202107,13044,33047,11614,30903,378,1152,9311,24362,9689,25514
260270,202107,4460,10477,3906,9830,97,352,3332,8254,3429,8606
260280,202107,13029,38282,11747,36462,405,1646,10060,30775,10465,32421
260290,202107,42310,104271,36406,95864,3857,10290,24887,65300,28744,75590
260300,202107,9823,25961,8574,24277,173,673,7321,20652,7494,21325
260310,202107,5601,13709,4932,12877,353,758,3797,10134,4150,10892
260320,202107,7993,22533,6790,20506,223,644,5557,16831,5780,17475
260330,202107,2634,7898,2300,7220,58,187,1835,5626,1893,5813
260340,202107,2112,5532,1835,5129,23,96,1615,4420,1638,4516
260345,202107,26607,66612,22240,60371,3363,9587,11784,31365,15147,40952
260350,202107,5803,13160,5015,12267,50,142,4512,10966,4562,11108
260360,202107,2636,6636,2378,6180,43,139,1725,4393,1768,4532
260370,202107,5714,15880,4920,14571,201,590,3834,11280,4035,11870
260380,202107,5168,14775,4433,13581,167,485,3385,10293,3552,10778
260390,202107,4799,13980,3971,12303,221,599,2674,8196,2895,8795
260392,202107,3563,10965,3227,10551,88,518,2687,8770,2775,9288
260400,202107,19460,43556,16784,40100,452,1146,13425,30923,13877,32069
260410,202107,76822,181228,60079,158136,10742,29263,26660,72590,37402,101853
260415,202107,4516,11735,3899,10760,44,167,3260,8848,3304,9015
260420,202107,12725,26286,10822,24191,84,236,10080,22355,10164,22591
260430,202107,2834,8577,2436,7790,122,410,1686,5343,1808,5753
260440,202107,3833,9590,3411,8981,65,204,2929,7598,2994,7802
260450,202107,5876,14456,5252,13648,286,545,4373,11586,4659,12131
260460,202107,5428,15524,4629,14153,476,1587,2817,8478,3293,10065
260470,202107,4988,12946,4209,12054,75,152,3861,11218,3936,11370
260480,202107,4180,10639,3522,9715,290,803,2414,6788,2704,7591
260490,202107,5434,12352,4817,11472,28,126,4408,10335,4436,10461
260500,202107,6225,15151,5323,13900,402,911,3787,10060,4189,10971
260510,202107,10191,24512,8546,22222,92,337,7538,19414,7630,19751
260515,202107,4581,11858,3607,10079,151,364,2489,6759,2640,7123
260520,202107,17076,38717,14872,35948,708,1638,12245,29272,12953,30910
260530,202107,10022,28262,8540,25995,116,544,7399,22234,7515,22778
260540,202107,7396,15894,6533,14811,138,313,5904,13311,6042,13624
260545,202107,73,222,48,162,3,12,21,67,24,79
260550,202107,3237,8588,2630,7616,139,428,1818,5159,1957,5587
260560,202107,6144,15421,5172,14014,111,392,4364,11628,4475,12020
260570,202107,8021,21025,7090,19776,336,969,5745,16069,6081,17038
260580,202107,4582,10706,4123,10102,23,68,3781,9219,3804,9287
260590,202107,7245,15750,6128,14523,219,462,5254,12556,5473,13018
260600,202107,32352,81277,26452,72445,1035,3016,20315,54542,21350,57558
260610,202107,7724,19363,6887,18272,437,1125,5157,13728,5594,14853
260620,202107,17336,43177,15216,40196,1238,3559,11265,29184,12503,32743
260630,202107,2466,6520,2017,5828,42,133,1642,4668,1684,4801
260640,202107,22871,50072,19313,46006,817,1908,15846,37503,16663,39411
260650,202107,6464,16242,5212,14728,505,874,4145,12247,4650,13121
260660,202107,7244,18313,6312,17090,240,757,5407,14416,5647,15173
260670,202107,2325,5955,1918,5312,79,199,1358,3663,1437,3862
260680,202107,29867,69821,25192,63258,1905,4856,17642,43608,19547,48464
260690,202107,3613,9203,3018,8287,68,245,2391,6520,2459,6765
260700,202107,6469,17547,5978,16991,20,69,5798,16562,5818,16631
260710,202107,1405,3595,1195,3283,32,114,942,2587,974,2701
260720,202107,26925,62408,22824,57285,2243,5322,16407,41878,18650,47200
260730,202107,8163,22573,7139,21167,233,737,6024,17665,6257,18402
260740,202107,1360,3815,1141,3456,14,64,903,2798,917,2862
260750,202107,7361,19716,6055,18119,242,482,5277,16316,5519,16798
260760,202107,6084,13712,5239,12730,163,378,4433,10805,4596,11183
260765,202107,8528,23636,7424,22121,350,1292,5350,15621,5700,16913
260770,202107,4021,9970,3339,8848,116,351,2639,6890,2755,7241
260775,202107,5433,14073,4763,13083,173,580,3773,10046,3946,10626
260780,202107,3833,11021,3427,10381,407,1260,2114,6299,2521,7559
260790,202107,125377,274434,103822,246877,15620,35764,64386,153776,80006,189540
260795,202107,3088,7626,2644,7065,87,257,2114,5701,2201,5958
260800,202107,5551,12542,5007,11806,179,460,4360,9986,4539,10446
260805,202107,3780,10317,3211,9353,206,616,2343,6775,2549,7391
260810,202107,6777,17720,5971,16210,434,1055,4442,11878,4876,12933
260820,202107,4655,10519,4146,9935,92,269,3471,8204,3563,8473
260825,202107,3066,8822,2701,8190,110,337,2043,6147,2153,6484
260830,202107,4320,12275,3587,10990,486,1273,2235,7129,2721,8402
260840,202107,4322,10911,3872,10306,225,511,3247,8692,3472,9203
260845,202107,4674,11892,4135,10996,254,693,3110,8107,3364,8800
260850,202107,5349,14106,4477,12498,347,1003,2887,7802,3234,8805
260860,202107,3469,9678,2975,8840,97,306,2406,6997,2503,7303
260870,202107,4597,10856,3944,10061,65,236,3531,8899,3596,9135
260875,202107,7642,17950,6237,15933,537,1303,4340,11226,4877,12529
260880,202107,9896,27264,8623,25131,430,1238,6789,19773,7219,21011
260890,202107,13364,33241,11609,30618,678,1806,8410,21688,9088,23494
260900,202107,5634,15126,4648,13758,291,868,3180,9395,3471,10263
260910,202107,3352,8868,2919,8224,105,287,2305,6470,2410,6757
260915,202107,5127,14866,4487,14119,48,206,4118,12982,4166,13188
260920,202107,3586,8295,3048,7711,123,226,2589,6662,2712,6888
260930,202107,4127,12109,3571,11142,165,567,2753,8371,2918,8938
260940,202107,15406,35692,13415,32967,1114,2677,10014,24287,11128,26964
260950,202107,7465,19243,6031,16830,356,1166,3989,10556,4345,11722
260960,202107,74407,160822,60145,142842,6173,14743,39284,92235,45457,106978
260970,202107,5997,15008,5324,14115,277,554,3945,10771,4222,11325
260980,202107,4715,13360,4137,12645,52,157,3781,11675,3833,11832
260990,202107,18942,49654,16053,45721,821,2265,12632,35678,13453,37943
261000,202107,17020,38721,14351,35396,411,1177,11628,28081,12039,29258
261010,202107,2397,6162,2109,5781,96,206,1815,5029,1911,5235
261020,202107,6594,16804,5730,15406,272,692,4719,12420,4991,13112
261030,202107,4175,11832,3675,10960,114,430,2936,8522,3050,8952
261040,202107,5584,15589,4566,13703,142,502,3515,10253,3657,10755
261050,202107,8327,20532,7558,19401,395,677,5993,15511,6388,16188
261060,202107,14696,35843,12828,33606,251,761,10811,28017,11062,28778
261070,202107,68459,145525,56842,130415,3282,7060,43234,97277,46516,104337
261080,202107,6972,16231,6338,15463,146,318,5867,14315,6013,14633
261090,202107,20239,46293,18002,43409,350,999,15816,37541,16166,38540
261100,202107,8876,23349,7766,21727,522,1431,5813,16296,6335,17727
261110,202107,70680,191337,59451,171221,7869,23646,35541,100964,43410,124610
261120,202107,3714,9157,3227,8482,70,159,2794,7341,2864,7500
261130,202107,7549,17963,6634,16759,121,349,5874,14705,5995,15054
261140,202107,3852,8663,3436,8118,198,476,2703,6304,2901,6780
261150,202107,5373,13806,4753,12880,85,281,4100,11000,4185,11281
261153,202107,1957,5779,1650,5188,54,174,1112,3518,1166,3692
261160,202107,224235,504928,182646,448657,43455,109614,76962,192956,120417,302570
261170,202107,6667,15539,5884,14467,252,518,4909,12003,5161,12521
261180,202107,9783,23763,8538,22158,496,1148,6218,16363,6714,17511
261190,202107,4766,13443,4281,12666,142,616,3453,9913,3595,10529
261200,202107,3474,7784,3074,7255,197,469,2526,5878,2723,6347
261210,202107,1975,4711,1696,4318,76,187,1403,3521,1479,3708
261220,202107,14397,39114,12118,35071,1419,4280,7177,20437,8596,24717
261230,202107,4167,11603,3489,10692,38,138,2934,9085,2972,9223
261240,202107,5667,13587,4987,12537,319,705,4040,10109,4359,10814
261245,202107,3905,10556,3264,9442,71,316,2624,7313,2695,7629
261247,202107,3107,8930,2594,8026,145,447,1841,5643,1986,6090
261250,202107,23878,52689,20756,49089,2703,5744,14504,35688,17207,41432
261255,202107,4258,12112,3499,10653,129,494,2703,8043,2832,8537
261260,202107,13179,34508,11507,32335,302,1079,10055,27972,10357,29051
261270,202107,4674,11012,4084,10281,198,449,3371,8486,3569,8935
261280,202107,2584,7076,2267,6541,61,204,1808,5073,1869,5277
261290,202107,3011,7647,2518,7089,57,206,2047,5831,2104,6037
261300,202107,13104,35211,11212,32082,495,1709,8465,23614,8960,25323
261310,202107,9344,22900,8013,21117,573,1614,6015,15523,6588,17137
261320,202107,6239,17014,5438,15710,74,293,4660,13298,4734,13591
261330,202107,5870,14134,5294,13388,113,392,4627,11467,4740,11859
261340,202107,4414,11896,3844,11177,123,437,3231,9283,3354,9720
261350,202107,8922,25815,7879,24044,118,458,6412,19380,6530,19838
261360,202107,8412,19632,7110,17808,239,613,5728,13987,5967,14600
261370,202107,24874,60439,20879,55041,2355,5801,13447,35976,15802,41777
261380,202107,4270,12391,3776,11557,422,1365,2538,7686,2960,9051
261390,202107,17374,48014,14681,43736,1157,3709,9852,29050,11009,32759
261400,202107,4753,14614,4164,13347,191,715,3127,9797,3318,10512
261410,202107,9960,24173,8202,21519,366,1055,6622,16940,6988,17995
261420,202107,7655,22068,6911,21169,666,2269,5048,15437,5714,17706
261430,202107,3583,9800,3053,8972,48,190,2576,7458,2624,7648
261440,202107,1513,4398,1262,3934,49,210,904,2708,953,2918
261450,202107,15032,39880,13283,37235,163,553,10993,30955,11156,31508
261460,202107,7913,21008,6947,19517,293,832,5567,15634,5860,16466
261470,202107,4251,10337,3670,9537,30,113,3174,8209,3204,8322
261480,202107,5313,15763,4584,14543,209,748,3567,11140,3776,11888
261485,202107,5199,14236,4523,13211,348,1088,3348,9668,3696,10756
261500,202107,6283,15537,5483,14459,403,883,3795,10456,4198,11339
261510,202107,1946,5655,1697,5249,59,212,1296,4035,1355,4247
261520,202107,2390,7172,2151,6695,59,194,1599,4955,1658,5149
261530,202107,12634,35464,10272,31313,827,2880,5507,16057,6334,18937
261540,202107,8753,23986,7920,22822,1242,3344,4426,13626,5668,16970
261550,202107,3794,9862,3283,9079,243,679,2365,6429,2608,7108
261560,202107,8225,23355,7162,21789,300,1004,5625,17103,5925,18107
261570,202107,3580,9496,2856,8323,169,559,1980,5698,2149,6257
261580,202107,7045,18083,6093,16788,93,417,5503,14959,5596,15376
261590,202107,2804,7006,2285,6275,78,232,1725,4708,1803,4940
261600,202107,5512,13223,4694,12044,285,581,3376,8833,3661,9414
261610,202107,2185,6199,1755,5408,117,416,1154,3540,1271,3956
261618,202107,2617,6319,2291,5850,79,181,1854,4696,1933,4877
261620,202107,4279,11819,3895,11249,746,1904,2552,7697,3298,9601
261630,202107,6238,17314,5307,15581,369,1214,3530,10001,3899,11215
261640,202107,38751,84535,33044,77593,1975,3456,24977,60728,26952,64184
261650,202107,4345,10399,3697,9581,179,455,2807,7258,2986,7713
270010,202107,4529,14763,3924,13733,121,671,3176,10812,3297,11483
270020,202107,4030,9852,3533,9223,125,389,3041,7758,3166,8147
270030,202107,35113,93394,29323,84182,3288,9331,20145,57636,23433,66967
270040,202107,11289,28888,9721,27026,383,1146,8191,22674,8574,23820
270050,202107,5685,12918,4839,11963,374,686,4080,10367,4454,11053
270060,202107,2327,5756,1955,5329,169,386,1536,4277,1705,4663
270070,202107,4805,13249,4170,12373,110,394,3508,10226,3618,10620
270080,202107,1496,4008,1270,3630,43,124,988,2736,1031,2860
270090,202107,1829,5431,1645,5080,43,165,1385,4187,1428,4352
270100,202107,5852,14548,5069,13421,205,595,4244,11042,4449,11637
270110,202107,3382,7604,2752,6886,148,287,2185,5762,2333,6049
270120,202107,2707,7357,2351,6873,66,260,1975,5674,2041,5934
270130,202107,5248,13180,4556,12345,156,454,3895,10577,4051,11031
270135,202107,2076,4898,1757,4544,30,102,1621,4158,1651,4260
270140,202107,9850,22730,7915,20065,347,1001,6207,15071,6554,16072
270150,202107,2703,8091,2459,7741,3,19,2320,7289,2323,7308
270160,202107,6242,16593,5322,15543,110,371,4884,14325,4994,14696
270170,202107,3455,9884,2905,9118,161,704,2215,6678,2376,7382
270180,202107,2303,7048,2113,6807,38,186,1916,6102,1954,6288
270190,202107,1783,5035,1588,4800,22,102,1438,4324,1460,4426
270200,202107,2541,7516,2209,7050,88,278,1657,5287,1745,5565
270210,202107,5918,13591,5047,12599,56,196,4671,11511,4727,11707
270220,202107,1701,4277,1354,3779,175,492,856,2354,1031,2846
270230,202107,9735,26025,8135,23579,779,2290,5785,16796,6564,19086
270235,202107,6086,18225,5272,16937,138,478,4429,14131,4567,14609
270240,202107,11510,30314,9486,27541,928,2710,6790,19920,7718,22630
270250,202107,2952,7120,2603,6630,180,419,2116,5390,2296,5809
270255,202107,4600,12906,3637,11184,107,406,2814,8515,2921,8921
270260,202107,5614,16429,5083,15551,94,439,4453,13356,4547,13795
270270,202107,1091,2767,911,2544,105,280,670,1888,775,2168
270280,202107,3951,9367,3173,8399,524,779,2204,6374,2728,7153
270290,202107,7842,24207,7067,22953,120,597,6251,20069,6371,20666
270300,202107,4390,11130,3425,10080,191,443,2659,8064,2850,8507
270310,202107,7189,19635,6185,18098,73,381,5385,15424,5458,15805
270320,202107,5667,16405,4911,14956,326,1006,3593,10654,3919,11660
270330,202107,4133,13002,3667,12293,231,912,2909,9704,3140,10616
270340,202107,1641,4266,1413,3962,42,113,1216,3369,1258,3482
270350,202107,1932,4425,1571,4009,125,339,1140,2940,1265,3279
270360,202107,2741,6671,2451,6348,90,182,2259,5903,2349,6085
270370,202107,1448,4344,1324,4122,31,138,1141,3499,1172,3637
270375,202107,3174,7327,2648,6751,22,58,2485,6350,2507,6408
270380,202107,5694,15376,4804,14248,528,1427,3389,10400,3917,11827
270390,202107,1258,3109,1017,2830,16,60,857,2401,873,2461
270400,202107,6730,16985,5668,15418,237,549,4585,12425,4822,12974
270410,202107,4814,13553,4184,12606,134,457,3530,10594,3664,11051
270420,202107,5855,16788,5262,15924,110,466,4599,13669,4709,14135
270430,202107,140621,325895,110571,287571,20912,55888,53002,140543,73914,196431
270440,202107,4855,12760,4214,11979,76,291,3737,10526,3813,10817
270450,202107,7360,19130,6450,18029,282,797,5374,15305,5656,16102
270460,202107,3825,8385,3268,7722,160,293,2937,6981,3097,7274
270470,202107,11348,30893,9909,28882,611,1938,7758,22639,8369,24577
270480,202107,3031,7829,2554,7150,87,304,2098,5757,2185,6061
270490,202107,968,2613,846,2464,50,144,682,1986,732,2130
270500,202107,5036,15007,4477,14078,257,877,3566,11097,3823,11974
270510,202107,5861,14995,4939,13838,374,1203,3692,10028,4066,11231
270520,202107,4246,11675,3380,10236,718,2214,1361,4368,2079,6582
270530,202107,1347,3765,1136,3434,59,158,805,2480,864,2638
270540,202107,2332,6393,1993,5959,53,189,1741,5152,1794,5341
270550,202107,7009,17644,5595,16082,724,1655,3995,12062,4719,13717
270560,202107,3090,7760,2619,7124,163,464,2096,5644,2259,6108
270570,202107,4348,11699,3703,10744,250,640,2934,8555,3184,9195
270580,202107,2327,6461,2102,6145,113,324,1796,5229,1909,5553
270590,202107,1614,4823,1488,4652,14,69,1406,4385,1420,4454
270600,202107,2815,8529,2546,8122,42,198,2268,7155,2310,7353
270610,202107,3716,9537,3222,8882,96,248,2864,7880,2960,8128
270620,202107,1297,3798,1196,3612,23,84,1041,3063,1064,3147
270630,202107,18014,43189,15534,39813,657,1896,13005,32709,13662,34605
270640,202107,5593,15617,4905,14523,171,641,4080,11890,4251,12531
270642,202107,2583,8178,2292,7726,154,605,1748,5807,1902,6412
270644,202107,3808,9287,3153,8447,401,920,2250,6278,2651,7198
270650,202107,3324,9409,2905,8842,305,962,2193,6680,2498,7642
270660,202107,2034,5097,1742,4688,78,244,1334,3540,1412,3784
270670,202107,17117,38320,14305,34888,384,1037,12316,29357,12700,30394
270680,202107,5719,13287,5122,12639,124,181,4794,11991,4918,12172
270690,202107,9620,23214,8076,21271,353,945,6542,17088,6895,18033
270700,202107,539,1576,473,1463,38,114,345,1060,383,1174
270710,202107,5702,16618,5066,15642,262,875,4057,12417,4319,13292
270720,202107,3707,10537,3307,9875,57,280,2942,8621,2999,8901
270730,202107,8383,18034,7363,16947,326,525,5748,14726,6074,15251
270740,202107,2417,6245,2129,5909,86,281,1778,4880,1864,5161
270750,202107,5852,14989,5121,14076,60,242,4579,12486,4639,12728
270760,202107,3473,9472,2943,8754,53,220,2467,7295,2520,7515
270770,202107,21576,52090,17340,46852,2893,6904,10428,29903,13321,36807
270780,202107,1902,4955,1755,4750,58,183,1566,4195,1624,4378
270790,202107,1734,4555,1457,4172,116,336,1088,3104,1204,3440
270800,202107,11342,30110,10242,28554,361,1165,8794,24260,9155,25425
270810,202107,3446,9552,2733,8389,171,583,1922,5813,2093,6396
270820,202107,1661,4833,1415,4446,46,206,1131,3485,1177,3691
270830,202107,5223,12382,4224,11152,159,511,3443,8932,3602,9443
270840,202107,8586,25074,7645,23722,148,720,6688,20337,6836,21057
270850,202107,9133,21284,8067,20033,748,1879,6593,16280,7341,18159
270860,202107,14915,32225,11866,28810,587,1237,9665,23476,10252,24713
270870,202107,2306,6287,1890,5618,264,707,1186,3715,1450,4422
270880,202107,8197,24260,7319,22934,203,835,6147,18978,6350,19813
270890,202107,3138,8275,2637,7564,206,595,1805,5162,2011,5757
270895,202107,3257,9638,2939,9229,68,365,2622,8076,2690,8441
270900,202107,1802,4537,1370,3859,26,68,1081,3022,1107,3090
270910,202107,4123,11566,3575,10716,97,276,2993,8859,3090,9135
270915,202107,10034,27693,8130,24628,659,2216,5604,16590,6263,18806
270920,202107,5727,16523,5206,15688,83,369,4507,13255,4590,13624
270930,202107,17817,40200,13803,35553,1750,3949,9260,25313,11010,29262
270940,202107,6751,17202,5692,15925,184,680,4551,12366,4735,13046
280010,202107,699,1903,563,1626,15,58,403,1066,418,1124
280020,202107,5074,12527,4277,11280,393,986,2986,7900,3379,8886
280030,202107,79791,182405,63770,160031,12644,31535,30103,78130,42747,109665
280040,202107,3014,8092,2631,7517,259,700,1823,5240,2082,5940
280050,202107,4108,11440,3504,10520,655,1953,1917,5782,2572,7735
280060,202107,6476,16130,5149,14124,906,2594,2513,7158,3419,9752
280067,202107,7213,17234,6130,15591,289,725,4543,11416,4832,12141
280070,202107,1895,5571,1759,5354,110,323,1456,4408,1566,4731
280100,202107,4134,10650,3478,9630,349,959,2339,6517,2688,7476
280110,202107,1509,3857,1324,3584,13,49,1188,3141,1201,3190
280120,202107,7718,21693,6861,20334,794,2114,4921,15013,5715,17127
280130,202107,9201,21211,8040,19610,419,1067,6493,15723,6912,16790
280140,202107,5651,13143,4977,12227,258,663,4132,10106,4390,10769
280150,202107,4323,10589,3753,9817,470,1056,2723,7298,3193,8354
280160,202107,1211,3420,1024,3115,94,326,701,2078,795,2404
280170,202107,5330,13647,4785,12963,264,620,3851,10508,4115,11128
280190,202107,1349,2878,1203,2686,49,113,1018,2229,1067,2342
280200,202107,1301,3320,1083,3019,58,192,829,2272,887,2464
280210,202107,17757,42246,15457,39024,1723,4196,9949,25230,11672,29426
280220,202107,1754,4619,1504,4292,47,186,1245,3529,1292,3715
280230,202107,4553,11046,3775,9887,334,674,2599,6973,2933,7647
280240,202107,3413,8918,3035,8349,33,167,2641,7082,2674,7249
280250,202107,953,2219,792,1976,85,215,548,1335,633,1550
280260,202107,2302,5415,2021,5060,38,86,1836,4642,1874,4728
280270,202107,2519,6637,2236,6216,171,429,1787,4995,1958,5424
280280,202107,4235,12259,3768,11565,549,1426,2554,8279,3103,9705
280290,202107,19035,48329,16353,44573,1368,3783,11011,30255,12379,34038
280300,202107,12677,29057,11101,27370,350,766,8102,22132,8452,22898
280310,202107,1429,3612,1197,3231,41,120,902,2385,943,2505
280320,202107,8964,23452,7765,21668,996,2581,5153,14386,6149,16967
280330,202107,4814,11647,4099,10664,253,676,3012,7852,3265,8528
280340,202107,5693,11763,4726,10707,269,417,4042,9400,4311,9817
280350,202107,26799,61344,23576,57117,1090,2669,18762,44752,19852,47421
280360,202107,5745,15600,5038,14447,681,1949,3020,8861,3701,10810
280370,202107,2253,5362,1879,4751,81,156,1487,3719,1568,3875
280380,202107,1038,2676,880,2468,76,202,596,1707,672,1909
280390,202107,3794,8980,3210,8090,195,392,2512,6397,2707,6789
280400,202107,3988,9719,3466,9021,537,1216,2177,5962,2714,7178
280410,202107,2473,6523,2033,5845,162,457,1273,3599,1435,4056
280420,202107,4413,11453,4070,11022,70,254,3749,10099,3819,10353
280430,202107,2152,5084,1891,4747,62,190,1557,3791,1619,3981
280440,202107,4430,11339,3913,10577,137,431,3326,8768,3463,9199
280445,202107,2431,6053,2179,5633,50,123,1685,4208,1735,4331
280450,202107,10393,23974,9005,22101,1136,2374,5748,14880,6884,17254
280460,202107,7110,16295,6433,15380,430,890,5366,12814,5796,13704
280470,202107,1729,4755,1468,4276,96,293,1067,3051,1163,3344
280480,202107,45780,107718,39570,99007,3314,8484,27998,68715,31312,77199
280490,202107,3849,10774,3303,9846,94,358,2571,7454,2665,7812
280500,202107,1032,2389,889,2201,23,57,758,1848,781,1905
280510,202107,2709,6513,2351,6023,62,206,1864,4647,1926,4853
280520,202107,1758,4261,1549,3974,90,200,1223,3120,1313,3320
280530,202107,2502,6149,2187,5712,211,450,1626,4329,1837,4779
280540,202107,8967,23641,8160,22483,252,783,7152,19512,7404,20295
280550,202107,6690,15286,5538,13680,157,537,4621,11022,4778,11559
280560,202107,7551,20199,7082,19507,114,401,6307,17152,6421,17553
280570,202107,6631,15765,5373,14205,245,686,3946,10561,4191,11247
280580,202107,5905,15027,5155,13946,546,1249,3720,10248,4266,11497
280590,202107,2961,6616,2541,6117,123,414,2004,4615,2127,5029
280600,202107,3825,9666,3410,9092,288,678,2401,6478,2689,7156
280610,202107,2552,6113,2295,5740,134,331,1886,4677,2020,5008
280620,202107,5689,13435,4893,12394,426,887,3462,9157,3888,10044
280630,202107,4050,10776,3730,10349,214,586,3024,8421,3238,9007
280640,202107,2411,6298,2133,5986,49,135,1913,5401,1962,5536
280650,202107,1236,3201,1008,2861,86,279,723,1962,809,2241
280660,202107,3854,8179,3306,7549,283,454,2688,6336,2971,6790
280670,202107,20341,45462,17558,41890,1421,3246,13338,31827,14759,35073
280680,202107,2838,6656,2441,6091,236,435,1749,4479,1985,4914
280690,202107,999,2336,849,2149,53,121,678,1685,731,1806
280700,202107,1211,2950,1048,2710,21,52,832,2119,853,2171
280710,202107,15743,34559,13358,31851,616,1032,11217,27539,11833,28571
280720,202107,2742,6150,2276,5588,41,135,1694,4312,1735,4447
280730,202107,1119,2810,990,2612,62,165,736,1874,798,2039
280740,202107,14842,34801,12743,31651,913,2259,9210,22421,10123,24680
280750,202107,3736,10145,3234,9280,191,559,2344,6643,2535,7202
280760,202107,6755,17206,5887,15893,646,1547,3806,10695,4452,12242
290010,202107,3233,6700,2114,4980,5,17,1754,3968,1759,3985
290020,202107,5472,14257,4980,13640,347,627,4188,11893,4535,12520
290030,202107,4797,10636,3868,9626,184,405,3251,8222,3435,8627
290035,202107,5341,11307,4420,10124,351,518,3520,8396,3871,8914
290040,202107,4434,10387,3759,9581,133,308,2894,7890,3027,8198
290050,202107,2105,6621,1771,5912,102,409,1235,4018,1337,4427
290060,202107,1392,3165,1033,2626,141,325,637,1642,778,1967
290070,202107,38399,82158,33058,75576,1854,4315,25827,58369,27681,62684
290080,202107,5366,15424,4654,14368,488,1535,3195,10038,3683,11573
290090,202107,2219,4210,1562,3510,18,48,1418,3175,1436,3223
290100,202107,9971,25504,8060,22716,1395,3635,4239,12639,5634,16274
290110,202107,5342,13747,4717,12776,431,1127,3267,8851,3698,9978
290115,202107,4149,11870,3522,10762,274,808,2664,8185,2938,8993
290120,202107,6720,16207,5651,14725,136,418,4835,12387,4971,12805
290130,202107,4911,11631,3825,10202,175,412,2942,7940,3117,8352
290135,202107,4408,10179,3621,8919,145,366,2889,6875,3034,7241
290140,202107,4591,11732,3558,10378,82,296,3031,8818,3113,9114
290150,202107,2649,6493,2262,6027,149,353,1726,4696,1875,5049
290160,202107,3617,7868,3217,7326,238,445,2619,5991,2857,6436
290170,202107,3457,8587,3052,8148,105,237,2719,7384,2824,7621
290180,202107,3070,8237,2544,7379,71,231,2098,6041,2169,6272
290190,202107,4421,11919,3909,11239,98,355,3282,9288,3380,9643
290195,202107,2420,5824,1938,5200,29,107,1660,4433,1689,4540
290200,202107,4282,11605,3459,10216,158,486,2603,7606,2761,8092
290205,202107,3616,8993,3223,8431,174,489,2544,6527,2718,7016
290210,202107,13251,35811,11736,33499,821,2077,9184,26589,10005,28666
290220,202107,3024,7187,2649,6708,116,285,2177,5501,2293,5786
290225,202107,3313,6929,2527,6103,126,208,2166,5321,2292,5529
290230,202107,2609,6666,2386,6395,40,98,2156,5797,2196,5895
290240,202107,3814,9393,3023,8424,67,216,2548,7094,2615,7310
290250,202107,4019,11516,3346,10518,99,290,2751,8824,2850,9114
290260,202107,5579,13345,4704,12087,183,561,3923,9876,4106,10437
290265,202107,3646,10342,2965,9067,223,634,2056,6313,2279,6947
290270,202107,10831,36720,10100,35487,508,2177,8170,28530,8678,30707
290280,202107,6306,18435,5439,16714,291,1008,3923,11884,4214,12892
290290,202107,10248,29069,8378,25714,763,2486,5664,17150,6427,19636
290300,202107,4255,11495,3151,9407,156,482,2246,6704,2402,7186
290310,202107,1721,3983,1383,3581,32,138,1162,2934,1194,3072
290320,202107,25385,64622,20293,57010,4298,11713,9850,29310,14148,41023
290323,202107,3821,10312,3314,9523,113,337,2571,7460,2684,7797
290327,202107,4231,11954,3618,10782,271,748,2593,7706,2864,8454
290330,202107,2355,4751,1843,4206,45,60,1649,3824,1694,3884
290340,202107,5945,14337,4512,12610,416,1107,3292,9362,3708,10469
290350,202107,4897,13364,4089,11991,264,725,2893,8541,3157,9266
290360,202107,5124,13106,4490,12290,134,307,3856,10652,3990,10959
290370,202107,5386,12737,3956,10863,210,473,2774,7760,2984,8233
290380,202107,5780,15005,4782,13646,108,240,4091,11866,4199,12106
290390,202107,15002,41859,12464,37813,1393,4035,8012,24724,9405,28759
290395,202107,3053,8435,2454,7416,57,242,1884,5624,1941,5866
290400,202107,3873,10215,3154,9035,104,365,2451,6896,2555,7261
290405,202107,4802,13575,4085,12354,313,954,2766,8537,3079,9491
290410,202107,5846,15442,4484,13287,105,426,3405,9870,3510,10296
290420,202107,3213,8505,2670,7674,88,246,2127,6079,2215,6325
290430,202107,3367,8835,2761,7895,219,653,1932,5416,2151,6069
290440,202107,2974,7131,2161,5869,93,197,1523,4246,1616,4443
290450,202107,3695,8953,2927,7814,120,252,2226,5963,2346,6215
290460,202107,12402,34278,10423,30603,2187,6484,4369,12890,6556,19374
290470,202107,4757,11175,3505,9465,423,1152,1997,5495,2420,6647
290475,202107,6711,19135,5690,17364,66,346,4732,14179,4798,14525
290480,202107,1843,4543,1509,4068,67,217,1086,2788,1153,3005
290485,202107,4740,13396,4159,12590,97,446,3571,10671,3668,11117
290490,202107,9251,21359,8313,20089,474,978,6576,16140,7050,17118
290500,202107,4206,12212,3283,10280,536,1735,1452,4429,1988,6164
290510,202107,3661,8797,3056,8017,57,184,2711,7060,2768,7244
290515,202107,3723,10219,3232,9534,42,133,2923,8763,2965,8896
290520,202107,11884,33148,9248,28139,639,1995,5611,16933,6250,18928
290530,202107,5114,14396,4311,13097,110,446,3654,11022,3764,11468
290540,202107,3458,8862,3108,8479,40,120,2901,7913,2941,8033
290550,202107,4340,11245,3794,10600,11,60,3500,9891,3511,9951
290560,202107,6397,16265,4863,14053,368,1303,3224,8996,3592,10299
290570,202107,45325,109655,40200,103192,2274,5851,32526,82978,34800,88829
290580,202107,8196,23047,7090,21470,637,1729,5197,16248,5834,17977
290590,202107,7131,21595,6003,19598,143,503,4824,15857,4967,16360
290600,202107,19559,53152,17136,49254,758,2047,13716,39498,14474,41545
290610,202107,2650,7993,2082,6823,83,307,1469,4770,1552,5077
290620,202107,6200,17338,5366,15972,191,541,4520,13456,4711,13997
290630,202107,9698,22588,7765,20129,673,1629,5869,15463,6542,17092
290640,202107,2882,7159,2223,6222,118,301,1567,4565,1685,4866
290650,202107,13140,31909,11596,30181,2412,6023,7378,20044,9790,26067
290660,202107,3747,9493,3101,8509,59,161,2339,6593,2398,6754
290670,202107,6872,18445,5841,16798,377,1020,4483,13114,4860,14134
290680,202107,11233,30360,9406,27673,186,908,7808,22607,7994,23515
290682,202107,4868,12314,4227,11459,140,287,3555,9759,3695,10046
290685,202107,3557,7907,2563,6494,218,487,1533,4193,1751,4680
290687,202107,6773,17712,5538,15704,697,1871,3539,10277,4236,12148
290689,202107,2952,7971,2243,6677,188,586,1505,4498,1693,5084
290690,202107,5350,13807,4331,12390,278,860,3164,8906,3442,9766
290700,202107,2802,7181,2485,6784,45,163,2184,5932,2229,6095
290710,202107,8487,23310,7286,21667,224,648,6106,18276,6330,18924
290720,202107,18903,50830,17167,48170,903,2696,13863,38530,14766,41226
290730,202107,7133,16769,6078,15550,303,599,4762,12430,5065,13029
290740,202107,1072,2799,848,2440,25,75,721,2070,746,2145
290750,202107,11610,28079,10071,25675,653,1707,7519,18644,8172,20351
290755,202107,2049,5702,1671,5023,96,266,1149,3504,1245,3770
290760,202107,3850,10969,3168,9709,160,430,2184,6871,2344,7301
290770,202107,2731,8393,2496,8100,46,198,2105,6949,2151,7147
290780,202107,8310,20329,7166,18832,267,524,5562,15036,5829,15560
290790,202107,4899,13126,4267,12207,189,463,3500,10185,3689,10648
290800,202107,7166,14431,5010,11948,268,542,3766,9106,4034,9648
290810,202107,5372,13853,4353,12379,109,315,3325,9672,3434,9987
290820,202107,5024,13193,4529,12512,200,539,3409,9568,3609,10107
290830,202107,4594,10418,4059,9707,26,89,3537,8283,3563,8372
290840,202107,17942,46107,15325,42061,2036,4596,9744,28511,11780,33107
290850,202107,7186,16448,6394,15598,240,489,5533,13625,5773,14114
290860,202107,6232,17440,5413,16506,214,621,4561,14231,4775,14852
290870,202107,4797,13035,3647,10861,174,494,2523,7507,2697,8001
290880,202107,1443,3491,1164,3131,98,232,755,2160,853,2392
290890,202107,9592,18998,8608,17907,156,332,8027,16605,8183,16937
290900,202107,2517,6411,1960,5448,121,264,1195,3342,1316,3606
290910,202107,5328,12411,4060,10521,40,100,3472,8910,3512,9010
290920,202107,5259,13001,4728,12382,107,150,4404,11766,4511,11916
290930,202107,7656,21020,6215,18534,204,786,4832,14060,5036,14846
290940,202107,3655,10190,3083,9366,165,530,2463,7480,2628,8010
290950,202107,1478,3692,1204,3277,72,187,835,2292,907,2479
290960,202107,5869,14558,5226,13752,232,499,4366,11560,4598,12059
290970,202107,3283,9617,2691,8533,100,367,2085,6626,2185,6993
290980,202107,12941,30073,10892,27010,716,1901,7051,16966,7767,18867
290990,202107,9848,25772,8750,24033,266,1004,7360,19599,7626,20603
291000,202107,3446,8668,2671,7686,117,328,2170,6334,2287,6662
291005,202107,15828,38290,13974,35909,1475,3344,10611,27665,12086,31009
291010,202107,3130,9332,2544,8064,146,505,1639,5060,1785,5565
291020,202107,1287,3090,1045,2676,28,85,765,1845,793,1930
291030,202107,2609,6174,1857,4904,120,278,1149,2980,1269,3258
291040,202107,5601,14893,4629,13519,159,526,3651,10658,3810,11184
291050,202107,8251,20408,7073,18820,752,2022,5094,13448,5846,15470
291060,202107,6575,18826,5600,17529,308,1160,4323,13435,4631,14595
291070,202107,16773,43871,14019,39502,388,1234,11432,31969,11820,33203
291072,202107,26069,63986,19040,52333,3225,9065,8655,23783,11880,32848
291075,202107,5616,13499,5068,12686,96,231,4274,10486,4370,10717
291077,202107,1711,4397,1337,3743,70,126,934,2658,1004,2784
291080,202107,119405,283660,94536,249445,25563,68129,28816,82731,54379,150860
291085,202107,5784,14260,4814,12788,169,482,4032,10667,4201,11149
291090,202107,2145,3926,1589,3309,42,71,1331,2742,1373,2813
291100,202107,3301,7065,2286,5864,99,253,1765,4504,1864,4757
291110,202107,6298,18149,5390,16642,295,1032,4208,12606,4503,13638
291120,202107,7948,18870,6719,17328,317,814,5178,13362,5495,14176
291125,202107,2332,4017,1761,3378,88,129,1435,2794,1523,2923
291130,202107,3371,9396,2503,7713,56,266,1890,5609,1946,5875
291140,202107,4998,13134,3620,10656,502,1308,2174,6439,2676,7747
291150,202107,2562,5484,1981,4834,4,16,1887,4601,1891,4617
291160,202107,5145,13902,4284,12679,382,1156,2880,8496,3262,9652
291165,202107,2244,6024,1665,4882,30,120,1201,3387,1231,3507
291170,202107,21423,53267,17836,47326,984,2798,11870,30852,12854,33650
291180,202107,6583,14698,4848,12429,230,549,3831,9823,4061,10372
291185,202107,3135,8113,2763,7530,114,296,2167,5954,2281,6250
291190,202107,8017,19038,6638,17284,267,697,5362,14007,5629,14704
291200,202107,2895,7758,2133,6314,70,217,1367,3876,1437,4093
291210,202107,7332,15339,5445,13186,135,435,4041,9839,4176,10274
291220,202107,4417,11983,3996,11374,240,683,3122,8868,3362,9551
291230,202107,4669,9737,3548,8514,39,89,3230,7808,3269,7897
291240,202107,4190,10639,3543,9554,60,202,3039,8097,3099,8299
291250,202107,3454,9946,2695,8552,143,423,1738,5548,1881,5971
291260,202107,1483,3435,1217,3088,28,85,995,2548,1023,2633
291270,202107,5796,14219,4532,12431,288,788,3367,9285,3655,10073
291280,202107,2769,6484,2046,5461,193,483,1300,3454,1493,3937
291290,202107,5860,15096,4487,12993,355,1057,3042,8772,3397,9829
291300,202107,3936,10436,3112,9070,113,343,2378,6839,2491,7182
291310,202107,5141,13559,4415,12260,170,478,3686,10165,3856,10643
291320,202107,6332,17071,4951,14551,1104,3047,2417,7531,3521,10578
291330,202107,1912,4734,1596,4223,70,179,1215,3130,1285,3309
291340,202107,4455,11181,3586,9705,106,289,2703,7237,2809,7526
291345,202107,2981,8694,2701,8266,99,322,2266,6958,2365,7280
291350,202107,7050,16901,5481,15037,59,167,4770,13291,4829,13458
291360,202107,37611,84445,29585,74923,2927,6942,19411,50762,22338,57704
291370,202107,8365,22244,7369,20676,566,1596,5462,15087,6028,16683
291380,202107,3605,9500,3149,8887,96,345,2657,7438,2753,7783
291390,202107,13547,28431,10445,25020,456,981,8638,20721,9094,21702
291400,202107,14602,35529,12080,31837,1352,3123,7642,21255,8994,24378
291410,202107,3084,7951,2415,6797,34,134,1788,4951,1822,5085
291420,202107,2030,4826,1580,4269,18,70,1410,3796,1428,3866
291430,202107,2797,7688,2411,7050,78,287,1923,5454,2001,5741
291440,202107,6653,18555,5777,17132,322,951,4483,13384,4805,14335
291450,202107,10173,23238,8371,21181,74,119,7424,19262,7498,19381
291460,202107,16205,41782,14197,38828,700,2021,10749,29123,11449,31144
291465,202107,9354,22507,7329,20199,119,521,6352,17365,6471,17886
291470,202107,18250,39440,15228,35975,865,1730,11263,27386,12128,29116
291480,202107,44227,95434,33119,80598,3673,9176,18184,43989,21857,53165
291490,202107,5699,13984,4914,13101,134,409,4438,11793,4572,12202
291500,202107,5226,12378,4388,11269,57,204,4022,10334,4079,10538
291510,202107,4523,10819,3348,9341,36,209,2830,7799,2866,8008
291520,202107,4663,10304,3518,8805,187,495,2725,6765,2912,7260
291530,202107,2413,5323,1724,4442,296,682,979,2760,1275,3442
291535,202107,3511,10123,3058,9306,163,433,2344,7373,2507,7806
291540,202107,2315,5030,1598,4175,80,211,1305,3406,1385,3617
291550,202107,5806,12967,4506,11333,446,897,3013,7839,3459,8736
291560,202107,18905,43996,13808,37300,1598,4048,7848,22342,9446,26390
291570,202107,2423,5634,1900,4995,54,149,1582,4295,1636,4444
291580,202107,6572,16515,5186,14685,266,709,3780,10704,4046,11413
291590,202107,2295,5371,2016,5057,75,237,1808,4449,1883,4686
291600,202107,5501,12517,4242,10622,361,945,2920,7095,3281,8040
291610,202107,5694,14561,5102,13910,60,218,4698,12784,4758,13002
291620,202107,3203,7095,2408,6222,122,299,1857,4910,1979,5209
291630,202107,3541,7587,2649,6454,232,597,1980,4799,2212,5396
291640,202107,17090,40308,12966,34468,1804,4425,6236,17019,8040,21444
291650,202107,9444,23202,8359,21927,566,1006,7001,18933,7567,19939
291660,202107,2100,5020,1556,4211,125,381,1030,2633,1155,3014
291670,202107,2089,5408,1749,4913,103,251,1304,3728,1407,3979
291680,202107,4117,9851,3327,8741,313,824,2333,6161,2646,6985
291685,202107,4983,11734,4005,10439,214,427,3059,8211,3273,8638
291690,202107,4260,9199,2991,7374,323,638,2187,5495,2510,6133
291700,202107,9021,25275,7950,23447,333,1055,6490,18822,6823,19877
291710,202107,5416,12470,4053,10601,323,824,2852,7435,3175,8259
291720,202107,4552,13413,3818,11968,671,2137,2145,6659,2816,8796
291730,202107,6482,16045,5589,14872,249,725,4688,12404,4937,13129
291733,202107,2815,7148,2396,6603,62,158,1751,5106,1813,5264
291735,202107,3021,7853,2424,6819,77,169,1856,5215,1933,5384
291740,202107,4079,10384,3004,8373,99,218,2082,5804,2181,6022
291750,202107,20738,47958,16901,42342,1829,4326,11003,28173,12832,32499
291760,202107,10769,30015,8434,26300,2495,8788,2255,7014,4750,15802
291770,202107,7436,19389,6228,17330,285,862,4783,12933,5068,13795
291780,202107,5274,13684,4747,12955,87,287,4158,11239,4245,11526
291790,202107,2770,7457,2512,7126,226,515,1898,5578,2124,6093
291800,202107,31130,75677,23435,64443,4103,10611,10867,31479,14970,42090
291810,202107,10703,25001,9058,23007,368,844,7545,19495,7913,20339
291820,202107,4030,10187,3508,9514,91,255,2855,7764,2946,8019
291830,202107,4693,10687,3839,9537,219,397,3020,7588,3239,7985
291835,202107,6671,19663,5270,17016,461,1543,3448,11310,3909,12853
291840,202107,48742,131130,42437,121421,3981,12112,30376,86297,34357,98409
291845,202107,2693,6713,2135,6033,100,272,1794,5132,1894,5404
291850,202107,4288,11535,3580,10388,143,387,2854,8372,2997,8759
291855,202107,2301,4370,1786,3802,28,63,1631,3474,1659,3537
291860,202107,2339,5993,1632,4644,39,89,1093,3016,1132,3105
291870,202107,1326,3273,888,2509,36,91,614,1721,650,1812
291875,202107,3017,8912,2598,8050,52,214,1932,5809,1984,6023
291880,202107,5795,16041,4939,14629,241,642,3655,10986,3896,11628
291890,202107,1641,3306,1062,2635,148,325,679,1716,827,2041
291900,202107,1398,3155,1069,2670,20,64,858,2087,878,2151
291905,202107,2486,6234,2052,5562,74,256,1599,4180,1673,4436
291910,202107,3119,7561,2628,6966,51,169,2254,6153,2305,6322
291915,202107,7456,20867,6071,18537,197,648,4563,14149,4760,14797
291920,202107,27829,70065,23695,64439,1974,5886,17069,45342,19043,51228
291930,202107,2584,6645,2214,6146,222,609,1535,4316,1757,4925
291940,202107,4042,10008,2725,7822,207,572,1605,4594,1812,5166
291950,202107,9228,27616,7803,24912,274,974,5443,17246,5717,18220
291955,202107,16014,39387,14234,37101,1169,3122,11272,29411,12441,32533
291960,202107,3354,8201,2827,7505,150,302,2231,6125,2381,6427
291970,202107,4728,11560,3961,10622,144,434,3013,8116,3157,8550
291980,202107,10054,27822,8116,24495,1023,2728,5173,16050,6196,18778
291990,202107,2404,6082,1962,5537,23,81,1815,5133,1838,5214
291992,202107,4011,9507,3264,8554,287,614,2569,6918,2856,7532
291995,202107,2231,5849,1826,5200,44,164,1444,4008,1488,4172
292000,202107,2720,6175,2214,5575,78,244,1784,4471,1862,4715
292010,202107,5857,13367,4782,11856,146,369,4037,9826,4183,10195
292020,202107,4812,13336,4031,11981,165,578,3106,8954,3271,9532
292030,202107,1995,5765,1807,5434,101,316,1183,3474,1284,3790
292040,202107,4634,11419,3630,9940,223,523,2760,7733,2983,8256
292045,202107,4258,10655,3178,9079,34,95,2843,8256,2877,8351
292050,202107,6725,18308,5461,16152,243,786,3563,10411,3806,11197
292060,202107,11544,26108,10656,24997,414,900,9407,21807,9821,22707
292070,202107,5858,14847,5109,13967,314,796,4335,11841,4649,12637
292080,202107,3295,7949,2705,7193,67,214,2432,6427,2499,6641
292090,202107,4645,9912,3267,8239,186,437,2498,6338,2684,6775
292100,202107,12761,29441,10989,27258,1597,3721,6632,17156,8229,20877
292105,202107,3769,8967,3282,8312,75,164,2780,7045,2855,7209
292110,202107,6234,14554,4434,11814,872,2385,2234,5940,3106,8325
292120,202107,7209,18014,5980,15978,344,925,4473,11768,4817,12693
292130,202107,3561,8330,2958,7590,130,370,2285,5787,2415,6157
292140,202107,5440,12123,4615,10945,187,419,3948,9337,4135,9756
292145,202107,2609,7001,2188,6290,93,218,1733,5014,1826,5232
292150,202107,15320,39665,13292,36438,263,955,11009,29585,11272,30540
292160,202107,3085,7251,2331,6287,34,81,1903,5415,1937,5496
292170,202107,8956,22797,7518,20524,370,1055,5761,15413,6131,16468
292180,202107,2966,7908,2201,6509,147,437,1391,4031,1538,4468
292190,202107,3020,7791,2575,7138,132,384,1956,5423,2088,5807
292200,202107,9137,21847,6804,18577,1221,3431,3208,9170,4429,12601
292205,202107,3819,10446,3318,9713,56,251,2889,8424,2945,8675
292210,202107,6763,15185,5491,13604,70,266,5003,12297,5073,12563
292220,202107,2276,5174,1988,4755,71,156,1557,3619,1628,3775
292225,202107,3341,9430,2957,8852,53,231,2597,7644,2650,7875
292230,202107,8921,20812,7992,19645,171,533,6918,16737,7089,17270
292240,202107,4890,13826,4321,12819,271,786,3107,9206,3378,9992
292250,202107,6107,15191,5490,14295,367,934,4214,10906,4581,11840
292260,202107,3450,8818,3075,8335,83,216,2684,7286,2767,7502
292265,202107,3559,9335,2993,8489,56,240,2436,6771,2492,7011
292270,202107,4372,9863,3475,8796,118,269,2858,7267,2976,7536
292273,202107,2879,6037,2300,5335,60,99,1664,4147,1724,4246
292275,202107,1650,4248,1300,3784,53,150,978,2890,1031,3040
292280,202107,2705,6216,2172,5606,92,163,1817,4845,1909,5008
292285,202107,2672,6255,2128,5525,75,157,1749,4577,1824,4734
292290,202107,7718,19680,6068,17408,162,536,4994,14303,5156,14839
292300,202107,10514,25668,8285,22728,815,2330,5693,15669,6508,17999
292303,202107,3013,8399,2618,7773,89,186,2170,6530,2259,6716
292305,202107,2317,6148,2142,5913,40,161,1933,5263,1973,5424
292310,202107,7126,17087,6180,15943,110,336,5489,13994,5599,14330
292320,202107,6310,16718,5036,14412,229,730,3763,10490,3992,11220
292330,202107,2760,5957,2245,5379,104,174,1731,4372,1835,4546
292335,202107,4970,12601,4409,11783,237,534,3704,10050,3941,10584
292340,202107,5533,15388,4584,13592,222,620,3372,9961,3594,10581
292350,202107,2583,6880,2158,6300,76,263,1761,5169,1837,5432
292360,202107,5128,13312,4276,11885,230,679,3025,8338,3255,9017
292370,202107,10381,24207,8945,22342,114,365,8322,20578,8436,20943
292380,202107,6959,19106,6224,17808,423,1192,4740,13458,5163,14650
292390,202107,4717,8823,3457,7387,113,207,3028,6467,3141,6674
292400,202107,22867,63276,19730,58361,1866,5381,13586,40568,15452,45949
292405,202107,4647,11011,3920,9872,91,226,3275,8110,3366,8336
292410,202107,2261,5316,1877,4828,68,140,1653,4292,1721,4432
292420,202107,3649,10391,3344,9936,108,419,2922,8524,3030,8943
292430,202107,5040,14680,3832,12474,283,912,2516,8243,2799,9155
292440,202107,8794,27338,8137,26344,108,519,7318,23568,7426,24087
292450,202107,4126,11520,3221,9792,91,334,2531,7644,2622,7978
292460,202107,5359,13805,4434,12311,235,601,3456,9558,3691,10159
292465,202107,2807,6912,2395,6394,95,199,1609,4727,1704,4926
292467,202107,1983,5361,1740,5034,279,678,1170,3562,1449,4240
292470,202107,3081,7621,2390,6564,74,119,1829,5068,1903,5187
292480,202107,6402,14829,5203,13371,71,241,4726,12055,4797,12296
292490,202107,2387,5704,2024,5181,104,193,1620,4202,1724,4395
292500,202107,7020,18166,5638,15848,405,1196,3829,10647,4234,11843
292510,202107,14077,36211,11015,31435,539,1560,7786,22208,8325,23768
292520,202107,7363,17945,6479,16651,425,1133,5105,12953,5530,14086
292525,202107,6207,14373,5106,13147,128,270,4476,11716,4604,11986
292530,202107,30499,77916,23775,66888,5125,14678,10467,29759,15592,44437
292540,202107,4604,8249,3639,7226,122,189,3299,6586,3421,6775
292550,202107,8462,21322,6523,19007,494,1281,4560,14290,5054,15571
292560,202107,4553,11178,3876,10238,112,274,2965,7816,3077,8090
292570,202107,3769,9683,3164,8589,52,174,2693,7141,2745,7315
292575,202107,6941,19493,6371,18746,417,1158,5075,15171,5492,16329
292580,202107,7735,19125,6375,17138,123,352,5402,14378,5525,14730
292590,202107,7569,19766,6384,17674,318,882,5094,13907,5412,14789
292593,202107,2936,7168,2432,6338,72,176,2051,5298,2123,5474
292595,202107,5656,14539,4844,13544,134,420,4132,11489,4266,11909
292600,202107,10916,29197,9433,26979,394,1035,7506,21583,7900,22618
292610,202107,4409,11089,3769,9994,164,368,2917,7795,3081,8163
292620,202107,6517,17529,5385,16154,133,275,4850,14875,4983,15150
292630,202107,9046,21434,7271,18622,777,1912,4543,11815,5320,13727
292640,202107,8585,24246,7449,22384,210,704,5407,16403,5617,17107
292650,202107,4534,11085,4053,10458,107,258,3690,9443,3797,9701
292660,202107,11661,30839,9866,28198,472,1393,7409,21341,7881,22734
292665,202107,2224,6411,1917,6003,70,191,1586,5065,1656,5256
292670,202107,3646,9724,2831,8215,133,391,1908,5427,2041,5818
292680,202107,4131,10526,3268,9048,165,404,2436,6615,2601,7019
292690,202107,2697,6801,1878,5476,195,513,1141,3478,1336,3991
292700,202107,10271,27271,8975,25291,728,1690,6225,18199,6953,19889
292710,202107,2722,7891,2539,7650,41,106,2334,7065,2375,7171
292720,202107,9251,21446,7807,19778,209,535,6257,16176,6466,16711
292730,202107,5073,11276,4633,10613,349,566,3816,8988,4165,9554
292740,202107,325576,769007,280817,706360,37627,93958,178366,446842,215993,540800
292750,202107,6430,16444,5672,15380,222,556,4515,12475,4737,13031
292760,202107,4095,11313,3585,10438,179,542,2713,7831,2892,8373
292770,202107,6688,16696,5413,14950,724,2026,3586,10166,4310,12192
292780,202107,2183,4176,1626,3513,74,164,1308,2716,1382,2880
292790,202107,4094,8502,3103,7425,164,346,2561,6194,2725,6540
292800,202107,11629,28550,9947,26019,331,832,8300,21521,8631,22353
292805,202107,3793,8796,2993,7780,113,290,2382,6161,2495,6451
292810,202107,11301,28106,9046,24616,603,1404,6613,17809,7216,19213
292820,202107,7427,20302,5450,16974,361,1221,3855,11814,4216,13035
292830,202107,2996,6900,2552,6361,86,198,2176,5479,2262,5677
292840,202107,8883,22878,7520,21046,132,442,6611,18290,6743,18732
292850,202107,2526,6470,2115,5882,141,349,1481,4125,1622,4474
292860,202107,16898,36856,15188,34865,388,961,13221,29989,13609,30950
292870,202107,19489,46425,16858,42829,974,2369,11866,29753,12840,32122
292880,202107,11436,30567,9745,28028,257,957,7734,21557,7991,22514
292890,202107,7373,19717,6512,18499,166,641,5733,16192,5899,16833
292895,202107,3224,6613,2423,5448,104,218,1976,4392,2080,4610
292900,202107,2683,7034,2433,6651,46,176,2029,5401,2075,5577
292905,202107,4434,11123,3533,9787,97,304,2708,7416,2805,7720
292910,202107,4807,12891,4396,12318,186,490,3439,9587,3625,10077
292920,202107,9836,26752,9120,25773,271,958,7858,21890,8129,22848
292925,202107,5432,15172,4536,13564,225,621,3250,9706,3475,10327
292930,202107,6611,18832,5728,17261,488,1589,3714,10946,4202,12535
292935,202107,2558,6177,2002,5559,14,71,1806,5042,1820,5113
292937,202107,2887,7158,2510,6683,71,184,2073,5526,2144,5710
292940,202107,2998,7358,2384,6440,214,484,1678,4725,1892,5209
292950,202107,9757,24274,8538,22520,518,1144,6479,17081,6997,18225
292960,202107,5287,12632,4419,11406,135,328,3528,9051,3663,9379
292970,202107,3945,10915,3504,10258,72,283,2940,8649,3012,8932
292975,202107,4453,9428,3957,8880,117,192,3605,8184,3722,8376
292980,202107,3576,8139,2932,7212,72,208,2477,5985,2549,6193
292990,202107,11367,31119,9545,27922,530,1666,7117,20457,7647,22123
293000,202107,2777,6429,2383,5837,46,152,1931,4724,1977,4876
293010,202107,18947,47056,15330,41524,1883,5216,9458,25665,11341,30881
293015,202107,8827,26072,7011,22634,462,1510,4751,15623,5213,17133
293020,202107,10059,28643,9047,27209,121,421,8160,24604,8281,25025
293030,202107,5301,13694,4052,11769,106,302,2800,8373,2906,8675
293040,202107,4577,11538,3839,10499,59,195,3380,9201,3439,9396
293050,202107,23658,55681,20872,51589,1296,3044,15678,38377,16974,41421
293060,202107,3687,9607,2981,8274,237,693,2053,5578,2290,6271
293070,202107,25750,60773,22645,56874,1910,4937,16984,42509,18894,47446
293075,202107,3721,11238,3247,10446,104,468,2692,8617,2796,9085
293076,202107,3646,8667,3316,8286,62,128,2960,7488,3022,7616
293077,202107,6656,17772,5334,15689,481,1480,3264,10157,3745,11637
293080,202107,4880,14045,4179,12836,80,363,3415,10287,3495,10650
293090,202107,3307,9426,2555,8169,222,665,1657,5399,1879,6064
293100,202107,5953,15409,4944,13629,216,539,3915,10768,4131,11307
293105,202107,3904,12091,3409,11078,233,759,2402,7765,2635,8524
293110,202107,2474,5993,2062,5404,65,183,1683,4353,1748,4536
293120,202107,4706,12225,4228,11502,232,454,3484,9643,3716,10097
293130,202107,3841,10317,3356,9697,59,224,2951,8455,3010,8679
293135,202107,31365,71753,23270,61214,3355,9548,11148,29705,14503,39253
293140,202107,2534,5336,2207,4945,61,102,1895,4257,1956,4359
293150,202107,5526,16160,4546,14329,309,982,3144,9961,3453,10943
293160,202107,3782,9231,3226,8628,238,384,2720,7632,2958,8016
293170,202107,5093,10319,4458,9542,104,208,3936,8392,4040,8600
293180,202107,4507,12358,3756,11011,66,256,3019,8654,3085,8910
293190,202107,14550,38520,12858,36121,121,515,11496,32057,11617,32572
293200,202107,8943,21312,7269,18668,202,552,5935,15074,6137,15626
293210,202107,5294,13607,4552,12462,273,711,3557,9741,3830,10452
293220,202107,5298,13080,3903,10796,725,1980,1907,5388,2632,7368
293230,202107,4116,10086,3071,8643,213,603,2165,6184,2378,6787
293240,202107,4645,11938,3744,10484,72,150,2812,8257,2884,8407
293245,202107,3947,10428,3584,9898,153,417,3041,8334,3194,8751
293250,202107,6131,13946,4976,12455,190,476,4108,10270,4298,10746
293260,202107,4911,12550,4055,11213,143,345,2837,7940,2980,8285
293270,202107,7443,15988,5884,14324,441,598,4589,12118,5030,12716
293280,202107,4528,11697,3957,10887,238,569,3074,8596,3312,9165
293290,202107,15884,43644,14091,40857,1639,4784,9651,28124,11290,32908
293300,202107,5971,14136,5149,12943,308,728,3785,9568,4093,10296
293305,202107,4295,10013,3753,9341,69,151,3386,8454,3455,8605
293310,202107,2177,5422,1834,4903,42,124,1467,3864,1509,3988
293315,202107,4262,9790,3513,8686,194,414,2880,7110,3074,7524
293317,202107,2746,6293,2450,5880,168,294,1913,4629,2081,4923
293320,202107,12358,29019,10936,27448,208,575,9907,24722,10115,25297
293325,202107,1825,4395,1422,3866,200,509,889,2471,1089,2980
293330,202107,64317,173596,52509,153251,8630,26132,25773,74251,34403,100383
293340,202107,2248,6201,1852,5503,92,270,1297,3835,1389,4105
293345,202107,3769,9846,3028,8715,412,933,1900,6055,2312,6988
293350,202107,6559,18606,5656,17525,56,266,5165,16214,5221,16480
293360,202107,15140,37695,12894,34708,275,1139,11395,30133,11670,31272
310010,202107,993,2171,647,1700,39,130,246,608,285,738
310020,202107,2943,7628,2221,6366,442,1350,616,1702,1058,3052
310030,202107,1928,5302,1480,4526,211,712,962,2846,1173,3558
310040,202107,880,2234,696,1919,33,126,468,1186,501,1312
310050,202107,1516,4431,1270,4045,115,461,851,2615,966,3076
310060,202107,3215,8867,2779,8288,79,300,2317,6845,2396,7145
310070,202107,343,773,245,633,11,23,181,464,192,487
310080,202107,702,1844,513,1509,79,251,246,686,325,937
310090,202107,4881,12432,4029,11053,259,752,3021,8169,3280,8921
310100,202107,3647,9710,3080,8797,73,313,2576,7171,2649,7484
310110,202107,4848,12313,3755,10482,682,2071,1819,4864,2501,6935
310120,202107,657,1558,427,1195,48,155,251,649,299,804
310130,202107,369,944,312,859,26,100,238,628,264,728
310140,202107,288,791,202,649,39,147,80,234,119,381
310150,202107,5943,14930,4433,12233,507,1592,2217,5746,2724,7338
310160,202107,8882,21490,6532,17658,1110,3258,2601,6944,3711,10202
310163,202107,1098,3187,882,2770,180,617,280,808,460,1425
310170,202107,9740,23938,7803,20966,654,1741,5510,14822,6164,16563
310180,202107,1952,4646,1424,3808,166,482,844,2192,1010,2674
310190,202107,2824,7945,2318,7049,518,1764,412,1162,930,2926
310200,202107,2036,5798,1518,4816,178,644,738,2275,916,2919
310205,202107,1161,3088,928,2715,118,390,546,1601,664,1991
310210,202107,2597,6878,2134,6053,121,343,1517,4197,1638,4540
310220,202107,1300,3460,1007,2895,79,238,665,1841,744,2079
310230,202107,2274,6105,1828,5287,218,672,1156,3140,1374,3812
310240,202107,1036,2999,881,2734,46,168,611,1819,657,1987
310250,202107,1077,2794,884,2484,17,62,648,1790,665,1852
310260,202107,3294,8290,2209,6402,608,2056,699,1658,1307,3714
310270,202107,2834,6696,2264,5933,84,250,1884,4937,1968,5187
310280,202107,2565,5818,2028,5060,229,596,1273,3070,1502,3666
310285,202107,1899,5889,1580,5320,151,544,974,3273,1125,3817
310290,202107,1225,3128,1015,2771,184,582,557,1364,741,1946
310300,202107,1620,4506,1377,4096,134,488,826,2283,960,2771
310310,202107,328,778,213,582,39,103,103,275,142,378
310320,202107,541,1329,382,1085,17,64,227,616,244,680
310330,202107,493,1140,302,812,45,144,119,276,164,420
310340,202107,8399,21482,6772,18750,927,2526,3382,9572,4309,12098
310350,202107,13229,31257,9186,24835,1430,4129,4472,11588,5902,15717
310360,202107,555,1227,434,1072,14,35,299,726,313,761
310370,202107,1314,3956,1122,3602,207,737,349,1199,556,1936
310375,202107,900,2187,642,1806,91,265,363,1024,454,1289
310380,202107,399,899,219,618,32,94,101,271,133,365
310390,202107,508,1450,407,1260,78,251,138,382,216,633
310400,202107,11359,27191,8415,22764,731,2270,5346,13992,6077,16262
310410,202107,858,2437,564,1900,79,295,227,708,306,1003
310420,202107,4820,12182,3420,9647,462,1420,1474,3867,1936,5287
310430,202107,1651,4347,1113,3362,215,706,425,1117,640,1823
310440,202107,690,1776,479,1389,40,139,260,696,300,835
310445,202107,1423,3954,1042,3196,62,183,744,2243,806,2426
310450,202107,4649,11465,3539,9741,146,518,2705,7227,2851,7745
310460,202107,1818,4750,1390,3966,222,686,513,1342,735,2028
310470,202107,3767,8206,2940,7120,280,630,2100,5231,2380,5861
310480,202107,1028,2584,804,2221,93,265,496,1327,589,1592
310490,202107,2899,7727,2288,6733,249,864,1292,3549,1541,4413
310500,202107,1413,3823,1082,3274,178,617,580,1683,758,2300
310510,202107,2199,5621,1505,4368,262,829,591,1710,853,2539
310520,202107,1195,3068,878,2501,142,384,459,1328,601,1712
310530,202107,781,1943,533,1518,67,218,190,447,257,665
310540,202107,3081,8542,2547,7599,504,1609,1166,3290,1670,4899
310550,202107,1306,3209,935,2598,70,248,549,1401,619,1649
310560,202107,15770,40226,11300,32385,1429,4581,5089,13122,6518,17703
310570,202107,1070,2750,848,2442,49,170,643,1821,692,1991
310590,202107,4284,11062,3432,9472,217,655,2031,5279,2248,5934
310600,202107,1427,4032,1168,3502,140,474,629,1779,769,2253
310610,202107,488,1304,318,1027,117,388,50,150,167,538
310620,202107,190159,471013,140721,382841,17187,54207,73600,181780,90787,235987
310630,202107,4782,12705,3730,10644,434,1301,2226,6174,2660,7475
310640,202107,1228,3468,1009,3051,164,555,486,1384,650,1939
310650,202107,2533,6864,1866,5597,149,482,1152,3315,1301,3797
310660,202107,1353,3587,1109,3253,26,85,944,2760,970,2845
310665,202107,1450,3611,1181,3242,17,61,970,2714,987,2775
310670,202107,61061,153150,51690,137420,4555,13594,35820,90709,40375,104303
310680,202107,797,1838,658,1641,18,65,562,1352,580,1417
310690,202107,2110,5282,1546,4353,113,359,932,2480,1045,2839
310700,202107,496,1071,390,939,22,70,310,727,332,797
310710,202107,5971,16447,4381,14077,839,3142,773,2234,1612,5376
310720,202107,1093,2472,854,2171,30,97,653,1600,683,1697
310730,202107,10572,27120,9025,24704,360,1184,6774,18082,7134,19266
310740,202107,6711,17882,4900,14257,666,2167,1963,5128,2629,7295
310750,202107,1307,3068,999,2629,102,313,567,1368,669,1681
310760,202107,687,1699,481,1385,34,102,264,764,298,866
310770,202107,1129,2980,788,2454,84,309,411,1182,495,1491
310780,202107,4337,10130,3605,9189,74,195,2931,7475,3005,7670
310790,202107,1867,5771,1605,5216,350,1208,275,774,625,1982
310800,202107,2453,7080,1793,5752,339,1330,108,272,447,1602
310810,202107,1346,3231,1114,2859,51,138,808,2001,859,2139
310820,202107,1265,3144,773,2325,164,504,174,548,338,1052
310825,202107,2687,7795,2164,6937,54,301,1774,5506,1828,5807
310830,202107,1980,5399,1453,4407,242,864,623,1770,865,2634
310840,202107,2175,5767,1645,4878,343,1171,455,1157,798,2328
310850,202107,1452,3968,1205,3609,35,161,938,2704,973,2865
310855,202107,3177,8224,2457,7059,162,544,1761,4945,1923,5489
310860,202107,6971,19816,5639,17302,548,1704,3461,10766,4009,12470
310870,202107,992,2330,784,2034,55,126,579,1503,634,1629
310880,202107,1006,2951,805,2550,105,333,454,1413,559,1746
310890,202107,2258,6371,1469,4796,256,902,225,629,481,1531
310900,202107,4024,10959,2805,8325,424,1327,1244,3424,1668,4751
310910,202107,2240,5362,1581,4329,134,426,355,905,489,1331
310920,202107,1940,4916,1481,4245,176,544,884,2480,1060,3024
310925,202107,1002,2619,823,2329,43,146,603,1622,646,1768
310930,202107,5909,14931,4171,12163,801,2317,1883,5781,2684,8098
310940,202107,6899,15801,5582,13912,177,505,4362,10608,4539,11113
310945,202107,1341,3401,1064,2961,181,523,522,1405,703,1928
310950,202107,1952,5689,1302,4245,213,763,375,1037,588,1800
310960,202107,741,1943,412,1249,74,260,79,214,153,474
310970,202107,1175,3401,831,2684,213,744,133,385,346,1129
310980,202107,314,728,190,525,20,60,112,309,132,369
310990,202107,1350,3589,1066,3110,146,452,586,1669,732,2121
311000,202107,3953,10780,2896,9051,700,2290,1168,3596,1868,5886
311010,202107,950,2591,764,2246,189,623,369,1055,558,1678
311020,202107,1185,2942,757,2168,44,130,414,1149,458,1279
311030,202107,1773,4294,1268,3463,262,809,554,1436,816,2245
311040,202107,267,829,220,729,69,235,72,224,141,459
311050,202107,3120,7478,2344,6349,350,1070,1207,3108,1557,4178
311060,202107,3372,8428,2525,6909,335,1028,1029,2568,1364,3596
311070,202107,2426,5833,1775,4847,145,519,1041,2643,1186,3162
311080,202107,1193,2653,967,2302,58,152,754,1710,812,1862
311090,202107,2213,6780,1783,5979,394,1428,574,1888,968,3316
311100,202107,2520,6966,1504,4920,275,1004,293,823,568,1827
311110,202107,3739,7551,2103,5266,408,1044,690,1778,1098,2822
311115,202107,1428,3085,1207,2798,70,149,973,2244,1043,2393
311120,202107,7162,18327,5538,15469,810,2515,2117,5202,2927,7717
311130,202107,1933,4969,1467,4322,105,387,869,2480,974,2867
311140,202107,1513,3686,1212,3276,66,205,878,2336,944,2541
311150,202107,1462,4598,1142,3972,171,672,618,2094,789,2766
311160,202107,3995,11192,2858,9098,693,2376,869,2639,1562,5015
311170,202107,908,2256,717,2000,42,117,448,1332,490,1449
311180,202107,1409,3109,901,2368,181,491,372,988,553,1479
311190,202107,895,2438,679,2023,111,384,272,693,383,1077
311200,202107,2132,5650,1539,4506,277,896,570,1510,847,2406
311205,202107,904,2572,744,2275,38,145,475,1367,513,1512
311210,202107,1048,2990,909,2791,120,321,637,2033,757,2354
311220,202107,775,2085,653,1866,38,132,445,1196,483,1328
311230,202107,8277,23985,6311,20061,1173,3875,2284,7367,3457,11242
311240,202107,1108,2799,862,2452,172,489,388,1112,560,1601
311250,202107,1211,3383,940,2867,181,544,380,1086,561,1630
311260,202107,2826,6737,1823,5012,246,769,818,1981,1064,2750
311265,202107,1322,3375,976,2797,40,150,678,1899,718,2049
311270,202107,3025,8873,2652,8271,135,568,1947,5843,2082,6411
311280,202107,1121,2872,577,1769,83,289,95,241,178,530
311290,202107,1920,5628,1750,5286,122,364,1220,3693,1342,4057
311300,202107,4860,13067,4007,11658,167,610,3213,9163,3380,9773
311310,202107,578,1576,489,1419,37,116,315,879,352,995
311320,202107,3358,9960,2907,9003,312,1135,1521,4305,1833,5440
311330,202107,5537,13922,4413,12131,470,1336,2513,7035,2983,8371
311340,202107,10846,29401,8588,25454,2034,6493,2586,7220,4620,13713
311350,202107,2512,6002,1795,4724,176,482,977,2330,1153,2812
311360,202107,1149,2745,761,2186,199,643,267,757,466,1400
311370,202107,4827,11396,3584,9471,201,658,2367,5871,2568,6529
311380,202107,377,1111,274,895,60,194,130,439,190,633
311390,202107,1805,5352,1446,4859,622,2329,374,1144,996,3473
311400,202107,1625,4340,1190,3508,227,681,354,925,581,1606
311410,202107,1853,5234,1482,4657,215,754,854,2585,1069,3339
311420,202107,1579,4532,1129,3599,205,744,307,824,512,1568
311430,202107,4355,11176,2917,8395,460,1366,1049,2910,1509,4276
311440,202107,3064,8302,2336,7081,623,2177,483,1353,1106,3530
311450,202107,1839,5368,1337,4437,338,1270,329,919,667,2189
311455,202107,1037,2252,700,1757,152,398,297,769,449,1167
311460,202107,531,1583,350,1192,64,262,78,213,142,475
311470,202107,529,1578,358,1191,85,321,50,155,135,476
311480,202107,1123,2739,919,2424,65,152,698,1853,763,2005
311490,202107,255,741,195,629,31,126,93,265,124,391
311500,202107,485,1157,379,997,20,66,255,643,275,709
311510,202107,3380,8534,2377,6836,300,959,1050,2818,1350,3777
311520,202107,658,1776,578,1630,72,250,331,912,403,1162
311530,202107,8822,20190,5694,15240,1309,3882,1551,3921,2860,7803
311535,202107,843,2259,580,1716,93,280,212,583,305,863
311540,202107,515,1563,458,1459,63,229,328,1011,391,1240
311545,202107,2013,5657,1726,5210,91,308,1335,3991,1426,4299
311547,202107,1553,3785,1353,3483,48,110,1006,2589,1054,2699
311550,202107,2935,7890,2358,6875,333,1085,1035,2832,1368,3917
311560,202107,324,679,208,505,80,182,49,111,129,293
311570,202107,1632,3716,1156,3056,36,103,913,2444,949,2547
311580,202107,2201,4099,1495,3261,180,314,977,2162,1157,2476
311590,202107,534,1372,428,1213,80,254,233,650,313,904
311600,202107,1741,3941,1452,3562,108,277,1152,2773,1260,3050
311610,202107,2319,7126,1935,6376,156,602,1190,3826,1346,4428
311615,202107,3389,9202,2748,8160,103,366,2208,6434,2311,6800
311620,202107,441,1107,375,1028,116,365,198,494,314,859
311630,202107,1371,3709,1130,3228,119,356,703,1962,822,2318
311640,202107,725,1909,585,1695,59,203,302,801,361,1004
311650,202107,1995,4907,1617,4327,194,552,978,2526,1172,3078
311660,202107,2959,8373,2213,6895,331,1135,593,1533,924,2668
311670,202107,1623,4083,1207,3342,154,468,517,1413,671,1881
311680,202107,2258,6193,1718,5209,120,350,1225,3697,1345,4047
311690,202107,625,1321,494,1162,37,71,365,900,402,971
311700,202107,2248,5264,1783,4610,19,94,1522,3830,1541,3924
311710,202107,1553,4405,1144,3684,272,957,388,1248,660,2205
311720,202107,442,1260,352,1101,38,135,181,574,219,709
311730,202107,3644,9266,2428,6898,674,2052,538,1534,1212,3586
311740,202107,938,2371,786,2184,69,174,644,1857,713,2031
311750,202107,4009,11593,3225,10206,351,1211,2005,6100,2356,7311
311760,202107,674,1862,554,1653,67,242,290,757,357,999
311770,202107,2203,6102,1737,5293,288,892,792,2319,1080,3211
311780,202107,1416,3961,1035,3230,154,566,373,1006,527,1572
311783,202107,2338,6135,1906,5420,33,152,1552,4241,1585,4393
311787,202107,856,2407,667,1974,94,312,297,766,391,1078
311790,202107,1539,4123,1011,3138,227,770,288,846,515,1616
311800,202107,5113,14967,4120,12879,843,2746,616,1575,1459,4321
311810,202107,953,2807,754,2464,43,155,514,1653,557,1808
311820,202107,828,1959,617,1644,60,186,394,988,454,1174
311830,202107,8652,24078,6045,18531,1660,5421,765,2274,2425,7695
311840,202107,3819,9312,3095,8288,217,623,2333,6195,2550,6818
311850,202107,375,969,303,837,11,32,206,538,217,570
311860,202107,64279,157993,49820,133517,6367,18539,29097,73878,35464,92417
311870,202107,1939,5045,1368,4047,241,812,587,1577,828,2389
311880,202107,6628,16617,5570,15163,299,670,4185,11681,4484,12351
311890,202107,1737,4078,1341,3533,88,255,941,2351,1029,2606
311900,202107,768,1921,578,1662,50,159,375,1061,425,1220
311910,202107,4169,10467,3152,9133,537,1517,1600,4820,2137,6337
311920,202107,2173,5571,1754,4967,120,288,1114,3278,1234,3566
311930,202107,4061,9249,2936,7694,804,2274,987,2425,1791,4699
311940,202107,16173,41242,11928,33313,1594,4862,5510,14335,7104,19197
311950,202107,2403,6231,1836,5283,123,391,1134,3292,1257,3683
311960,202107,500,1214,397,1062,28,96,241,582,269,678
311970,202107,430,1346,319,1070,55,228,75,208,130,436
311980,202107,471,1237,251,816,20,68,94,298,114,366
311990,202107,542,1257,344,958,61,205,142,351,203,556
311995,202107,975,2659,519,1612,16,51,75,150,91,201
312000,202107,798,1929,599,1635,52,129,382,1067,434,1196
312010,202107,1013,2695,795,2349,40,134,542,1528,582,1662
312015,202107,1408,3973,1251,3724,41,161,1023,2979,1064,3140
312020,202107,1744,5203,1266,4155,203,702,279,807,482,1509
312030,202107,2085,4994,1802,4684,15,59,1699,4412,1714,4471
312040,202107,856,2468,613,1995,75,244,270,858,345,1102
312050,202107,1225,3681,990,3233,209,831,344,1000,553,1831
312060,202107,934,2213,598,1770,148,452,257,756,405,1208
312070,202107,942,2615,671,2070,30,104,396,1149,426,1253
312080,202107,2777,6710,2115,5737,114,327,1431,3724,1545,4051
312083,202107,948,2376,729,2042,51,177,529,1429,580,1606
312087,202107,2586,6588,2099,5835,52,154,1679,4690,1731,4844
312090,202107,10812,27643,8534,24086,1121,3452,4520,12231,5641,15683
312100,202107,1607,4542,1285,3950,87,329,799,2344,886,2673
312110,202107,1070,3217,884,2848,177,658,333,971,510,1629
312120,202107,1044,2769,719,2206,184,653,209,525,393,1178
312125,202107,1817,4504,1529,4110,98,285,1182,3081,1280,3366
312130,202107,1077,2589,815,2156,71,205,367,890,438,1095
312140,202107,724,2056,597,1800,112,371,269,751,381,1122
312150,202107,487,1319,418,1185,19,60,288,760,307,820
312160,202107,9463,24893,7308,21151,818,2585,3632,10080,4450,12665
312170,202107,910,2359,705,1985,37,129,461,1251,498,1380
312180,202107,1421,3704,1144,3198,150,435,608,1659,758,2094
312190,202107,697,1886,525,1576,72,249,215,612,287,861
312200,202107,4566,12168,3613,10624,754,2120,1652,4984,2406,7104
312210,202107,1414,3073,1032,2537,47,128,780,1878,827,2006
312220,202107,1617,4928,1398,4526,99,340,901,2937,1000,3277
312230,202107,15630,39091,10804,30543,2298,7353,2731,6459,5029,13812
312235,202107,2018,4940,1587,4341,102,314,1139,3016,1241,3330
312240,202107,756,2350,582,1994,108,407,173,570,281,977
312245,202107,2766,6862,2281,6135,52,120,1925,5159,1977,5279
312247,202107,1046,2417,760,2012,112,315,441,1155,553,1470
312250,202107,973,2555,621,1859,75,234,224,644,299,878
312260,202107,977,2556,778,2257,35,134,607,1681,642,1815
312270,202107,750,2028,572,1670,32,120,316,849,348,969
312280,202107,429,1231,335,1065,91,305,55,163,146,468
312290,202107,847,2395,698,2139,122,411,234,669,356,1080
312300,202107,1021,3036,683,2208,162,576,131,347,293,923
312310,202107,988,2860,796,2475,115,391,386,1150,501,1541
312320,202107,2088,5235,1524,4276,331,961,336,933,667,1894
312330,202107,878,2503,717,2171,70,236,448,1319,518,1555
312340,202107,265,661,190,543,33,127,99,235,132,362
312350,202107,263,521,191,443,19,46,132,301,151,347
312352,202107,1595,4713,1406,4359,90,281,843,2804,933,3085
312360,202107,3114,8786,2317,7308,420,1463,830,2421,1250,3884
312370,202107,1980,4946,1626,4355,163,497,1024,2613,1187,3110
312380,202107,2208,4936,1846,4474,7,20,1651,3946,1658,3966
312385,202107,1294,3416,1006,2912,179,545,382,1132,561,1677
312390,202107,1967,5472,1452,4526,193,704,484,1341,677,2045
312400,202107,2964,8222,2489,7426,685,2238,820,2438,1505,4676
312410,202107,12522,33345,10242,29628,1717,5032,5784,16486,7501,21518
312420,202107,3967,10278,3285,9176,614,1848,1728,4666,2342,6514
312430,202107,8097,21055,6647,18513,339,1084,4815,13078,5154,14162
312440,202107,972,3093,802,2715,374,1351,127,392,501,1743
312450,202107,1222,3528,934,3020,259,875,286,971,545,1846
312460,202107,470,1160,335,955,48,137,190,553,238,690
312470,202107,482,1151,300,822,30,92,108,258,138,350
312480,202107,1057,2577,750,2124,87,282,392,1041,479,1323
312490,202107,2282,5296,1807,4628,166,476,1066,2666,1232,3142
312500,202107,1073,2565,887,2317,40,139,652,1680,692,1819
312510,202107,4109,10807,2975,8667,718,2050,730,2118,1448,4168
312520,202107,264,660,203,568,42,132,90,238,132,370
312530,202107,662,1552,563,1437,28,69,456,1203,484,1272
312540,202107,1642,4414,1127,3424,144,456,631,1855,775,2311
312550,202107,814,2106,631,1753,45,143,412,1062,457,1205
312560,202107,1978,5104,1597,4499,72,201,1180,3332,1252,3533
312570,202107,2437,5639,1830,4886,442,1171,803,2262,1245,3433
312580,202107,632,1687,442,1305,56,194,193,507,249,701
312590,202107,1624,4601,1265,3864,76,303,790,2232,866,2535
312595,202107,2089,5869,1740,5298,255,706,1041,3362,1296,4068
312600,202107,1207,2866,703,1889,113,369,125,383,238,752
312610,202107,7299,18103,4919,13768,692,2113,1755,4431,2447,6544
312620,202107,2587,6515,1922,5573,51,164,1537,4549,1588,4713
312630,202107,310,848,216,676,31,117,81,253,112,370
312640,202107,513,1377,360,1116,36,130,162,497,198,627
312650,202107,2115,5198,1482,4049,73,209,1058,2748,1131,2957
312660,202107,1345,3213,1027,2681,96,249,683,1736,779,1985
312670,202107,5151,13159,4305,11832,172,634,3228,8499,3400,9133
312675,202107,1332,3337,1095,2997,55,156,900,2435,955,2591
312680,202107,1428,3922,1234,3612,41,168,1028,2936,1069,3104
312690,202107,3035,6268,2347,5454,43,109,1967,4575,2010,4684
312695,202107,996,2592,847,2358,49,104,657,1835,706,1939
312700,202107,2123,5463,1559,4453,139,470,923,2495,1062,2965
312705,202107,1472,3411,1271,3120,13,40,1171,2851,1184,2891
312707,202107,1435,4000,1095,3409,69,268,714,2129,783,2397
312710,202107,6676,15117,4051,11072,967,2844,1139,3251,2106,6095
312720,202107,1130,2882,847,2441,95,290,524,1454,619,1744
312730,202107,1676,3883,1192,3225,96,279,710,1859,806,2138
312733,202107,1402,3618,1058,2974,23,77,745,1972,768,2049
312735,202107,757,1943,611,1669,79,212,352,898,431,1110
312737,202107,813,1769,584,1451,60,162,393,953,453,1115
312738,202107,729,1794,526,1457,49,147,309,817,358,964
312740,202107,438,1083,257,780,48,167,59,127,107,294
312750,202107,1610,4512,1204,3752,192,623,532,1561,724,2184
312760,202107,1849,5314,1330,4236,231,757,495,1515,726,2272
312770,202107,45732,107919,29036,79491,5507,16295,10086,26598,15593,42893
312780,202107,2495,7205,2101,6559,233,745,1385,4341,1618,5086
312790,202107,253,583,138,401,2,6,40,83,42,89
312800,202107,5182,14184,3969,11889,826,2621,1586,4532,2412,7153
312810,202107,1567,4147,1054,3298,258,888,389,1113,647,2001
312820,202107,1811,4685,1465,4090,69,222,1085,2962,1154,3184
312825,202107,1414,3211,1235,2982,20,61,1072,2534,1092,2595
312830,202107,2853,7842,1753,5629,315,1146,457,1373,772,2519
312840,202107,1476,3773,1183,3301,70,253,714,1862,784,2115
312850,202107,1006,2350,713,1926,19,70,450,1121,469,1191
312860,202107,1112,2816,763,2287,186,577,178,503,364,1080
312870,202107,6256,16418,3965,12071,600,1949,1041,2879,1641,4828
312880,202107,1495,3668,1155,3104,44,133,687,1875,731,2008
312890,202107,2312,5604,1722,4656,134,331,883,2424,1017,2755
312900,202107,1276,3207,1037,2892,152,471,492,1487,644,1958
312910,202107,1575,2866,857,1934,190,367,319,755,509,1122
312920,202107,1013,2652,712,2173,119,423,271,742,390,1165
312930,202107,2474,5942,1898,5091,404,1079,844,2346,1248,3425
312940,202107,1011,2720,803,2425,60,233,467,1349,527,1582
312950,202107,3141,7577,2110,5945,457,1443,768,2050,1225,3493
312960,202107,1884,4843,1594,4410,86,211,1205,3436,1291,3647
312965,202107,1674,4477,1397,4060,115,303,969,2819,1084,3122
312970,202107,1468,4030,1185,3576,142,499,734,2106,876,2605
312980,202107,25344,67672,20459,59060,3973,12222,9326,25301,13299,37523
312990,202107,524,1264,350,973,57,186,178,443,235,629
313000,202107,483,1364,365,1149,23,104,222,661,245,765
313005,202107,2610,7312,2203,6631,140,388,1588,4733,1728,5121
313010,202107,5414,14314,4325,12590,718,2269,2555,7312,3273,9581
313020,202107,1116,3266,816,2609,132,443,172,481,304,924
313030,202107,1188,2614,809,2085,67,221,541,1322,608,1543
313040,202107,838,2519,693,2232,39,166,424,1294,463,1460
313050,202107,1808,4866,1268,4062,199,773,410,1152,609,1925
313055,202107,1963,5146,1746,4838,75,216,1498,4132,1573,4348
313060,202107,996,2389,714,1904,141,452,156,383,297,835
313065,202107,1691,4890,1492,4570,42,147,1176,3514,1218,3661
313070,202107,962,2483,743,2121,72,217,436,1204,508,1421
313080,202107,400,1096,298,902,53,179,113,285,166,464
313090,202107,5381,13755,4569,12469,306,951,3158,8510,3464,9461
313100,202107,1351,3453,1038,3003,27,110,791,2236,818,2346
313110,202107,1498,3884,1114,3226,100,350,611,1639,711,1989
313115,202107,2864,7922,2287,6827,265,912,1242,3409,1507,4321
313120,202107,3903,9065,2870,7716,197,583,1936,5209,2133,5792
313130,202107,32644,81839,24865,67785,2437,7577,14279,36563,16716,44140
313140,202107,700,1466,444,1113,25,62,326,815,351,877
313150,202107,1400,3854,1050,3235,318,1054,177,496,495,1550
313160,202107,1266,3107,999,2712,19,66,765,2007,784,2073
313170,202107,11434,31769,8432,26185,1299,4415,3356,9627,4655,14042
313180,202107,2237,5799,1626,4571,260,690,902,2547,1162,3237
313190,202107,4525,12725,3294,10226,563,1867,1154,3345,1717,5212
313200,202107,1144,3085,995,2824,15,52,843,2326,858,2378
313210,202107,4029,11166,3304,9880,366,1118,2014,5879,2380,6997
313220,202107,1792,4614,1189,3427,156,501,505,1287,661,1788
313230,202107,3017,8222,2470,7543,45,154,2052,6396,2097,6550
313240,202107,10415,25007,6835,19393,950,3090,3221,8522,4171,11612
313250,202107,6335,18188,4828,14933,881,2696,2137,6359,3018,9055
313260,202107,713,1808,524,1484,64,231,266,684,330,915
313270,202107,5952,14345,4812,12795,525,1247,3380,9251,3905,10498
313280,202107,477,1305,313,970,35,119,129,382,164,501
313290,202107,1007,3039,757,2589,181,693,277,933,458,1626
313300,202107,1682,4394,1248,3649,297,934,341,881,638,1815
313310,202107,1259,3647,988,3083,148,541,302,806,450,1347
313320,202107,2146,5600,1556,4666,267,908,590,1810,857,2718
313330,202107,4266,10899,3238,9353,147,518,2121,6081,2268,6599
313340,202107,1455,3216,1052,2659,75,203,760,1888,835,2091
313350,202107,3048,8256,2006,5951,217,738,780,1985,997,2723
313360,202107,1571,3769,1074,2965,157,532,568,1435,725,1967
313370,202107,1567,4236,1278,3681,172,545,594,1566,766,2111
313375,202107,1868,4848,1206,3592,224,723,254,682,478,1405
313380,202107,6547,16039,4758,12823,741,2256,2327,5579,3068,7835
313390,202107,816,2566,711,2385,54,230,477,1537,531,1767
313400,202107,3767,9070,2908,7884,119,347,2252,5989,2371,6336
313410,202107,1389,3484,1064,2927,82,247,741,1973,823,2220
313420,202107,16216,35463,8557,22811,1941,5755,1121,2954,3062,8709
313430,202107,998,2818,775,2362,114,430,364,955,478,1385
313440,202107,6221,13316,4187,10683,342,912,2730,6965,3072,7877
313450,202107,763,1990,542,1568,93,290,194,480,287,770
313460,202107,2169,6035,1718,5317,339,1187,793,2326,1132,3513
313470,202107,2913,7264,2301,6367,200,550,1570,4403,1770,4953
313480,202107,1067,2981,638,2046,52,187,212,628,264,815
313490,202107,3058,7386,1594,4716,364,1185,397,1147,761,2332
313500,202107,553,1507,407,1199,34,104,172,469,206,573
313505,202107,10385,26831,8861,24757,326,1051,7126,19933,7452,20984
313507,202107,1512,3797,1238,3372,32,132,997,2623,1029,2755
313510,202107,14635,39433,11398,33064,1352,3827,5383,15348,6735,19175
313520,202107,15131,41045,12093,35884,574,1916,9101,26428,9675,28344
313530,202107,577,1673,435,1378,47,168,144,389,191,557
313535,202107,2447,6641,2013,5821,268,700,1253,3650,1521,4350
313540,202107,821,2374,662,2001,118,371,282,769,400,1140
313545,202107,1164,3781,990,3439,124,466,547,1827,671,2293
313550,202107,1848,5453,1537,4729,288,977,820,2418,1108,3395
313560,202107,2808,5374,2110,4528,60,95,1785,3864,1845,3959
313570,202107,1023,2873,837,2545,197,619,337,1008,534,1627
313580,202107,6103,15108,4786,12936,482,1346,2934,7870,3416,9216
313590,202107,1115,3001,900,2683,175,555,451,1426,626,1981
313600,202107,4230,10838,3525,9761,81,287,3023,8224,3104,8511
313610,202107,1099,2666,885,2308,82,239,581,1431,663,1670
313620,202107,5538,14350,4350,12221,478,1553,2591,6971,3069,8524
313630,202107,9106,21420,6512,17570,615,1928,3989,10475,4604,12403
313640,202107,1245,2625,770,2026,118,328,423,1103,541,1431
313650,202107,1730,5072,1366,4462,95,360,882,2912,977,3272
313652,202107,800,2417,718,2260,86,287,486,1480,572,1767
313655,202107,1168,2859,908,2537,55,156,666,1875,721,2031
313657,202107,1191,3080,949,2697,31,110,721,1940,752,2050
313660,202107,990,2735,804,2411,73,265,520,1497,593,1762
313665,202107,5185,13442,4142,11643,382,1205,2669,7140,3051,8345
313670,202107,51447,123761,33702,93994,4503,13773,15757,41367,20260,55140
313680,202107,1078,2791,894,2487,53,159,619,1675,672,1834
313690,202107,848,2542,646,2160,142,525,193,616,335,1141
313695,202107,1901,4931,1430,4158,105,298,913,2739,1018,3037
313700,202107,3022,9281,2643,8778,240,742,2025,6810,2265,7552
313710,202107,1513,3354,1079,2779,68,179,730,1892,798,2071
313720,202107,6067,16306,4352,12737,596,1840,1835,4933,2431,6773
313730,202107,1444,3101,1068,2619,82,172,704,1759,786,1931
313740,202107,1751,6115,1469,5387,298,1245,289,919,587,2164
313750,202107,2119,5481,1662,4702,282,887,840,2211,1122,3098
313753,202107,2272,5369,1511,4127,155,469,816,2154,971,2623
313760,202107,5796,15559,4485,13032,792,2599,2136,5723,2928,8322
313770,202107,4119,11301,3272,9960,153,450,2482,7668,2635,8118
313780,202107,4156,10687,3091,8963,247,801,964,2882,1211,3683
313790,202107,531,1545,472,1440,50,163,291,869,341,1032
313800,202107,1416,3100,1032,2579,96,263,561,1338,657,1601
313810,202107,1684,4139,1360,3685,46,158,1065,2813,1111,2971
313820,202107,18287,45968,11530,31701,1912,5392,2984,7981,4896,13373
313830,202107,411,1173,292,906,52,184,103,292,155,476
313835,202107,928,2644,768,2362,67,246,428,1234,495,1480
313840,202107,7766,19840,6015,17005,1315,3999,1316,3817,2631,7816
313850,202107,1006,2417,795,2132,137,425,376,905,513,1330
313860,202107,2714,7009,2057,5802,276,911,956,2444,1232,3355
313862,202107,1327,2763,653,1790,40,111,301,824,341,935
313865,202107,2671,6884,2210,6152,90,256,1677,4577,1767,4833
313867,202107,1422,4209,1188,3782,218,686,607,2002,825,2688
313868,202107,1742,5175,1437,4600,45,178,1101,3404,1146,3582
313870,202107,1022,2596,696,2009,92,281,272,713,364,994
313880,202107,1896,4799,1400,3956,166,532,721,1847,887,2379
313890,202107,2178,4541,1639,3839,28,86,1274,2894,1302,2980
313900,202107,4498,12509,3226,9960,780,2624,827,2283,1607,4907
313910,202107,719,2044,542,1705,95,320,114,364,209,684
313920,202107,3021,8859,2517,7824,493,1539,1268,3963,1761,5502
313925,202107,1648,4052,1336,3519,148,375,907,2382,1055,2757
313930,202107,4839,13993,3932,12373,276,943,2582,8006,2858,8949
313940,202107,9227,26000,6876,21952,677,2627,1730,6245,2407,8872
313950,202107,5477,11809,4155,10197,306,932,2703,6694,3009,7626
313960,202107,5897,13869,3963,10629,734,2214,1267,3090,2001,5304
313970,202107,1574,4128,1324,3715,22,69,856,2352,878,2421
313980,202107,1323,3391,880,2717,140,472,365,1069,505,1541
313990,202107,1978,6082,1451,4922,311,1232,553,1664,864,2896
314000,202107,10185,25339,8470,22451,634,2062,5596,14547,6230,16609
314010,202107,1488,3500,1182,3087,33,105,916,2320,949,2425
314015,202107,2038,5464,1573,4661,180,634,898,2550,1078,3184
314020,202107,534,1423,370,1141,88,323,71,241,159,564
314030,202107,811,2263,637,1944,74,216,332,1007,406,1223
314040,202107,604,1627,497,1431,81,264,257,704,338,968
314050,202107,1943,5060,1441,4135,133,443,811,2172,944,2615
314053,202107,1948,5639,1573,4910,315,949,843,2750,1158,3699
314055,202107,2274,5927,1916,5385,41,161,1587,4436,1628,4597
314060,202107,1351,3488,1027,2985,31,100,730,2097,761,2197
314070,202107,4930,13091,3900,11290,727,2084,1772,5082,2499,7166
314080,202107,2186,5533,1516,4399,165,526,670,1773,835,2299
314085,202107,2351,6291,1923,5645,186,551,1172,3480,1358,4031
314090,202107,5010,12889,4300,11845,255,797,2861,8148,3116,8945
314100,202107,3068,7307,2378,6349,37,112,1780,4784,1817,4896
314110,202107,5138,13976,4197,12221,470,1523,2328,6294,2798,7817
314120,202107,733,1683,322,940,53,175,89,246,142,421
314130,202107,667,1748,435,1323,28,101,254,746,282,847
314140,202107,4645,12657,3723,10980,488,1475,1897,5516,2385,6991
314150,202107,1528,3749,1118,3050,63,162,763,2048,826,2210
314160,202107,2346,5910,1717,4765,214,642,754,2086,968,2728
314170,202107,947,2588,775,2255,40,150,515,1394,555,1544
314180,202107,5643,15188,4550,13440,348,1066,2785,8255,3133,9321
314190,202107,640,1564,477,1328,74,236,252,652,326,888
314200,202107,3088,8434,2559,7550,170,525,1777,5128,1947,5653
314210,202107,2141,5424,1694,4631,229,653,770,2056,999,2709
314220,202107,1491,3969,1120,3337,229,761,423,1164,652,1925
314225,202107,1108,3111,928,2808,69,170,669,2065,738,2235
314230,202107,842,2127,683,1921,79,231,438,1266,517,1497
314240,202107,1116,2929,865,2545,184,562,352,1044,536,1606
314250,202107,496,1382,314,995,46,128,112,334,158,462
314260,202107,1028,2647,791,2331,157,513,425,1221,582,1734
314270,202107,3336,9220,2744,8304,66,266,2056,6166,2122,6432
314280,202107,3565,8082,2421,6351,257,752,1397,3460,1654,4212
314290,202107,4566,11570,3789,10202,319,866,2590,6829,2909,7695
314300,202107,2078,5746,1359,4225,232,783,472,1318,704,2101
314310,202107,3986,10244,2673,7997,798,2661,411,1047,1209,3708
314315,202107,1001,3164,854,2855,44,179,613,1996,657,2175
314320,202107,3205,8503,2113,6471,363,1211,789,2274,1152,3485
314330,202107,51785,141878,39519,120432,9949,31540,8558,27274,18507,58814
314340,202107,2536,6240,1602,4583,294,971,407,1014,701,1985
314345,202107,1485,4241,1197,3721,136,425,742,2285,878,2710
314350,202107,833,2225,544,1697,114,363,126,326,240,689
314360,202107,557,1606,360,1194,52,183,120,357,172,540
314370,202107,768,1993,620,1777,48,146,413,1150,461,1296
314380,202107,1163,3079,765,2384,173,611,168,500,341,1111
314390,202107,14794,36325,9918,27639,1495,4530,3504,8643,4999,13173
314400,202107,3977,11724,3056,9896,782,2646,1123,3812,1905,6458
314410,202107,2830,7806,1994,6238,249,906,620,2017,869,2923
314420,202107,854,2064,628,1699,33,118,431,1109,464,1227
314430,202107,8174,19266,5767,15342,818,2283,2783,7048,3601,9331
314435,202107,1952,5115,1520,4407,154,464,933,2641,1087,3105
314437,202107,930,2326,671,1907,73,219,348,984,421,1203
314440,202107,633,1780,452,1426,140,489,85,210,225,699
314450,202107,1473,3813,1233,3421,138,409,693,1853,831,2262
314460,202107,3223,9623,2369,7881,578,2052,590,1858,1168,3910
314465,202107,2266,6366,1925,5734,46,151,1503,4380,1549,4531
314467,202107,914,2374,773,2150,19,53,618,1674,637,1727
314470,202107,2428,6733,2007,5898,343,1081,935,2553,1278,3634
314480,202107,7661,20794,5789,16947,901,2950,2325,6000,3226,8950
314490,202107,1128,2883,827,2277,64,194,544,1447,608,1641
314500,202107,1683,3972,1220,3361,310,823,419,1207,729,2030
314505,202107,2122,5037,1739,4497,89,250,1304,3271,1393,3521
314510,202107,2086,5271,1474,4338,294,964,670,1916,964,2880
314520,202107,5370,15927,4144,13494,830,2969,680,1962,1510,4931
314530,202107,5539,17282,4970,16205,305,1173,3705,11823,4010,12996
314535,202107,2557,6540,2089,5861,71,252,1644,4590,1715,4842
314537,202107,1164,3244,900,2818,47,165,655,2008,702,2173
314540,202107,417,1027,289,817,22,64,169,452,191,516
314545,202107,2015,4673,1809,4437,31,80,1587,3976,1618,4056
314550,202107,738,1742,543,1448,34,112,323,789,357,901
314560,202107,4737,13707,3489,10998,479,1729,1315,3638,1794,5367
314570,202107,320,877,234,721,29,97,109,341,138,438
314580,202107,458,1349,365,1167,93,296,121,386,214,682
314585,202107,667,2021,510,1678,53,205,234,749,287,954
314587,202107,2173,5747,1666,4945,305,857,911,2738,1216,3595
314590,202107,4291,11302,3184,9284,399,1292,1494,3978,1893,5270
314600,202107,1964,5218,1194,3772,261,859,136,420,397,1279
314610,202107,9319,22625,6753,18888,953,3162,3096,8828,4049,11990
314620,202107,2320,5296,1848,4701,39,119,1562,3958,1601,4077
314625,202107,1591,4213,1367,3903,25,143,1187,3318,1212,3461
314630,202107,5596,13656,4575,12288,103,401,3818,10167,3921,10568
314640,202107,720,1669,531,1376,63,191,316,759,379,950
314650,202107,845,1937,535,1453,49,155,306,740,355,895
314655,202107,1594,4326,1144,3532,161,467,573,1811,734,2278
314660,202107,335,755,226,568,12,27,147,360,159,387
314670,202107,1672,3720,1162,2990,19,53,796,2010,815,2063
314675,202107,1754,4476,1486,4036,68,202,1178,3122,1246,3324
314690,202107,2104,5659,1594,4916,387,1303,573,1750,960,3053
314700,202107,11225,30160,7563,23271,1307,4402,2782,8207,4089,12609
314710,202107,8318,22808,6122,18236,933,3096,2338,6071,3271,9167
314720,202107,2255,6570,1580,5190,287,1011,361,1103,648,2114
314730,202107,2411,6151,1747,4978,291,905,644,1687,935,2592
314740,202107,3087,8537,2420,7343,326,1024,1230,3623,1556,4647
314750,202107,286,777,220,642,26,89,133,340,159,429
314760,202107,2014,5836,1312,4279,230,835,318,806,548,1641
314770,202107,1113,3156,626,1972,63,209,193,549,256,758
314780,202107,366,882,252,705,39,125,142,353,181,478
314790,202107,12358,32042,8771,25464,1528,5014,3514,9460,5042,14474
314795,202107,1587,4073,1344,3660,27,115,1086,2842,1113,2957
314800,202107,11223,28135,7128,20686,1228,3842,1926,4968,3154,8810
314810,202107,9370,24338,6872,20074,1761,5438,2191,6269,3952,11707
314820,202107,1284,3037,1008,2610,70,221,632,1548,702,1769
314830,202107,1677,4836,1402,4329,200,662,722,2163,922,2825
314840,202107,864,2646,674,2309,48,211,461,1497,509,1708
314850,202107,2288,5016,1857,4479,51,138,1606,3865,1657,4003
314860,202107,3348,9460,2802,8487,149,594,2014,5925,2163,6519
314870,202107,6623,15805,5025,13771,227,628,3747,10426,3974,11054
314875,202107,1893,5506,1677,5220,170,425,1313,4242,1483,4667
314880,202107,857,2046,665,1748,42,115,407,1078,449,1193
314890,202107,436,1270,337,1069,54,187,144,429,198,616
314900,202107,806,2084,623,1764,84,267,287,780,371,1047
314910,202107,1707,4720,1271,4008,191,702,662,1957,853,2659
314915,202107,2199,6396,1849,5775,117,365,1223,3754,1340,4119
314920,202107,505,1304,340,1057,16,42,220,700,236,742
314930,202107,5791,15947,4419,13385,707,2403,1844,5114,2551,7517
314940,202107,422,1005,350,888,39,96,226,555,265,651
314950,202107,581,1426,400,1143,25,82,217,574,242,656
314960,202107,867,1999,668,1681,26,79,488,1158,514,1237
314970,202107,1002,2917,772,2447,131,456,346,991,477,1447
314980,202107,1649,4111,1253,3531,206,649,643,1759,849,2408
314990,202107,2558,7302,1853,5733,361,1154,402,1124,763,2278
314995,202107,1676,4559,1335,3951,29,115,910,2535,939,2650
315000,202107,1139,2845,818,2350,62,179,532,1513,594,1692
315010,202107,382,1038,295,889,48,171,146,415,194,586
315015,202107,2325,6390,2022,5881,184,619,1366,3897,1550,4516
315020,202107,808,2327,575,1816,61,229,255,750,316,979
315030,202107,615,1606,416,1242,92,285,86,217,178,502
315040,202107,924,2440,753,2140,101,324,471,1278,572,1602
315050,202107,1271,3151,940,2634,51,178,520,1378,571,1556
315053,202107,1164,2967,888,2496,54,155,526,1407,580,1562
315057,202107,1820,5257,1476,4689,139,396,986,3255,1125,3651
315060,202107,614,1804,451,1476,92,301,115,363,207,664
315070,202107,559,1423,398,1149,92,290,130,349,222,639
315080,202107,3223,8581,2525,7319,138,430,1755,4833,1893,5263
315090,202107,823,2419,614,2023,83,306,262,821,345,1127
315100,202107,1388,3960,915,2905,125,470,406,1119,531,1589
315110,202107,2090,4857,1524,4015,138,356,780,2108,918,2464
315120,202107,13036,29563,9689,24611,1158,2670,5478,14398,6636,17068
315130,202107,1706,4569,1422,4088,140,464,610,1628,750,2092
315140,202107,3005,8156,2375,7046,437,1432,1189,3309,1626,4741
315150,202107,4481,10673,3188,8629,435,1366,1546,4087,1981,5453
315160,202107,1912,4579,1272,3579,263,798,572,1561,835,2359
315170,202107,1388,4313,989,3357,207,762,271,865,478,1627
315180,202107,18061,43040,10301,28982,1292,4095,3566,8768,4858,12863
315190,202107,2261,4899,1760,4248,229,552,1235,3023,1464,3575
315200,202107,4129,11363,3038,9482,822,2785,787,2372,1609,5157
315210,202107,9046,22882,6337,17343,678,1998,3249,8025,3927,10023
315213,202107,1136,2953,987,2745,20,73,818,2218,838,2291
315217,202107,2903,8114,2203,6942,73,285,1491,4519,1564,4804
315220,202107,8795,23368,6963,20199,999,3008,3306,9595,4305,12603
315230,202107,3087,6998,2580,6320,210,332,1807,4824,2017,5156
315240,202107,2480,7048,2069,6350,424,1365,986,3054,1410,4419
315250,202107,14162,37320,10395,30338,1570,4919,4443,12325,6013,17244
315260,202107,894,2401,494,1581,77,244,38,109,115,353
315270,202107,891,2523,652,2074,87,295,229,636,316,931
315280,202107,2923,7192,1834,5273,452,1380,318,902,770,2282
315290,202107,1194,2897,720,2143,184,608,209,608,393,1216
315300,202107,661,1597,473,1331,57,180,276,781,333,961
315310,202107,1261,3442,966,2896,70,229,565,1582,635,1811
315320,202107,675,1946,475,1543,68,248,193,575,261,823
315330,202107,774,2551,442,1667,66,282,153,505,219,787
315340,202107,3004,7153,2139,5874,343,954,1065,2894,1408,3848
315350,202107,1632,4332,1316,3845,153,519,794,2270,947,2789
315360,202107,1806,5161,1400,4348,193,627,612,1740,805,2367
315370,202107,558,1511,447,1306,79,224,205,584,284,808
315380,202107,268,747,195,589,33,116,28,71,61,187
315390,202107,1191,3277,965,2869,124,450,503,1368,627,1818
315400,202107,4172,11033,3308,9507,387,1193,1937,5291,2324,6484
315410,202107,2560,5677,1913,4731,396,1088,392,997,788,2085
315415,202107,1472,3917,1190,3481,250,851,425,1244,675,2095
315420,202107,1512,4148,1056,3297,184,604,238,701,422,1305
315430,202107,3736,8942,2651,7326,441,1414,1183,3089,1624,4503
315440,202107,1074,2783,850,2416,69,230,506,1340,575,1570
315445,202107,1994,4682,1450,3910,86,265,1084,2879,1170,3144
315450,202107,2361,6320,1937,5621,255,650,1194,3512,1449,4162
315460,202107,40445,108510,33481,96295,4332,14159,19351,52039,23683,66198
315470,202107,675,1827,483,1373,35,112,274,735,309,847
315480,202107,1163,3273,838,2596,142,453,282,836,424,1289
315490,202107,2982,7405,2100,6006,271,797,825,2227,1096,3024
315500,202107,536,1411,337,984,40,142,173,434,213,576
315510,202107,1303,3287,1099,3005,14,52,977,2626,991,2678
315520,202107,1027,2742,846,2451,44,143,662,1872,706,2015
315530,202107,631,1708,505,1484,108,369,274,747,382,1116
315540,202107,1616,4191,1120,3277,87,292,513,1446,600,1738
315550,202107,1910,4972,1254,3766,245,844,330,982,575,1826
315560,202107,6493,19041,5528,17323,321,941,3749,11922,4070,12863
315570,202107,2153,5632,1711,4891,161,503,882,2435,1043,2938
315580,202107,3176,7298,2456,6170,344,916,986,2366,1330,3282
315590,202107,945,2294,735,1978,54,178,472,1189,526,1367
315600,202107,2588,7775,1826,6283,302,939,888,3276,1190,4215
315610,202107,1023,2519,772,2075,103,345,363,840,466,1185
315620,202107,537,1391,410,1204,46,147,225,665,271,812
315630,202107,1082,2788,827,2329,116,364,411,1055,527,1419
315640,202107,359,870,268,756,28,100,166,446,194,546
315645,202107,1018,2578,711,2080,151,481,191,522,342,1003
315650,202107,1727,4089,1396,3630,41,118,1119,2841,1160,2959
315660,202107,2481,6054,1858,4984,90,272,1346,3475,1436,3747
315670,202107,14335,38082,10988,32130,2010,6165,5113,14241,7123,20406
315680,202107,3277,9111,2438,7539,251,923,1392,4067,1643,4990
315690,202107,3727,8923,2291,6499,483,1370,593,1834,1076,3204
315700,202107,8576,22912,6508,18912,973,2961,2935,8134,3908,11095
315710,202107,1894,4545,1361,3752,52,174,957,2567,1009,2741
315720,202107,4515,12256,3751,10887,176,665,2662,7422,2838,8087
315725,202107,2293,5786,1759,4934,222,588,1058,3119,1280,3707
315727,202107,577,1457,441,1239,51,174,193,513,244,687
315730,202107,607,1808,530,1661,92,328,177,486,269,814
315733,202107,1335,3305,1002,2760,151,469,378,969,529,1438
315737,202107,1200,3267,945,2773,26,99,678,1907,704,2006
315740,202107,824,2252,667,1935,63,207,448,1217,511,1424
315750,202107,1274,3292,1020,2895,93,274,638,1828,731,2102
315760,202107,1180,2723,1028,2516,48,154,852,2030,900,2184
315765,202107,2012,5167,1655,4700,28,103,1470,4160,1498,4263
315770,202107,1040,2806,807,2480,317,1067,160,436,477,1503
315780,202107,31617,83970,26442,74799,1378,4762,18355,49318,19733,54080
315790,202107,3679,11086,3136,10086,307,1026,1924,6333,2231,7359
315800,202107,1343,4454,1012,3645,134,547,371,1158,505,1705
315810,202107,1328,3276,1095,2880,60,180,847,2151,907,2331
315820,202107,2656,6889,2121,6143,197,591,1490,4334,1687,4925
315830,202107,1247,3618,843,2728,87,302,271,741,358,1043
315840,202107,910,2149,643,1683,46,151,342,806,388,957
315850,202107,1225,3466,968,3024,176,568,485,1440,661,2008
315860,202107,502,1400,353,1140,55,194,124,350,179,544
315870,202107,484,1273,386,1115,26,82,271,752,297,834
315880,202107,1147,2854,796,2233,92,281,234,612,326,893
315890,202107,1738,4819,1411,4370,345,1190,705,2156,1050,3346
315895,202107,6459,17150,4865,14063,450,1456,2531,6803,2981,8259
315900,202107,829,2095,714,1933,63,172,528,1399,591,1571
315910,202107,539,1442,453,1308,70,195,297,864,367,1059
315920,202107,1477,3697,846,2518,126,449,280,737,406,1186
315930,202107,1130,2458,771,1948,139,327,346,890,485,1217
315935,202107,895,2644,714,2296,135,461,260,820,395,1281
315940,202107,622,1666,493,1472,64,197,262,753,326,950
315950,202107,1165,3186,964,2859,90,259,742,2204,832,2463
315960,202107,5756,15791,3956,12191,1051,3541,527,1142,1578,4683
315970,202107,591,1547,470,1386,59,176,309,931,368,1107
315980,202107,4395,9281,2463,6178,452,1198,956,2186,1408,3384
315990,202107,3632,9168,2844,7814,330,927,1560,4136,1890,5063
316000,202107,653,1577,502,1357,52,170,268,686,320,856
316010,202107,826,2218,619,1858,58,190,319,857,377,1047
316020,202107,961,2789,769,2415,111,390,424,1242,535,1632
316030,202107,2798,7689,2156,6529,240,731,1371,4237,1611,4968
316040,202107,2624,7309,1956,6052,313,1121,565,1518,878,2639
316045,202107,2110,5339,1941,5133,78,148,1698,4598,1776,4746
316050,202107,416,1122,328,980,51,139,177,494,228,633
316060,202107,701,1686,515,1440,18,74,367,983,385,1057
316070,202107,5585,15075,4567,13193,805,2308,2108,5908,2913,8216
316080,202107,766,2330,597,1990,146,528,91,252,237,780
316090,202107,422,1165,329,986,43,137,170,464,213,601
316095,202107,1337,4059,1044,3322,266,902,379,1136,645,2038
316100,202107,2535,7211,1861,5821,306,1050,708,2003,1014,3053
316105,202107,857,2213,701,1965,44,137,480,1379,524,1516
316110,202107,14233,39571,11923,35720,828,2757,8257,24360,9085,27117
316120,202107,1280,3473,843,2494,124,385,277,645,401,1030
316130,202107,1268,2852,841,2150,65,187,507,1249,572,1436
316140,202107,1259,3290,794,2416,87,286,371,1110,458,1396
316150,202107,2145,4680,1717,4089,208,612,778,1749,986,2361
316160,202107,1048,2759,842,2385,36,117,603,1669,639,1786
316165,202107,891,2127,704,1844,112,334,400,985,512,1319
316170,202107,1250,3028,948,2580,35,106,678,1764,713,1870
316180,202107,1496,4130,1036,3221,153,539,245,686,398,1225
316190,202107,2770,7697,1666,5086,238,766,658,1775,896,2541
316200,202107,3354,9423,2581,8085,548,1835,817,2460,1365,4295
316210,202107,4838,13967,3444,10709,1132,3887,195,470,1327,4357
316220,202107,660,1969,449,1513,90,345,50,192,140,537
316225,202107,1609,3602,1209,2976,49,178,924,2120,973,2298
316230,202107,443,1186,342,1012,59,186,167,488,226,674
316240,202107,5689,16151,4977,14892,359,1145,3771,11130,4130,12275
316245,202107,3266,10034,2971,9550,102,547,2391,7358,2493,7905
316250,202107,11049,25914,8203,21429,1638,4600,3117,8045,4755,12645
316255,202107,2949,8021,2588,7459,106,304,1971,5756,2077,6060
316257,202107,1434,3384,1047,2722,94,260,662,1635,756,1895
316260,202107,2317,5558,1838,4811,215,548,987,2641,1202,3189
316265,202107,1158,3068,906,2637,16,58,688,1963,704,2021
316270,202107,3820,11415,3288,10285,487,1600,1689,5065,2176,6665
316280,202107,3025,8205,2582,7406,334,1023,1421,3950,1755,4973
316290,202107,3635,9831,2948,8555,354,1117,1185,3299,1539,4416
316292,202107,5379,13954,4324,12240,551,1616,2745,7499,3296,9115
316294,202107,876,2541,664,2179,117,453,174,526,291,979
316295,202107,3435,9457,2807,8379,146,539,1974,5615,2120,6154
316300,202107,1038,2853,832,2534,35,116,596,1793,631,1909
316310,202107,816,2153,548,1675,117,411,107,272,224,683
316320,202107,701,1908,550,1676,55,196,270,799,325,995
316330,202107,1109,2803,852,2377,54,173,649,1761,703,1934
316340,202107,1011,2668,755,2210,82,296,418,1161,500,1457
316350,202107,1364,3712,1128,3316,155,460,681,1990,836,2450
316360,202107,647,1689,539,1514,48,145,403,1129,451,1274
316370,202107,5671,14227,4350,11928,601,1913,2062,5042,2663,6955
316380,202107,1771,4219,1400,3683,58,119,967,2563,1025,2682
316390,202107,799,2128,571,1730,237,815,82,212,319,1027
316400,202107,1227,3402,811,2583,102,357,285,806,387,1163
316410,202107,1152,3115,966,2835,57,185,780,2235,837,2420
316420,202107,1995,5331,1739,5002,39,135,1437,4054,1476,4189
316430,202107,899,2282,603,1782,98,332,245,654,343,986
316440,202107,843,2543,677,2249,118,450,192,577,310,1027
316443,202107,562,1537,411,1248,99,344,100,284,199,628
316447,202107,2091,5425,1818,4996,23,77,1596,4326,1619,4403
316450,202107,2215,6498,1703,5439,248,834,970,3021,1218,3855
316460,202107,1295,3252,1059,2886,115,345,695,1811,810,2156
316470,202107,7246,20311,5280,16223,789,2693,2124,5924,2913,8617
316480,202107,203,542,175,505,53,146,71,206,124,352
316490,202107,334,885,235,703,39,123,79,199,118,322
316500,202107,1248,3788,828,2797,173,641,186,579,359,1220
316510,202107,815,2567,650,2237,104,366,336,1160,440,1526
316520,202107,1401,3318,1099,2832,122,386,600,1395,722,1781
316530,202107,1160,2980,840,2407,84,312,438,1121,522,1433
316540,202107,963,2387,773,2099,104,308,420,1039,524,1347
316550,202107,1378,3939,1187,3593,40,148,929,2782,969,2930
316553,202107,4548,13067,3299,10126,441,1487,1349,3646,1790,5133
316555,202107,2741,8154,2464,7777,90,299,2088,6629,2178,6928
316556,202107,530,1293,407,1071,24,66,252,597,276,663
316557,202107,1088,3272,947,3050,307,1079,344,1056,651,2135
316560,202107,346,940,244,788,37,134,98,296,135,430
316570,202107,1389,3874,1157,3456,288,855,384,1208,672,2063
316580,202107,404,844,254,606,34,88,131,293,165,381
316590,202107,1379,3460,965,2668,216,520,450,1232,666,1752
316600,202107,952,2868,812,2581,129,424,407,1291,536,1715
316610,202107,601,1847,491,1672,54,230,292,962,346,1192
316620,202107,2180,5532,1911,5154,84,244,1539,4139,1623,4383
316630,202107,1611,4698,1335,4184,347,1097,507,1764,854,2861
316640,202107,141,366,113,328,16,57,54,132,70,189
316650,202107,1085,3279,869,2942,83,307,545,1848,628,2155
316660,202107,195,470,80,237,9,31,15,29,24,60
316670,202107,1805,4488,1368,3806,345,1001,437,1176,782,2177
316680,202107,2333,5856,1737,4738,103,299,1293,3442,1396,3741
316690,202107,1456,4009,1102,3373,179,590,486,1431,665,2021
316695,202107,1046,2970,869,2659,28,102,603,1826,631,1928
316700,202107,412,927,339,844,14,40,273,656,287,696
316710,202107,3279,10321,2581,8893,426,1587,1175,3933,1601,5520
316720,202107,21634,57636,16152,47270,2665,8314,7149,19665,9814,27979
316730,202107,485,1244,389,1071,36,128,200,507,236,635
316740,202107,783,2206,677,2039,73,254,429,1304,502,1558
316750,202107,410,1162,314,984,72,233,127,378,199,611
316760,202107,3514,11050,2945,9934,1138,4197,726,2315,1864,6512
316770,202107,1655,3633,1255,3102,29,81,1019,2573,1048,2654
316780,202107,558,1607,442,1385,161,542,92,261,253,803
316790,202107,758,2016,554,1613,99,320,161,432,260,752
316800,202107,6607,18078,5304,15724,642,2080,2541,7341,3183,9421
316805,202107,1076,2320,868,2092,56,156,674,1626,730,1782
316810,202107,630,1725,454,1396,77,262,255,756,332,1018
316820,202107,316,751,171,489,19,69,72,191,91,260
316830,202107,838,2122,667,1852,73,205,413,1143,486,1348
316840,202107,2858,7155,2273,6195,175,573,1622,4217,1797,4790
316850,202107,2005,5141,1477,4206,228,710,687,1831,915,2541
316860,202107,20391,50905,14978,42800,2231,7377,6937,19184,9168,26561
316870,202107,8237,21809,6168,17867,866,2740,2868,7745,3734,10485
316880,202107,1002,2633,820,2368,139,442,436,1199,575,1641
316890,202107,1193,2629,725,2014,83,300,468,1221,551,1521
316900,202107,2424,6357,1913,5363,390,1165,587,1548,977,2713
316905,202107,521,1530,418,1329,111,381,168,540,279,921
316910,202107,906,2325,552,1701,124,418,51,146,175,564
316920,202107,1836,4411,1313,3644,203,607,678,1832,881,2439
316930,202107,8300,23183,6271,19556,1442,4802,1738,5083,3180,9885
316935,202107,4262,11260,3135,9178,540,1725,1268,3446,1808,5171
316940,202107,6632,19029,5173,16078,733,2479,2220,6386,2953,8865
316950,202107,1971,4480,1533,3885,40,120,1284,3214,1324,3334
316960,202107,5243,11587,3783,9631,360,998,2583,6431,2943,7429
316970,202107,3959,10814,3423,9836,492,1446,1508,4097,2000,5543
316980,202107,703,2072,534,1752,168,617,73,239,241,856
316990,202107,12716,33314,9459,26839,2209,6787,1591,4125,3800,10912
317000,202107,2525,7281,2211,6829,170,427,1648,5175,1818,5602
317005,202107,2641,7196,2105,6135,326,987,1151,3288,1477,4275
317010,202107,25058,58039,15952,44194,2899,8923,6409,17878,9308,26801
317020,202107,63519,149545,38100,105812,6790,20640,12533,32075,19323,52715
317030,202107,700,1815,551,1610,13,47,426,1232,439,1279
317040,202107,11355,28052,8010,22384,1679,5052,2837,8137,4516,13189
317043,202107,902,1989,651,1638,48,124,481,1189,529,1313
317047,202107,1194,2857,827,2273,67,206,536,1412,603,1618
317050,202107,1242,3761,909,2987,120,431,370,1051,490,1482
317052,202107,2426,6571,1957,5824,268,774,1213,3646,1481,4420
317057,202107,2016,4526,1495,3719,31,109,1067,2582,1098,2691
317060,202107,528,1349,333,958,42,128,134,342,176,470
317065,202107,1166,3379,959,2979,59,173,608,1803,667,1976
317070,202107,7583,20749,5548,16856,916,3107,1872,5322,2788,8429
317075,202107,958,2424,716,2023,86,274,372,964,458,1238
317080,202107,6435,14684,4793,12113,1192,3292,1723,4213,2915,7505
317090,202107,4923,13865,4363,12966,291,774,3242,9712,3533,10486
317100,202107,2703,6334,1768,4805,405,1129,650,1749,1055,2878
317103,202107,2337,5929,1999,5449,69,300,1603,4205,1672,4505
317107,202107,1496,3907,1141,3258,72,232,692,1789,764,2021
317110,202107,677,1565,350,1053,65,224,106,328,171,552
317115,202107,1102,3124,944,2830,68,186,627,1889,695,2075
317120,202107,16725,43792,13692,38934,1037,3517,8861,23960,9898,27477
317130,202107,11968,27310,7926,20735,1163,3369,2888,7417,4051,10786
317140,202107,939,2211,737,1902,50,143,506,1326,556,1469
317150,202107,991,2355,760,2062,28,87,605,1612,633,1699
317160,202107,3675,8593,2459,6692,132,385,1366,3836,1498,4221
317170,202107,1865,4609,1374,3770,171,558,673,1632,844,2190
317180,202107,2049,6224,1508,4934,278,951,401,1189,679,2140
317190,202107,1223,3263,906,2738,208,610,394,1192,602,1802
317200,202107,6234,16326,4682,13246,1011,3061,1144,2949,2155,6010
317210,202107,1225,2904,952,2535,25,89,702,1899,727,1988
317220,202107,273,815,236,748,48,166,106,334,154,500
320010,202107,4780,13624,3798,11648,418,1420,2342,6939,2760,8359
320013,202107,2145,5666,1498,4409,234,697,671,2062,905,2759
320016,202107,3072,7726,2429,6755,200,521,1750,4898,1950,5419
320020,202107,4185,10644,3116,8802,616,1936,1201,3448,1817,5384
320030,202107,1790,4916,1188,3698,212,708,422,1249,634,1957
320035,202107,1997,5311,1637,4705,386,1228,766,2105,1152,3333
320040,202107,4526,12506,3768,11143,511,1569,2109,5987,2620,7556
320050,202107,1786,4027,1545,3691,186,519,918,2115,1104,2634
320060,202107,14101,37608,10507,30359,1583,4925,4885,13108,6468,18033
320070,202107,1675,4542,1206,3617,198,670,479,1303,677,1973
320080,202107,5967,15071,4185,11529,814,2359,1530,3967,2344,6326
320090,202107,8941,23302,5943,17182,1327,4084,2105,5636,3432,9720
320100,202107,3289,8699,2695,7684,432,1310,1426,4061,1858,5371
320110,202107,2211,5055,1542,3997,193,533,826,2030,1019,2563
320115,202107,2088,6470,1786,5968,763,2676,504,1761,1267,4437
320120,202107,25684,64375,18162,50910,2460,7380,8627,22739,11087,30119
320130,202107,51523,138600,42516,122375,5013,15737,25508,70746,30521,86483
320140,202107,3819,10280,2575,7815,361,1278,1082,3170,1443,4448
320150,202107,14669,37367,10587,29672,2573,7950,1555,3894,4128,11844
320160,202107,6594,17903,4912,14706,762,2467,2152,6310,2914,8777
320170,202107,1832,5138,1334,4144,359,1091,484,1623,843,2714
320180,202107,710,2218,567,1941,197,734,151,455,348,1189
320190,202107,3019,9396,2324,7872,568,2059,568,1767,1136,3826
320200,202107,1402,3721,959,2926,211,717,329,976,540,1693
320210,202107,4519,11320,3477,9556,562,1656,1785,4663,2347,6319
320220,202107,3431,8663,2660,7401,373,1130,1501,3917,1874,5047
320225,202107,1433,4380,1028,3430,350,1269,205,670,555,1939
320230,202107,5431,14568,4123,12362,846,2747,1554,4507,2400,7254
320240,202107,17346,43131,12984,36151,3161,9570,3960,10872,7121,20442
320245,202107,3247,9372,2522,7910,854,2846,402,1222,1256,4068
320250,202107,2710,7310,1829,5277,401,1285,574,1436,975,2721
320255,202107,1991,6043,1708,5522,425,1429,778,2564,1203,3993
320260,202107,1491,4120,904,2819,179,605,216,557,395,1162
320265,202107,2519,7663,2025,6659,857,3045,294,933,1151,3978
320270,202107,2337,6574,1806,5523,455,1517,610,1856,1065,3373
320280,202107,7729,20159,6323,17768,1194,3617,3187,8658,4381,12275
320290,202107,1419,4146,923,2982,242,847,222,681,464,1528
320300,202107,3987,11673,3159,9993,862,2974,913,2702,1775,5676
320305,202107,5380,14917,4168,12541,741,2432,2024,5904,2765,8336
320310,202107,2374,6346,1667,4882,293,914,730,2003,1023,2917
320313,202107,2561,6220,1732,4715,334,996,480,1155,814,2151
320316,202107,1585,4413,1299,3922,204,621,740,2237,944,2858
320320,202107,23438,60115,16726,48468,3822,11486,5858,17012,9680,28498
320330,202107,3044,8115,2370,6903,414,1249,1246,3656,1660,4905
320332,202107,8577,22650,6816,19384,1424,4326,3025,8349,4449,12675
320334,202107,1855,5115,1295,3977,270,987,313,724,583,1711
320335,202107,1616,4627,1154,3575,227,816,322,916,549,1732
320340,202107,5158,12526,4265,11220,518,1450,2481,6586,2999,8036
320350,202107,5667,13632,4013,10703,435,1290,2205,5440,2640,6730
320360,202107,1479,3770,1097,3065,141,390,520,1403,661,1793
320370,202107,2681,8061,1976,6542,589,2100,582,1893,1171,3993
320380,202107,2786,7229,2308,6456,266,796,1425,3894,1691,4690
320390,202107,7658,20081,5633,16090,1142,3489,2246,5979,3388,9468
320400,202107,3456,9576,2558,7674,707,2252,789,2240,1496,4492
320405,202107,5437,13842,4140,11570,582,1780,2155,5787,2737,7567
320410,202107,5001,12673,3767,10680,660,1804,1855,5484,2515,7288
320420,202107,3465,8755,2668,7406,547,1697,825,2158,1372,3855
320425,202107,2268,5374,1732,4463,135,346,1068,2697,1203,3043
320430,202107,3365,8304,2683,7105,371,1020,1627,4135,1998,5155
320435,202107,2239,6873,1723,5777,608,2174,516,1732,1124,3906
320440,202107,1602,4371,1183,3557,186,605,519,1468,705,2073
320450,202107,1880,5258,1467,4483,266,927,675,1915,941,2842
320455,202107,4619,13727,3146,10235,730,2568,784,2273,1514,4841
320460,202107,2228,6439,1602,5133,373,1301,438,1287,811,2588
320465,202107,1425,3849,1085,3228,157,467,571,1735,728,2202
320470,202107,3842,10344,2818,8229,563,1780,775,2041,1338,3821
320480,202107,1933,5004,1571,4403,166,528,1009,2743,1175,3271
320490,202107,24206,60805,18150,50295,2959,8611,7906,21661,10865,30272
320495,202107,1396,3748,1012,3005,237,800,312,845,549,1645
320500,202107,54424,142624,43642,124220,5750,17768,25522,69486,31272,87254
320501,202107,4768,13610,3555,11383,965,3466,1062,3312,2027,6778
320503,202107,2358,6701,1537,4991,430,1504,384,1209,814,2713
320506,202107,2806,8288,2064,6626,627,2165,175,570,802,2735
320510,202107,11340,29871,9260,26332,933,3003,5801,15820,6734,18823
320515,202107,1861,5059,1447,4212,366,1172,476,1304,842,2476
320517,202107,2245,6616,1799,5653,531,1821,571,1754,1102,3575
320520,202107,39719,100304,29991,83968,4749,14727,13178,35217,17927,49944
320530,202107,35889,92184,28562,79349,2348,7640,18337,47907,20685,55547
330010,202107,24981,63589,20760,56744,2258,6788,14304,37815,16562,44603
330015,202107,1445,3460,1142,3024,189,560,655,1663,844,2223
330020,202107,20378,49987,17156,45388,2317,6736,11894,30870,14211,37606
330022,202107,1973,5219,1535,4504,243,704,853,2506,1096,3210
330023,202107,5722,13107,4328,11197,638,1828,2599,6531,3237,8359
330025,202107,7346,16579,4448,11832,934,2720,1072,2687,2006,5407
330030,202107,10742,28082,8234,24086,773,2657,5189,14428,5962,17085
330040,202107,15832,40085,12745,35001,970,3025,8875,23370,9845,26395
330045,202107,89795,205883,74233,186276,5534,13428,59214,148094,64748,161522
330050,202107,2769,7114,2083,5972,373,1153,1089,2965,1462,4118
330060,202107,5528,14073,4337,11965,807,2498,1862,4689,2669,7187
330070,202107,24564,59784,19907,53179,2775,8000,12301,32427,15076,40427
330080,202107,9247,22560,7871,20653,910,2552,5484,14159,6394,16711
330090,202107,3481,7204,2444,5789,142,361,1747,4122,1889,4483
330093,202107,2842,6653,2153,5710,124,346,1641,4318,1765,4664
330095,202107,1442,3882,1142,3356,111,352,672,1842,783,2194
330100,202107,74595,191414,63821,175755,3395,10984,49607,134412,53002,145396
330110,202107,2130,5822,1713,5140,248,807,1014,2936,1262,3743
330115,202107,2622,6172,1848,4974,246,768,1061,2730,1307,3498
330120,202107,3706,7996,2807,6862,202,559,2034,4772,2236,5331
330130,202107,4586,12086,3745,10835,476,1425,2382,6843,2858,8268
330140,202107,4044,10081,3227,8926,366,1142,2191,5869,2557,7011
330150,202107,2376,6108,1833,5257,310,907,924,2576,1234,3483
330160,202107,1400,3718,1036,3074,193,604,544,1536,737,2140
330170,202107,118757,283773,95950,253242,12654,32640,65220,174121,77874,206761
330180,202107,2043,4777,1577,4138,90,262,1108,2838,1198,3100
330185,202107,10582,25599,8853,23222,458,1444,7176,18384,7634,19828
330187,202107,4794,11660,3798,10050,496,1396,2317,6039,2813,7435
330190,202107,36758,85363,31047,77598,1887,5104,24988,61596,26875,66700
330200,202107,17180,41952,13990,38023,2668,6725,8764,24747,11432,31472
330205,202107,2323,5594,1763,4700,116,341,1210,3086,1326,3427
330210,202107,3497,8392,2577,6842,316,894,1363,3411,1679,4305
330220,202107,13087,31373,9375,25237,1726,5234,3752,9310,5478,14544
330225,202107,4081,9976,3110,8531,195,651,2244,5988,2439,6639
330227,202107,17790,41802,14870,38276,621,1619,12701,32439,13322,34058
330230,202107,2235,4769,1473,3803,115,317,855,2214,970,2531
330240,202107,25226,63324,21072,57053,2104,6397,14889,39146,16993,45543
330245,202107,1821,4376,1101,3121,220,605,400,1132,620,1737
330250,202107,41343,101645,34159,91173,5159,14180,21858,57771,27017,71951
330260,202107,5164,12049,3926,10394,304,946,2902,7400,3206,8346
330270,202107,34021,75657,20995,54298,3083,8575,8860,21630,11943,30205
330280,202107,2481,6254,1878,5260,196,600,1130,3037,1326,3637
330285,202107,26822,61763,21230,53837,1217,3646,16320,40000,17537,43646
330290,202107,4196,9869,3391,8808,321,962,2478,6195,2799,7157
330300,202107,6075,13862,4476,11611,326,927,3175,8015,3501,8942
330310,202107,2824,6709,2025,5416,149,330,1356,3628,1505,3958
330320,202107,18233,41331,14103,36197,1643,3826,10073,26312,11716,30138
330330,202107,44928,94941,35034,81640,2839,7287,25452,57736,28291,65023
330340,202107,19058,43659,13717,35518,1907,5674,7333,17620,9240,23294
330350,202107,154367,345051,127869,313014,7419,18793,106563,258745,113982,277538
330360,202107,7603,18099,6490,16763,211,494,5519,14233,5730,14727
330370,202107,5265,14581,4071,12579,905,2860,1720,5487,2625,8347
330380,202107,5938,15111,4529,12690,609,2055,2549,6720,3158,8775
330385,202107,4236,11687,3472,10585,731,2443,1741,5197,2472,7640
330390,202107,28380,73541,21833,62613,2736,9083,13251,35669,15987,44752
330395,202107,3372,8046,2754,7270,144,446,2061,5290,2205,5736
330400,202107,3589,9135,3061,8317,144,526,2329,5952,2473,6478
330410,202107,3555,9079,2563,7392,494,1526,1175,3170,1669,4696
330411,202107,2923,7753,2280,6592,148,498,1590,4394,1738,4892
330412,202107,1687,4611,1380,4111,127,422,911,2583,1038,3005
330414,202107,25334,61868,20651,55501,1414,4069,15720,41491,17134,45560
330415,202107,4976,13008,3778,10908,374,1122,2160,6122,2534,7244
330420,202107,13106,31518,9419,25605,1010,3155,5253,13203,6263,16358
330430,202107,10045,23474,8445,21310,272,856,6839,16760,7111,17616
330440,202107,2849,7263,2179,6148,266,864,1355,3661,1621,4525
330450,202107,1498,4086,1189,3572,145,465,670,1961,815,2426
330452,202107,18881,46411,15142,40680,1728,5274,9992,25779,11720,31053
330455,202107,588310,1353956,460047,1173196,58032,157632,305170,762044,363202,919676
330460,202107,1197,3156,898,2738,151,492,476,1418,627,1910
330470,202107,5526,13240,3936,10799,1134,3217,1107,3082,2241,6299
330475,202107,10247,25438,8292,22929,1185,3771,5430,14570,6615,18341
330480,202107,6206,15624,5211,14175,420,1253,3633,9552,4053,10805
330490,202107,118241,265029,96113,235477,10384,26130,68876,167027,79260,193157
330500,202107,7806,18651,6436,16801,605,1781,4657,11898,5262,13679
330510,202107,43221,103424,32304,88168,4692,13847,20465,54781,25157,68628
330513,202107,1328,3278,1075,2950,201,571,591,1656,792,2227
330515,202107,2639,6852,2119,6132,351,1128,1222,3413,1573,4541
330520,202107,12156,30933,9980,27637,1066,3288,6524,17520,7590,20808
330530,202107,1778,4213,1303,3515,246,719,616,1649,862,2368
330540,202107,2971,7648,2303,6517,575,1667,871,2441,1446,4108
330550,202107,10219,24735,7899,21739,1909,5822,3720,9992,5629,15814
330555,202107,19533,39799,16223,35950,727,1740,13523,30225,14250,31965
330560,202107,4279,10991,3459,9659,541,1513,2058,5620,2599,7133
330570,202107,2800,7441,2391,6850,356,1096,1587,4508,1943,5604
330575,202107,5794,14473,4999,13166,297,889,4045,10322,4342,11211
330580,202107,19191,49371,15113,42150,2317,7022,7960,21028,10277,28050
330590,202107,1521,3969,1254,3624,230,656,777,2301,1007,2957
330600,202107,13319,33571,10780,29520,883,2800,7086,18728,7969,21528
330610,202107,9822,25486,7901,22486,683,2137,5368,14984,6051,17121
330615,202107,2178,5822,1729,5228,315,971,1080,3342,1395,4313
330620,202107,4278,11775,3358,10216,685,2218,1484,4249,2169,6467
330630,202107,26028,63635,20543,55193,1241,3934,14865,38537,16106,42471
350010,202107,2214,5756,1241,3694,248,800,256,566,504,1366
350020,202107,728,1837,415,1238,51,173,140,389,191,562
350030,202107,3642,9929,2769,8438,645,2191,1274,3598,1919,5789
350040,202107,768,2179,441,1482,56,215,135,348,191,563
350050,202107,1481,3573,979,2724,201,636,346,792,547,1428
350055,202107,960,2497,763,2190,85,264,458,1246,543,1510
350060,202107,243,608,142,403,16,52,62,166,78,218
350070,202107,3375,8785,2219,6695,435,1424,757,2022,1192,3446
350075,202107,634,1795,476,1490,169,560,63,206,232,766
350080,202107,672,1736,455,1359,57,191,182,496,239,687
350090,202107,616,1433,374,1025,66,196,158,401,224,597
350100,202107,2415,6262,1698,5016,113,422,1088,3008,1201,3430
350110,202107,502,1231,347,964,18,56,210,573,228,629
350115,202107,1235,3522,1008,3057,162,549,517,1413,679,1962
350120,202107,676,1556,380,1022,36,119,206,489,242,608
350130,202107,3275,8522,2577,7246,450,1279,1260,3350,1710,4629
350140,202107,799,2184,560,1737,47,189,294,835,341,1024
350150,202107,555,1644,448,1438,94,296,133,398,227,694
350160,202107,11746,29421,8037,22614,1016,3202,4768,12676,5784,15878
350170,202107,2502,6929,2071,6006,310,1000,1045,2724,1355,3724
350180,202107,1033,2487,566,1640,90,271,181,485,271,756
350190,202107,2959,8232,2042,6265,344,1214,902,2359,1246,3573
350200,202107,467,1298,356,1088,19,64,232,662,251,726
350210,202107,6213,14207,4270,11199,471,1367,2665,6675,3136,8042
350220,202107,3024,8142,2065,6270,412,1294,691,1885,1103,3179
350230,202107,1017,2528,838,2282,148,431,480,1272,628,1703
350240,202107,669,1894,433,1346,99,318,113,303,212,621
350250,202107,2997,8188,2244,6921,609,2053,649,1948,1258,4001
350260,202107,857,1972,552,1470,55,162,335,846,390,1008
350270,202107,4741,12317,3771,10514,506,1567,2078,5351,2584,6918
350275,202107,2513,6620,1995,5839,300,953,1219,3416,1519,4369
350280,202107,19305,43449,11903,31474,1798,5007,5023,12598,6821,17605
350290,202107,3267,8891,2254,6831,402,1327,910,2558,1312,3885
350300,202107,659,1728,494,1423,57,168,282,757,339,925
350310,202107,983,2742,729,2247,111,396,309,860,420,1256
350315,202107,616,1500,406,1149,23,78,218,558,241,636
350320,202107,16105,40531,11898,33175,2273,7009,4898,12557,7171,19566
350330,202107,14596,35062,10573,27571,1053,3024,6761,16601,7814,19625
350335,202107,389,1087,300,920,39,133,137,398,176,531
350340,202107,1213,3058,757,2232,118,404,324,837,442,1241
350350,202107,770,1890,596,1700,65,213,370,1039,435,1252
350360,202107,1095,3184,833,2655,210,685,268,873,478,1558
350370,202107,705,1745,499,1352,162,414,159,419,321,833
350380,202107,4641,12536,3345,9880,953,2735,883,2664,1836,5399
350390,202107,11250,28801,8896,24897,1547,4585,4573,12198,6120,16783
350395,202107,450,1126,235,721,28,85,86,235,114,320
350400,202107,8391,20180,5863,16063,1462,4287,1626,4348,3088,8635
350410,202107,10518,28682,7769,23470,1505,5014,3088,8595,4593,13609
350420,202107,849,2238,577,1663,89,276,142,349,231,625
350430,202107,718,1881,575,1662,72,229,355,952,427,1181
350440,202107,2126,5196,1728,4609,133,359,1127,2947,1260,3306
350450,202107,6595,17949,5101,15355,1085,3601,2095,5908,3180,9509
350460,202107,1862,4748,1058,3142,154,470,382,1034,536,1504
350470,202107,262,656,205,559,11,36,144,377,155,413
350480,202107,1031,2475,682,1891,127,409,188,422,315,831
350490,202107,2029,5194,1442,4236,316,961,474,1268,790,2229
350500,202107,679,1785,503,1476,62,196,239,653,301,849
350510,202107,1251,3135,939,2585,95,294,572,1483,667,1777
350520,202107,2288,6770,1787,5816,268,964,784,2298,1052,3262
350530,202107,2986,7410,2251,6018,234,718,1342,3314,1576,4032
350535,202107,1529,4079,1323,3789,176,552,832,2309,1008,2861
350540,202107,2082,4760,1556,4003,178,448,991,2463,1169,2911
350550,202107,8686,21179,6038,16787,617,2053,3474,8869,4091,10922
350560,202107,3943,10831,3160,9491,269,865,2070,6003,2339,6868
350570,202107,25809,70478,21031,61474,3562,11545,11073,30827,14635,42372
350580,202107,2148,5640,1334,3983,342,1114,269,656,611,1770
350590,202107,5229,13857,3852,10832,489,1545,2286,5921,2775,7466
350600,202107,36048,82419,22633,59488,3253,9709,10512,25242,13765,34951
350610,202107,7212,19254,5163,15260,784,2570,2547,7029,3331,9599
350620,202107,437,1087,264,814,24,73,151,440,175,513
350630,202107,1531,3841,1127,3146,73,262,741,1904,814,2166
350635,202107,9859,23676,7382,19829,920,2717,4596,11760,5516,14477
350640,202107,938,2475,502,1521,71,207,145,393,216,600
350650,202107,8923,23321,6207,18039,1090,3427,2471,6667,3561,10094
350660,202107,4666,11921,3604,10174,559,1564,1969,5577,2528,7141
350670,202107,1816,4807,1485,4327,173,507,957,2810,1130,3317
350680,202107,1124,2988,779,2368,132,417,323,935,455,1352
350690,202107,1337,3407,949,2753,157,483,496,1407,653,1890
350700,202107,5010,12475,3650,10364,761,2468,1590,4310,2351,6778
350710,202107,2985,8001,2519,7187,443,1458,1338,3482,1781,4940
350715,202107,792,2233,664,2017,82,300,349,972,431,1272
350720,202107,162,427,120,355,18,56,45,114,63,170
350730,202107,647,1738,548,1564,27,94,404,1088,431,1182
350740,202107,1762,4590,1214,3506,198,612,433,1145,631,1757
350745,202107,599,1475,343,1007,29,110,149,396,178,506
350750,202107,10512,26908,8123,22814,1381,4519,3835,9665,5216,14184
350760,202107,15603,38020,11415,30897,2196,6622,5099,12360,7295,18982
350770,202107,1099,2658,669,1916,46,142,407,1128,453,1270
350775,202107,728,1670,505,1343,60,152,247,673,307,825
350780,202107,2437,5796,1749,4822,305,985,586,1883,891,2868
350790,202107,2134,5594,1367,4150,251,811,378,951,629,1762
350800,202107,3643,10224,3130,9344,248,845,2181,6308,2429,7153
350810,202107,2952,7015,2259,6018,421,1029,1037,2825,1458,3854
350820,202107,978,2261,579,1560,76,225,269,651,345,876
350830,202107,897,2453,519,1628,79,249,154,398,233,647
350840,202107,3449,9913,2621,8376,560,2013,1188,3459,1748,5472
350850,202107,8186,22097,6475,19039,1205,3838,3223,8897,4428,12735
350860,202107,3754,9798,3229,9087,111,396,2500,6975,2611,7371
350870,202107,2639,7292,1972,6233,253,883,1124,3459,1377,4342
350880,202107,1380,3851,1091,3288,277,885,275,776,552,1661
350890,202107,558,1449,357,1028,53,164,131,329,184,493
350900,202107,8011,21090,5295,15507,984,3154,2114,5653,3098,8807
350910,202107,941,2237,812,2044,96,252,588,1451,684,1703
350920,202107,12695,30710,10781,27660,398,1261,8939,22101,9337,23362
350925,202107,4276,11362,3077,9242,554,1805,1502,4175,2056,5980
350930,202107,1525,3916,1072,3052,67,201,677,1881,744,2082
350940,202107,2312,5973,1775,5106,176,584,1119,3053,1295,3637
350945,202107,880,2438,671,2036,105,345,337,939,442,1284
350950,202107,93283,235180,72470,196867,8753,25904,45414,117704,54167,143608
350960,202107,6652,17716,5158,14959,620,2041,3067,8458,3687,10499
350970,202107,3624,9954,2592,8070,737,2521,575,1531,1312,4052
350980,202107,670,1793,535,1538,133,401,246,700,379,1101
350990,202107,1860,5040,1387,4283,314,1092,512,1494,826,2586
350995,202107,836,2564,755,2404,60,225,525,1612,585,1837
351000,202107,2918,7587,2017,5968,372,1145,713,2056,1085,3201
351010,202107,352,861,232,659,29,92,117,316,146,408
351015,202107,874,2567,713,2225,108,371,339,952,447,1323
351020,202107,8900,23816,6806,20245,1458,4294,3166,9266,4624,13560
351030,202107,2943,8547,2364,7428,330,1142,1301,3950,1631,5092
351040,202107,5248,12796,4401,11535,211,650,3616,9221,3827,9871
351050,202107,17143,41185,12492,34095,2324,6703,5779,15553,8103,22256
351060,202107,50793,125458,39173,105855,3781,11297,26706,69518,30487,80815
351070,202107,1390,3381,770,2342,189,624,124,359,313,983
351080,202107,2820,6673,2030,5742,199,674,1379,3704,1578,4378
351090,202107,331,941,243,782,46,152,70,229,116,381
351100,202107,2728,7232,1787,5366,378,1201,515,1564,893,2765
351110,202107,6374,16016,4229,12125,650,2068,1926,5172,2576,7240
351120,202107,754,1934,533,1553,69,219,204,571,273,790
351130,202107,1242,3125,577,1747,99,314,150,404,249,718
351140,202107,2303,6303,1719,5205,329,1130,751,2004,1080,3134
351150,202107,2818,7937,1924,6016,256,904,720,2015,976,2919
351160,202107,1110,3377,811,2686,150,539,202,551,352,1090
351170,202107,1376,3720,1178,3376,79,253,848,2333,927,2586
351190,202107,1044,2864,716,2211,127,383,266,780,393,1163
351200,202107,1653,3883,1238,3287,87,267,880,2194,967,2461
351210,202107,1626,3938,1037,2848,79,253,603,1517,682,1770
351220,202107,3431,9438,2944,8647,287,854,1989,5753,2276,6607
351230,202107,1878,4936,1409,4113,247,816,682,1811,929,2627
351240,202107,2467,6176,1523,4252,330,1011,551,1375,881,2386
351250,202107,1124,2908,669,2011,76,243,256,757,332,1000
351260,202107,936,2312,681,1855,145,405,248,631,393,1036
351270,202107,493,1333,384,1113,40,133,192,482,232,615
351280,202107,3983,10222,3087,8568,626,1777,1375,3678,2001,5455
351290,202107,1261,3078,889,2443,118,356,541,1422,659,1778
351300,202107,19440,51523,13605,40490,2274,7386,6119,17266,8393,24652
351310,202107,3598,8617,2745,7310,147,502,2053,5194,2200,5696
351320,202107,975,2748,715,2232,118,396,241,668,359,1064
351330,202107,500,1201,410,1036,21,66,290,654,311,720
351340,202107,6437,17871,5203,15700,1219,3807,2332,7022,3551,10829
351350,202107,11840,29071,9780,25852,903,2554,7226,18567,8129,21121
351360,202107,3920,10231,3225,9204,677,2105,1430,3765,2107,5870
351370,202107,2099,5729,1413,4313,314,1033,434,1200,748,2233
351380,202107,49322,116940,35006,92408,4072,11637,20693,52082,24765,63719
351385,202107,411,1027,169,502,30,87,51,122,81,209
351390,202107,1381,3320,858,2554,114,398,501,1401,615,1799
351400,202107,976,2657,808,2328,101,296,523,1458,624,1754
351410,202107,2701,7344,1950,5900,332,1005,776,2296,1108,3301
351420,202107,489,1160,276,786,34,95,162,425,196,520
351430,202107,973,2547,776,2224,59,169,546,1510,605,1679
351440,202107,3565,9254,2382,6862,421,1270,663,1653,1084,2923
351450,202107,1781,4642,1191,3565,242,816,219,496,461,1312
351460,202107,919,2341,731,2051,142,400,428,1183,570,1583
351470,202107,1243,3095,987,2679,84,290,657,1668,741,1958
351480,202107,2574,7395,2041,6491,359,1269,899,2649,1258,3918
351490,202107,2106,5788,1809,5263,61,246,1490,4191,1551,4437
351492,202107,357,952,295,818,7,21,226,610,233,631
351495,202107,191,483,148,403,15,35,87,236,102,271
351500,202107,40291,96753,30866,81309,4270,11871,19072,48096,23342,59967
351510,202107,13099,31811,9557,25875,1083,3383,6056,15587,7139,18970
351512,202107,497,1302,363,1012,64,190,126,322,190,512
351515,202107,3332,7400,2112,5510,371,1092,602,1644,973,2736
351518,202107,2541,6280,1688,4787,209,665,949,2403,1158,3068
351519,202107,688,1857,430,1348,81,262,68,188,149,450
351520,202107,1353,3310,602,1779,54,184,279,734,333,918
351530,202107,364,946,214,631,36,114,94,232,130,346
351535,202107,1872,4558,1358,3674,204,603,699,1769,903,2372
351540,202107,2711,6661,1829,5077,218,703,815,1987,1033,2690
351550,202107,7445,18228,5065,13951,477,1505,2891,7357,3368,8862
351560,202107,458,1303,351,1090,81,268,100,282,181,550
351565,202107,251,701,202,610,40,132,56,141,96,273
351570,202107,22349,58130,17142,47962,1653,5014,10930,29294,12583,34308
351580,202107,235,599,134,411,14,44,57,179,71,223
351590,202107,523,1173,279,748,23,87,163,388,186,475
351600,202107,1397,3686,1071,3073,119,374,596,1598,715,1972
351610,202107,784,1837,486,1308,26,75,282,713,308,788
351620,202107,24067,62295,17531,51253,2673,8896,8207,21713,10880,30609
351630,202107,29823,76116,24054,66411,2974,8819,15605,41392,18579,50211
351640,202107,18387,47037,14491,40164,1329,4327,9896,26050,11225,30377
351650,202107,370,978,183,584,21,65,55,162,76,227
351660,202107,753,2062,492,1507,74,232,105,273,179,505
351670,202107,6214,16379,4103,11854,858,2466,1692,4564,2550,7030
351680,202107,435,1209,283,883,38,128,74,187,112,315
351685,202107,394,1118,317,995,85,274,101,295,186,569
351690,202107,1159,2870,646,1862,89,295,290,737,379,1032
351700,202107,1332,3267,972,2666,188,532,484,1245,672,1777
351710,202107,792,2086,581,1700,52,177,325,853,377,1030
351720,202107,1477,3754,989,2912,159,514,410,1108,569,1622
351730,202107,978,2545,811,2291,63,212,507,1360,570,1572
351740,202107,3550,8794,2838,7447,476,1374,1464,3491,1940,4865
351750,202107,1476,3738,913,2758,149,476,392,1117,541,1593
351760,202107,3370,9289,2501,7607,484,1686,1010,2751,1494,4437
351770,202107,1903,5398,1540,4721,261,846,867,2551,1128,3397
351780,202107,1230,3079,745,2184,101,350,290,776,391,1126
351790,202107,1411,3358,1126,2980,176,480,650,1752,826,2232
351800,202107,540,1226,271,718,33,93,107,237,140,330
351810,202107,1102,2859,923,2600,58,146,639,1713,697,1859
351820,202107,2704,7436,1919,5933,485,1629,457,1289,942,2918
351830,202107,4644,12198,3585,10370,293,1003,2306,6334,2599,7337
351840,202107,9084,24335,6856,20291,885,2970,3829,10499,4714,13469
351850,202107,1570,4257,1040,3204,150,522,370,966,520,1488
351860,202107,2767,7777,2126,6597,320,1121,1183,3630,1503,4751
351870,202107,24465,61348,18223,51145,4253,12388,7597,21427,11850,33815
351880,202107,141675,355308,107118,296941,21125,65107,54618,142981,75743,208088
351885,202107,948,2496,744,2159,53,192,496,1374,549,1566
351890,202107,874,2239,558,1707,109,361,109,287,218,648
351900,202107,1162,3012,892,2605,117,333,536,1547,653,1880
351905,202107,462,1249,328,989,27,92,166,438,193,530
351907,202107,21792,56096,17058,47841,1834,5732,11058,29658,12892,35390
351910,202107,1727,4362,1218,3298,79,243,726,1760,805,2003
351920,202107,912,2423,687,1985,106,341,284,740,390,1081
351925,202107,932,2408,715,2018,88,291,376,968,464,1259
351930,202107,3335,9122,2985,8487,541,1562,2025,5663,2566,7225
351940,202107,1127,2837,814,2297,126,383,400,1112,526,1495
351950,202107,1752,3899,1326,3280,63,183,960,2277,1023,2460
351960,202107,5249,13013,3827,10507,836,2448,1713,4379,2549,6827
351970,202107,7472,21444,5915,18775,876,3185,3320,10107,4196,13292
351980,202107,1039,2430,682,1853,93,293,381,935,474,1228
351990,202107,1526,3553,1108,2926,47,173,547,1288,594,1461
352000,202107,2767,7710,2389,6933,247,823,1594,4330,1841,5153
352010,202107,2377,6150,1931,5419,512,1608,421,1208,933,2816
352020,202107,1409,3805,1087,3273,146,504,554,1558,700,2062
352030,202107,5986,15505,4657,13323,816,2533,2386,6565,3202,9098
352040,202107,3546,9086,2515,7069,392,1204,942,2316,1334,3520
352042,202107,3257,7757,2210,6091,368,1157,1098,2870,1466,4027
352044,202107,2150,5576,1289,3968,197,689,263,751,460,1440
352050,202107,13257,34553,8800,25890,2030,6830,1797,4480,3827,11310
352060,202107,757,1993,562,1629,88,284,240,628,328,912
352070,202107,945,1901,612,1466,57,152,324,697,381,849
352080,202107,495,1244,287,831,33,110,97,252,130,362
352090,202107,1550,4493,1290,3992,154,546,627,1765,781,2311
352100,202107,3543,9716,2840,8405,571,1851,1255,3555,1826,5406
352110,202107,648,1835,489,1529,96,313,198,566,294,879
352115,202107,555,1486,462,1336,59,191,278,790,337,981
352120,202107,914,2623,740,2278,72,202,444,1274,516,1476
352130,202107,2146,5833,1443,4163,220,642,608,1622,828,2264
352140,202107,1180,3185,843,2525,142,438,380,1102,522,1540
352150,202107,910,2367,709,2036,78,240,491,1375,569,1615
352160,202107,1033,2505,746,2048,64,221,428,1118,492,1339
352170,202107,3060,8013,2434,6813,273,851,1563,4101,1836,4952
352180,202107,2432,6445,1830,5378,413,1379,571,1471,984,2850
352190,202107,1285,3410,1023,3007,180,472,529,1625,709,2097
352200,202107,326,968,235,785,35,135,83,272,118,407
352210,202107,20792,47910,16320,41938,919,2671,12830,32233,13749,34904
352215,202107,696,1746,581,1573,82,239,347,910,429,1149
352220,202107,22607,54428,16028,43104,2641,7881,8081,19818,10722,27699
352230,202107,15400,43124,11962,36742,2795,9517,4263,12002,7058,21519
352240,202107,10335,26212,7915,22245,1675,5261,3477,9099,5152,14360
352250,202107,23729,64879,19101,57067,2803,9000,11826,34593,14629,43593
352260,202107,5063,12400,3463,9356,498,1535,2002,4861,2500,6396
352265,202107,955,2606,844,2452,84,267,596,1675,680,1942
352270,202107,1458,4280,1088,3505,222,768,382,1151,604,1919
352280,202107,2471,6087,1856,5205,189,623,1119,2936,1308,3559
352290,202107,1239,3471,1006,3035,132,442,536,1454,668,1896
352300,202107,882,2340,609,1776,81,274,323,872,404,1146
352310,202107,43537,114119,32616,95328,7558,22625,14581,42784,22139,65409
352320,202107,6865,17433,5335,14609,715,2210,2952,7247,3667,9457
352330,202107,2334,6028,1790,5263,270,940,1043,2853,1313,3793
352340,202107,6393,16571,4759,13614,715,2342,2454,6439,3169,8781
352350,202107,2291,6374,1789,5275,158,567,1092,2971,1250,3538
352360,202107,1297,3388,1066,2985,82,274,798,2150,880,2424
352370,202107,1126,3100,976,2850,17,69,800,2287,817,2356
352380,202107,856,2271,640,1895,136,408,219,631,355,1039
352390,202107,15250,36977,10463,28611,1652,4923,5745,14824,7397,19747
352400,202107,3633,9928,2969,8706,607,2075,1386,3777,1993,5852
352410,202107,3449,8701,2632,7342,225,749,1641,4375,1866,5124
352420,202107,841,2038,599,1687,117,347,224,584,341,931
352430,202107,8548,20757,6226,16730,1079,3311,3204,8060,4283,11371
352440,202107,19259,51320,14534,42282,3451,10410,5259,14807,8710,25217
352450,202107,792,1896,409,1246,59,199,151,429,210,628
352460,202107,3101,8314,2179,6671,407,1372,920,2631,1327,4003
352470,202107,3439,8626,2624,7319,274,885,1671,4414,1945,5299
352480,202107,4266,9988,2874,7515,406,1243,1404,3206,1810,4449
352490,202107,799,2251,644,1980,102,346,293,838,395,1184
352500,202107,10683,27135,7249,20767,2830,8909,826,1356,3656,10265
352510,202107,3985,10733,2986,8967,558,1814,1432,4119,1990,5933
352520,202107,2986,7615,2322,6525,375,1205,1354,3459,1729,4664
352530,202107,11212,28299,7668,21669,1291,4143,2877,6958,4168,11101
352540,202107,605,1742,451,1416,66,218,162,459,228,677
352550,202107,1039,2821,735,2246,123,433,266,714,389,1147
352560,202107,591,1614,457,1361,70,230,242,658,312,888
352570,202107,2485,6934,1614,5071,373,1275,193,458,566,1733
352580,202107,648,1662,542,1470,44,136,374,966,418,1102
352585,202107,343,911,252,751,20,78,157,421,177,499
352590,202107,13398,34614,9432,27197,2201,6955,4406,11767,6607,18722
352600,202107,1949,5226,1533,4474,140,438,979,2713,1119,3151
352610,202107,2872,7838,2156,6620,415,1438,906,2590,1321,4028
352620,202107,5804,14420,4422,12456,1202,3453,1812,5142,3014,8595
352630,202107,862,2101,643,1792,108,338,304,789,412,1127
352640,202107,3117,7852,2256,6323,227,651,1301,3487,1528,4138
352650,202107,613,1707,426,1305,58,187,166,484,224,671
352660,202107,1118,3213,926,2828,99,322,576,1713,675,2035
352670,202107,9981,26508,6769,20219,1574,5142,2112,5767,3686,10909
352680,202107,3384,9751,2353,7435,377,1391,1092,3052,1469,4443
352690,202107,28231,69629,22195,59540,1261,4018,16014,41155,17275,45173
352700,202107,630,1541,478,1342,139,435,163,446,302,881
352710,202107,5344,13646,3837,10938,892,2785,1613,4251,2505,7036
352720,202107,8296,21974,6507,18710,2241,6682,1929,5156,4170,11838
352725,202107,595,1392,341,942,23,67,180,463,203,530
352730,202107,5625,16204,5111,15057,580,1845,2333,5987,2913,7832
352740,202107,2356,5589,1789,4769,173,536,1088,2726,1261,3262
352750,202107,437,1082,274,788,43,140,115,287,158,427
352760,202107,1784,4850,1391,4087,104,292,798,2348,902,2640
352770,202107,899,2384,629,1863,116,364,254,705,370,1069
352780,202107,662,1834,471,1442,98,269,121,387,219,656
352790,202107,449,1180,328,944,24,72,143,362,167,434
352800,202107,1282,3803,898,2911,232,779,126,333,358,1112
352810,202107,1203,2791,776,2054,135,374,449,1118,584,1492
352820,202107,472,1309,342,1079,67,206,73,223,140,429
352830,202107,604,1518,286,865,25,77,79,196,104,273
352840,202107,4093,11403,3348,10084,993,3283,1200,3411,2193,6694
352850,202107,11272,27035,7833,21506,1980,5990,2698,6606,4678,12596
352860,202107,1090,2981,836,2535,146,469,320,925,466,1394
352870,202107,906,2211,633,1678,55,167,391,984,446,1151
352880,202107,1755,4136,1229,3224,207,561,588,1479,795,2040
352885,202107,315,854,243,734,27,81,141,412,168,493
352890,202107,709,1699,468,1204,50,143,268,597,318,740
352900,202107,18648,47828,12434,35670,2005,6086,5349,14377,7354,20463
352910,202107,423,1105,249,747,23,69,86,222,109,291
352920,202107,2710,6812,2003,5628,114,354,1398,3798,1512,4152
352930,202107,5933,15728,4475,12920,756,2433,2192,5881,2948,8314
352940,202107,22806,60363,16780,48089,2994,9317,8126,21901,11120,31218
352950,202107,580,1510,361,1102,92,289,73,204,165,493
352960,202107,761,1998,445,1348,65,216,127,307,192,523
352965,202107,227,629,144,464,38,119,36,105,74,224
352970,202107,3034,7192,2352,6067,225,633,1582,3988,1807,4621
352980,202107,1382,3579,1089,3146,250,804,559,1563,809,2367
352990,202107,4410,11847,3331,10061,639,2079,1654,4800,2293,6879
353000,202107,499,1338,291,856,41,135,73,169,114,304
353010,202107,2675,6540,1770,4887,329,1060,779,1929,1108,2989
353020,202107,3622,9222,2195,6322,301,961,764,2081,1065,3042
353030,202107,4689,11612,3236,9107,716,2186,952,2516,1668,4702
353040,202107,669,1506,470,1216,104,266,216,545,320,811
353050,202107,5329,14908,3801,11813,694,2309,1733,5152,2427,7461
353060,202107,49937,125687,41415,112168,2690,8594,31414,82198,34104,90792
353070,202107,10191,28538,7494,22769,1292,4323,3308,9154,4600,13477
353080,202107,4344,11675,2879,8837,509,1804,1136,3011,1645,4815
353090,202107,612,1777,491,1531,33,112,316,945,349,1057
353100,202107,303,802,145,452,24,78,41,107,65,185
353110,202107,7658,19766,6149,17654,1347,3959,3045,9144,4392,13103
353120,202107,419,1018,324,867,39,128,168,394,207,522
353130,202107,2656,6140,1679,4469,400,1179,580,1378,980,2557
353140,202107,2769,6758,2016,5506,99,328,1450,3793,1549,4121
353150,202107,1649,4000,1184,3252,241,677,494,1289,735,1966
353160,202107,632,1620,461,1345,57,168,206,546,263,714
353170,202107,544,1425,406,1230,76,246,185,574,261,820
353180,202107,10438,25023,8265,21581,809,2327,6005,15154,6814,17481
353190,202107,3479,9168,2786,7793,359,1073,1634,4274,1993,5347
353200,202107,1848,4843,1041,3222,169,586,305,840,474,1426
353205,202107,418,1238,353,1095,55,177,169,506,224,683
353210,202107,925,2098,603,1583,22,56,424,1085,446,1141
353215,202107,386,1043,304,897,46,149,143,388,189,537
353220,202107,734,1937,477,1415,98,275,83,237,181,512
353230,202107,846,2268,662,1984,178,577,244,670,422,1247
353240,202107,2396,6386,1994,5750,271,896,1205,3330,1476,4226
353250,202107,1305,2912,821,2134,102,297,459,1133,561,1430
353260,202107,1215,2777,678,1901,90,276,320,848,410,1124
353270,202107,715,1832,610,1649,48,146,426,1084,474,1230
353280,202107,691,1835,489,1476,134,409,119,344,253,753
353282,202107,1874,5196,1573,4655,174,557,979,2751,1153,3308
353284,202107,363,815,201,525,19,70,100,225,119,295
353286,202107,177,436,108,325,17,51,39,108,56,159
353290,202107,1499,3943,933,2822,165,494,279,775,444,1269
353300,202107,2167,5675,1606,4590,260,854,724,1828,984,2682
353310,202107,414,994,300,798,21,69,201,507,222,576
353320,202107,673,1616,571,1482,6,23,500,1289,506,1312
353325,202107,706,2011,495,1546,102,319,169,507,271,826
353330,202107,617,1564,427,1218,53,149,218,574,271,723
353340,202107,3074,8256,2287,6718,443,1457,1127,3054,1570,4511
353350,202107,3853,9574,2730,7453,595,1665,872,2149,1467,3814
353360,202107,678,1856,521,1555,52,163,303,875,355,1038
353370,202107,583,1636,486,1483,44,135,346,1026,390,1161
353380,202107,298,852,247,759,23,72,124,355,147,427
353390,202107,6620,16091,4996,13417,433,1325,3124,7923,3557,9248
353400,202107,482,1278,368,1067,68,227,143,347,211,574
353410,202107,534,1428,404,1196,70,201,227,680,297,881
353420,202107,432,1113,266,778,61,177,21,58,82,235
353430,202107,2280,6145,1772,5220,319,1005,865,2419,1184,3424
353440,202107,68073,179844,50016,145519,7608,24080,27642,75825,35250,99905
353450,202107,377,926,254,716,32,104,123,313,155,417
353460,202107,3314,8837,2442,7233,219,706,1051,2969,1270,3675
353470,202107,8539,21953,6253,17751,1014,3286,2822,7373,3836,10659
353475,202107,1612,4074,1145,3146,159,487,575,1455,734,1942
353480,202107,1638,4326,1312,3773,51,189,947,2634,998,2823
353490,202107,1127,2914,771,2254,104,343,361,980,465,1323
353500,202107,1091,2556,799,2112,170,464,443,1139,613,1603
353510,202107,835,2436,612,1911,139,443,166,451,305,894
353520,202107,1060,2721,680,2044,71,244,338,921,409,1165
353530,202107,2490,6457,1963,5513,252,807,1082,2813,1334,3620
353540,202107,2166,5745,1785,5136,274,827,1055,2943,1329,3770
353550,202107,5979,15068,4866,13298,746,2119,2837,7445,3583,9564
353560,202107,2398,6297,1838,5457,486,1547,564,1505,1050,3052
353570,202107,599,1556,441,1292,51,165,244,668,295,833
353580,202107,2215,5754,1673,4699,367,1034,745,2032,1112,3066
353590,202107,707,1810,488,1414,80,241,231,680,311,921
353600,202107,1735,4245,1313,3514,158,421,721,1889,879,2310
353610,202107,660,1946,486,1604,88,357,173,521,261,878
353620,202107,2797,7206,2015,5893,376,1219,725,1938,1101,3157
353625,202107,523,1303,359,1020,30,95,214,584,244,679
353630,202107,1408,4178,1186,3718,222,774,506,1457,728,2231
353640,202107,1391,3553,1115,3124,156,435,623,1724,779,2159
353650,202107,7898,20739,6034,17294,658,2076,3567,9621,4225,11697
353657,202107,399,1030,287,848,29,97,129,345,158,442
353660,202107,1315,2756,897,2202,311,781,319,753,630,1534
353670,202107,4173,11356,3245,9567,593,1961,1573,4249,2166,6210
353680,202107,709,1818,524,1556,66,229,317,875,383,1104
353690,202107,418,1087,203,618,23,78,43,108,66,186
353700,202107,2138,5451,1769,4855,117,379,1317,3459,1434,3838
353710,202107,5522,12286,3319,8410,393,1032,1742,3919,2135,4951
353715,202107,439,1142,263,815,4,19,98,289,102,308
353720,202107,2051,5266,1576,4550,236,725,890,2510,1126,3235
353730,202107,4550,11682,3477,9830,455,1521,1919,4945,2374,6466
353740,202107,2077,5359,1473,4319,333,1075,495,1300,828,2375
353750,202107,917,2715,672,2246,142,526,162,507,304,1033
353760,202107,13170,29782,10116,25732,2083,5323,5299,13353,7382,18676
353770,202107,688,2023,418,1376,67,239,48,144,115,383
353780,202107,5643,15002,4532,12973,987,3138,2217,5840,3204,8978
353790,202107,2843,8366,2075,6758,514,1845,423,1188,937,3033
353800,202107,19298,49320,15196,42773,2231,6529,8419,23606,10650,30135
353810,202107,1222,3224,799,2346,113,376,350,968,463,1344
353820,202107,1804,4766,1254,3689,257,827,415,1132,672,1959
353830,202107,671,1663,488,1364,85,247,212,571,297,818
353850,202107,1663,4480,1288,3791,263,782,479,1354,742,2136
353860,202107,2733,7319,2100,6264,476,1625,958,2552,1434,4177
353870,202107,30864,79359,22265,63032,2746,8612,11876,30772,14622,39384
353880,202107,3248,8808,2558,7523,218,734,1550,4365,1768,5099
353890,202107,2897,6149,2098,4998,146,386,1507,3345,1653,3731
353900,202107,760,2101,560,1711,77,267,232,657,309,924
353910,202107,2530,6812,2110,6154,207,691,1463,4172,1670,4863
353920,202107,1935,5242,1397,4217,323,1105,331,830,654,1935
353930,202107,4586,11951,3145,9255,514,1759,1360,3502,1874,5261
353940,202107,1179,3298,818,2576,138,464,278,781,416,1245
353950,202107,3350,8922,2566,7462,508,1588,1332,3623,1840,5211
353960,202107,831,2094,581,1623,107,290,227,606,334,896
353970,202107,658,1543,494,1293,39,116,347,888,386,1004
353980,202107,16646,41263,13039,35105,782,2457,9530,24537,10312,26994
353990,202107,975,2357,596,1672,109,324,273,728,382,1052
354000,202107,2587,6112,1458,4036,321,912,247,651,568,1563
354010,202107,359,917,254,746,52,159,130,371,182,530
354020,202107,3813,10024,3035,8469,637,1945,1367,3461,2004,5406
354025,202107,724,2006,492,1552,71,248,141,417,212,665
354030,202107,520,1133,283,752,60,168,136,335,196,503
354040,202107,823,1869,532,1409,28,87,393,1000,421,1087
354050,202107,943,2642,667,2148,141,499,225,676,366,1175
354060,202107,3490,9681,2468,7533,460,1536,1011,2763,1471,4299
354070,202107,3853,9905,2612,7493,427,1410,1191,2934,1618,4344
354075,202107,2827,7883,2255,6852,304,996,1308,3883,1612,4879
354080,202107,1359,3682,900,2792,177,570,273,770,450,1340
354085,202107,455,932,363,814,0,0,276,569,276,569
354090,202107,1692,4659,1458,4185,77,235,1139,3199,1216,3434
354100,202107,20186,53474,13990,42829,2978,9811,5387,16322,8365,26133
354105,202107,1439,3588,1003,2807,120,347,480,1256,600,1603
354110,202107,452,1261,326,1017,55,166,110,336,165,502
354120,202107,1393,3704,953,2777,193,610,320,812,513,1422
354130,202107,5459,14219,3644,10759,867,2710,202,380,1069,3090
354140,202107,19943,48504,13657,37029,2160,6525,6097,15074,8257,21599
354150,202107,2992,7011,2294,5917,454,1218,938,2376,1392,3594
354160,202107,2888,8211,2186,6825,582,1971,648,1837,1230,3808
354165,202107,702,2042,538,1718,84,312,278,821,362,1133
354170,202107,1927,5248,1607,4657,106,347,984,2705,1090,3052
354180,202107,395,1083,288,863,46,141,131,354,177,495
354190,202107,1568,4325,1109,3383,70,232,553,1596,623,1828
354200,202107,898,2137,686,1814,69,208,457,1133,526,1341
354210,202107,907,2368,741,2097,50,160,514,1358,564,1518
354220,202107,3239,8567,2471,7061,351,1091,1337,3590,1688,4681
354230,202107,802,1956,647,1771,33,109,482,1276,515,1385
354240,202107,1771,4833,1196,3688,198,656,384,1057,582,1713
354250,202107,646,1563,403,1140,90,280,112,292,202,572
354260,202107,8254,21510,6305,18147,1203,3763,2824,7760,4027,11523
354270,202107,1030,3038,845,2679,176,545,333,1027,509,1572
354280,202107,819,2000,694,1818,59,182,469,1136,528,1318
354290,202107,944,2960,796,2661,124,409,412,1422,536,1831
354300,202107,3637,10475,3081,9459,776,2405,1299,3942,2075,6347
354310,202107,736,2161,608,1912,147,492,235,682,382,1174
354320,202107,994,2383,656,1827,98,307,254,625,352,932
354323,202107,515,1199,323,850,54,123,137,344,191,467
354325,202107,1545,4533,1083,3482,175,563,346,1049,521,1612
354330,202107,9739,24241,6681,18149,788,2402,3984,10057,4772,12459
354340,202107,34805,86137,24032,67454,3285,10426,13427,35859,16712,46285
354350,202107,1228,3108,971,2686,137,392,580,1533,717,1925
354360,202107,635,1606,386,1199,82,255,89,274,171,529
354370,202107,1030,2869,830,2554,122,405,503,1494,625,1899
354380,202107,677,1754,486,1443,87,347,136,308,223,655
354390,202107,14342,34086,9542,25740,1585,4611,4525,11428,6110,16039
354400,202107,1579,4962,1219,4131,201,743,459,1525,660,2268
354410,202107,6411,16725,4896,13783,913,2815,2399,6303,3312,9118
354420,202107,1531,3905,1140,3221,145,433,689,1847,834,2280
354425,202107,2808,6730,1994,5319,450,1227,810,2139,1260,3366
354430,202107,1564,4130,1220,3604,109,352,749,2110,858,2462
354440,202107,615,1591,408,1176,70,225,177,459,247,684
354450,202107,449,1166,262,806,36,115,87,227,123,342
354460,202107,879,2201,593,1694,82,242,307,865,389,1107
354470,202107,476,1180,332,909,25,80,167,400,192,480
354480,202107,1303,2901,844,2174,77,188,532,1312,609,1500
354490,202107,827,2404,612,1940,108,357,272,803,380,1160
354500,202107,2202,6018,1781,5375,532,1662,418,1300,950,2962
354510,202107,737,2026,599,1768,45,141,344,922,389,1063
354515,202107,357,996,262,803,39,137,111,328,150,465
354520,202107,7175,19299,5088,14901,672,2272,2821,7642,3493,9914
354530,202107,4485,12570,3486,10639,886,2690,1182,3743,2068,6433
354540,202107,1361,3541,999,2911,210,632,369,1065,579,1697
354550,202107,613,1576,484,1334,68,205,279,734,347,939
354560,202107,2334,5578,1269,3548,155,444,649,1673,804,2117
354570,202107,1275,3141,514,1419,91,252,64,166,155,418
354580,202107,8569,22298,5641,16720,846,2709,2850,8098,3696,10807
354600,202107,2042,5218,1615,4465,164,514,1065,2789,1229,3303
354610,202107,460,1172,271,801,25,75,138,390,163,465
354620,202107,490,1327,313,990,41,163,130,374,171,537
354625,202107,313,837,184,593,30,95,36,87,66,182
354630,202107,2164,6305,1752,5489,591,1911,338,987,929,2898
354640,202107,3385,9528,2548,7861,365,1244,1056,3010,1421,4254
354650,202107,907,2329,736,2053,59,161,472,1295,531,1456
354660,202107,3673,8531,1958,5691,173,596,920,2434,1093,3030
354670,202107,1084,2945,760,2286,144,464,290,803,434,1267
354680,202107,5560,14162,4186,11960,895,2713,2133,6149,3028,8862
354690,202107,507,1563,368,1252,77,284,113,352,190,636
354700,202107,929,2454,667,1950,80,257,350,940,430,1197
354710,202107,521,1374,365,1054,47,146,157,384,204,530
354720,202107,296,708,138,400,59,170,25,75,84,245
354730,202107,10116,28130,7749,23593,995,3318,4466,13059,5461,16377
354740,202107,312,834,130,430,14,56,25,70,39,126
354750,202107,2778,7049,1843,5315,254,796,827,2108,1081,2904
354760,202107,2230,5816,1591,4644,335,1057,548,1417,883,2474
354765,202107,368,970,154,479,19,67,39,105,58,172
354770,202107,2503,6112,1845,4953,303,858,877,2213,1180,3071
354780,202107,57793,143392,44330,117510,3865,11708,29418,73099,33283,84807
354790,202107,1015,2746,787,2375,74,243,489,1416,563,1659
354800,202107,2620,6651,2067,5803,511,1449,918,2453,1429,3902
354805,202107,1381,3138,961,2530,112,289,552,1360,664,1649
354810,202107,661,1917,397,1364,49,195,111,349,160,544
354820,202107,971,2726,680,2175,106,381,189,482,295,863
354830,202107,479,1145,303,833,55,159,94,244,149,403
354840,202107,934,2306,576,1581,56,164,312,788,368,952
354850,202107,21291,54402,14906,43157,1566,5144,9076,24929,10642,30073
354860,202107,1784,4890,1114,3506,173,594,335,951,508,1545
354870,202107,60776,151968,47097,126894,4633,13671,30187,76876,34820,90547
354880,202107,5964,14547,2962,8299,326,1047,1179,2706,1505,3753
354890,202107,16099,40022,12476,33984,1664,5064,7249,19179,8913,24243
354900,202107,416,1027,267,762,60,187,72,154,132,341
354910,202107,6001,15550,3717,11410,851,2755,742,2118,1593,4873
354920,202107,525,1387,264,862,29,104,60,168,89,272
354925,202107,312,879,188,602,26,89,46,124,72,213
354930,202107,386,927,254,700,23,69,129,327,152,396
354940,202107,2436,7067,1757,5588,584,2003,398,1151,982,3154
354950,202107,1544,3884,1238,3468,54,201,936,2494,990,2695
354960,202107,935,2470,707,2127,72,237,388,1087,460,1324
354970,202107,4319,11733,3385,10157,365,1243,2183,6317,2548,7560
354980,202107,34520,80942,23634,62382,2405,7529,14687,36094,17092,43623
354990,202107,70556,175257,53046,143343,4022,12658,35340,89471,39362,102129
354995,202107,2923,6419,2203,5484,141,406,1651,3964,1792,4370
355000,202107,1641,4002,1231,3399,207,660,604,1512,811,2172
355010,202107,3924,10493,2399,7273,779,2431,322,996,1101,3427
355020,202107,3708,10129,2743,8432,521,1796,1160,3349,1681,5145
355030,202107,1419662,3451906,1037631,2721469,149708,431282,539025,1302299,688733,1733581
355040,202107,3105,7471,2408,6563,261,729,1764,4790,2025,5519
355050,202107,1032,2326,762,1948,176,512,309,707,485,1219
355060,202107,6364,16824,4646,13682,722,2467,2369,6322,3091,8789
355070,202107,10047,25058,8201,22133,955,2940,5249,13264,6204,16204
355080,202107,954,2703,611,2058,123,448,91,248,214,696
355090,202107,1221,3413,958,2966,204,652,380,1120,584,1772
355100,202107,22628,58192,17609,50786,2676,8157,10729,30571,13405,38728
355110,202107,869,2348,626,1975,163,587,98,278,261,865
355120,202107,751,1939,543,1630,46,142,260,763,306,905
355130,202107,848,1877,440,1141,33,106,276,660,309,766
355140,202107,2004,4435,1691,4010,85,224,1407,3254,1492,3478
355150,202107,4344,11282,3467,9744,368,1156,2272,6112,2640,7268
355160,202107,2226,5983,1608,4897,390,1301,408,1143,798,2444
355170,202107,11396,28165,8913,24022,1530,4447,4801,12511,6331,16958
355180,202107,2925,7617,2077,6217,383,1290,847,2299,1230,3589
355190,202107,1892,4898,1483,4247,391,1110,730,2220,1121,3330
355200,202107,829,2531,701,2324,195,707,287,909,482,1616
355210,202107,3094,8330,2391,6892,434,1392,1161,3135,1595,4527
355220,202107,47944,124583,38175,106018,7785,23002,17178,44185,24963,67187
355230,202107,1188,2989,645,1914,116,340,227,624,343,964
355240,202107,26131,68057,18368,52683,2186,6829,10261,27531,12447,34360
355250,202107,38562,101183,28823,82538,7209,21643,11011,30200,18220,51843
355255,202107,674,1665,375,1128,57,184,132,392,189,576
355260,202107,1582,3756,1115,3000,134,426,650,1621,784,2047
355270,202107,1183,3440,913,2899,203,681,347,993,550,1674
355280,202107,32354,80813,23252,64001,2911,8669,12256,31585,15167,40254
355290,202107,922,2460,714,2103,139,392,317,899,456,1291
355300,202107,1335,3878,1062,3349,178,611,392,1149,570,1760
355310,202107,957,2614,713,2211,100,299,402,1266,502,1565
355320,202107,531,1380,396,1133,71,230,162,382,233,612
355330,202107,3021,7569,2338,6398,116,407,1794,4678,1910,5085
355340,202107,4257,9362,3244,8018,389,888,2018,5089,2407,5977
355350,202107,1363,3823,1012,3161,192,637,389,1163,581,1800
355360,202107,1231,3111,944,2671,117,367,559,1538,676,1905
355365,202107,368,952,199,651,45,142,27,88,72,230
355370,202107,5550,14045,4285,12018,1026,2636,1817,5649,2843,8285
355380,202107,2931,7745,2222,6468,371,1204,826,2067,1197,3271
355385,202107,1486,3864,1229,3493,104,359,795,2057,899,2416
355390,202107,836,2254,606,1761,127,399,237,618,364,1017
355395,202107,2022,5451,1427,4269,234,736,509,1341,743,2077
355400,202107,9401,26272,7451,22455,1712,5879,2802,7502,4514,13381
355410,202107,23412,63670,14568,45330,2818,9587,4081,12302,6899,21889
355420,202107,631,1983,529,1796,134,489,140,449,274,938
355430,202107,3774,9473,2833,7775,598,1651,1322,3572,1920,5223
355440,202107,771,2080,473,1456,78,248,137,392,215,640
355450,202107,3266,8340,2188,6247,345,1062,970,2512,1315,3574
355460,202107,513,1233,318,910,47,163,155,399,202,562
355465,202107,446,1146,345,985,44,138,196,544,240,682
355470,202107,1134,2885,656,1945,163,537,196,507,359,1044
355475,202107,349,811,284,724,14,33,215,534,229,567
355480,202107,4084,11073,3316,9926,444,1540,2176,6346,2620,7886
355490,202107,957,2516,542,1659,40,132,283,793,323,925
355495,202107,830,2281,600,1893,63,248,227,628,290,876
355500,202107,6991,17648,4267,12442,628,1986,1567,4207,2195,6193
355510,202107,1409,3385,907,2546,122,377,379,947,501,1324
355520,202107,375,838,184,528,34,91,60,175,94,266
355530,202107,396,927,147,435,14,51,56,147,70,198
355535,202107,521,1384,394,1180,76,288,184,504,260,792
355540,202107,11092,27177,9096,24381,1187,3501,6141,15902,7328,19403
355550,202107,632,1821,523,1613,60,205,292,832,352,1037
355560,202107,1166,2957,659,1997,148,516,28,81,176,597
355570,202107,255,704,132,433,23,78,30,79,53,157
355580,202107,1221,2925,770,2159,138,459,291,724,429,1183
355590,202107,179,450,138,385,14,44,87,233,101,277
355600,202107,1573,3812,1048,2931,160,475,388,1100,548,1575
355610,202107,1831,4455,1215,3390,129,393,651,1714,780,2107
355620,202107,5166,13464,3875,10953,388,1318,2217,5748,2605,7066
355630,202107,2462,6630,1754,5321,259,830,903,2641,1162,3471
355635,202107,899,2608,668,2155,113,392,200,578,313,970
355640,202107,3237,8821,2210,6768,433,1394,661,1972,1094,3366
355645,202107,4256,11782,3121,9792,451,1544,1686,5111,2137,6655
355650,202107,6546,17457,5056,14733,1300,3985,1517,3896,2817,7881
355660,202107,1377,3520,950,2762,163,490,282,799,445,1289
355670,202107,3932,10409,2673,7620,310,1034,1379,3467,1689,4501
355680,202107,2873,7775,1337,4205,329,1119,98,291,427,1410
355690,202107,805,2328,522,1771,123,466,12,22,135,488
355695,202107,262,738,154,487,13,58,33,79,46,137
355700,202107,7689,21542,6305,18502,968,3094,3540,9766,4508,12860
355710,202107,9389,21934,6217,16184,838,2459,3079,7082,3917,9541
355715,202107,495,1319,268,817,55,178,47,122,102,300
355720,202107,1482,4112,1169,3560,175,568,644,1850,819,2418
355730,202107,946,2574,779,2272,123,397,399,1085,522,1482
410010,202107,1316,3611,1015,2986,196,626,253,712,449,1338
410020,202107,1055,3130,809,2569,273,817,175,569,448,1386
410030,202107,1598,4272,1366,3918,191,576,757,2210,948,2786
410040,202107,13261,36095,9736,29466,2127,6886,3024,8426,5151,15312
410045,202107,835,2230,606,1778,92,296,230,613,322,909
410050,202107,2349,5826,1626,4583,258,810,603,1583,861,2393
410060,202107,2157,5984,1675,5056,365,1154,523,1500,888,2654
410070,202107,2030,5044,1516,4125,226,708,606,1464,832,2172
410080,202107,1375,3629,973,2897,272,848,201,598,473,1446
410090,202107,1142,2876,968,2604,109,271,547,1557,656,1828
410100,202107,1955,5539,1286,3967,186,657,123,363,309,1020
410105,202107,502,1246,289,837,31,87,105,285,136,372
410110,202107,3408,8413,2402,6536,302,888,1138,2906,1440,3794
410115,202107,592,1501,428,1214,53,161,171,444,224,605
410120,202107,2763,7442,2383,6891,466,1432,1314,3686,1780,5118
410130,202107,1282,3416,1110,3095,202,642,585,1513,787,2155
410140,202107,16874,40491,11227,30475,1994,5916,3053,7548,5047,13464
410150,202107,17040,39574,8750,23582,1472,4382,2147,5159,3619,9541
410160,202107,3004,8200,2402,7139,540,1712,804,2384,1344,4096
410165,202107,731,1933,596,1667,58,182,347,907,405,1089
410170,202107,2982,7619,1979,5501,420,1269,122,359,542,1628
410180,202107,15059,41378,11609,34454,1612,5235,5996,16518,7608,21753
410185,202107,434,1267,311,956,57,181,82,222,139,403
410190,202107,2220,5465,1611,4395,323,917,416,1065,739,1982
410200,202107,5896,13259,3242,8704,519,1596,434,1120,953,2716
410210,202107,3310,8158,2146,6108,348,1110,730,1777,1078,2887
410220,202107,549,1414,357,1060,53,164,84,239,137,403
410230,202107,1830,4806,1403,3975,204,614,609,1581,813,2195
410240,202107,5334,13771,3651,10508,742,2365,501,1273,1243,3638
410250,202107,2627,6222,1953,5149,145,455,955,2451,1100,2906
410260,202107,1901,4692,1184,3363,156,449,557,1523,713,1972
410270,202107,483,1268,347,1030,44,150,141,409,185,559
410275,202107,644,1782,458,1392,79,264,180,498,259,762
410280,202107,2411,6268,1608,4712,205,694,667,1778,872,2472
410290,202107,3482,9563,2412,7331,688,2054,597,1812,1285,3866
410300,202107,706,1726,560,1502,60,182,270,664,330,846
410302,202107,352,896,205,621,17,54,100,296,117,350
410304,202107,1315,3356,1092,2941,118,336,683,1769,801,2105
410305,202107,1766,4195,1238,3438,106,330,806,2156,912,2486
410310,202107,2654,7325,2147,6379,302,998,1133,3285,1435,4283
410315,202107,646,1520,400,1127,140,403,98,281,238,684
410320,202107,1082,2965,732,2256,107,381,133,376,240,757
410322,202107,597,1547,345,993,39,123,154,385,193,508
410330,202107,1574,3775,1088,2874,177,488,314,823,491,1311
410335,202107,885,2334,674,1941,102,316,278,732,380,1048
410337,202107,859,2096,601,1596,81,225,211,503,292,728
410340,202107,522,1463,349,1048,26,79,159,396,185,475
410345,202107,2526,6491,1363,3983,251,750,373,935,624,1685
410347,202107,762,1944,566,1583,54,185,185,523,239,708
410350,202107,1652,4009,1191,3251,145,424,567,1434,712,1858
410360,202107,4405,10786,3361,8966,497,1386,1463,3793,1960,5179
410370,202107,14239,37777,9259,26198,1057,3224,3917,9691,4974,12915
410380,202107,1688,4186,1236,3374,189,545,406,1001,595,1546
410390,202107,2770,6829,1855,5229,371,1168,619,1550,990,2718
410395,202107,939,2641,763,2280,158,472,291,890,449,1362
410400,202107,6916,17698,5273,14613,716,2110,2745,7159,3461,9269
410405,202107,903,2060,640,1680,108,328,304,739,412,1067
410410,202107,1326,3466,1244,3338,150,469,798,2214,948,2683
410420,202107,11468,30713,8709,25259,1317,4285,3695,9602,5012,13887
410425,202107,3437,9498,2368,7317,374,1242,856,2397,1230,3639
410430,202107,13531,33427,9528,26192,1404,4229,3534,8995,4938,13224
410440,202107,2363,6892,2021,6264,305,1062,1070,3219,1375,4281
410442,202107,2426,7152,1926,6048,481,1561,524,1545,1005,3106
410445,202107,2312,6535,1682,5328,324,1169,279,966,603,2135
410450,202107,1530,3724,1143,3125,213,628,444,1153,657,1781
410460,202107,2257,5529,1677,4549,180,517,813,2099,993,2616
410465,202107,2853,8142,2261,7023,402,1303,768,2217,1170,3520
410470,202107,2147,5806,1513,4677,391,1387,208,696,599,2083
410480,202107,38719,91723,21174,60821,3176,10197,4834,11822,8010,22019
410490,202107,11596,31472,8397,24973,1450,4606,3468,9631,4918,14237
410500,202107,1942,4971,1324,3817,275,889,353,883,628,1772
410510,202107,1874,4644,1262,3511,239,637,379,1045,618,1682
410520,202107,3099,9585,2727,8837,955,3186,825,2744,1780,5930
410530,202107,1654,3954,782,2170,100,288,208,473,308,761
410540,202107,2917,7752,2025,5962,319,1026,875,2429,1194,3455
410550,202107,7839,20581,5256,15062,868,2724,1437,3554,2305,6278
410560,202107,1520,3926,1133,3143,233,709,388,923,621,1632
410570,202107,2670,7113,1924,5797,547,1959,198,596,745,2555
410580,202107,26923,68736,19697,55695,3366,10225,8940,23578,12306,33803
410590,202107,1586,4476,1104,3359,151,496,334,850,485,1346
410600,202107,1829,4785,1415,3997,330,902,421,1260,751,2162
410610,202107,732,1868,556,1545,61,196,255,650,316,846
410620,202107,2578,7213,1732,5261,378,1221,247,714,625,1935
410630,202107,2586,6642,1697,4887,291,1005,369,836,660,1841
410640,202107,4952,11445,3408,8783,719,2129,416,1095,1135,3224
410645,202107,1122,3120,918,2863,270,868,435,1369,705,2237
410650,202107,2426,6467,1677,4984,315,1003,617,1680,932,2683
410655,202107,930,2213,652,1714,24,66,334,834,358,900
410657,202107,633,1705,387,1170,52,173,120,308,172,481
410660,202107,3570,8897,2112,5772,362,1003,652,1640,1014,2643
410670,202107,1047,2561,644,1813,131,366,203,512,334,878
410680,202107,2650,7789,1830,5757,417,1323,272,898,689,2221
410685,202107,536,1358,401,1130,101,319,150,379,251,698
410690,202107,136974,327665,92527,246904,13803,41908,37548,88272,51351,130180
410700,202107,2549,6384,2113,5711,373,1022,991,2615,1364,3637
410710,202107,910,2266,596,1687,114,337,239,614,353,951
410712,202107,674,1866,561,1660,107,352,263,727,370,1079
410715,202107,861,2460,548,1765,68,225,215,660,283,885
410720,202107,3379,8460,2710,7248,398,1261,730,1903,1128,3164
410725,202107,1148,2792,670,1900,138,421,92,218,230,639
410730,202107,723,1905,567,1618,118,390,123,351,241,741
410740,202107,915,2534,671,2067,82,286,273,831,355,1117
410750,202107,1830,4539,1463,3874,230,662,683,1728,913,2390
410752,202107,383,936,207,596,27,80,97,262,124,342
410753,202107,342,1003,239,765,36,130,52,151,88,281
410754,202107,1125,2849,931,2560,65,154,632,1820,697,1974
410755,202107,589,1506,420,1178,50,147,197,501,247,648
410760,202107,3731,9539,2709,7697,658,2153,619,1606,1277,3759
410765,202107,14892,40766,11633,34391,1962,6261,2809,7288,4771,13549
410770,202107,1091,2541,767,1999,68,186,396,1030,464,1216
410773,202107,1317,3450,1153,3202,113,354,746,2003,859,2357
410775,202107,1551,3782,1358,3500,61,182,921,2303,982,2485
410780,202107,655,1610,441,1203,68,194,128,324,196,518
410785,202107,736,1882,562,1588,90,289,180,508,270,797
410790,202107,894,2486,741,2202,180,572,66,139,246,711
410800,202107,3514,7736,2827,6751,49,147,1849,4274,1898,4421
410810,202107,453,1180,341,967,34,104,134,314,168,418
410820,202107,967,2686,519,1557,105,327,87,223,192,550
410830,202107,41965,99234,29037,77898,5466,16462,11460,28732,16926,45194
410832,202107,1055,2719,846,2355,90,280,508,1334,598,1614
410840,202107,9007,22380,5364,15508,975,3032,1406,3770,2381,6802
410845,202107,1178,2893,911,2489,168,472,366,980,534,1452
410850,202107,2293,6443,2009,5930,326,1011,966,2784,1292,3795
410855,202107,788,1944,506,1398,56,152,244,620,300,772
410860,202107,4534,10922,3567,9373,276,865,2203,5454,2479,6319
410865,202107,1489,4256,1283,3868,125,408,748,2304,873,2712
410870,202107,1270,3353,1035,2960,97,283,671,1896,768,2179
410880,202107,4783,12500,3331,9854,525,1584,495,1565,1020,3149
410890,202107,1049,2899,806,2433,172,581,244,694,416,1275
410895,202107,1024,3185,866,2848,262,946,211,661,473,1607
410900,202107,889,2360,631,1860,104,320,148,365,252,685
410910,202107,417,965,258,665,13,42,139,321,152,363
410920,202107,890,2130,645,1730,83,247,321,827,404,1074
410930,202107,1750,4438,1203,3474,281,950,212,578,493,1528
410940,202107,23547,62800,17134,51506,3452,11357,5452,15947,8904,27304
410950,202107,1964,5686,1769,5402,59,181,1449,4405,1508,4586
410960,202107,8010,19375,5585,15383,1215,3720,2254,6144,3469,9864
410965,202107,1201,2990,822,2284,80,244,489,1325,569,1569
410970,202107,4211,11113,2991,8793,659,2286,418,1004,1077,3290
410975,202107,1396,3346,1057,2826,120,354,506,1299,626,1653
410980,202107,7967,19527,5184,14582,571,1752,2298,5857,2869,7609
410990,202107,1424,3404,970,2676,191,617,371,984,562,1601
411000,202107,685,1796,484,1428,66,222,148,361,214,583
411005,202107,487,1204,289,782,50,149,94,216,144,365
411007,202107,2313,6322,1872,5574,450,1422,630,1834,1080,3256
411010,202107,4273,12633,3363,10798,823,2879,366,1066,1189,3945
411020,202107,2422,6696,1958,5876,538,1665,510,1513,1048,3178
411030,202107,795,1917,564,1465,45,146,303,694,348,840
411040,202107,1031,2586,554,1565,74,227,173,411,247,638
411050,202107,2033,6215,1664,5412,394,1390,250,682,644,2072
411060,202107,2105,5558,1370,4029,269,880,263,724,532,1604
411065,202107,434,1095,283,803,33,99,124,332,157,431
411070,202107,7713,19201,6086,16528,738,2197,3173,8369,3911,10566
411080,202107,2016,5264,1628,4624,390,1295,349,935,739,2230
411090,202107,829,2174,545,1624,46,159,155,434,201,593
411095,202107,2815,6511,1559,4228,193,550,398,1007,591,1557
411100,202107,1258,3213,878,2527,86,280,316,916,402,1196
411110,202107,650,1670,308,941,35,108,19,43,54,151
411120,202107,1356,3642,1118,3208,308,1034,251,656,559,1690
411125,202107,5401,15501,4817,14450,1099,3236,2264,7137,3363,10373
411130,202107,752,1979,538,1582,105,280,183,593,288,873
411140,202107,2330,7001,1959,6243,600,2032,509,1603,1109,3635
411150,202107,4063,10164,2726,7441,501,1597,247,485,748,2082
411155,202107,1012,2564,625,1833,94,267,281,775,375,1042
411160,202107,374,852,257,676,26,74,68,184,94,258
411170,202107,775,2235,599,1840,134,434,213,618,347,1052
411180,202107,5766,14987,4518,12850,652,2004,2196,5849,2848,7853
411190,202107,1884,4764,1387,3853,204,611,551,1389,755,2000
411200,202107,5005,13369,3622,10813,856,2866,813,2082,1669,4948
411210,202107,3381,7473,2287,5702,404,1094,784,1855,1188,2949
411220,202107,909,2288,644,1784,148,451,172,441,320,892
411230,202107,870,2296,635,1850,134,415,207,581,341,996
411240,202107,1655,3892,1131,2972,132,407,552,1317,684,1724
411250,202107,2306,6019,1680,4901,315,1080,502,1384,817,2464
411260,202107,326,822,227,627,23,69,97,231,120,300
411270,202107,2084,5450,1548,4394,209,618,749,1971,958,2589
411275,202107,1509,3441,1045,2686,139,438,502,1187,641,1625
411280,202107,1338,3599,915,2790,230,718,126,359,356,1077
411290,202107,857,2216,538,1594,67,203,262,762,329,965
411295,202107,1292,3226,924,2510,115,326,410,1048,525,1374
411300,202107,1070,2653,703,1936,72,226,320,764,392,990
411310,202107,905,2053,699,1771,77,196,309,775,386,971
411320,202107,5672,14378,4139,11651,605,1820,1832,4671,2437,6491
411325,202107,1422,3974,1199,3580,216,605,643,1998,859,2603
411330,202107,3399,9063,2482,7394,548,1773,746,2241,1294,4014
411340,202107,851,2288,510,1542,82,248,145,418,227,666
411342,202107,1097,2620,614,1669,105,298,204,511,309,809
411345,202107,1143,2886,870,2439,64,186,632,1781,696,1967
411350,202107,2965,7808,1915,5681,451,1458,326,844,777,2302
411360,202107,740,1759,526,1425,75,219,191,482,266,701
411370,202107,61984,150646,45219,122034,3247,10352,26955,67411,30202,77763
411373,202107,1444,3610,1167,3200,114,349,624,1724,738,2073
411375,202107,1125,2806,822,2244,130,362,321,858,451,1220
411380,202107,1194,2704,813,1992,46,124,506,1138,552,1262
411390,202107,1536,4172,1198,3429,198,612,470,1166,668,1778
411400,202107,2408,5805,1810,4698,150,468,980,2388,1130,2856
411410,202107,2766,7551,2045,6043,425,1373,464,1277,889,2650
411420,202107,4493,10786,2434,6882,316,1008,467,987,783,1995
411430,202107,3664,9760,2797,8147,566,1785,981,2628,1547,4413
411435,202107,412,1126,264,821,58,177,82,225,140,402
411440,202107,2617,7161,2093,6170,444,1413,673,1877,1117,3290
411450,202107,2510,6662,1898,5635,240,706,1038,3135,1278,3841
411460,202107,4439,11240,2806,8151,404,1357,539,1394,943,2751
411470,202107,821,2063,607,1657,106,331,241,567,347,898
411480,202107,5309,13844,3886,11213,669,2316,1505,3874,2174,6190
411490,202107,1671,4266,1283,3622,145,475,553,1385,698,1860
411500,202107,1340,3536,904,2613,149,466,173,402,322,868
411510,202107,2394,5950,1928,5183,335,1058,542,1478,877,2536
411520,202107,33787,81715,20157,55337,2299,7239,8068,19686,10367,26925
411530,202107,984,2530,594,1784,94,313,90,232,184,545
411535,202107,524,1502,341,1071,45,161,98,276,143,437
411540,202107,2679,6486,1853,5003,123,399,1005,2651,1128,3050
411545,202107,930,2652,779,2388,71,228,496,1527,567,1755
411550,202107,740,1846,545,1488,82,235,106,317,188,552
411560,202107,2018,5395,1165,3580,145,506,60,144,205,650
411570,202107,7411,16991,5004,13414,1135,3296,917,2491,2052,5787
411573,202107,785,2098,655,1873,105,304,296,826,401,1130
411575,202107,2113,5644,1580,4572,267,821,422,1173,689,1994
411580,202107,4997,11431,3040,8416,413,1392,552,1331,965,2723
411585,202107,635,1878,302,977,62,200,56,170,118,370
411590,202107,415,1115,305,899,42,121,153,415,195,536
411600,202107,334,823,205,614,35,105,65,183,100,288
411605,202107,1591,3676,1033,2806,139,478,514,1373,653,1851
411610,202107,2660,6119,1904,4828,64,217,1324,3126,1388,3343
411620,202107,2766,7287,2353,6645,379,1126,1287,3631,1666,4757
411630,202107,832,2090,526,1533,65,228,197,508,262,736
411640,202107,470,1202,322,890,42,125,102,242,144,367
411650,202107,219,621,143,457,27,92,29,71,56,163
411660,202107,937,2367,680,1904,57,166,274,717,331,883
411670,202107,1497,3542,1024,2654,112,304,528,1258,640,1562
411680,202107,1474,3904,1104,3175,173,565,463,1276,636,1841
411690,202107,4082,10182,3080,8469,680,1863,815,2416,1495,4279
411695,202107,657,1935,447,1394,45,153,189,542,234,695
411700,202107,1744,4431,1186,3379,267,777,200,549,467,1326
411705,202107,1966,5908,1661,5379,293,880,991,3409,1284,4289
411710,202107,2056,5111,1413,3917,308,855,326,855,634,1710
411720,202107,1097,2505,784,1967,138,362,310,750,448,1112
411721,202107,1030,2509,781,2056,141,358,235,608,376,966
411722,202107,923,2434,540,1587,95,298,190,470,285,768
411725,202107,1242,3401,832,2597,194,659,170,506,364,1165
411727,202107,1554,4240,1019,3102,223,695,135,378,358,1073
411729,202107,684,1639,388,1056,42,143,148,357,190,500
411730,202107,5493,14295,4261,11931,786,2365,1949,5318,2735,7683
411740,202107,537,1361,284,815,73,192,58,154,131,346
411745,202107,833,2354,579,1781,70,245,143,349,213,594
411750,202107,5780,15022,4231,12007,548,1673,2021,5380,2569,7053
411760,202107,6933,18221,5374,15568,1648,4968,1015,3345,2663,8313
411770,202107,3142,8934,2294,7093,506,1680,397,1098,903,2778
411780,202107,2722,7528,2367,6884,674,2052,788,2342,1462,4394
411790,202107,2933,6996,1668,4726,316,1019,407,990,723,2009
411800,202107,1083,3079,799,2403,137,449,155,408,292,857
411810,202107,1631,4167,1212,3339,202,581,530,1353,732,1934
411820,202107,12067,33795,9859,29990,2289,7484,4360,12835,6649,20319
411830,202107,569,1393,422,1126,88,261,67,181,155,442
411840,202107,12712,33255,8816,25292,1417,4369,2519,6451,3936,10820
411845,202107,604,1688,359,1124,49,179,88,239,137,418
411850,202107,7521,18912,5135,14731,1233,3908,976,2535,2209,6443
411860,202107,717,1941,518,1529,84,259,120,301,204,560
411870,202107,602,1726,425,1327,89,310,96,281,185,591
411880,202107,2367,5740,1727,4740,231,701,675,1739,906,2440
411885,202107,1141,2942,829,2378,126,422,251,645,377,1067
411890,202107,1445,3792,1030,3021,174,576,105,288,279,864
411900,202107,811,2212,516,1583,109,359,102,287,211,646
411910,202107,1087,3175,798,2576,180,680,308,897,488,1577
411915,202107,15826,38467,10999,29800,1537,4600,4689,11451,6226,16051
411920,202107,1207,3426,1001,3012,209,726,371,1030,580,1756
411925,202107,506,1322,361,1053,74,218,149,413,223,631
411930,202107,5024,14947,4227,13481,1855,6430,268,1036,2123,7466
411940,202107,3372,9723,2628,8144,617,1934,864,2426,1481,4360
411950,202107,15008,39858,12431,35600,1559,5068,7493,20461,9052,25529
411960,202107,6214,16192,4892,13578,836,2487,2029,5397,2865,7884
411965,202107,485,1320,352,1059,48,158,152,426,200,584
411970,202107,1225,2742,951,2374,187,440,410,1182,597,1622
411980,202107,1510,3645,1089,2961,277,742,397,1071,674,1813
411990,202107,39063,100679,25226,75716,4489,14850,8953,25309,13442,40159
411995,202107,3986,9594,3050,8139,858,2503,774,1979,1632,4482
412000,202107,1877,4317,1293,3338,33,104,893,2140,926,2244
412010,202107,634,1911,477,1566,78,265,126,354,204,619
412015,202107,558,1557,453,1369,65,203,257,770,322,973
412020,202107,462,1272,298,933,45,170,122,344,167,514
412030,202107,622,1734,460,1440,67,210,159,488,226,698
412033,202107,973,2536,699,1984,85,253,264,633,349,886
412035,202107,750,2013,476,1516,58,210,248,751,306,961
412040,202107,667,1760,383,1170,56,159,52,148,108,307
412050,202107,1624,4025,1110,3081,245,752,249,692,494,1444
412060,202107,7476,21328,6202,18802,1593,5469,1728,5022,3321,10491
412065,202107,642,1750,473,1411,100,323,108,318,208,641
412070,202107,1251,3216,983,2695,130,386,376,930,506,1316
412080,202107,2342,6353,1627,4937,238,740,481,1318,719,2058
412085,202107,322,767,115,351,11,33,25,64,36,97
412090,202107,6354,16086,4663,12992,1056,3123,1714,4787,2770,7910
412100,202107,1747,4625,1321,3839,429,1409,292,887,721,2296
412110,202107,852,2254,590,1733,77,244,193,544,270,788
412120,202107,2104,5889,1605,4938,324,1110,417,1071,741,2181
412125,202107,676,1904,462,1441,79,252,103,317,182,569
412130,202107,835,2057,573,1575,92,250,148,417,240,667
412135,202107,640,1679,302,899,48,159,94,239,142,398
412140,202107,1784,4261,1206,3259,184,612,255,655,439,1267
412150,202107,2893,7347,2460,6602,356,1101,1490,3766,1846,4867
412160,202107,896,2747,502,1675,64,238,67,179,131,417
412170,202107,4461,12038,3743,10881,689,2246,1578,4210,2267,6456
412175,202107,1341,3745,1117,3364,237,752,473,1415,710,2167
412180,202107,1718,4681,1259,3831,152,530,559,1571,711,2101
412190,202107,3440,8493,2530,6911,307,898,1076,2919,1383,3817
412200,202107,1771,5138,1258,3991,308,1060,181,535,489,1595
412210,202107,673,1584,423,1158,55,168,168,415,223,583
412215,202107,3521,9367,2699,7766,638,1789,1101,3467,1739,5256
412217,202107,1029,2634,856,2320,45,124,601,1561,646,1685
412220,202107,5690,15750,4663,13895,1321,3824,1430,4576,2751,8400
412230,202107,2761,7958,2173,6827,344,1241,536,1427,880,2668
412240,202107,7764,19785,4950,14224,852,2637,1466,3745,2318,6382
412250,202107,2073,5264,1521,4203,355,1028,299,745,654,1773
412260,202107,1298,3381,968,2710,146,416,295,791,441,1207
412265,202107,953,2534,747,2174,157,471,295,815,452,1286
412270,202107,1059,2863,683,2070,83,281,266,720,349,1001
412280,202107,419,1142,328,987,79,246,94,270,173,516
412290,202107,1058,2669,735,2096,107,328,242,633,349,961
412300,202107,1706,4392,1197,3498,255,782,269,814,524,1596
412310,202107,755,2137,582,1776,106,369,177,492,283,861
412320,202107,818,2067,526,1477,47,158,151,418,198,576
412330,202107,1639,4283,1128,3339,233,726,378,1151,611,1877
412340,202107,1239,3332,816,2413,94,322,119,334,213,656
412350,202107,3064,7912,1992,5804,359,1130,340,889,699,2019
412360,202107,266,719,192,561,6,29,123,336,129,365
412370,202107,874,2456,593,1857,115,397,74,221,189,618
412380,202107,1581,4257,1129,3368,282,871,115,388,397,1259
412382,202107,498,1198,333,931,38,136,151,347,189,483
412385,202107,2252,6059,1847,5290,593,1595,574,1827,1167,3422
412390,202107,2588,6118,2065,5309,347,908,726,1854,1073,2762
412395,202107,716,2024,516,1569,70,201,224,688,294,889
412400,202107,960,2491,692,1977,127,403,201,557,328,960
412402,202107,2330,5646,1632,4512,426,1181,210,633,636,1814
412405,202107,3209,8358,2101,6293,513,1795,126,343,639,2138
412410,202107,6424,16369,4720,13602,767,2553,1561,4171,2328,6724
412420,202107,551,1373,364,995,24,73,177,414,201,487
412430,202107,612,1527,324,935,33,104,134,361,167,465
412440,202107,2849,7495,1909,5736,428,1358,392,1187,820,2545
412450,202107,520,1473,351,1060,42,126,35,81,77,207
412460,202107,1117,2845,872,2434,167,503,383,1030,550,1533
412470,202107,1586,4891,1304,4268,296,1026,283,916,579,1942
412480,202107,1095,2865,738,2116,119,368,250,635,369,1003
412490,202107,1363,3292,1088,2803,142,370,545,1311,687,1681
412500,202107,2029,5045,1538,4141,320,892,430,1043,750,1935
412510,202107,1970,5886,1349,4343,316,1092,165,471,481,1563
412520,202107,1276,3211,713,2028,169,460,87,252,256,712
412530,202107,721,1893,520,1483,75,240,118,335,193,575
412535,202107,840,2154,573,1646,106,336,115,273,221,609
412540,202107,1213,3031,881,2440,84,294,297,864,381,1158
412545,202107,705,1806,489,1381,79,241,142,388,221,629
412550,202107,34963,91591,25042,71982,3855,11988,10294,26880,14149,38868
412555,202107,306,791,208,584,21,64,70,159,91,223
412560,202107,4926,13881,3754,11218,639,2137,1149,3394,1788,5531
412570,202107,4603,11390,2666,7688,485,1605,323,958,808,2563
412575,202107,1059,2645,847,2286,110,328,450,1142,560,1470
412580,202107,1483,3777,1059,2993,74,239,588,1577,662,1816
412590,202107,410,1071,230,704,30,95,24,67,54,162
412600,202107,1715,4516,1303,3708,181,569,609,1612,790,2181
412610,202107,868,2268,621,1739,75,227,284,686,359,913
412620,202107,1286,3316,984,2864,186,619,306,823,492,1442
412625,202107,8905,23262,5485,16465,733,2449,342,968,1075,3417
412627,202107,1169,3241,762,2401,142,492,209,647,351,1139
412630,202107,2944,8455,2136,6751,383,1263,618,1752,1001,3015
412635,202107,410,1091,277,810,32,104,93,225,125,329
412640,202107,1062,2771,615,1834,75,229,179,470,254,699
412650,202107,1730,4609,1369,3896,223,709,528,1300,751,2009
412660,202107,2557,6531,1844,5178,253,756,625,1566,878,2322
412665,202107,410,1014,320,851,65,178,139,365,204,543
412667,202107,1861,4789,1365,3831,194,587,588,1562,782,2149
412670,202107,891,2070,574,1550,115,351,146,364,261,715
412680,202107,2134,5563,1485,4333,181,608,524,1324,705,1932
412690,202107,1174,3053,845,2426,145,460,304,820,449,1280
412700,202107,1977,5143,1652,4637,205,635,907,2486,1112,3121
412710,202107,5949,16973,4433,13757,815,2804,1173,3151,1988,5955
412720,202107,1187,3417,916,2836,138,448,218,551,356,999
412730,202107,2596,6696,1818,5166,310,992,702,1841,1012,2833
412740,202107,1976,5433,1360,4196,216,760,188,582,404,1342
412750,202107,4112,10573,3343,9476,268,882,2206,5947,2474,6829
412760,202107,3002,7993,2496,7145,461,1484,1333,3575,1794,5059
412770,202107,10775,27270,5891,17652,780,2509,1270,3155,2050,5664
412780,202107,1212,3168,921,2648,200,624,345,957,545,1581
412785,202107,2194,5112,1557,4066,138,372,1057,2708,1195,3080
412788,202107,1445,3993,1183,3538,328,983,451,1300,779,2283
412790,202107,1368,3587,794,2435,114,397,244,638,358,1035
412795,202107,1288,3277,698,2084,95,308,132,356,227,664
412796,202107,2203,6207,1814,5502,360,1169,602,1670,962,2839
412800,202107,3799,9107,2656,7014,284,877,1294,3018,1578,3895
412810,202107,12481,31548,8170,22919,967,3157,3228,7995,4195,11152
412820,202107,6332,17171,4495,13470,1069,3423,1277,3768,2346,7191
412830,202107,356,1004,256,792,36,105,71,204,107,309
412840,202107,1927,4694,1383,3661,141,420,675,1619,816,2039
412850,202107,2842,7338,2076,6037,310,965,891,2529,1201,3494
412853,202107,1541,3832,1286,3393,170,498,677,1584,847,2082
412855,202107,1356,3478,829,2388,120,394,215,542,335,936
412860,202107,763,1863,519,1473,78,237,271,713,349,950
412862,202107,676,1648,462,1287,100,285,170,440,270,725
412863,202107,1282,3801,1140,3543,264,854,523,1616,787,2470
412865,202107,721,1953,530,1563,151,447,124,401,275,848
412870,202107,868,2227,633,1840,178,565,139,455,317,1020
412880,202107,881,2363,587,1774,97,336,111,307,208,643
420005,202107,423,1227,258,846,29,94,120,396,149,490
420010,202107,3321,8023,2230,6201,125,373,1639,4606,1764,4979
420020,202107,434,1338,287,959,45,173,66,158,111,331
420030,202107,98,345,61,247,16,72,20,76,36,148
420040,202107,519,1545,321,1102,66,249,28,70,94,319
420050,202107,714,1603,476,1191,72,199,285,640,357,839
420055,202107,161,488,84,303,20,90,23,73,43,163
420060,202107,106,285,65,187,6,19,14,32,20,51
420070,202107,728,2157,543,1771,109,356,216,691,325,1047
420075,202107,81,199,41,120,7,26,14,22,21,48
420080,202107,376,1045,294,855,70,231,119,330,189,561
420090,202107,416,1275,265,916,60,223,47,136,107,359
420100,202107,1277,3256,1069,2940,63,194,859,2323,922,2517
420110,202107,253,802,227,743,41,145,120,376,161,521
420120,202107,603,1598,410,1191,59,197,211,538,270,735
420125,202107,360,1081,252,841,60,225,89,276,149,501
420127,202107,313,803,125,371,15,48,47,129,62,177
420130,202107,3648,9855,2776,8424,392,1397,1317,3659,1709,5056
420140,202107,3788,10008,2758,8227,749,2523,493,1483,1242,4006
420150,202107,677,1707,469,1353,48,160,277,766,325,926
420160,202107,190,449,66,206,8,28,18,54,26,82
420165,202107,154,429,92,296,22,69,27,77,49,146
420170,202107,290,902,197,660,25,92,67,191,92,283
420180,202107,168,529,106,372,17,60,29,89,46,149
420190,202107,206,623,124,420,29,109,47,149,76,258
420195,202107,1503,3779,1128,3188,284,935,285,711,569,1646
420200,202107,5087,12115,3150,8550,408,1331,1355,3162,1763,4493
420205,202107,1885,4978,1263,3704,179,552,676,1966,855,2518
420207,202107,1934,4970,1221,3601,206,691,509,1398,715,2089
420208,202107,322,905,184,638,56,202,40,117,96,319
420209,202107,156,485,100,312,16,54,49,139,65,193
420210,202107,3311,8325,2304,6697,358,1188,1169,3221,1527,4409
420213,202107,786,2375,667,2145,143,493,335,1055,478,1548
420215,202107,209,626,148,491,41,154,43,138,84,292
420220,202107,282,805,173,577,28,109,77,232,105,341
420230,202107,5331,14138,4066,11805,574,1807,2210,6116,2784,7923
420240,202107,14416,39469,9268,27617,1101,3752,4498,11697,5599,15449
420243,202107,399,1105,328,970,49,166,210,592,259,758
420245,202107,1470,3710,1088,3057,79,271,686,1814,765,2085
420250,202107,445,1218,375,1105,52,173,224,617,276,790
420253,202107,468,1128,331,929,34,97,192,537,226,634
420257,202107,157,399,99,298,13,50,53,156,66,206
420260,202107,1130,2889,828,2478,113,396,556,1627,669,2023
420270,202107,551,1422,287,826,43,136,121,321,164,457
420280,202107,1268,3701,999,3136,175,621,395,1163,570,1784
420285,202107,121,263,57,164,7,34,22,46,29,80
420287,202107,445,1021,325,860,82,226,124,329,206,555
420290,202107,4956,13837,3835,11346,530,1767,2240,6141,2770,7908
420300,202107,7514,20966,4400,13602,741,2528,1445,3875,2186,6403
420310,202107,799,1825,417,1147,41,127,229,590,270,717
420315,202107,782,2163,534,1734,87,311,249,790,336,1101
420320,202107,5322,14121,3833,11676,1032,3454,1005,2850,2037,6304
420325,202107,333,927,238,737,32,100,100,288,132,388
420330,202107,982,2813,623,2051,103,380,191,576,294,956
420340,202107,932,2553,702,2146,150,466,142,391,292,857
420350,202107,1193,3034,887,2498,63,219,632,1734,695,1953
420360,202107,2962,8003,1605,5075,290,1001,121,367,411,1368
420370,202107,1195,3103,983,2762,75,254,718,1943,793,2197
420380,202107,4419,11469,2983,8855,602,1903,1163,3266,1765,5169
420390,202107,1077,2609,753,1964,127,389,310,578,437,967
420395,202107,1175,3282,816,2563,128,450,130,298,258,748
420400,202107,1005,2756,703,2138,111,393,310,881,421,1274
420410,202107,581,1522,450,1255,32,95,322,883,354,978
420415,202107,286,829,212,670,50,171,85,285,135,456
420417,202107,599,1737,467,1473,126,417,178,570,304,987
420419,202107,139,493,111,427,40,161,9,37,49,198
420420,202107,11799,30200,7955,23226,2062,6847,2342,6164,4404,13011
420425,202107,638,1696,436,1276,36,123,220,616,256,739
420430,202107,3148,8324,1879,5587,411,1282,622,1697,1033,2979
420435,202107,257,664,136,433,17,62,68,208,85,270
420440,202107,703,1878,431,1313,126,405,127,364,253,769
420445,202107,261,630,172,471,32,86,78,198,110,284
420450,202107,747,2163,541,1713,90,359,198,536,288,895
420455,202107,2021,4818,1473,4004,219,633,713,1861,932,2494
420460,202107,9341,24563,7052,20355,959,3133,3693,10153,4652,13286
420470,202107,587,1521,314,972,59,217,62,159,121,376
420475,202107,66,174,25,82,6,21,2,6,8,27
420480,202107,5250,12787,3260,9515,606,1946,1189,3422,1795,5368
420490,202107,361,999,259,789,52,183,101,297,153,480
420500,202107,1356,3674,874,2788,138,498,402,1253,540,1751
420510,202107,154,432,79,257,11,46,19,50,30,96
420515,202107,75,206,48,142,7,32,18,47,25,79
420517,202107,765,2075,647,1853,64,188,429,1235,493,1423
420519,202107,303,733,217,607,18,59,135,380,153,439
420520,202107,274,724,141,464,19,66,10,31,29,97
420530,202107,809,2340,557,1794,78,310,222,616,300,926
420535,202107,235,688,98,334,15,56,39,129,54,185
420540,202107,38478,91046,25538,69481,3562,10933,9525,22463,13087,33396
420543,202107,210,619,161,507,17,53,84,241,101,294
420545,202107,1262,3729,953,3050,163,589,352,998,515,1587
420550,202107,3581,9366,2353,7302,350,1282,1050,3288,1400,4570
420555,202107,300,853,213,671,22,76,128,386,150,462
420560,202107,391,961,260,764,46,147,156,455,202,602
420570,202107,2433,6377,1903,5389,302,984,897,2427,1199,3411
420580,202107,1815,4619,1303,3837,295,930,429,1296,724,2226
420590,202107,2777,7364,1665,4977,276,980,471,1092,747,2072
420600,202107,1067,3005,832,2577,93,352,502,1474,595,1826
420610,202107,354,1022,228,738,54,175,79,266,133,441
420620,202107,768,1872,514,1459,112,331,196,552,308,883
420630,202107,916,2746,672,2155,74,263,401,1214,475,1477
420640,202107,487,1303,246,816,75,248,37,119,112,367
420650,202107,3654,9508,2295,6693,317,1011,923,2343,1240,3354
420660,202107,426,1082,271,753,60,167,55,141,115,308
420665,202107,665,1704,438,1325,74,252,195,524,269,776
420670,202107,1232,3385,783,2441,126,482,282,750,408,1232
420675,202107,187,510,111,363,20,87,56,166,76,253
420680,202107,309,701,160,494,29,96,77,225,106,321
420690,202107,860,2529,544,1803,76,301,149,430,225,731
420700,202107,2630,6833,2002,5794,203,638,1230,3455,1433,4093
420710,202107,1025,2850,791,2342,73,281,499,1329,572,1610
420720,202107,1161,3194,845,2650,142,481,449,1332,591,1813
420730,202107,3176,8188,2375,6873,384,1240,1273,3514,1657,4754
420740,202107,488,1430,270,950,54,213,19,75,73,288
420750,202107,1941,5524,1252,3944,211,775,515,1474,726,2249
420757,202107,86,208,39,116,4,6,17,53,21,59
420760,202107,313,904,172,529,32,112,52,142,84,254
420765,202107,459,1299,220,716,26,88,103,320,129,408
420768,202107,1353,3735,1179,3452,138,397,885,2585,1023,2982
420770,202107,437,1199,203,706,28,112,65,207,93,319
420775,202107,268,783,185,594,33,117,71,190,104,307
420780,202107,915,2544,553,1723,105,358,93,262,198,620
420785,202107,199,521,142,401,14,50,71,165,85,215
420790,202107,1024,3027,764,2503,117,446,434,1349,551,1795
420800,202107,655,1621,343,1004,69,233,146,404,215,637
420810,202107,1455,4383,1183,3846,311,1175,466,1290,777,2465
420820,202107,12802,31572,9311,25938,1630,5040,4389,11324,6019,16364
420830,202107,4403,11343,3312,9410,566,1688,1475,4048,2041,5736
420840,202107,484,1423,235,861,55,202,19,80,74,282
420845,202107,2513,6285,1581,4621,292,1021,664,1818,956,2839
420850,202107,1080,3379,676,2329,111,407,149,451,260,858
420860,202107,363,917,207,640,32,112,55,145,87,257
420870,202107,771,2147,573,1755,150,509,215,593,365,1102
420880,202107,1059,3137,814,2629,162,626,313,912,475,1538
420890,202107,8209,22042,5147,15729,704,2327,1820,4917,2524,7244
420895,202107,175,505,110,336,28,87,35,109,63,196
420900,202107,1524,3739,929,2701,119,420,432,1095,551,1515
420910,202107,31861,83100,20417,61175,2931,9934,8376,22120,11307,32054
420915,202107,502,1790,370,1414,54,200,206,801,260,1001
420917,202107,430,1051,196,527,33,89,96,259,129,348
420920,202107,80,219,36,123,2,5,6,22,8,27
420930,202107,16657,42690,11893,34347,1988,6362,5400,14747,7388,21109
420940,202107,3168,7634,1918,5505,426,1382,414,959,840,2341
420945,202107,133,375,105,317,21,70,43,116,64,186
420950,202107,349,1001,198,646,27,110,55,161,82,271
420960,202107,1056,2546,753,2034,120,370,344,833,464,1203
420970,202107,2348,6314,1654,5052,457,1440,484,1481,941,2921
420980,202107,275,905,237,825,109,390,60,217,169,607
420985,202107,318,897,166,570,41,163,46,137,87,300
420990,202107,314,973,182,650,29,109,41,144,70,253
421000,202107,555,1645,406,1319,87,312,92,253,179,565
421003,202107,468,1097,158,457,4,14,17,37,21,51
421005,202107,66,193,51,171,12,42,22,72,34,114
421010,202107,3306,8967,2383,7248,454,1555,661,1750,1115,3305
421020,202107,377,1156,298,1014,42,169,148,478,190,647
421030,202107,781,2290,596,1919,169,609,209,612,378,1221
421040,202107,635,1519,394,1148,30,103,243,691,273,794
421050,202107,1038,2750,687,1988,133,424,269,688,402,1112
421055,202107,179,483,104,311,16,51,62,168,78,219
421060,202107,674,1931,485,1527,84,301,242,700,326,1001
421070,202107,659,1963,419,1358,67,240,165,497,232,737
421080,202107,519,1472,428,1301,42,154,254,760,296,914
421085,202107,377,1048,150,503,14,44,28,75,42,119
421090,202107,270,694,152,430,12,43,49,122,61,165
421100,202107,781,1734,334,988,73,246,86,200,159,446
421105,202107,1569,4182,1094,3271,168,532,528,1498,696,2030
421110,202107,1111,2854,913,2591,32,109,645,1913,677,2022
421120,202107,1032,3052,746,2425,117,430,215,592,332,1022
421125,202107,296,758,212,605,71,231,77,187,148,418
421130,202107,4877,13937,4021,12276,896,3121,2047,5851,2943,8972
421140,202107,343,926,211,639,38,113,77,213,115,326
421145,202107,437,1182,280,841,67,209,88,237,155,446
421150,202107,616,1672,410,1271,64,231,193,546,257,777
421160,202107,518,1402,387,1151,57,187,237,661,294,848
421165,202107,225,670,138,455,30,100,52,166,82,266
421170,202107,1049,2849,895,2603,137,386,555,1659,692,2045
421175,202107,973,2385,592,1793,110,377,265,772,375,1149
421180,202107,391,1024,219,681,38,148,100,269,138,417
421185,202107,322,825,220,619,21,73,131,350,152,423
421187,202107,277,849,174,591,29,95,58,195,87,290
421189,202107,350,1008,274,860,46,155,109,314,155,469
421190,202107,11337,30280,7812,23590,1334,4312,3006,8355,4340,12667
421200,202107,694,1941,576,1737,87,317,340,961,427,1278
421205,202107,191,505,140,423,25,89,66,184,91,273
421210,202107,1070,2671,605,1870,114,367,223,675,337,1042
421220,202107,1375,4041,1069,3405,231,810,352,1026,583,1836
421223,202107,319,872,199,647,45,143,97,314,142,457
421225,202107,834,2411,709,2204,114,420,437,1323,551,1743
421227,202107,651,1827,424,1350,76,262,197,642,273,904
421230,202107,573,1474,369,1093,70,238,140,405,210,643
421240,202107,288,832,140,483,16,67,27,84,43,151
421250,202107,2111,5226,1490,4231,153,482,908,2474,1061,2956
421260,202107,215,669,49,177,10,43,5,14,15,57
421265,202107,679,1768,601,1654,18,46,516,1413,534,1459
421270,202107,341,911,146,512,27,91,43,147,70,238
421280,202107,2005,5229,1521,4444,210,742,871,2399,1081,3141
421290,202107,968,2584,500,1502,102,322,109,300,211,622
421300,202107,268,682,131,419,13,54,19,55,32,109
421310,202107,186,523,126,407,26,84,65,204,91,288
421315,202107,230,589,153,434,45,120,39,123,84,243
421320,202107,636,1990,342,1138,35,100,33,59,68,159
421330,202107,600,1756,433,1402,91,334,115,338,206,672
421335,202107,350,1044,283,930,61,222,119,379,180,601
421340,202107,1413,3850,1025,3155,166,586,496,1401,662,1987
421350,202107,1515,3884,1012,3009,191,628,391,1101,582,1729
421360,202107,2249,5936,1347,4094,245,877,508,1331,753,2208
421370,202107,732,2316,452,1572,74,281,133,387,207,668
421380,202107,837,2153,718,1968,87,271,428,1126,515,1397
421390,202107,166,446,63,219,14,43,24,70,38,113
421400,202107,343,1057,250,838,49,190,127,394,176,584
421410,202107,173,489,82,298,22,87,21,67,43,154
421415,202107,179,505,119,353,22,76,31,65,53,141
421420,202107,558,1514,455,1323,51,171,280,794,331,965
421430,202107,100,314,73,245,8,28,17,53,25,81
421440,202107,622,1659,372,1188,66,204,155,475,221,679
421450,202107,467,1326,269,885,31,108,38,135,69,243
421460,202107,354,1057,193,713,14,54,22,61,36,115
421470,202107,299,820,187,589,31,97,66,227,97,324
421480,202107,2760,7313,1850,5491,339,1187,745,2027,1084,3214
421490,202107,116,395,70,265,11,39,13,41,24,80
421500,202107,2084,6021,1411,4613,348,1325,339,969,687,2294
421505,202107,300,814,249,742,31,115,167,473,198,588
421507,202107,426,1176,238,782,51,190,84,245,135,435
421510,202107,358,1000,233,694,35,109,119,334,154,443
421520,202107,500,1317,318,913,30,85,176,454,206,539
421530,202107,291,845,162,549,25,109,35,85,60,194
421535,202107,381,1005,243,764,38,147,140,418,178,565
421540,202107,309,734,173,521,27,91,57,152,84,243
421545,202107,618,1809,461,1533,101,408,224,689,325,1097
421550,202107,2087,5439,1682,4833,320,934,949,2726,1269,3660
421555,202107,168,509,68,240,6,22,8,14,14,36
421560,202107,86,286,58,216,10,42,20,67,30,109
421565,202107,909,2313,611,1848,149,509,185,538,334,1047
421567,202107,420,1288,276,903,82,292,82,231,164,523
421568,202107,326,958,227,720,40,149,87,262,127,411
421569,202107,153,428,72,227,9,28,42,134,51,162
421570,202107,1293,3507,910,2711,193,637,280,751,473,1388
421575,202107,291,837,219,644,31,103,106,288,137,391
421580,202107,4322,11558,2793,8404,390,1376,1109,2834,1499,4210
421590,202107,163,482,120,390,28,99,44,138,72,237
421600,202107,576,1516,384,1113,70,236,135,334,205,570
421605,202107,734,1898,529,1561,94,238,275,879,369,1117
421610,202107,1032,2756,694,2120,115,384,220,652,335,1036
421620,202107,3775,9915,2322,7261,437,1608,730,2112,1167,3720
421625,202107,129,362,65,202,10,27,19,58,29,85
421630,202107,2585,6701,1682,4978,284,1009,638,1576,922,2585
421635,202107,265,700,186,541,14,44,119,317,133,361
421640,202107,668,1789,484,1515,107,377,202,617,309,994
421650,202107,2425,6590,1661,5180,352,1278,548,1487,900,2765
421660,202107,10436,28653,7395,22779,1073,3726,3386,9495,4459,13221
421670,202107,759,2129,540,1618,96,322,251,716,347,1038
421680,202107,1092,2883,845,2464,150,475,513,1386,663,1861
421690,202107,1341,3758,917,2880,160,542,315,985,475,1527
421700,202107,519,1506,361,1159,73,257,124,378,197,635
421710,202107,197,634,100,347,21,74,27,89,48,163
421715,202107,116,306,94,259,21,58,51,138,72,196
421720,202107,1929,5193,1163,3553,288,926,296,788,584,1714
421725,202107,256,615,141,418,21,64,69,179,90,243
421730,202107,398,1096,231,659,31,94,124,328,155,422
421740,202107,759,2125,512,1604,113,385,158,446,271,831
421750,202107,877,2050,424,1222,92,285,166,434,258,719
421755,202107,167,462,94,287,15,55,43,116,58,171
421760,202107,992,2580,688,2030,120,383,247,617,367,1000
421770,202107,2359,6151,1702,5015,450,1280,584,1855,1034,3135
421775,202107,214,552,130,391,16,50,56,157,72,207
421780,202107,821,2388,540,1794,106,393,227,678,333,1071
421790,202107,869,2336,502,1645,109,369,213,677,322,1046
421795,202107,176,485,124,360,22,69,39,104,61,173
421800,202107,2616,6956,1911,5664,226,772,1109,3101,1335,3873
421810,202107,639,1733,435,1350,46,168,250,761,296,929
421820,202107,963,2777,590,1872,108,382,201,528,309,910
421825,202107,1354,3684,1208,3468,100,310,891,2494,991,2804
421830,202107,1996,5745,1627,5066,336,1106,635,1942,971,3048
421835,202107,230,558,153,436,34,117,56,147,90,264
421840,202107,206,641,144,501,23,86,33,99,56,185
421850,202107,369,1016,214,712,52,202,52,129,104,331
421860,202107,301,820,173,557,25,86,62,177,87,263
421870,202107,4514,11184,3332,8993,485,1564,1771,4209,2256,5773
421875,202107,291,846,122,371,16,48,33,84,49,132
421880,202107,673,1878,462,1419,97,323,129,378,226,701
421885,202107,228,628,147,445,33,107,47,121,80,228
421890,202107,849,2492,632,2059,101,389,351,1084,452,1473
421895,202107,400,1002,344,928,38,106,233,664,271,770
421900,202107,1032,2710,791,2217,95,304,399,1008,494,1312
421910,202107,312,893,197,629,26,106,48,122,74,228
421915,202107,367,1028,215,677,45,138,43,125,88,263
421917,202107,575,1319,328,1007,112,360,87,289,199,649
421920,202107,366,1100,264,900,97,344,80,270,177,614
421930,202107,2583,6428,1391,4177,278,957,505,1310,783,2267
421935,202107,398,1213,315,1036,59,198,185,594,244,792
421940,202107,370,1065,179,572,28,96,36,91,64,187
421950,202107,3089,7648,1786,5192,346,1094,466,1177,812,2271
421960,202107,181,439,96,279,14,54,32,67,46,121
421970,202107,1880,4794,1174,3352,217,727,478,1178,695,1905
421985,202107,302,820,189,588,25,87,76,219,101,306
422000,202107,1928,4899,1575,4359,143,470,1093,2973,1236,3443
430003,202107,575,1521,380,1173,67,220,171,528,238,748
430005,202107,268,704,171,532,24,80,85,254,109,334
430010,202107,1732,4098,1381,3560,225,573,890,2271,1115,2844
430020,202107,587,1330,442,1138,45,135,292,721,337,856
430030,202107,923,2160,503,1406,118,378,158,400,276,778
430040,202107,10462,24343,6347,17282,1638,4740,951,2703,2589,7443
430045,202107,460,1148,327,905,25,79,220,595,245,674
430047,202107,233,502,94,254,22,55,26,73,48,128
430050,202107,864,2172,510,1460,103,316,135,364,238,680
430055,202107,275,664,138,382,17,63,73,172,90,235
430057,202107,80,164,29,77,7,23,7,15,14,38
430060,202107,17798,46366,13840,40167,2712,8298,6610,18895,9322,27193
430063,202107,809,2225,661,1927,132,387,354,1031,486,1418
430064,202107,1119,2962,826,2380,201,608,356,997,557,1605
430066,202107,95,190,67,148,6,14,52,110,58,124
430070,202107,727,1846,123,400,19,77,20,47,39,124
430080,202107,892,2183,545,1507,87,287,293,682,380,969
430085,202107,913,1986,542,1396,97,264,239,599,336,863
430087,202107,818,1937,682,1760,62,167,482,1231,544,1398
430090,202107,514,1357,202,654,19,84,54,153,73,237
430100,202107,860,2028,518,1392,93,282,160,369,253,651
430105,202107,1233,3177,825,2476,122,421,405,1165,527,1586
430107,202107,181,520,102,315,20,61,26,72,46,133
430110,202107,2244,5500,1667,4662,302,889,827,2263,1129,3152
430120,202107,1229,3534,817,2510,136,421,365,1107,501,1528
430130,202107,3535,7882,2592,6569,844,2194,469,1453,1313,3647
430140,202107,1006,2545,716,2025,166,438,367,1026,533,1464
430150,202107,571,1447,313,932,71,222,89,267,160,489
430155,202107,243,615,116,348,22,63,22,59,44,122
430160,202107,20604,46749,16195,40671,1770,4774,9936,24536,11706,29310
430163,202107,3241,7440,2286,5940,78,259,1727,4383,1805,4642
430165,202107,312,766,100,308,12,27,14,39,26,66
430170,202107,976,2537,346,1161,54,183,43,123,97,306
430175,202107,656,1891,557,1679,131,392,264,799,395,1191
430180,202107,658,1575,504,1312,69,162,319,846,388,1008
430185,202107,684,1702,355,1013,96,246,52,144,148,390
430187,202107,765,1627,556,1366,67,178,332,821,399,999
430190,202107,1429,3618,1137,3171,239,706,531,1427,770,2133
430192,202107,125,330,41,119,5,15,9,21,14,36
430195,202107,413,1197,59,205,5,19,6,13,11,32
430200,202107,1039,3017,834,2644,283,930,230,762,513,1692
430205,202107,453,1159,406,1075,13,46,361,929,374,975
430210,202107,6127,15582,4148,11426,679,2004,1275,2793,1954,4797
430215,202107,305,782,196,567,38,110,72,214,110,324
430220,202107,664,1638,208,680,23,85,47,121,70,206
430222,202107,193,528,146,432,17,55,51,147,68,202
430223,202107,258,654,202,563,15,36,121,331,136,367
430225,202107,16,32,10,23,0,0,7,16,7,16
430230,202107,1990,5286,1639,4743,139,452,1203,3411,1342,3863
430235,202107,371,1012,237,738,36,122,59,159,95,281
430237,202107,514,1175,385,969,16,45,296,725,312,770
430240,202107,1363,3112,771,2094,80,257,404,995,484,1252
430245,202107,725,1974,566,1678,128,404,294,880,422,1284
430250,202107,948,2253,681,1836,232,668,44,105,276,773
430258,202107,138,369,100,290,6,15,54,151,60,166
430260,202107,700,1801,481,1389,56,181,278,810,334,991
430265,202107,219,625,148,487,28,87,53,182,81,269
430270,202107,2985,7168,2361,6208,358,1019,1476,3767,1834,4786
430280,202107,5175,11864,3624,9279,673,1747,1638,4122,2311,5869
430290,202107,2267,5095,1850,4617,58,171,1576,3841,1634,4012
430300,202107,10456,25495,7905,21170,1159,3415,4301,11082,5460,14497
430310,202107,12395,29972,8461,22857,1062,3162,4210,10586,5272,13748
430320,202107,1034,2561,573,1667,54,160,337,972,391,1132
430330,202107,710,1690,427,1137,76,210,164,401,240,611
430340,202107,607,1415,397,1072,64,161,234,625,298,786
430350,202107,8159,19873,6237,16591,681,1968,3919,9893,4600,11861
430355,202107,301,795,111,357,16,53,13,33,29,86
430360,202107,863,2041,580,1550,109,330,240,594,349,924
430367,202107,323,697,186,471,30,95,108,248,138,343
430370,202107,531,1388,222,649,29,82,60,142,89,224
430380,202107,715,1720,343,1036,77,271,96,274,173,545
430390,202107,3308,7838,2043,5568,404,1236,309,615,713,1851
430400,202107,1025,2173,782,1850,65,173,456,1043,521,1216
430410,202107,545,1267,380,1003,53,137,242,634,295,771
430420,202107,2649,6932,2038,5666,428,1279,1038,2717,1466,3996
430430,202107,570,1417,263,793,60,174,56,175,116,349
430435,202107,1548,3828,1195,3262,198,585,639,1730,837,2315
430440,202107,3904,10354,3085,8987,283,913,1978,5719,2261,6632
430450,202107,6876,16690,5478,14247,1066,2975,2607,6495,3673,9470
430460,202107,35571,87314,26611,72823,4250,12772,13866,36324,18116,49096
430461,202107,231,600,75,227,14,49,29,68,43,117
430462,202107,277,738,161,502,30,97,49,144,79,241
430463,202107,6358,16245,4686,13212,888,2821,2197,5844,3085,8665
430465,202107,453,1135,358,954,61,183,224,574,285,757
430466,202107,4373,10770,3434,9281,742,2083,1658,4257,2400,6340
430467,202107,509,1197,356,964,49,161,196,480,245,641
430468,202107,1302,3146,1036,2764,74,229,734,1902,808,2131
430469,202107,531,1397,80,245,9,29,19,42,28,71
430470,202107,5672,14343,3790,11009,1081,3415,954,2606,2035,6021
430471,202107,546,1500,446,1317,67,212,266,754,333,966
430480,202107,677,1871,435,1344,56,183,103,271,159,454
430485,202107,172,438,63,187,22,60,6,21,28,81
430490,202107,386,980,212,631,21,79,107,273,128,352
430495,202107,399,1057,267,809,41,131,119,337,160,468
430500,202107,1006,2535,701,2020,228,700,194,512,422,1212
430510,202107,27743,70058,19911,55299,3120,9690,9424,24081,12544,33771
430511,202107,348,976,140,442,16,54,20,57,36,111
430512,202107,998,2183,778,1859,171,418,299,719,470,1137
430513,202107,801,1953,372,1060,60,186,173,451,233,637
430515,202107,377,1047,275,839,38,112,150,453,188,565
430517,202107,1206,3507,907,2832,154,475,477,1497,631,1972
430520,202107,1339,3309,728,2021,131,389,175,441,306,830
430530,202107,995,2447,416,1230,69,202,117,333,186,535
430535,202107,3586,9030,2605,7247,355,1026,1327,3544,1682,4570
430537,202107,386,1200,338,1090,21,61,270,873,291,934
430540,202107,618,1461,338,972,63,176,156,447,219,623
430543,202107,939,1602,563,1181,60,129,223,552,283,681
430544,202107,765,2107,527,1585,126,385,170,496,296,881
430545,202107,2484,6145,1855,5203,313,887,1023,2887,1336,3774
430550,202107,351,973,257,774,49,154,100,282,149,436
430558,202107,117,269,55,149,7,14,20,55,27,69
430560,202107,286,648,141,405,23,76,49,128,72,204
430570,202107,862,2081,621,1650,103,322,314,756,417,1078
430580,202107,834,2049,596,1690,161,484,243,701,404,1185
430583,202107,199,488,35,105,4,12,10,22,14,34
430585,202107,227,548,119,329,18,60,49,110,67,170
430587,202107,200,535,150,444,22,70,59,163,81,233
430590,202107,1377,3286,1138,2929,62,185,927,2337,989,2522
430593,202107,21,64,15,43,2,4,6,17,8,21
430595,202107,440,1093,129,412,13,48,19,44,32,92
430597,202107,457,1138,241,700,24,74,78,179,102,253
430600,202107,1999,5072,855,2414,130,382,207,540,337,922
430605,202107,1316,3375,961,2726,111,349,478,1299,589,1648
430607,202107,571,1282,457,1116,29,72,328,787,357,859
430610,202107,5863,13424,3927,10535,1054,3267,897,2291,1951,5558
430613,202107,295,678,88,257,11,30,24,56,35,86
430620,202107,662,1582,495,1279,74,220,295,680,369,900
430630,202107,427,1165,122,390,23,73,29,75,52,148
430632,202107,452,1157,200,588,31,86,82,230,113,316
430635,202107,566,1285,429,1056,46,122,318,770,364,892
430637,202107,463,1084,351,916,35,103,239,600,274,703
430640,202107,1114,2925,749,2182,112,324,300,817,412,1141
430642,202107,363,994,274,793,47,142,138,372,185,514
430645,202107,154,363,60,163,11,32,19,45,30,77
430650,202107,1705,4671,1353,4090,395,1179,557,1831,952,3010
430655,202107,283,695,176,489,27,86,88,214,115,300
430660,202107,5336,13272,4085,11239,856,2473,1841,4967,2697,7440
430670,202107,652,1543,498,1289,42,109,288,763,330,872
430673,202107,545,1212,237,645,37,104,93,231,130,335
430675,202107,241,697,54,195,7,23,14,47,21,70
430676,202107,5275,12692,4209,11089,524,1463,2639,6822,3163,8285
430680,202107,1066,2769,620,1850,167,508,137,384,304,892
430690,202107,2841,7522,2242,6455,753,2308,633,1745,1386,4053
430692,202107,218,664,171,585,13,42,126,445,139,487
430693,202107,943,2423,572,1708,104,367,152,421,256,788
430695,202107,412,1021,256,718,31,77,134,363,165,440
430697,202107,410,1029,323,899,67,167,170,511,237,678
430700,202107,7732,18565,4792,13172,922,2733,1218,3005,2140,5738
430705,202107,405,941,199,561,18,49,84,215,102,264
430710,202107,1720,3571,1206,2898,148,401,730,1700,878,2101
430720,202107,701,1665,368,1095,43,128,197,583,240,711
430730,202107,1013,2711,706,2127,84,254,380,1111,464,1365
430740,202107,670,1772,354,1126,59,190,97,308,156,498
430745,202107,349,936,233,693,57,191,73,185,130,376
430750,202107,1501,3695,1013,2842,319,921,368,1013,687,1934
430755,202107,454,1102,293,782,27,86,158,385,185,471
430760,202107,2093,5049,1606,4313,311,922,782,1993,1093,2915
430770,202107,6560,16058,5100,13856,608,1895,3306,8630,3914,10525
430780,202107,1935,4709,1198,3459,193,627,541,1489,734,2116
430781,202107,477,1312,283,862,65,183,83,229,148,412
430783,202107,350,795,210,578,24,67,131,339,155,406
430786,202107,36,128,26,99,5,20,4,16,9,36
430790,202107,4648,11076,3286,8733,344,1077,2028,4996,2372,6073
430800,202107,771,1728,582,1455,43,104,380,947,423,1051
430805,202107,349,887,231,643,11,37,157,420,168,457
430807,202107,526,1283,290,838,33,106,136,361,169,467
430810,202107,735,1725,321,927,41,144,125,318,166,462
430820,202107,1196,3193,733,2296,127,403,225,674,352,1077
430825,202107,268,652,90,242,11,26,32,82,43,108
430830,202107,1738,4775,1406,4145,106,313,986,2864,1092,3177
430840,202107,1076,2554,731,1986,110,280,465,1290,575,1570
430843,202107,179,424,84,224,8,24,32,73,40,97
430845,202107,485,1130,316,860,49,140,150,383,199,523
430850,202107,2279,5813,1554,4435,240,743,576,1682,816,2425
430860,202107,890,2071,420,1174,51,172,196,457,247,629
430865,202107,528,1318,377,1058,100,283,108,308,208,591
430870,202107,584,1542,262,830,40,144,76,207,116,351
430880,202107,1504,3352,1028,2627,167,424,560,1398,727,1822
430885,202107,168,435,88,280,6,17,54,169,60,186
430890,202107,1018,2455,684,1896,51,210,146,376,197,586
430900,202107,3152,6791,2210,5465,172,530,1492,3459,1664,3989
430905,202107,878,2140,562,1547,100,300,240,631,340,931
430910,202107,2162,5753,1638,4687,249,822,767,1909,1016,2731
430912,202107,504,1401,352,1091,31,90,218,693,249,783
430915,202107,481,1419,367,1208,136,426,95,332,231,758
430920,202107,23441,58342,17969,49389,2243,6729,10977,29430,13220,36159
430925,202107,90,202,38,113,4,12,19,54,23,66
430930,202107,10700,24749,7019,19133,1306,3541,2960,8426,4266,11967
430940,202107,939,2407,574,1652,118,354,203,525,321,879
430950,202107,820,1802,530,1317,34,111,354,804,388,915
430955,202107,393,1015,109,300,25,68,33,68,58,136
430957,202107,166,556,152,528,19,69,103,355,122,424
430960,202107,1351,3141,777,2117,152,438,333,859,485,1297
430965,202107,1588,3727,1226,3161,67,174,929,2444,996,2618
430970,202107,364,865,195,541,26,83,98,241,124,324
430975,202107,512,1468,393,1195,74,241,206,598,280,839
430980,202107,393,883,228,608,26,81,106,254,132,335
430990,202107,551,1550,361,1120,53,172,158,490,211,662
430995,202107,556,1391,424,1180,56,163,241,653,297,816
431000,202107,1363,3200,589,1695,117,367,43,105,160,472
431010,202107,2339,6097,1580,4759,324,1035,457,1238,781,2273
431020,202107,7765,16738,4644,12118,948,2850,1690,3845,2638,6695
431030,202107,361,973,174,576,33,124,25,77,58,201
431033,202107,3927,8981,2588,6906,542,1488,972,2572,1514,4060
431036,202107,338,737,71,209,7,23,22,52,29,75
431040,202107,899,2225,580,1680,67,218,293,780,360,998
431041,202107,447,1027,319,830,28,66,189,494,217,560
431043,202107,317,784,186,547,39,131,90,252,129,383
431046,202107,107,279,44,133,5,12,9,25,14,37
431050,202107,1366,3264,971,2623,185,542,441,1219,626,1761
431053,202107,661,1720,386,1144,72,232,125,320,197,552
431055,202107,596,1412,489,1242,60,134,351,891,411,1025
431057,202107,225,643,125,409,29,96,32,96,61,192
431060,202107,5694,13952,3849,10872,865,2689,1141,3078,2006,5767
431065,202107,408,1000,297,817,41,122,152,412,193,534
431070,202107,422,1119,250,748,53,171,77,219,130,390
431075,202107,221,626,131,420,32,111,37,119,69,230
431080,202107,594,1591,417,1218,66,225,155,425,221,650
431085,202107,800,2045,508,1392,56,156,274,734,330,890
431087,202107,404,1109,326,953,21,63,230,679,251,742
431090,202107,405,943,160,487,25,83,42,132,67,215
431100,202107,3397,7319,2346,5971,283,730,1293,3329,1576,4059
431110,202107,1434,3245,982,2463,232,619,414,931,646,1550
431112,202107,632,1673,520,1472,48,165,359,954,407,1119
431113,202107,409,1073,341,946,58,173,182,486,240,659
431115,202107,968,2687,761,2307,79,305,482,1365,561,1670
431120,202107,2701,6908,1880,5377,485,1520,477,1265,962,2785
431123,202107,377,1016,251,742,56,149,131,408,187,557
431125,202107,973,2706,781,2336,279,823,272,861,551,1684
431127,202107,201,531,65,213,8,28,12,34,20,62
431130,202107,2996,7435,2246,6227,320,984,1259,3401,1579,4385
431140,202107,5877,13659,3606,9449,418,1183,1617,3705,2035,4888
431142,202107,525,1349,395,1128,45,131,245,703,290,834
431150,202107,1052,2738,765,2217,138,439,345,964,483,1403
431160,202107,667,1867,436,1354,86,286,125,377,211,663
431162,202107,523,1260,313,880,36,114,165,416,201,530
431164,202107,166,376,42,130,8,25,7,22,15,47
431170,202107,452,1218,322,953,99,298,92,266,191,564
431171,202107,666,1538,546,1381,130,283,299,795,429,1078
431173,202107,411,1055,310,904,80,274,134,361,214,635
431175,202107,1331,3041,843,2221,131,343,330,829,461,1172
431177,202107,827,2162,645,1880,113,398,417,1152,530,1550
431179,202107,335,722,103,289,18,49,27,70,45,119
431180,202107,2201,5518,1382,3929,314,913,436,1179,750,2092
431190,202107,600,1511,271,778,33,94,86,210,119,304
431198,202107,392,1092,315,946,89,283,107,333,196,616
431200,202107,372,924,90,245,16,47,12,33,28,80
431205,202107,217,588,117,371,35,115,35,119,70,234
431210,202107,622,1479,505,1322,135,361,214,586,349,947
431213,202107,258,683,196,571,10,34,101,286,111,320
431215,202107,619,1469,300,865,26,82,142,380,168,462
431217,202107,159,406,112,320,16,53,60,153,76,206
431220,202107,535,1360,332,967,33,115,187,497,220,612
431225,202107,1514,3509,1166,2947,122,319,795,2003,917,2322
431230,202107,684,1913,551,1632,78,230,330,955,408,1185
431235,202107,150,380,20,70,2,4,4,19,6,23
431237,202107,337,1041,270,885,49,182,130,398,179,580
431238,202107,34,96,28,83,5,16,13,31,18,47
431240,202107,4674,11200,3722,9733,418,1256,2388,5890,2806,7146
431242,202107,255,647,222,594,41,117,131,334,172,451
431244,202107,331,785,170,474,19,71,66,152,85,223
431245,202107,1324,3026,841,2205,62,173,474,1197,536,1370
431247,202107,281,696,173,478,30,95,79,185,109,280
431250,202107,1747,4248,1289,3635,282,801,651,1981,933,2782
431260,202107,278,736,176,548,24,89,61,188,85,277
431261,202107,263,777,210,685,16,52,117,366,133,418
431262,202107,341,956,177,575,14,42,115,377,129,419
431265,202107,1612,3754,666,1909,79,264,221,545,300,809
431267,202107,248,608,162,430,6,21,118,289,124,310
431270,202107,2862,6319,1536,4102,325,870,510,1414,835,2284
431275,202107,114,319,64,203,22,66,11,36,33,102
431280,202107,238,640,79,249,5,18,13,31,18,49
431290,202107,350,1017,227,718,40,124,38,101,78,225
431295,202107,69,165,20,57,3,8,4,10,7,18
431300,202107,291,760,60,184,8,21,21,56,29,77
431301,202107,298,836,68,213,10,30,6,20,16,50
431303,202107,625,1577,380,1074,23,79,173,437,196,516
431306,202107,2342,5449,1439,3962,194,590,628,1542,822,2132
431308,202107,25,76,23,72,10,34,10,31,20,65
431310,202107,552,1462,386,1109,47,132,180,482,227,614
431320,202107,654,1770,364,1156,61,184,96,269,157,453
431330,202107,1737,4054,884,2503,145,469,357,896,502,1365
431333,202107,219,567,119,346,20,56,45,110,65,166
431335,202107,36,106,20,72,4,10,0,0,4,10
431337,202107,2658,6809,2015,5774,309,1028,1204,3294,1513,4322
431339,202107,417,1068,311,882,88,256,113,313,201,569
431340,202107,19015,45562,13402,36198,1962,5865,6512,16409,8474,22274
431342,202107,428,956,313,772,30,57,248,615,278,672
431344,202107,391,987,237,699,10,32,124,358,134,390
431346,202107,236,580,96,302,17,56,22,59,39,115
431349,202107,690,1732,412,1138,83,226,169,461,252,687
431350,202107,4266,10622,3211,8848,402,1280,1813,4762,2215,6042
431360,202107,563,1311,281,776,90,255,64,177,154,432
431365,202107,2087,4748,1654,4164,120,338,1269,3150,1389,3488
431370,202107,4628,10917,3390,8947,630,1752,1733,4635,2363,6387
431380,202107,837,2198,682,1956,47,141,479,1370,526,1511
431390,202107,2654,6417,1688,4723,152,505,888,2185,1040,2690
431395,202107,1358,3239,983,2680,188,535,496,1368,684,1903
431400,202107,315,878,180,571,35,108,37,112,72,220
431402,202107,905,1970,675,1624,83,193,463,1108,546,1301
431403,202107,200,548,155,456,24,71,68,191,92,262
431405,202107,4869,12481,3788,10691,592,1853,1969,5227,2561,7080
431406,202107,547,1511,390,1173,74,212,196,609,270,821
431407,202107,478,1267,339,975,70,226,184,499,254,725
431410,202107,17862,43486,12292,33893,1641,5202,6694,17043,8335,22245
431413,202107,227,610,57,187,6,19,10,35,16,54
431415,202107,692,1658,445,1244,75,251,222,557,297,808
431417,202107,568,1242,380,944,59,172,204,485,263,657
431420,202107,1637,3602,1234,3049,151,377,735,1774,886,2151
431430,202107,567,1430,282,856,46,150,90,242,136,392
431440,202107,30452,69618,21232,55423,3360,9602,8842,21330,12202,30932
431442,202107,141,401,71,240,13,50,9,27,22,77
431445,202107,390,1081,105,331,13,36,13,34,26,70
431446,202107,260,742,192,607,29,112,94,283,123,395
431447,202107,767,1979,430,1261,86,260,133,395,219,655
431449,202107,789,2023,487,1405,92,247,179,531,271,778
431450,202107,2307,4651,1796,3935,71,169,1424,3043,1495,3212
431454,202107,38,125,31,106,8,25,10,31,18,56
431455,202107,586,1367,292,770,36,98,143,340,179,438
431460,202107,2940,6922,2042,5355,537,1467,504,1327,1041,2794
431470,202107,1426,3909,1044,3102,175,527,443,1328,618,1855
431475,202107,238,636,56,188,5,18,10,24,15,42
431477,202107,388,999,237,693,40,108,96,256,136,364
431478,202107,221,581,50,157,11,29,4,9,15,38
431480,202107,3479,8401,2793,7361,677,1772,1399,3715,2076,5487
431490,202107,109602,252845,83476,213492,5503,16711,61329,150466,66832,167177
431500,202107,495,1246,371,1020,66,193,194,505,260,698
431505,202107,254,607,173,483,12,40,123,339,135,379
431507,202107,334,779,135,395,45,143,33,86,78,229
431510,202107,1645,4122,1112,3093,266,783,380,1065,646,1848
431513,202107,224,487,123,321,11,22,75,197,86,219
431514,202107,114,289,84,237,3,10,59,157,62,167
431515,202107,465,1147,348,941,81,221,196,495,277,716
431517,202107,56,165,46,139,4,11,23,67,27,78
431520,202107,395,982,165,503,15,55,75,199,90,254
431530,202107,4828,10230,2858,7246,599,1466,951,2458,1550,3924
431531,202107,214,508,137,367,19,44,55,139,74,183
431532,202107,555,1268,342,888,65,191,152,379,217,570
431535,202107,237,620,108,335,24,82,23,59,47,141
431540,202107,1799,5638,1668,5457,55,202,1357,4465,1412,4667
431545,202107,361,908,71,208,7,22,21,58,28,80
431550,202107,2161,5340,1554,4229,249,713,776,2031,1025,2744
431555,202107,675,1515,399,1055,34,98,229,601,263,699
431560,202107,23881,56225,16260,44406,3202,8989,5709,16326,8911,25315
431570,202107,4363,10455,3672,9452,436,1231,2621,6496,3057,7727
431575,202107,295,694,237,609,72,159,107,285,179,444
431580,202107,596,1536,383,1113,45,148,206,570,251,718
431590,202107,601,1650,452,1354,86,267,173,527,259,794
431595,202107,366,988,247,737,44,127,95,262,139,389
431600,202107,1467,3381,1043,2750,206,591,456,1161,662,1752
431610,202107,1425,3544,970,2727,153,407,486,1405,639,1812
431620,202107,487,1232,227,643,43,131,85,212,128,343
431630,202107,1334,3233,644,1845,95,277,252,685,347,962
431640,202107,6394,14715,5415,13482,468,1220,4113,10265,4581,11485
431642,202107,588,1396,364,963,40,101,157,388,197,489
431643,202107,385,927,182,515,16,42,52,151,68,193
431645,202107,1870,4093,1475,3574,50,157,1212,2890,1262,3047
431647,202107,303,722,94,270,8,17,25,62,33,79
431650,202107,126,338,88,278,8,27,42,120,50,147
431660,202107,887,2293,424,1317,61,220,110,297,171,517
431670,202107,1188,2775,723,1940,117,324,345,862,462,1186
431673,202107,235,602,87,296,6,23,14,35,20,58
431675,202107,410,1053,110,370,8,28,20,59,28,87
431680,202107,8154,20204,5983,16277,1299,3647,2617,6922,3916,10569
431690,202107,25101,60153,17151,46135,3180,9125,7547,19935,10727,29060
431695,202107,185,448,110,325,20,66,56,147,76,213
431697,202107,472,1089,365,927,52,129,215,553,267,682
431700,202107,1367,3436,1121,2995,181,431,654,1770,835,2201
431710,202107,13722,31677,9697,25965,1425,4103,5231,14016,6656,18119
431720,202107,6781,16292,4113,11321,976,2800,837,2089,1813,4889
431725,202107,27,75,21,65,3,10,9,24,12,34
431730,202107,4042,9347,2544,7036,553,1596,840,2491,1393,4087
431740,202107,5333,12296,3557,9385,876,2682,957,2206,1833,4888
431750,202107,7655,19417,5807,16497,1376,4067,2198,6217,3574,10284
431755,202107,323,856,80,261,12,29,11,31,23,60
431760,202107,5474,12119,3765,9428,410,1150,2354,5593,2764,6743
431770,202107,1960,4444,1519,3860,118,295,1118,2794,1236,3089
431775,202107,203,513,102,316,20,65,14,36,34,101
431780,202107,2205,5276,1440,3898,225,658,604,1578,829,2236
431790,202107,793,2085,551,1616,93,257,245,735,338,992
431795,202107,273,669,136,405,30,84,36,105,66,189
431800,202107,8342,19402,5229,14560,1251,4169,486,1402,1737,5571
431805,202107,285,672,79,263,10,40,10,20,20,60
431810,202107,3360,7695,2106,5460,392,1052,904,2246,1296,3298
431820,202107,2140,5592,1666,4840,471,1451,592,1775,1063,3226
431830,202107,9049,19440,6683,16257,1727,4971,1559,3727,3286,8698
431840,202107,2693,6770,2167,5940,299,849,1421,3863,1720,4712
431842,202107,518,1275,181,547,25,86,75,203,100,289
431843,202107,335,871,248,701,30,88,121,330,151,418
431844,202107,201,532,70,229,16,59,20,71,36,130
431845,202107,508,1321,359,1027,41,115,208,591,249,706
431846,202107,278,701,238,643,12,32,209,566,221,598
431848,202107,149,373,79,228,10,31,17,37,27,68
431849,202107,407,983,83,244,9,24,13,26,22,50
431850,202107,4200,11068,3226,9186,715,2217,1110,3070,1825,5287
431860,202107,646,1498,352,941,55,159,206,527,261,686
431861,202107,94,260,58,180,9,28,19,60,28,88
431862,202107,465,1438,386,1302,72,265,197,637,269,902
431870,202107,21262,52396,17101,46010,1808,5532,10831,27937,12639,33469
431880,202107,3988,10063,2843,8055,399,1308,1409,3762,1808,5070
431890,202107,4661,11556,2925,8250,802,2442,507,1606,1309,4048
431900,202107,971,2384,628,1777,92,283,325,860,417,1143
431910,202107,762,1783,289,783,37,113,90,205,127,318
431912,202107,490,1295,381,1106,77,238,217,629,294,867
431915,202107,1119,2602,879,2228,27,77,685,1706,712,1783
431920,202107,1251,2826,1036,2548,35,74,879,2157,914,2231
431930,202107,679,1760,468,1365,170,471,161,492,331,963
431935,202107,85,218,61,170,16,43,13,34,29,77
431936,202107,312,864,177,534,33,104,83,229,116,333
431937,202107,142,352,92,253,10,24,40,90,50,114
431940,202107,3112,7176,1816,4839,158,454,990,2524,1148,2978
431950,202107,1922,4893,1533,4261,364,1057,662,1779,1026,2836
431960,202107,2984,7105,2239,5783,587,1620,653,1647,1240,3267
431970,202107,399,997,175,505,37,116,39,89,76,205
431971,202107,86,211,38,115,4,16,8,17,12,33
431973,202107,484,1532,393,1348,44,142,277,957,321,1099
431975,202107,108,216,21,63,2,7,6,17,8,24
431980,202107,954,2453,736,2100,144,439,361,983,505,1422
431990,202107,5818,13697,4119,11263,430,1424,2293,6029,2723,7453
432000,202107,12003,27934,8812,23053,1894,5056,4097,10694,5991,15750
432010,202107,2635,6117,1761,4651,310,852,799,1934,1109,2786
432020,202107,1778,4582,1097,3122,228,690,375,1021,603,1711
432023,202107,523,1235,265,739,33,95,116,295,149,390
432026,202107,946,2590,697,2107,182,536,206,636,388,1172
432030,202107,381,925,230,628,17,53,131,339,148,392
432032,202107,339,848,233,636,24,71,134,333,158,404
432035,202107,657,1817,574,1679,166,458,255,799,421,1257
432040,202107,1089,2544,420,1274,53,177,172,470,225,647
432045,202107,153,433,100,322,20,62,37,123,57,185
432050,202107,557,1343,416,1105,76,212,185,497,261,709
432055,202107,562,1496,370,1145,127,401,67,192,194,593
432057,202107,183,492,145,391,10,24,73,186,83,210
432060,202107,428,1016,134,412,32,106,36,103,68,209
432065,202107,199,552,143,434,34,108,52,163,86,271
432067,202107,731,2059,622,1819,57,190,464,1307,521,1497
432070,202107,1715,4291,1178,3280,206,652,505,1277,711,1929
432080,202107,4947,11270,3756,9469,585,1711,1797,4302,2382,6013
432085,202107,378,987,275,827,58,186,130,388,188,574
432090,202107,2181,5277,1286,3582,230,672,588,1536,818,2208
432100,202107,987,2418,487,1441,102,316,85,211,187,527
432110,202107,2083,5370,1445,4246,333,1081,184,481,517,1562
432120,202107,3069,8045,2431,7011,411,1332,1143,3132,1554,4464
432130,202107,2635,6482,2192,5831,635,1712,934,2536,1569,4248
432132,202107,178,511,109,358,21,70,53,152,74,222
432135,202107,1000,2310,673,1762,52,146,476,1235,528,1381
432140,202107,1674,4846,1278,4051,175,592,791,2482,966,3074
432143,202107,1396,3610,1066,3103,64,205,704,2028,768,2233
432145,202107,1766,4579,1127,3276,167,510,366,907,533,1417
432146,202107,103,291,74,245,25,93,24,69,49,162
432147,202107,481,1287,290,896,102,316,66,197,168,513
432149,202107,447,1070,229,639,26,73,100,247,126,320
432150,202107,3334,8163,2481,6700,482,1396,1102,2901,1584,4297
432160,202107,5305,13468,3867,11180,853,2782,1335,3717,2188,6499
432162,202107,229,490,34,91,6,19,10,20,16,39
432163,202107,122,288,24,66,0,0,4,5,4,5
432166,202107,659,1790,522,1516,102,340,190,480,292,820
432170,202107,1568,4124,1083,3233,196,648,453,1268,649,1916
432180,202107,3136,7299,1710,4654,293,840,685,1635,978,2475
432183,202107,373,1058,263,817,58,201,87,247,145,448
432185,202107,825,2102,480,1434,40,131,237,663,277,794
432190,202107,1997,4733,1386,3775,137,431,860,2221,997,2652
432195,202107,857,2146,581,1648,133,348,223,656,356,1004
432200,202107,3505,8556,2546,7063,354,1017,1513,4171,1867,5188
432210,202107,403,1060,254,770,47,163,115,301,162,464
432215,202107,610,1765,555,1682,47,115,420,1302,467,1417
432218,202107,249,606,117,326,12,38,54,127,66,165
432220,202107,3695,8497,2639,6798,513,1311,1280,3309,1793,4620
432225,202107,99,272,74,224,10,28,45,137,55,165
432230,202107,748,1739,401,1100,42,114,182,449,224,563
432232,202107,475,1162,301,868,62,185,106,274,168,459
432234,202107,268,670,124,363,18,49,21,56,39,105
432235,202107,44,125,18,57,5,17,4,13,9,30
432237,202107,309,791,274,735,12,23,227,602,239,625
432240,202107,16408,39273,12043,33474,919,2511,7776,22613,8695,25124
432250,202107,5579,15494,4146,12671,1036,3281,1747,5330,2783,8611
432252,202107,422,1003,275,736,32,89,148,368,180,457
432253,202107,873,2577,583,1856,143,488,49,136,192,624
432254,202107,699,1620,205,595,33,84,43,120,76,204
432255,202107,101,256,57,169,4,13,27,73,31,86
432260,202107,5064,12665,3761,10249,1014,2840,1357,3536,2371,6376
432270,202107,1947,5201,1581,4512,473,1469,420,1129,893,2598
432280,202107,1465,3577,781,2253,100,320,282,671,382,991
432285,202107,142,427,22,67,2,6,3,7,5,13
432290,202107,338,918,192,582,62,197,37,83,99,280
432300,202107,26708,65653,20103,55144,2554,7982,12289,32285,14843,40267
432310,202107,848,2208,613,1780,65,195,406,1176,471,1371
432320,202107,203,466,83,247,8,28,29,77,37,105
432330,202107,228,506,72,227,10,23,12,41,22,64
432335,202107,159,446,57,197,6,24,13,42,19,66
432340,202107,313,757,140,439,13,42,40,117,53,159
432345,202107,748,1628,642,1504,15,38,543,1249,558,1287
432350,202107,337,851,180,551,31,91,65,208,96,299
432360,202107,234,691,46,156,4,12,15,48,19,60
432370,202107,301,735,205,573,16,54,142,384,158,438
432375,202107,477,1171,360,944,84,220,163,421,247,641
432377,202107,163,507,35,124,3,14,6,13,9,27
432380,202107,1853,4877,1275,3841,190,612,667,1969,857,2581
500020,202107,2788,6994,2101,5880,208,661,1325,3589,1533,4250
500025,202107,1195,2911,754,2080,75,206,395,1056,470,1262
500060,202107,8212,22793,5641,17463,688,2238,3295,10357,3983,12595
500070,202107,4529,11295,3219,9083,582,1686,1440,4111,2022,5797
500080,202107,1681,4020,1034,2854,191,602,400,967,591,1569
500085,202107,2023,5001,1427,3984,357,1034,634,1684,991,2718
500090,202107,2189,5642,1486,4428,217,689,485,1558,702,2247
500100,202107,3712,9312,2827,7879,421,1308,1459,3820,1880,5128
500110,202107,8493,21207,5595,16694,1100,3610,1727,6018,2827,9628
500124,202107,2134,6039,1704,5340,298,838,884,2944,1182,3782
500150,202107,1384,3048,888,2347,133,376,378,958,511,1334
500190,202107,5077,13016,3262,9504,625,1816,875,2447,1500,4263
500200,202107,2626,6069,1842,4764,170,439,1128,2820,1298,3259
500210,202107,4807,11141,3409,9303,972,2550,1462,4146,2434,6696
500215,202107,1424,3837,1040,3154,99,336,594,1784,693,2120
500220,202107,2927,7907,1989,6178,338,1084,686,2068,1024,3152
500230,202107,2084,4715,1590,4039,188,462,1083,2709,1271,3171
500240,202107,4133,11863,2967,9460,438,1492,1255,4079,1693,5571
500260,202107,3398,7157,2209,5572,287,732,1228,2977,1515,3709
500270,202107,141408,327363,87069,237061,13327,40002,34395,86893,47722,126895
500280,202107,1451,3575,981,2849,179,530,443,1290,622,1820
500290,202107,3784,9030,2261,6363,337,1080,735,1783,1072,2863
500295,202107,3707,8792,2393,6495,402,1196,967,2280,1369,3476
500310,202107,1015,2051,699,1660,95,209,373,905,468,1114
500315,202107,3992,10613,3208,9469,246,739,2338,7019,2584,7758
500320,202107,20127,52707,13941,42555,3548,11135,4551,15083,8099,26218
500325,202107,5151,11222,3545,9031,369,915,2242,5766,2611,6681
500330,202107,6850,15269,4504,11903,366,1036,2370,6511,2736,7547
500345,202107,2090,5045,1398,3963,303,904,498,1387,801,2291
500348,202107,2407,6115,1800,5079,230,695,1051,2990,1281,3685
500350,202107,1353,3618,759,2339,86,262,309,922,395,1184
500370,202107,27933,70153,20138,57601,2369,7803,10947,30661,13316,38464
500375,202107,2561,6588,1727,4917,266,830,606,1556,872,2386
500380,202107,3464,8535,2415,6768,693,2086,449,1288,1142,3374
500390,202107,645,1342,395,1031,54,164,231,579,285,743
500400,202107,1601,3998,1060,2969,177,545,359,912,536,1457
500410,202107,2475,5927,1741,4851,181,471,992,2913,1173,3384
500430,202107,2714,6552,1869,5323,260,823,785,2377,1045,3200
500440,202107,1311,3130,814,2357,124,385,281,873,405,1258
500450,202107,1591,3874,943,2724,142,439,258,676,400,1115
500460,202107,3642,9570,2200,6744,341,1195,672,1996,1013,3191
500470,202107,2514,6637,1562,4702,416,1373,324,856,740,2229
500480,202107,2117,6435,1792,5940,165,522,1332,4505,1497,5027
500490,202107,1121,2551,664,1855,120,406,178,498,298,904
500500,202107,4332,11217,2798,8739,786,2888,307,985,1093,3873
500510,202107,725,1799,477,1347,38,107,295,813,333,920
500515,202107,1724,4409,1336,3785,174,535,769,2057,943,2592
500520,202107,3399,9853,2630,8491,667,2124,1063,3763,1730,5887
500525,202107,963,2735,762,2441,63,224,503,1601,566,1825
500540,202107,4651,11930,2741,8508,637,2525,234,655,871,3180
500560,202107,5617,14927,4531,13580,294,856,3682,11249,3976,12105
500568,202107,4489,9688,2756,7141,721,1837,866,2365,1587,4202
500570,202107,8146,18607,5213,13756,830,2405,2233,5455,3063,7860
500580,202107,3159,8162,2314,6682,564,1657,969,2825,1533,4482
500600,202107,3460,8533,2487,6992,553,1610,1017,2924,1570,4534
500620,202107,8223,21069,5554,16058,1032,3121,2292,6317,3324,9438
500625,202107,548,1460,360,1087,64,195,91,253,155,448
500627,202107,783,1987,482,1465,93,302,131,372,224,674
500630,202107,7483,16628,4211,11306,821,2401,1197,3171,2018,5572
500635,202107,3011,9267,2304,8337,158,577,1578,6310,1736,6887
500640,202107,1734,3753,1167,3007,42,123,801,2031,843,2154
500660,202107,19283,47736,13159,38843,3839,12950,3390,10278,7229,23228
500690,202107,2507,6689,1596,5121,515,1934,140,394,655,2328
500710,202107,3036,7878,2312,6654,602,1855,731,1941,1333,3796
500720,202107,5047,12503,3352,9679,759,2336,1049,3096,1808,5432
500730,202107,1120,2728,614,1801,120,340,137,422,257,762
500740,202107,4755,11159,3199,8748,439,1247,1569,4189,2008,5436
500750,202107,1040,2579,724,2041,88,224,301,806,389,1030
500755,202107,970,2471,557,1702,99,334,125,349,224,683
500769,202107,5391,13034,3058,8685,553,1677,441,1124,994,2801
500770,202107,1427,3811,953,3002,167,594,308,948,475,1542
500780,202107,1219,2889,776,2163,152,494,215,533,367,1027
500790,202107,6823,18007,5230,15296,1082,3416,2422,7084,3504,10500
500793,202107,2074,5178,1498,4205,352,1063,505,1296,857,2359
500795,202107,2718,6637,2183,5961,124,303,1712,4940,1836,5243
500797,202107,778,1950,505,1463,149,437,143,437,292,874
500800,202107,3442,7620,2126,5669,606,1931,291,848,897,2779
500830,202107,18553,45502,12787,35118,2665,7741,4511,11730,7176,19471
500840,202107,1440,3454,924,2481,124,327,380,965,504,1292
510010,202107,1868,4140,1278,3401,110,232,923,2488,1033,2720
510020,202107,4087,10034,2173,6306,376,1187,588,1484,964,2671
510025,202107,6828,16188,4239,12115,594,1836,1903,5238,2497,7074
510030,202107,3006,6462,2026,5054,335,831,1001,2409,1336,3240
510035,202107,1252,3238,802,2531,115,381,432,1472,547,1853
510040,202107,2451,5348,1824,4543,192,444,1124,2950,1316,3394
510050,202107,2244,4557,1519,3652,202,503,993,2385,1195,2888
510060,202107,1366,3362,862,2469,168,528,213,548,381,1076
510080,202107,1406,3560,942,2831,199,631,432,1207,631,1838
510100,202107,681,1547,487,1247,63,162,274,677,337,839
510120,202107,280,508,159,365,10,20,119,274,129,294
510125,202107,2059,5083,1624,4443,151,542,913,2331,1064,2873
510130,202107,1576,3880,1081,3092,221,663,368,1077,589,1740
510140,202107,3140,7867,2116,6581,772,2713,716,2228,1488,4941
510160,202107,1765,4494,1309,3905,147,410,965,2957,1112,3367
510170,202107,4899,12592,3646,10563,839,2520,1510,4344,2349,6864
510180,202107,15093,33161,9879,25780,2049,5871,3289,9491,5338,15362
510185,202107,1788,4558,1147,3646,457,1492,241,1030,698,2522
510190,202107,2076,5820,1325,4570,357,1361,236,888,593,2249
510250,202107,17792,43819,13182,36914,2443,7145,6532,18915,8975,26060
510260,202107,1840,7787,1535,7267,243,1250,953,4912,1196,6162
510263,202107,3242,8996,2008,6445,328,1152,385,1069,713,2221
510267,202107,5393,15141,3061,9915,501,1745,448,1258,949,3003
510268,202107,1253,3077,955,2611,118,312,583,1574,701,1886
510269,202107,1027,2731,628,1970,139,489,216,626,355,1115
510270,202107,3102,8574,2119,6849,340,1254,847,2716,1187,3970
510279,202107,1800,4567,1080,3320,168,570,405,1153,573,1723
510285,202107,1142,2945,759,2280,220,755,190,505,410,1260
510300,202107,3770,9320,2785,8005,407,1180,1629,4947,2036,6127
510305,202107,1444,3940,900,2902,174,604,207,759,381,1363
510310,202107,957,2302,653,1809,180,508,193,556,373,1064
510320,202107,3702,8989,2562,7094,547,1676,542,1491,1089,3167
510325,202107,4313,12473,3142,10328,873,3072,864,2884,1737,5956
510330,202107,2622,7791,1757,6277,307,1112,636,2661,943,3773
510335,202107,4957,14055,3758,12151,557,1903,2050,6746,2607,8649
510336,202107,442,1238,322,1054,44,143,171,624,215,767
510337,202107,1437,4080,914,3154,345,1314,189,664,534,1978
510340,202107,95200,209200,62378,162486,14286,43132,19872,49268,34158,92400
510343,202107,1126,2917,738,2222,115,399,333,946,448,1345
510345,202107,1278,3590,959,2956,160,493,417,1267,577,1760
510350,202107,3083,7688,2114,6089,443,1284,953,2760,1396,4044
510360,202107,2055,4095,1279,3196,74,119,899,2438,973,2557
510370,202107,1760,4877,1309,4157,178,622,779,2555,957,3177
510380,202107,574,1384,327,971,52,181,135,398,187,579
510385,202107,1214,4007,909,3444,85,377,601,2352,686,2729
510390,202107,1313,3351,879,2832,276,891,268,1060,544,1951
510395,202107,734,1596,500,1256,27,65,322,858,349,923
510410,202107,4851,13047,3543,10815,673,2126,1779,5725,2452,7851
510420,202107,2548,5193,1714,4102,110,258,1159,2783,1269,3041
510450,202107,496,1209,303,862,75,220,47,142,122,362
510452,202107,845,2355,628,1957,74,238,377,1140,451,1378
510454,202107,982,2661,760,2288,83,237,479,1517,562,1754
510455,202107,971,2601,685,2057,121,396,271,737,392,1133
510460,202107,1849,4573,1360,3838,137,444,839,2277,976,2721
510480,202107,4982,11679,3377,8836,587,1700,1374,3401,1961,5101
510490,202107,1733,4383,1297,3839,247,701,770,2333,1017,3034
510500,202107,1577,3820,966,2868,187,592,302,888,489,1480
510510,202107,3690,10345,2678,8586,622,2234,890,2974,1512,5208
510515,202107,5331,13339,3514,10151,745,2448,1077,2744,1822,5192
510517,202107,1127,3098,834,2614,256,910,161,452,417,1362
510520,202107,2304,4571,1278,3291,107,284,601,1691,708,1975
510523,202107,1291,2980,902,2395,158,427,551,1480,709,1907
510525,202107,7722,20689,5720,16798,882,2779,2721,7556,3603,10335
510530,202107,558,1428,413,1215,27,90,273,794,300,884
510550,202107,2307,6705,1682,5638,341,1201,792,2667,1133,3868
510558,202107,2375,6254,1733,5262,229,640,807,2710,1036,3350
510560,202107,1561,4403,964,3252,179,658,221,806,400,1464
510562,202107,5869,14487,4285,11799,980,2870,1484,4385,2464,7255
510590,202107,3005,7420,2211,6377,150,434,1618,4800,1768,5234
510600,202107,1446,3184,965,2490,155,392,487,1237,642,1629
510610,202107,2618,6207,1770,5115,189,601,1092,3153,1281,3754
510615,202107,2773,6716,1941,5424,295,898,1119,3145,1414,4043
510617,202107,1020,3070,805,2728,79,310,564,1963,643,2273
510618,202107,1221,3213,871,2638,190,626,399,1171,589,1797
510619,202107,809,2012,487,1440,71,200,100,264,171,464
510620,202107,1465,3266,680,1975,174,599,34,69,208,668
510621,202107,1604,4213,972,3025,222,760,271,737,493,1497
510622,202107,4909,13370,3349,10155,1080,3561,454,1275,1534,4836
510623,202107,2746,6763,2005,5596,466,1434,668,1866,1134,3300
510624,202107,1635,4153,807,2619,98,357,171,497,269,854
510625,202107,3113,7431,1732,5012,286,939,414,1213,700,2152
510626,202107,1469,3547,925,2685,239,797,200,595,439,1392
510627,202107,632,1608,346,1058,81,276,90,285,171,561
510628,202107,1488,3371,992,2731,227,655,376,1023,603,1678
510629,202107,1643,4534,1171,3685,205,697,397,1257,602,1954
510630,202107,3481,9433,2056,6741,464,1630,370,1343,834,2973
510631,202107,581,1370,421,1135,16,34,317,889,333,923
510637,202107,3781,8755,2684,7170,627,1860,832,2259,1459,4119
510642,202107,5486,15269,4179,13314,931,3298,1946,6210,2877,9508
510645,202107,1042,2011,641,1519,188,407,264,665,452,1072
510650,202107,7221,18019,5693,16342,658,1680,3797,12276,4455,13956
510665,202107,1844,3947,1170,2897,251,585,424,1151,675,1736
510670,202107,434,919,250,656,30,83,133,354,163,437
510675,202107,6374,17214,4385,13586,1180,4033,840,2473,2020,6506
510677,202107,2171,5454,1491,4455,204,709,811,2376,1015,3085
510680,202107,701,1764,397,1201,70,239,99,247,169,486
510682,202107,1534,4336,1121,3667,372,1392,287,862,659,2254
510685,202107,492,1397,348,1112,54,174,179,576,233,750
510700,202107,4079,9546,2852,7886,250,749,2157,5956,2407,6705
510704,202107,11089,25841,7432,19678,1720,4884,1815,4671,3535,9555
510706,202107,2173,6310,1506,5211,300,1077,758,2844,1058,3921
510710,202107,2765,6751,1800,4923,399,1150,563,1480,962,2630
510715,202107,628,1323,450,1091,29,74,262,619,291,693
510718,202107,2397,5410,1421,4089,351,983,561,1943,912,2926
510719,202107,459,953,270,703,27,80,156,379,183,459
510720,202107,860,1982,582,1572,111,334,267,689,378,1023
510724,202107,853,2283,590,1787,80,257,312,904,392,1161
510726,202107,1062,1933,579,1346,69,168,283,665,352,833
510729,202107,624,1439,289,823,33,107,75,230,108,337
510730,202107,2981,7063,2035,5640,237,765,1074,2862,1311,3627
510735,202107,1108,3047,857,2706,73,260,645,2020,718,2280
510740,202107,1015,2477,656,1821,112,311,322,872,434,1183
510757,202107,481,1525,377,1366,110,449,140,472,250,921
510760,202107,44783,96818,27060,70148,5462,16164,8552,20359,14014,36523
510770,202107,4313,9568,2960,7868,191,465,2063,5741,2254,6206
510774,202107,344,860,243,706,39,117,124,372,163,489
510775,202107,649,1692,406,1290,92,318,76,225,168,543
510776,202107,561,1344,397,1065,74,211,164,424,238,635
510777,202107,1583,4098,1139,3526,139,441,773,2404,912,2845
510779,202107,765,2000,587,1710,58,154,355,1112,413,1266
510780,202107,3866,9762,2873,8330,683,1927,1223,4018,1906,5945
510785,202107,2002,5138,1169,3657,332,1096,180,668,512,1764
510787,202107,2767,7739,1858,5895,518,1717,203,659,721,2376
510788,202107,596,1365,410,1085,65,174,191,580,256,754
510790,202107,18793,47070,12021,35109,2840,9134,1923,5143,4763,14277
510792,202107,9569,25934,5963,18990,1206,4302,1001,2895,2207,7197
510794,202107,1215,3253,865,2666,297,1008,154,413,451,1421
510795,202107,8899,22723,5932,17500,1267,4115,1615,4644,2882,8759
510800,202107,1630,4106,1069,3175,317,965,137,383,454,1348
510805,202107,1540,4195,1094,3396,224,778,430,1227,654,2005
510810,202107,643,1292,418,994,118,283,144,373,262,656
510820,202107,785,1466,442,1040,23,67,245,583,268,650
510830,202107,896,2094,678,1823,33,69,529,1498,562,1567
510835,202107,584,1400,390,1122,46,149,246,683,292,832
510840,202107,59184,123175,40530,100490,7881,18293,19871,54230,27752,72523
510850,202107,1884,4505,1150,3365,369,1253,142,353,511,1606
510860,202107,2402,6135,1509,4670,464,1731,164,478,628,2209
510880,202107,760,2089,578,1762,143,466,191,586,334,1052
510885,202107,660,1535,430,1203,85,245,128,375,213,620
510890,202107,733,2074,551,1756,143,491,238,748,381,1239
510895,202107,1326,3344,872,2593,155,554,387,1077,542,1631
520005,202107,2983,7481,2309,6629,672,1933,888,3033,1560,4966
520010,202107,2433,6725,1753,5421,398,1364,587,1634,985,2998
520013,202107,3221,7928,2100,5922,483,1372,589,1825,1072,3197
520015,202107,517,1269,379,1071,89,245,150,455,239,700
520017,202107,1251,3095,920,2593,222,643,387,1065,609,1708
520020,202107,441,965,337,844,25,78,271,663,296,741
520025,202107,34141,93278,29136,86365,3069,9501,20645,61241,23714,70742
520030,202107,5810,14334,4691,12810,298,852,3455,9391,3753,10243
520050,202107,412,962,248,669,17,45,155,435,172,480
520055,202107,1884,4425,1231,3203,159,344,662,1738,821,2082
520060,202107,1522,3986,1121,3286,253,863,294,827,547,1690
520080,202107,1849,4740,1410,4145,246,732,677,2203,923,2935
520082,202107,958,2376,732,2009,74,213,381,1082,455,1295
520085,202107,935,2343,725,2021,126,377,352,966,478,1343
520090,202107,885,1730,619,1440,83,145,439,1086,522,1231
520110,202107,38346,101297,26566,81657,7504,26369,2624,7365,10128,33734
520120,202107,200,479,115,338,11,34,47,141,58,175
520130,202107,4007,9432,3113,8055,639,1707,1305,3414,1944,5121
520140,202107,42233,110203,29035,87667,9940,32678,3594,11323,13534,44001
520145,202107,619,1383,423,1111,76,220,233,564,309,784
520150,202107,654,1497,483,1289,73,205,253,686,326,891
520160,202107,838,1911,586,1502,109,269,222,618,331,887
520170,202107,4870,9761,3230,7897,184,537,2474,5998,2658,6535
520180,202107,2459,6460,1993,5784,331,1060,1094,3115,1425,4175
520215,202107,1753,4141,1243,3374,283,804,438,1144,721,1948
520235,202107,706,1557,449,1180,46,136,230,592,276,728
520250,202107,1537,3838,1095,3126,326,998,265,855,591,1853
520260,202107,839,1906,534,1431,97,251,208,569,305,820
520280,202107,818,1886,639,1616,117,286,322,866,439,1152
520310,202107,1017,2166,658,1633,144,404,247,652,391,1056
520320,202107,1766,4640,1334,3936,166,501,756,2254,922,2755
520330,202107,4685,11929,3522,10028,523,1717,1778,4934,2301,6651
520340,202107,2535,5458,1561,4133,170,408,923,2552,1093,2960
520350,202107,2772,6526,1979,5363,551,1589,786,2167,1337,3756
520355,202107,1917,5157,1365,4079,441,1397,207,523,648,1920
520357,202107,754,1773,549,1473,40,90,397,1111,437,1201
520360,202107,721,1853,553,1581,137,417,175,517,312,934
520380,202107,1452,3567,882,2542,114,334,389,1061,503,1395
520390,202107,1072,2336,637,1781,190,583,192,578,382,1161
520393,202107,598,1360,390,1034,59,160,164,418,223,578
520396,202107,881,2200,738,1987,36,107,546,1453,582,1560
520400,202107,1642,3944,1262,3430,137,413,896,2414,1033,2827
520410,202107,2153,4603,1404,3495,181,496,745,1742,926,2238
520420,202107,384,866,305,746,21,54,243,568,264,622
520425,202107,1533,3695,846,2383,223,682,148,411,371,1093
520430,202107,2357,5271,1359,3738,233,754,59,157,292,911
520440,202107,2943,7022,1757,4934,420,1292,428,1137,848,2429
520450,202107,12345,28714,8406,22911,2582,7799,1783,5062,4365,12861
520455,202107,719,1942,518,1626,143,464,135,464,278,928
520460,202107,1049,2393,825,2110,77,169,655,1717,732,1886
520465,202107,824,2043,673,1843,60,183,513,1370,573,1553
520470,202107,2132,5293,1617,4614,474,1425,619,1906,1093,3331
520480,202107,895,2419,619,1958,183,597,155,481,338,1078
520485,202107,1563,4433,1286,4045,168,517,873,2739,1041,3256
520490,202107,4079,10959,3060,9346,902,2879,1233,3907,2135,6786
520495,202107,1611,3498,1226,2976,63,152,976,2385,1039,2537
520500,202107,1381,3536,970,2785,184,558,463,1325,647,1883
520505,202107,786,1698,549,1404,61,155,366,940,427,1095
520510,202107,7544,18436,5104,14730,1036,3367,1652,4910,2688,8277
520520,202107,1207,2939,904,2474,201,598,345,938,546,1536
520530,202107,2205,6008,1687,5128,370,1215,799,2478,1169,3693
520540,202107,3019,7750,1977,5744,358,1130,540,1473,898,2603
520545,202107,1091,2729,848,2336,185,454,363,1052,548,1506
520547,202107,932,2428,758,2143,158,466,397,1098,555,1564
520549,202107,14545,37532,12143,34143,1442,4264,8359,23248,9801,27512
520551,202107,4604,12105,3816,10949,402,1313,2706,7620,3108,8933
520552,202107,831,2094,681,1901,147,386,371,1125,518,1511
520570,202107,555,1238,362,936,84,181,129,385,213,566
520580,202107,2272,5017,1693,4345,164,437,1184,3036,1348,3473
520590,202107,1287,3134,883,2474,252,720,263,742,515,1462
520620,202107,8227,21648,6475,19064,1476,4500,3098,9335,4574,13835
520630,202107,789,1998,572,1624,76,238,245,682,321,920
520640,202107,2432,5842,1837,4832,417,1084,783,2145,1200,3229
520650,202107,1018,2220,719,1806,117,301,371,993,488,1294
520660,202107,554,1336,300,884,45,145,86,265,131,410
520670,202107,942,2514,791,2304,60,185,535,1535,595,1720
520680,202107,732,1823,560,1543,94,255,295,825,389,1080
520690,202107,307,706,209,559,65,164,60,174,125,338
520710,202107,414,995,296,804,18,46,197,522,215,568
520725,202107,1481,3459,1011,2687,116,363,639,1644,755,2007
520735,202107,776,1885,512,1441,105,267,207,623,312,890
520740,202107,2369,5134,1813,4481,350,784,973,2692,1323,3476
520750,202107,681,1612,471,1281,77,218,216,572,293,790
520753,202107,1244,3365,941,2780,165,512,373,1032,538,1544
520760,202107,1256,2773,1095,2583,27,50,1001,2400,1028,2450
520780,202107,1530,3540,1101,2937,122,309,568,1527,690,1836
520790,202107,3550,8272,2495,6581,368,979,1309,3588,1677,4567
520800,202107,16873,42699,13204,37294,1792,5181,7955,23095,9747,28276
520810,202107,1319,2731,1002,2373,149,343,654,1669,803,2012
520815,202107,566,1704,424,1404,79,271,118,404,197,675
520830,202107,1905,4006,1346,3363,78,169,1076,2672,1154,2841
520840,202107,2755,7229,2239,6555,849,2770,596,1842,1445,4612
520850,202107,697,1692,515,1428,149,484,161,449,310,933
520860,202107,7092,18641,5210,15503,1315,4233,1922,5568,3237,9801
520870,202107,114645,262451,77786,206683,15880,45389,28869,74942,44749,120331
520880,202107,7287,20502,5580,17398,1178,3845,2061,6418,3239,10263
520890,202107,4281,9905,2956,7856,487,1437,1391,3588,1878,5025
520910,202107,4694,11579,3013,8710,681,2166,750,2078,1431,4244
520915,202107,724,1984,444,1368,86,283,145,418,231,701
520920,202107,4574,10039,3253,8414,462,1215,1627,4495,2089,5710
520929,202107,693,1617,532,1393,51,113,300,839,351,952
520940,202107,975,2534,761,2231,51,117,577,1696,628,1813
520945,202107,521,1120,381,938,14,34,259,628,273,662
520960,202107,1106,2566,864,2214,266,621,377,1045,643,1666
520970,202107,2642,7022,2071,6120,440,1489,547,1751,987,3240
520980,202107,778,1855,571,1579,99,279,236,634,335,913
520990,202107,3044,7898,2446,7146,336,909,1632,4885,1968,5794
520993,202107,1170,2711,807,2143,137,403,427,1093,564,1496
520995,202107,2377,5944,1781,5106,260,772,707,2125,967,2897
521000,202107,8939,23087,5869,17418,1086,3340,1663,4850,2749,8190
521010,202107,3639,9354,2721,7747,266,751,1583,4491,1849,5242
521015,202107,794,1947,553,1518,40,128,353,927,393,1055
521020,202107,3555,8805,2095,6007,560,1788,191,576,751,2364
521030,202107,540,1175,374,924,47,98,208,540,255,638
521040,202107,7718,18565,5697,15405,1231,3429,2289,6456,3520,9885
521056,202107,942,2426,731,2117,244,682,196,651,440,1333
521060,202107,1001,2644,730,2123,142,441,270,775,412,1216
521080,202107,1128,2389,585,1555,83,244,259,613,342,857
521090,202107,3198,8402,2125,6276,515,1670,253,783,768,2453
521100,202107,1823,4110,1347,3441,234,563,813,2134,1047,2697
521120,202107,4696,11055,3481,9533,198,502,1693,5451,1891,5953
521130,202107,1016,2252,582,1529,19,50,295,831,314,881
521140,202107,1403,3548,1040,2906,101,289,560,1556,661,1845
521150,202107,12581,27135,7873,20448,1362,4062,3620,9645,4982,13707
521160,202107,672,1356,467,1070,77,147,281,651,358,798
521170,202107,1057,2441,776,2021,66,186,483,1211,549,1397
521180,202107,7698,20603,6311,18248,1061,3267,3243,9144,4304,12411
521190,202107,10973,26613,6486,19258,1585,5003,1343,4233,2928,9236
521200,202107,712,1681,497,1346,47,132,312,842,359,974
521205,202107,642,1547,489,1306,18,51,379,973,397,1024
521210,202107,719,1831,420,1225,77,237,96,222,173,459
521220,202107,3686,8710,2445,6809,370,1136,1073,2993,1443,4129
521225,202107,397,830,287,707,60,139,164,417,224,556
521230,202107,1376,3417,1205,3207,357,956,600,1741,957,2697
521250,202107,31730,81727,24785,71678,8795,26196,7342,23086,16137,49282
521260,202107,544,1250,406,1041,66,168,226,572,292,740
521270,202107,1860,4501,1624,4225,90,196,1264,3313,1354,3509
521280,202107,1793,4755,1347,4014,311,1002,556,1682,867,2684
521290,202107,522,1167,366,970,45,133,228,589,273,722
521295,202107,1140,2440,894,2178,70,127,752,1886,822,2013
521300,202107,1931,4670,1509,4073,286,720,899,2544,1185,3264
521305,202107,728,1676,525,1390,83,202,304,827,387,1029
521308,202107,4891,12670,3414,9960,299,869,2049,5837,2348,6706
521310,202107,8613,21667,6081,17402,1151,3645,2721,7426,3872,11071
521340,202107,417,958,300,783,23,62,202,526,225,588
521350,202107,2060,5114,1580,4405,139,446,1120,3035,1259,3481
521370,202107,1234,3093,750,2274,212,742,92,310,304,1052
521375,202107,1332,3214,901,2549,196,551,267,858,463,1409
521377,202107,1556,3233,1145,2732,123,203,884,2256,1007,2459
521380,202107,6367,16535,4109,12376,440,1423,1051,3407,1491,4830
521385,202107,681,1602,530,1411,52,125,299,861,351,986
521390,202107,713,1738,497,1418,147,471,158,478,305,949
521400,202107,2807,6362,2244,5699,247,582,1561,4083,1808,4665
521405,202107,1372,3454,983,2776,150,443,516,1438,666,1881
521410,202107,783,2071,586,1736,95,271,293,918,388,1189
521440,202107,1177,2846,865,2387,274,840,262,724,536,1564
521450,202107,3982,11579,2879,9421,774,2500,634,2300,1408,4800
521460,202107,5633,14378,3969,11473,1168,3542,1081,3182,2249,6724
521470,202107,715,1837,459,1352,66,178,172,514,238,692
521480,202107,400,975,248,701,57,148,80,223,137,371
521483,202107,2376,5541,1654,4472,332,940,702,1908,1034,2848
521486,202107,1826,4312,1384,3696,99,221,965,2623,1064,2844
521487,202107,412,971,291,809,44,117,160,463,204,580
521490,202107,930,2430,703,2060,39,138,485,1371,524,1509
521500,202107,2235,5373,1680,4557,97,319,1205,3177,1302,3496
521520,202107,744,1695,537,1401,88,218,230,626,318,844
521523,202107,12257,36175,10064,32734,2649,9283,2912,9718,5561,19001
521525,202107,1086,2435,826,2084,75,199,589,1470,664,1669
521530,202107,2335,5906,1433,4118,301,874,397,1128,698,2002
521540,202107,840,2100,583,1691,82,260,267,801,349,1061
521550,202107,1636,4091,913,2644,166,541,222,656,388,1197
521560,202107,4686,11802,3205,9803,639,1980,1443,4860,2082,6840
521565,202107,677,1579,511,1340,81,199,300,785,381,984
521570,202107,3475,9392,2378,7253,467,1685,155,497,622,2182
521580,202107,504,1197,301,850,42,126,105,273,147,399
521590,202107,675,1531,493,1278,77,216,298,751,375,967
521600,202107,440,1138,287,849,31,75,133,394,164,469
521630,202107,1718,3696,1083,2798,224,623,362,914,586,1537
521640,202107,2054,4674,1338,3620,250,704,468,1257,718,1961
521645,202107,573,1455,370,1088,80,217,117,341,197,558
521680,202107,1154,3370,869,2839,234,853,159,545,393,1398
521690,202107,555,1316,461,1198,62,175,289,744,351,919
521710,202107,3292,8001,2135,6118,360,1169,619,1629,979,2798
521720,202107,2337,5213,1542,4047,239,637,820,2173,1059,2810
521730,202107,3669,9935,2832,8538,751,2663,822,2078,1573,4741
521740,202107,4016,10138,3038,8723,773,2409,951,2827,1724,5236
521760,202107,15330,40505,11912,35372,2715,8816,4562,14561,7277,23377
521770,202107,3169,7355,2092,5668,583,1717,532,1510,1115,3227
521800,202107,6752,17530,4898,14514,1070,3232,1999,6463,3069,9695
521805,202107,813,1699,553,1368,143,338,245,650,388,988
521810,202107,668,1548,484,1301,76,194,286,797,362,991
521830,202107,5590,15140,4447,13389,272,986,3278,9680,3550,10666
521839,202107,822,1924,595,1549,87,259,353,835,440,1094
521850,202107,6127,13750,3861,10421,857,2427,672,1871,1529,4298
521860,202107,1564,4115,1082,3233,176,579,364,1028,540,1607
521870,202107,694,1908,493,1522,97,342,124,332,221,674
521878,202107,713,1790,505,1388,55,175,285,710,340,885
521880,202107,19114,46117,13037,36630,3393,10005,4390,12459,7783,22464
521890,202107,3228,8226,2147,6307,562,1806,458,1210,1020,3016
521900,202107,1498,3466,831,2414,243,687,71,208,314,895
521910,202107,1342,2758,921,2268,107,252,512,1361,619,1613
521920,202107,517,1350,372,1107,60,203,178,510,238,713
521925,202107,783,1980,564,1639,89,279,306,875,395,1154
521930,202107,5570,13116,3666,10261,962,2540,1323,4220,2285,6760
521935,202107,1082,2536,737,1952,71,199,416,1050,487,1249
521940,202107,1341,2846,854,2187,183,529,354,880,537,1409
521945,202107,674,1738,524,1486,99,283,276,807,375,1090
521950,202107,772,1839,533,1468,116,330,228,617,344,947
521960,202107,744,1881,501,1431,49,158,277,741,326,899
521970,202107,2586,6209,2028,5537,169,443,1536,4284,1705,4727
521971,202107,777,1811,550,1459,152,369,137,372,289,741
521973,202107,1517,3825,1256,3477,63,138,1022,2851,1085,2989
521975,202107,12126,31303,9910,28250,1732,4989,6037,17353,7769,22342
521980,202107,2590,5935,1988,5141,152,380,1497,3979,1649,4359
521990,202107,1115,3071,902,2700,186,592,363,1072,549,1664
522000,202107,2759,7034,2171,6305,389,1154,1216,3724,1605,4878
522005,202107,331,780,244,648,50,141,111,293,161,434
522010,202107,4262,10208,3044,8250,590,1736,1215,3196,1805,4932
522015,202107,1066,2713,779,2268,246,688,281,863,527,1551
522020,202107,5625,13060,3647,9979,756,2229,1355,3889,2111,6118
522026,202107,794,2077,530,1612,91,296,176,496,267,792
522028,202107,482,1168,332,916,74,217,111,308,185,525
522040,202107,3433,7461,2484,6197,254,716,1746,4248,2000,4964
522045,202107,17946,48614,13281,40448,3054,9964,3713,11037,6767,21001
522050,202107,1216,3081,834,2414,175,581,305,787,480,1368
522060,202107,2996,7692,2106,6243,212,614,1178,3618,1390,4232
522068,202107,1835,4557,1459,4110,109,267,1168,3344,1277,3611
522070,202107,698,1632,572,1452,12,32,499,1248,511,1280
522100,202107,733,1834,502,1483,71,229,257,725,328,954
522108,202107,1120,2615,880,2283,52,121,714,1825,766,1946
522119,202107,1746,4105,1363,3605,188,511,780,2145,968,2656
522130,202107,434,1080,308,909,31,83,210,648,241,731
522140,202107,20714,52902,14531,41962,3449,10630,4154,11420,7603,22050
522145,202107,803,1947,555,1577,157,436,212,618,369,1054
522150,202107,1109,2647,785,2122,209,569,214,598,423,1167
522155,202107,1098,2720,851,2348,170,405,483,1400,653,1805
522157,202107,657,1463,534,1315,23,62,432,1083,455,1145
522160,202107,6024,15274,3911,11453,1034,3258,330,1065,1364,4323
522170,202107,2624,6599,1964,5632,288,834,1129,3303,1417,4137
522180,202107,584,1361,367,952,60,163,93,258,153,421
522185,202107,20364,48904,14421,40806,5351,16695,3066,9348,8417,26043
522190,202107,771,1781,523,1364,104,265,201,520,305,785
522200,202107,1662,4592,1120,3591,229,798,224,684,453,1482
522205,202107,1769,4086,1321,3468,155,413,779,2054,934,2467
522220,202107,1330,3163,987,2659,122,312,595,1658,717,1970
522230,202107,1257,3070,1019,2735,189,600,548,1427,737,2027
530010,202107,182753,483575,149353,434585,21133,66951,90788,259162,111921,326113
110001,202106,4073,11156,2734,8674,602,2056,1026,3332,1628,5388
110002,202106,13429,34145,9816,28105,2654,8078,2668,7781,5322,15859
110003,202106,610,1799,456,1480,116,391,124,378,240,769
110004,202106,12391,31457,8363,24494,1693,5328,2509,7385,4202,12713
110005,202106,2560,6518,1785,5275,354,1112,482,1550,836,2662
110006,202106,1777,4920,1102,3499,177,623,230,704,407,1327
110007,202106,1309,3294,836,2502,251,797,208,763,459,1560
110008,202106,3480,9197,2595,7906,308,883,1687,5551,1995,6434
110009,202106,4414,12107,2866,9320,590,2062,1138,3730,1728,5792
110010,202106,8139,24851,6015,20813,1179,4078,2940,11140,4119,15218
110011,202106,7297,19019,4930,14779,1626,5195,650,2022,2276,7217
110012,202106,15950,39347,9608,28370,2076,6721,838,2665,2914,9386
110013,202106,5350,15186,3746,11974,1469,5011,419,1499,1888,6510
110014,202106,4036,10388,2773,8015,528,1636,1239,3478,1767,5114
110015,202106,5869,14817,3584,10496,733,2373,928,2452,1661,4825
110018,202106,3871,9613,2263,6810,398,1397,576,1754,974,3151
110020,202106,76220,178888,55231,150524,12298,34611,22263,67429,34561,102040
110025,202106,5362,12741,3615,9786,659,1924,1676,4493,2335,6417
110026,202106,533,1323,383,1104,85,285,154,471,239,756
110028,202106,7246,17940,4439,12964,1026,3308,625,1821,1651,5129
110029,202106,1580,3810,928,2673,191,566,350,1057,541,1623
110030,202106,13034,29571,8041,22196,1683,5380,1304,4011,2987,9391
110032,202106,3354,9235,2036,6471,654,2055,367,1300,1021,3355
110033,202106,3583,10918,2725,9376,953,3293,698,2707,1651,6000
110034,202106,3359,7769,2226,6224,679,2165,713,2178,1392,4343
110037,202106,1670,4841,1245,4085,291,943,565,1927,856,2870
110040,202106,2977,8093,2151,6598,557,1874,690,2044,1247,3918
110045,202106,4992,14092,3651,11641,941,3221,1196,3976,2137,7197
110050,202106,1840,4933,1295,3984,479,1666,221,672,700,2338
110060,202106,912,2659,619,1973,173,597,120,366,293,963
110070,202106,1538,4732,1125,3828,329,1199,242,762,571,1961
110080,202106,6503,14856,4915,12967,815,1983,3073,8745,3888,10728
110090,202106,601,1597,414,1264,78,251,146,442,224,693
110092,202106,1282,3612,896,2883,166,541,428,1498,594,2039
110094,202106,2851,8394,2121,6969,859,3023,234,820,1093,3843
110100,202106,1733,5018,1366,4314,376,1258,541,1755,917,3013
110110,202106,1786,4780,1283,3975,457,1460,247,881,704,2341
110120,202106,1336,3777,1021,3167,222,750,370,1131,592,1881
110130,202106,2898,7109,1694,4827,123,361,183,455,306,816
110140,202106,2147,6185,1489,4853,327,1127,481,1593,808,2720
110143,202106,1376,3729,975,2938,285,861,176,544,461,1405
110145,202106,906,2335,564,1704,125,376,223,706,348,1082
110146,202106,500,1258,358,1040,70,177,177,556,247,733
110147,202106,765,1971,490,1446,62,207,190,483,252,690
110148,202106,767,2103,461,1496,124,468,61,189,185,657
110149,202106,3171,8406,2178,6831,733,2424,473,1596,1206,4020
110150,202106,2835,6835,1824,5373,514,1691,446,1576,960,3267
110155,202106,754,2167,529,1638,116,393,183,523,299,916
110160,202106,1499,4517,1095,3628,299,1023,270,919,569,1942
110170,202106,2162,5459,1360,3982,231,725,723,2044,954,2769
110175,202106,1858,5197,1283,4055,204,668,496,1647,700,2315
110180,202106,1490,3963,1048,3088,139,447,557,1607,696,2054
120001,202106,3402,9747,2779,8827,445,1468,1744,5680,2189,7148
120005,202106,1973,7370,1797,7121,138,594,1448,5842,1586,6436
120010,202106,5468,15850,4646,14648,407,1196,3463,11271,3870,12467
120013,202106,2168,7337,1905,7019,373,1299,1246,4905,1619,6204
120017,202106,2595,8052,2265,7559,374,1254,1408,4993,1782,6247
120020,202106,15650,58258,14417,55931,973,4172,11618,45387,12591,49559
120025,202106,3206,8787,2576,8039,332,1009,1829,5910,2161,6919
120030,202106,6509,25452,6031,24565,402,1941,4682,19317,5084,21258
120032,202106,1810,7782,1726,7631,89,558,1476,6409,1565,6967
120033,202106,4262,15346,4008,14900,100,584,3523,12932,3623,13516
120034,202106,2763,9805,2370,9134,92,535,1991,7574,2083,8109
120035,202106,3879,14780,3675,14428,271,1265,3059,11989,3330,13254
120038,202106,2745,8612,2322,7929,493,1728,1278,4452,1771,6180
120039,202106,2047,8685,1920,8443,105,657,1563,6834,1668,7491
120040,202106,45535,138779,38850,128135,4987,17282,24892,83086,29879,100368
120042,202106,3430,12365,3190,11928,120,633,2731,10111,2851,10744
120043,202106,1481,5885,1352,5689,36,220,1239,5213,1275,5433
120045,202106,6181,15730,5350,14801,129,510,4855,13274,4984,13784
120050,202106,9480,33717,8700,32525,364,1835,7337,27529,7701,29364
120060,202106,9622,37470,8803,36281,342,2140,7691,31472,8033,33612
120070,202106,3303,10267,2860,9675,254,834,2094,7347,2348,8181
120080,202106,4441,13749,3955,13043,451,1499,2928,9906,3379,11405
130002,202106,3299,12217,2952,11697,158,539,2594,10510,2752,11049
130006,202106,2551,9131,2123,8387,188,717,1607,6448,1795,7165
130008,202106,2768,9541,2461,9097,62,310,2152,7964,2214,8274
130010,202106,4034,11576,3394,10854,84,212,3102,10104,3186,10316
130014,202106,3480,9826,2692,8592,445,1428,1665,5427,2110,6855
130020,202106,2986,11276,2667,10790,100,584,2241,9035,2341,9619
130030,202106,10881,33612,9925,32507,342,809,8922,29886,9264,30695
130040,202106,4335,12309,3583,11315,316,845,2835,9234,3151,10079
130050,202106,7754,27850,6488,26202,179,808,5875,24045,6054,24853
130060,202106,7888,30324,6761,28887,393,2039,5681,24305,6074,26344
130063,202106,6616,21314,5908,20538,192,821,5391,18832,5583,19653
130068,202106,3987,13397,3370,12545,186,1014,2605,9585,2791,10599
130070,202106,7897,21491,6501,19976,310,791,5366,17181,5676,17972
130080,202106,7488,26163,6570,25117,239,1219,5659,22047,5898,23266
130083,202106,2850,9074,2539,8694,151,567,2119,7411,2270,7978
130090,202106,3620,11056,3215,10565,47,199,2885,9677,2932,9876
130100,202106,8238,24444,6989,23147,105,183,6547,22339,6652,22522
130110,202106,8664,24356,7103,22440,1055,2658,5070,17422,6125,20080
130115,202106,5264,16361,4527,15530,105,340,4024,14044,4129,14384
130120,202106,14234,49850,12527,47606,1053,4336,10169,39141,11222,43477
130130,202106,5752,17434,4408,15653,399,1417,3173,11464,3572,12881
130140,202106,7423,25485,6506,24436,187,1016,5712,21583,5899,22599
130150,202106,3778,13862,3554,13612,65,407,3292,12646,3357,13053
130160,202106,5406,18586,4654,17636,290,1016,3951,15428,4241,16444
130165,202106,3310,12290,3105,12045,121,511,2807,11004,2928,11515
130170,202106,11839,33871,9567,31243,724,2484,7721,25792,8445,28276
130180,202106,4560,14633,4331,14376,42,196,4182,13871,4224,14067
130185,202106,19076,46082,15610,42381,1152,1942,12879,37522,14031,39464
130190,202106,19361,62643,15596,57120,1587,5649,11281,42964,12868,48613
130195,202106,2539,8980,2048,8316,79,369,1711,6969,1790,7338
130200,202106,2761,7452,2253,6802,86,303,1932,5818,2018,6121
130210,202106,1388,5129,1254,4972,98,561,1029,3959,1127,4520
130220,202106,2335,7862,1990,7435,57,264,1753,6645,1810,6909
130230,202106,4995,19629,4353,18732,197,1188,3818,16409,4015,17597
130240,202106,12787,37463,10423,34394,149,833,9455,31252,9604,32085
130250,202106,26855,78858,23044,74581,1564,4377,18784,63262,20348,67639
130255,202106,4770,15355,4147,14280,129,531,3411,11788,3540,12319
130260,202106,262568,715668,213723,647122,57793,184431,97165,308414,154958,492845
130270,202106,10066,34574,8358,31939,1430,5251,5317,21469,6747,26720
130280,202106,3647,14362,3360,14041,79,394,3146,13292,3225,13686
130290,202106,14035,44969,12253,42738,647,2250,10485,37383,11132,39633
130300,202106,5003,16694,4522,16052,142,748,3975,14105,4117,14853
130310,202106,6605,21361,5720,20241,265,1139,4938,17499,5203,18638
130320,202106,3501,11266,2911,10495,371,1280,2145,8041,2516,9321
130330,202106,4777,14962,3852,13859,212,888,3284,11878,3496,12766
130340,202106,24698,73674,21297,69832,1471,3768,17964,61122,19435,64890
130350,202106,4098,14541,3695,14036,145,718,3263,12367,3408,13085
130353,202106,7599,20110,6099,18229,768,2150,4393,13687,5161,15837
130356,202106,5435,16807,4504,15379,818,2677,2686,9832,3504,12509
130360,202106,3050,9923,2649,9374,82,340,2366,8367,2448,8707
130370,202106,5859,23065,5063,21955,316,1704,4046,17621,4362,19325
130380,202106,7433,30599,6913,29857,384,2118,5901,25338,6285,27456
130390,202106,6188,25199,5519,24104,544,2561,4345,19161,4889,21722
130395,202106,2466,7668,2128,7139,185,592,1674,5698,1859,6290
130400,202106,2868,8633,2462,8104,90,243,2213,7440,2303,7683
130406,202106,11155,37897,9329,35694,1758,6575,6154,24796,7912,31371
130410,202106,4556,15541,3905,14466,1110,4276,1812,6961,2922,11237
130420,202106,14369,48615,11973,45635,957,4269,9281,35855,10238,40124
130423,202106,4570,13869,4005,13226,192,734,3525,11590,3717,12324
130426,202106,2789,11071,2593,10841,59,321,2405,10137,2464,10458
130430,202106,4431,12170,3827,11383,203,667,3319,9820,3522,10487
130440,202106,5184,15724,4373,14753,76,327,4075,13813,4151,14140
140002,202106,2357,6792,2058,6433,101,351,1713,5467,1814,5818
140005,202106,3356,9260,2921,8757,133,335,2489,7705,2622,8040
140010,202106,56014,147361,44957,131062,11005,33964,18830,56439,29835,90403
140015,202106,3930,11422,3344,10712,218,653,2907,9523,3125,10176
140017,202106,4564,12374,3962,11611,277,702,3244,9860,3521,10562
140020,202106,5356,15244,4625,14302,252,969,3808,11714,4060,12683
140023,202106,2560,7471,2100,6820,198,644,1606,5336,1804,5980
140028,202106,2000,5116,1694,4734,77,245,1374,3845,1451,4090
140030,202106,5517,13808,4914,13115,327,602,4330,11951,4657,12553
140040,202106,2718,10298,2514,10031,83,509,2312,9087,2395,9596
140045,202106,2649,9676,2206,9062,382,1323,1413,6408,1795,7731
140047,202106,6424,17919,5370,16422,575,1785,3878,12069,4453,13854
140050,202106,1457,4215,1234,3902,117,339,933,3070,1050,3409
140060,202106,1761,4502,1534,4183,112,283,1261,3512,1373,3795
140070,202106,1926,9905,1862,9779,109,775,1592,8256,1701,9031
150010,202106,45820,114031,41362,108308,990,2185,37087,97308,38077,99493
150013,202106,2044,5075,1709,4713,146,266,1357,4002,1503,4268
150020,202106,14583,43201,13468,41760,1835,4696,10489,34067,12324,38763
150030,202106,8893,33120,8085,32139,498,1953,6995,28252,7493,30205
150034,202106,4434,10460,3650,9507,247,555,3041,8117,3288,8672
150040,202106,16489,42326,14519,40146,1257,1850,12196,36661,13453,38511
150050,202106,7225,24452,6605,23642,124,525,6102,22061,6226,22586
150060,202106,22591,60230,18198,53762,2673,8024,11877,35874,14550,43898
150070,202106,7167,25920,6300,24884,239,1044,5655,22588,5894,23632
150080,202106,94130,209218,77650,186714,19730,52102,20038,59620,39768,111722
150085,202106,8216,23053,7482,22194,115,342,7022,21002,7137,21344
150090,202106,10313,36387,9735,35284,777,2635,7881,28975,8658,31610
150095,202106,5978,16625,5239,15725,272,521,4538,14163,4810,14684
150100,202106,2907,9976,2567,9420,213,658,2021,7655,2234,8313
150110,202106,4441,17926,4127,17573,173,772,3808,16352,3981,17124
150120,202106,8249,25301,7823,24810,272,668,6965,22745,7237,23413
150125,202106,802,2020,585,1729,99,355,357,1034,456,1389
150130,202106,23295,65470,20075,60615,3912,10489,12230,40028,16142,50517
150140,202106,272931,611603,230296,553785,34620,79016,132638,332315,167258,411331
150145,202106,4372,13440,3686,12352,1049,3264,1711,6562,2760,9826
150150,202106,17065,42300,14877,39570,685,1876,12386,32940,13071,34816
150157,202106,3650,9720,2924,8784,316,891,2044,6468,2360,7359
150160,202106,3206,8935,2984,8616,482,1250,1958,5876,2440,7126
150170,202106,25399,80199,22274,75007,4001,12543,13633,49193,17634,61736
150172,202106,5205,13821,4176,12393,293,712,3133,9697,3426,10409
150175,202106,1698,5199,1421,4688,239,824,842,2809,1081,3633
150178,202106,10682,28131,8857,26028,259,542,7876,23622,8135,24164
150180,202106,23170,79451,20933,76914,1302,3485,18300,69548,19602,73033
150190,202106,6992,22442,6492,21839,184,745,5903,19829,6087,20574
150195,202106,5375,16577,5049,16077,203,684,4506,14337,4709,15021
150200,202106,5948,17237,5435,16671,58,152,5138,15870,5196,16022
150210,202106,27224,91608,25491,89395,1547,4904,21285,77284,22832,82188
150215,202106,8720,23996,7581,22305,1269,3647,4543,13857,5812,17504
150220,202106,12972,35526,11329,33199,1117,2974,7841,23647,8958,26621
150230,202106,13011,36012,11537,34043,1280,3326,7896,24455,9176,27781
150240,202106,33746,91095,28118,81720,7025,20952,10415,30547,17440,51499
150250,202106,4331,16130,4032,15798,591,2256,3157,12681,3748,14937
150260,202106,2784,8773,2506,8364,126,389,2054,6950,2180,7339
150270,202106,9288,25787,6555,20907,2040,6856,1529,5269,3569,12125
150275,202106,7089,21932,6455,21045,229,784,5580,18195,5809,18979
150276,202106,2425,6291,2089,5888,256,629,1397,4435,1653,5064
150277,202106,5308,13560,4233,12307,357,953,3149,9813,3506,10766
150280,202106,7122,27888,6869,27485,395,1505,5986,24230,6381,25735
150285,202106,3299,11458,2899,10830,259,931,2116,8145,2375,9076
150290,202106,10481,28096,9455,27002,318,603,8528,25038,8846,25641
150293,202106,9613,23172,7467,20396,1040,2745,4616,13329,5656,16074
150295,202106,7784,20587,5636,17638,1801,5974,1894,6915,3695,12889
150300,202106,2420,7072,2189,6787,32,109,2025,6313,2057,6422
150304,202106,4365,12505,3616,11366,614,1746,2266,7602,2880,9348
150307,202106,6172,19435,5677,18620,284,947,4611,15243,4895,16190
150309,202106,6531,18847,5260,16711,858,2684,3031,10089,3889,12773
150310,202106,7501,29380,7167,28989,191,1001,6432,26283,6623,27284
150320,202106,9399,25405,8586,24228,362,1071,6731,18972,7093,20043
150330,202106,14031,44058,12972,42445,1202,3548,9795,33342,10997,36890
150340,202106,2597,7494,2305,7060,347,992,1585,5030,1932,6022
150345,202106,8663,24209,7790,23058,417,1273,6732,19975,7149,21248
150350,202106,9150,22647,8383,21654,650,1147,6957,18500,7607,19647
150360,202106,24569,65932,19649,59797,2173,4885,13800,45459,15973,50344
150370,202106,11305,33256,9298,30544,1059,2827,6722,23969,7781,26796
150375,202106,3759,14920,3409,14432,197,927,2967,12692,3164,13619
150380,202106,11523,28721,9512,26100,106,397,8479,23226,8585,23623
150390,202106,7857,31047,7043,29800,1079,3884,5026,22716,6105,26600
150400,202106,6814,23822,6532,23304,222,749,5795,20795,6017,21544
150405,202106,9386,24220,8193,22800,498,999,6654,19179,7152,20178
150410,202106,2007,6085,1711,5589,265,692,1070,3719,1335,4411
150420,202106,40621,109869,31234,96253,8417,27099,11018,39684,19435,66783
150430,202106,8725,24606,7934,23592,911,1858,6192,19453,7103,21311
150440,202106,5924,18069,5365,17313,954,2687,3529,12184,4483,14871
150442,202106,27846,63712,23080,57914,2417,5741,16141,41399,18558,47140
150445,202106,6557,19582,5754,18389,203,629,4983,16007,5186,16636
150450,202106,5364,22106,4960,21572,377,1808,4203,18337,4580,20145
150460,202106,8511,27642,7763,26689,225,838,6713,23896,6938,24734
150470,202106,21438,55423,19125,52804,329,940,18043,49820,18372,50760
150475,202106,5215,15784,4473,14695,533,1548,3312,11295,3845,12843
150480,202106,14087,43787,12633,41673,2296,6428,8440,30061,10736,36489
150490,202106,8524,29267,7795,28364,337,1209,6774,24918,7111,26127
150495,202106,5473,18069,5224,17733,94,438,4787,16180,4881,16618
150497,202106,2853,8920,2298,7974,495,1747,1220,4553,1715,6300
150500,202106,3392,8473,3015,7945,279,676,2291,6039,2570,6715
150503,202106,4999,12560,3422,10524,968,3192,1085,3849,2053,7041
150506,202106,10815,31100,9047,28709,1899,5299,5583,19763,7482,25062
150510,202106,9953,35590,8645,33222,1380,4873,5528,22636,6908,27509
150520,202106,7552,28552,7240,28168,165,955,6616,25658,6781,26613
150530,202106,12379,41636,10696,39267,1316,3828,7864,30743,9180,34571
150540,202106,5082,13464,4353,12377,280,733,3608,10297,3888,11030
150543,202106,7229,19222,5921,17600,443,1278,4619,14378,5062,15656
150548,202106,10311,31824,9263,30385,225,871,8254,27190,8479,28061
150549,202106,2020,5792,1724,5375,44,142,1452,4574,1496,4716
150550,202106,21343,61155,17720,55283,4569,14327,7206,24185,11775,38512
150553,202106,32906,90459,26117,78758,7482,22627,10114,31997,17596,54624
150555,202106,2058,5336,1611,4632,185,406,1084,3321,1269,3727
150560,202106,1970,5741,1752,5329,308,860,1011,3231,1319,4091
150563,202106,2685,7815,2223,7030,430,1385,1247,4023,1677,5408
150565,202106,4581,14276,4086,13512,93,389,3435,11450,3528,11839
150570,202106,6582,20034,6140,19433,363,1023,5255,16854,5618,17877
150580,202106,10633,41027,9073,39295,542,2732,7300,33114,7842,35846
150590,202106,8443,28515,7233,27074,145,840,6642,24805,6787,25645
150600,202106,9765,31885,9091,31083,207,794,8459,29092,8666,29886
150610,202106,2951,8413,2637,7927,89,327,2250,6707,2339,7034
150611,202106,3375,9042,3011,8552,97,298,2673,7573,2770,7871
150613,202106,13992,37427,10589,31765,1884,5956,5344,15976,7228,21932
150616,202106,3650,9870,2655,8205,580,1854,1158,3590,1738,5444
150618,202106,7116,20039,5798,18041,544,1628,3699,12159,4243,13787
150619,202106,6897,18578,5700,16942,247,596,4797,14530,5044,15126
150620,202106,6904,22540,5947,20951,652,2132,4024,14681,4676,16813
150630,202106,6624,17119,6054,16425,295,747,5279,14370,5574,15117
150635,202106,5034,13511,4227,12230,583,1537,2747,8192,3330,9729
150640,202106,2294,6692,2097,6447,39,100,1957,6093,1996,6193
150650,202106,11699,31557,10132,29110,2856,7780,4455,14087,7311,21867
150655,202106,5764,16401,5217,15608,194,585,4536,13592,4730,14177
150658,202106,4602,12856,3567,11231,648,2116,1919,6381,2567,8497
150660,202106,5886,16366,5218,15450,577,1586,3589,10908,4166,12494
150670,202106,9163,20313,7292,18196,687,1278,5869,15459,6556,16737
150680,202106,71320,203604,55122,178229,13168,41311,24037,88805,37205,130116
150690,202106,2846,6851,2446,6398,85,171,2171,5823,2256,5994
150700,202106,6171,17932,5503,17074,371,877,4351,13999,4722,14876
150710,202106,3834,12584,3478,12025,294,954,2626,9314,2920,10268
150715,202106,5126,14271,4196,12868,285,778,3327,10420,3612,11198
150720,202106,6982,24122,6495,23399,433,1533,5403,19837,5836,21370
150730,202106,12590,37130,10788,34554,1179,3866,8081,26600,9260,30466
150740,202106,4128,11183,3610,10380,313,745,2729,8056,3042,8801
150745,202106,5146,14253,4135,12783,660,2100,2806,8862,3466,10962
150746,202106,1787,5095,1618,4862,71,169,1361,4157,1432,4326
150747,202106,5129,15462,4538,14544,681,1817,3126,10626,3807,12443
150750,202106,3816,11641,3200,10699,221,771,2449,8444,2670,9215
150760,202106,11905,34664,10787,33108,1525,4161,7513,24022,9038,28183
150770,202106,6705,23263,6274,22783,208,522,5700,21428,5908,21950
150775,202106,1023,2716,805,2440,124,401,482,1475,606,1876
150780,202106,4540,13697,4026,13090,152,407,3619,12103,3771,12510
150790,202106,6086,16495,5238,15582,294,705,3854,13235,4148,13940
150795,202106,14815,43885,12865,40941,2954,8775,7377,25087,10331,33862
150796,202106,4006,9438,3490,8849,237,481,2927,7618,3164,8099
150797,202106,4228,12509,3659,11731,166,369,3094,10205,3260,10574
150800,202106,13647,41973,12266,40155,1546,4665,9032,30793,10578,35458
150803,202106,7548,22866,7044,22103,443,1109,5992,19171,6435,20280
150805,202106,3644,10838,3095,10058,272,819,2336,7824,2608,8643
150808,202106,6206,17397,4581,14740,1699,6017,689,2589,2388,8606
150810,202106,21316,54428,16198,48300,3235,9811,8199,27461,11434,37272
150812,202106,5736,15492,5055,14398,425,1284,3835,10727,4260,12011
150815,202106,9999,28394,8355,26467,658,1967,6904,22331,7562,24298
150820,202106,12041,32323,10211,30067,1172,2789,7629,23889,8801,26678
150830,202106,12422,43690,11492,42563,478,1746,9832,37898,10310,39644
150835,202106,2607,8087,2243,7505,325,1084,1437,4846,1762,5930
150840,202106,7907,21593,6380,19205,1003,3277,3691,10994,4694,14271
160005,202106,1238,3299,1095,3121,66,215,924,2650,990,2865
160010,202106,2464,6482,2296,6300,19,98,2226,6044,2245,6142
160015,202106,2900,8156,2566,7754,71,220,2366,7190,2437,7410
160020,202106,2147,6624,1874,6287,160,465,1449,5111,1609,5576
160021,202106,1265,4575,1167,4453,55,281,930,3616,985,3897
160023,202106,1367,4585,1208,4316,148,481,818,3124,966,3605
160025,202106,1855,5545,1745,5421,13,42,1689,5260,1702,5302
160027,202106,8925,24700,7956,23464,694,1892,6306,19056,7000,20948
160030,202106,78608,215895,63760,195888,13371,38427,33513,114350,46884,152777
160040,202106,5966,19666,5446,19016,70,295,5119,17997,5189,18292
160050,202106,4974,14493,3889,13063,1453,4679,1357,5774,2810,10453
160053,202106,3997,11899,3605,11416,299,796,2893,9594,3192,10390
160055,202106,961,2729,927,2691,28,85,853,2495,881,2580
160060,202106,26692,66960,21793,61445,1309,3400,16892,50601,18201,54001
160070,202106,2652,9956,2367,9520,192,743,1863,7784,2055,8527
160080,202106,3397,10542,3003,10101,24,128,2829,9576,2853,9704
170025,202106,663,1691,485,1425,82,227,250,795,332,1022
170030,202106,1295,3783,1006,3290,160,478,462,1582,622,2060
170035,202106,1498,3806,1100,3187,78,238,714,2066,792,2304
170040,202106,1963,5343,1557,4765,106,344,992,3111,1098,3455
170070,202106,1957,4501,1401,3796,92,279,830,2362,922,2641
170100,202106,2491,7010,2069,6321,246,651,1270,4048,1516,4699
170105,202106,736,2076,511,1600,149,433,151,496,300,929
170110,202106,1005,2932,780,2522,105,357,421,1323,526,1680
170130,202106,1321,3805,963,3132,170,582,486,1594,656,2176
170190,202106,1462,3978,1082,3379,304,1043,301,1020,605,2063
170200,202106,2118,4934,1398,3776,211,569,564,1536,775,2105
170210,202106,25889,68722,19663,58428,6062,19723,2936,9527,8998,29250
170215,202106,1352,3545,1082,3175,43,175,866,2532,909,2707
170220,202106,6000,18166,5005,16382,1384,4349,1814,6736,3198,11085
170230,202106,1263,3616,933,2976,264,861,158,550,422,1411
170240,202106,2659,7245,2120,6383,141,454,1543,4571,1684,5025
170255,202106,4052,11428,2940,9466,607,1910,1247,4182,1854,6092
170270,202106,958,2293,649,1846,55,149,375,1062,430,1211
170290,202106,2928,8479,2545,7976,144,410,1981,6437,2125,6847
170300,202106,2100,5499,1702,4906,195,504,1154,3424,1349,3928
170305,202106,675,1798,570,1632,82,231,283,841,365,1072
170307,202106,991,3216,809,2876,97,349,471,1697,568,2046
170310,202106,1619,3974,1156,3254,170,513,553,1582,723,2095
170320,202106,1067,2733,801,2308,79,227,503,1494,582,1721
170330,202106,932,2790,844,2664,41,170,701,2158,742,2328
170360,202106,555,1459,391,1198,21,74,260,755,281,829
170370,202106,1281,3344,926,2757,258,740,271,894,529,1634
170380,202106,1843,5172,1393,4487,85,289,827,2758,912,3047
170382,202106,560,1624,469,1474,29,124,351,1059,380,1183
170384,202106,1653,5618,1358,5067,279,1012,689,2697,968,3709
170386,202106,1020,2736,638,2008,74,269,237,710,311,979
170388,202106,626,1741,445,1433,64,223,207,669,271,892
170389,202106,1069,3228,873,2903,53,193,628,2145,681,2338
170390,202106,1800,4017,1356,3488,33,73,1138,3003,1171,3076
170410,202106,595,1645,439,1370,21,83,290,869,311,952
170460,202106,379,993,313,891,39,113,210,609,249,722
170510,202106,965,2645,708,2200,43,157,455,1325,498,1482
170550,202106,6632,17308,4890,14528,1320,4208,1031,3327,2351,7535
170555,202106,1439,3780,1135,3313,84,239,550,1700,634,1939
170560,202106,1058,2880,808,2537,76,214,508,1714,584,1928
170600,202106,1312,3482,1062,3130,277,695,486,1613,763,2308
170610,202106,1636,4235,1187,3565,85,263,740,2209,825,2472
170625,202106,437,1148,295,870,39,103,116,334,155,437
170650,202106,1260,3659,1002,3233,114,383,613,2022,727,2405
170700,202106,3444,10003,2604,8392,515,1658,1149,3764,1664,5422
170710,202106,1506,3861,1175,3350,168,476,710,2068,878,2544
170720,202106,1776,4401,1353,3718,330,900,619,1764,949,2664
170730,202106,1114,2935,837,2482,127,303,448,1418,575,1721
170740,202106,2145,6893,1850,6365,165,627,1324,4536,1489,5163
170755,202106,906,2431,642,1990,89,280,265,832,354,1112
170765,202106,1169,2994,824,2444,150,436,348,1093,498,1529
170770,202106,1924,5345,1557,4784,149,470,1062,3286,1211,3756
170820,202106,3391,10045,2655,8710,533,1776,1205,4140,1738,5916
170825,202106,1039,2372,851,2127,100,225,614,1558,714,1783
170830,202106,1410,3688,1149,3283,226,593,688,2061,914,2654
170900,202106,2817,8623,2374,7986,219,632,1854,6415,2073,7047
170930,202106,3800,10291,2899,8617,666,2096,910,2730,1576,4826
170950,202106,11384,31014,7963,24885,2127,7610,863,2942,2990,10552
170980,202106,477,1237,370,1063,32,100,242,675,274,775
171050,202106,1673,5132,1455,4764,52,221,1210,3942,1262,4163
171070,202106,1373,3826,1180,3545,319,894,512,1840,831,2734
171090,202106,1092,2677,860,2355,91,261,541,1454,632,1715
171110,202106,585,1540,411,1223,79,219,180,506,259,725
171150,202106,1087,2652,687,1978,69,227,426,1214,495,1441
171180,202106,796,2116,529,1615,102,284,225,693,327,977
171190,202106,1888,6086,1642,5666,254,908,1018,3631,1272,4539
171195,202106,812,2517,651,2218,73,283,405,1358,478,1641
171200,202106,621,1679,467,1428,107,349,163,492,270,841
171215,202106,391,1061,325,954,30,98,216,607,246,705
171240,202106,814,2589,647,2289,28,153,442,1532,470,1685
171245,202106,744,2101,583,1789,49,163,376,1113,425,1276
171250,202106,1016,2693,747,2289,133,431,346,1081,479,1512
171270,202106,503,1715,394,1485,91,350,163,657,254,1007
171280,202106,897,2626,721,2310,70,240,443,1459,513,1699
171320,202106,4098,11271,3204,9714,653,1862,1193,3878,1846,5740
171330,202106,2822,7673,2188,6552,512,1532,921,2887,1433,4419
171360,202106,1456,4091,1160,3660,91,281,824,2704,915,2985
171370,202106,720,1787,553,1553,44,118,385,1097,429,1215
171380,202106,1500,3962,1261,3637,155,425,840,2569,995,2994
171395,202106,1019,2698,709,2141,60,201,454,1330,514,1531
171420,202106,2021,5766,1471,4683,261,826,647,2129,908,2955
171430,202106,1076,3086,909,2778,51,157,638,1888,689,2045
171488,202106,2408,6900,1918,6102,314,1017,987,3208,1301,4225
171500,202106,994,2445,751,2077,70,170,512,1443,582,1613
171510,202106,847,2652,734,2442,42,164,538,1773,580,1937
171515,202106,492,1217,373,1048,39,116,225,598,264,714
171525,202106,756,2027,572,1742,36,116,354,1051,390,1167
171550,202106,358,1004,275,875,39,145,148,447,187,592
171570,202106,1147,3392,974,3096,132,403,576,1908,708,2311
171575,202106,1780,4738,1156,3627,134,436,506,1597,640,2033
171610,202106,5867,16036,4365,13485,885,3084,1111,3753,1996,6837
171620,202106,2645,7363,2247,6789,103,413,1852,5556,1955,5969
171630,202106,1054,2638,816,2318,85,232,572,1678,657,1910
171650,202106,2106,5837,1630,5054,398,1332,473,1643,871,2975
171660,202106,2412,5995,1672,4774,215,548,943,2740,1158,3288
171665,202106,1259,3486,994,3055,183,624,476,1464,659,2088
171670,202106,1955,5141,1495,4381,223,683,754,2253,977,2936
171700,202106,1228,3394,898,2793,106,311,490,1542,596,1853
171720,202106,806,2028,637,1773,57,164,465,1283,522,1447
171750,202106,1352,3720,933,2936,217,715,129,505,346,1220
171780,202106,1237,3106,914,2643,83,256,635,1811,718,2067
171790,202106,1435,4528,1174,4005,176,598,577,1994,753,2592
171800,202106,736,1950,563,1703,64,222,326,973,390,1195
171820,202106,11719,32237,8718,27138,2091,6774,2371,8077,4462,14851
171830,202106,1604,4978,1371,4577,129,495,884,2971,1013,3466
171840,202106,784,2054,607,1780,21,62,393,1163,414,1225
171845,202106,668,1602,508,1370,47,169,329,851,376,1020
171850,202106,923,2973,790,2681,69,274,552,1841,621,2115
171855,202106,1082,3241,923,2947,56,162,603,1893,659,2055
171865,202106,434,1287,365,1180,59,194,196,603,255,797
171870,202106,841,2261,591,1813,74,211,300,942,374,1153
171875,202106,1333,3743,1071,3334,35,148,817,2520,852,2668
171880,202106,1239,3591,1089,3396,41,112,867,2775,908,2887
171884,202106,920,2586,685,2178,142,488,244,800,386,1288
171886,202106,1426,3772,1038,3162,280,972,224,696,504,1668
171888,202106,724,1999,502,1592,27,106,314,960,341,1066
171889,202106,398,1182,301,1002,67,247,115,370,182,617
171890,202106,1209,3330,881,2806,161,484,494,1591,655,2075
171900,202106,561,1874,426,1565,77,243,178,692,255,935
172000,202106,603,1732,503,1561,63,186,273,837,336,1023
172010,202106,1011,3409,873,3144,74,287,546,1976,620,2263
172015,202106,383,1288,290,1103,51,183,121,480,172,663
172020,202106,2852,7785,2504,7335,158,473,1842,5653,2000,6126
172025,202106,715,1944,537,1658,41,140,386,1198,427,1338
172030,202106,1273,3689,1074,3364,64,191,809,2539,873,2730
172049,202106,1345,3169,904,2563,187,476,436,1377,623,1853
172065,202106,1452,3631,1148,3248,100,209,906,2758,1006,2967
172080,202106,2395,6963,1946,6180,116,372,1300,4133,1416,4505
172085,202106,485,1303,313,945,59,173,109,311,168,484
172090,202106,4125,10092,3221,8903,134,347,2470,6946,2604,7293
172093,202106,480,1407,346,1166,20,96,204,654,224,750
172097,202106,696,1783,483,1418,65,192,210,609,275,801
172100,202106,50326,121974,36370,100397,6081,18303,13761,38723,19842,57026
172110,202106,1636,5808,1411,5459,112,455,1065,4254,1177,4709
172120,202106,5196,14968,4077,13142,514,1702,2251,7489,2765,9191
172125,202106,399,1061,306,914,24,79,186,534,210,613
172130,202106,634,1533,497,1312,20,73,356,865,376,938
172208,202106,2652,6272,2123,5590,239,466,1495,4122,1734,4588
172210,202106,2734,6777,2103,5977,288,875,1244,3723,1532,4598
210005,202106,19250,53888,14492,46107,4040,13317,5570,18611,9610,31928
210010,202106,1953,5957,1767,5735,74,289,1547,5047,1621,5336
210015,202106,3337,9838,2953,9342,153,458,2454,7819,2607,8277
210020,202106,7389,17333,6308,16078,90,264,5804,14855,5894,15119
210030,202106,4660,15301,4295,14752,305,1096,3564,12373,3869,13469
210040,202106,1937,4432,1722,4167,51,115,1474,3492,1525,3607
210043,202106,6071,17241,5174,15975,383,1150,4082,12803,4465,13953
210047,202106,6598,20238,5409,18671,128,639,4698,16228,4826,16867
210050,202106,2224,7364,1774,6536,195,748,1200,4501,1395,5249
210055,202106,1900,5993,1726,5728,56,200,1480,4946,1536,5146
210060,202106,7460,27149,6666,25767,719,2687,4586,18407,5305,21094
210070,202106,7135,19973,6667,19343,41,173,6321,18300,6362,18473
210080,202106,4321,14308,4105,14075,37,213,3794,13099,3831,13312
210083,202106,5703,15966,4750,14947,92,273,4440,14127,4532,14400
210087,202106,3013,8127,2587,7563,105,271,2154,6364,2259,6635
210090,202106,9143,28378,8545,27340,546,1346,7211,23424,7757,24770
210095,202106,6636,20996,6068,20280,292,1047,5068,17420,5360,18467
210100,202106,6762,20604,6010,19378,478,1546,4542,14808,5020,16354
210110,202106,2930,9254,2698,8974,55,290,2432,8065,2487,8355
210120,202106,23523,62636,19480,57431,1962,4481,13226,41881,15188,46362
210125,202106,4452,11894,3863,11196,777,1814,2619,8197,3396,10011
210130,202106,4366,11181,3624,10265,159,323,3072,8816,3231,9139
210135,202106,1578,4375,1333,3998,76,163,1084,3345,1160,3508
210140,202106,19879,50952,15356,45149,3017,8183,8392,26529,11409,34712
210150,202106,4393,10440,3919,9795,152,323,3330,8264,3482,8587
210160,202106,17062,48547,14708,45614,1313,4056,10435,33849,11748,37905
210170,202106,15621,47167,14525,45778,886,2197,12609,40494,13495,42691
210173,202106,2291,8710,2146,8458,100,570,1845,7208,1945,7778
210177,202106,3500,9574,3042,9010,217,514,2546,7865,2763,8379
210180,202106,1448,3819,1259,3591,24,63,1145,3274,1169,3337
210190,202106,5459,14369,4615,13241,82,291,3976,11307,4058,11598
210193,202106,1367,3903,1195,3628,36,112,884,2746,920,2858
210197,202106,2136,6477,1965,6248,153,442,1612,5254,1765,5696
210200,202106,7853,24826,6985,23404,401,1444,5562,18662,5963,20106
210203,202106,7102,20799,6046,19387,350,1137,4867,15944,5217,17081
210207,202106,4000,9575,3080,8576,160,315,2559,7333,2719,7648
210210,202106,8052,25723,7343,24729,138,776,6311,21101,6449,21877
210215,202106,2537,7909,2178,7377,115,549,1638,5482,1753,6031
210220,202106,6188,21161,5879,20712,141,932,5206,17997,5347,18929
210230,202106,5249,15575,4776,14867,515,1277,3865,12460,4380,13737
210232,202106,11383,34974,9348,31873,1720,5686,5600,20630,7320,26316
210235,202106,3391,10186,2993,9615,156,581,2507,8083,2663,8664
210237,202106,3072,9541,2641,9029,24,130,2462,8427,2486,8557
210240,202106,2624,8071,2417,7723,70,229,2021,6370,2091,6599
210250,202106,5920,17501,5394,16841,62,342,4967,15476,5029,15818
210255,202106,2614,7834,2233,7182,256,813,1498,4806,1754,5619
210260,202106,5507,16221,4854,15275,258,849,4105,12956,4363,13805
210270,202106,5052,13668,4512,12986,84,350,4052,11584,4136,11934
210275,202106,3480,8817,3032,8262,95,250,2505,6836,2600,7086
210280,202106,5740,15925,4625,14244,244,886,3488,10614,3732,11500
210290,202106,7523,19435,6744,18468,105,299,6315,17325,6420,17624
210300,202106,32582,88665,26640,80132,2530,7891,17801,55999,20331,63890
210310,202106,3145,7872,2780,7342,121,255,2436,6508,2557,6763
210312,202106,2796,6849,2489,6521,20,76,2371,6180,2391,6256
210315,202106,3046,8346,2630,7881,87,226,2323,7135,2410,7361
210317,202106,4148,12943,3758,12484,100,497,3374,11152,3474,11649
210320,202106,19321,57017,17673,54867,358,1531,15747,48743,16105,50274
210325,202106,3706,10331,3177,9647,111,311,2747,8589,2858,8900
210330,202106,24317,67338,19489,61227,5279,14759,9915,35797,15194,50556
210340,202106,10335,29533,9205,28038,722,2052,7094,22263,7816,24315
210350,202106,9132,26063,8041,24744,131,437,7211,22304,7342,22741
210355,202106,4283,13978,3793,13214,97,449,3223,11305,3320,11754
210360,202106,14067,42880,12535,40656,528,2260,9573,30533,10101,32793
210370,202106,11065,24508,8562,21874,251,407,7823,20479,8074,20886
210375,202106,3263,8592,2481,7503,713,2257,913,3070,1626,5327
210380,202106,5496,13865,4738,12971,245,584,4013,11107,4258,11691
210390,202106,2774,9112,2570,8769,108,451,2218,7534,2326,7985
210400,202106,4537,13600,4023,12990,128,371,3578,11775,3706,12146
210405,202106,6991,18433,5660,16569,1118,2922,3140,9958,4258,12880
210407,202106,2052,6571,1741,6033,76,296,1388,4769,1464,5065
210408,202106,2642,9563,2470,9317,147,642,1968,7481,2115,8123
210409,202106,3895,13091,3548,12617,95,475,2978,10717,3073,11192
210410,202106,3550,10400,3040,9567,129,466,2422,7539,2551,8005
210420,202106,3878,12158,3496,11480,200,569,2933,9786,3133,10355
210430,202106,2272,6598,2015,6266,105,283,1699,5388,1804,5671
210440,202106,4385,11695,3807,10972,79,234,3457,9941,3536,10175
210450,202106,2369,6955,2039,6484,92,287,1681,5359,1773,5646
210455,202106,4501,11554,3432,10207,926,2778,1609,5095,2535,7873
210460,202106,3784,10656,3202,9902,62,237,2802,8641,2864,8878
210462,202106,1719,5096,1455,4671,38,141,1179,3811,1217,3952
210465,202106,2753,7907,2396,7407,75,329,1936,5860,2011,6189
210467,202106,5954,18595,5200,17620,284,1040,4319,14866,4603,15906
210470,202106,1999,5278,1487,4549,111,251,1114,3572,1225,3823
210480,202106,16520,47906,13720,44467,1186,3362,9992,35198,11178,38560
210490,202106,3685,9130,2985,8177,68,167,2548,6976,2616,7143
210500,202106,6419,24158,5905,23293,395,1780,4833,19007,5228,20787
210510,202106,5940,19349,5190,18542,107,488,4677,16935,4784,17423
210515,202106,3767,11002,3268,10428,188,635,2666,8731,2854,9366
210520,202106,2534,7276,2275,6937,67,243,1942,5870,2009,6113
210530,202106,51980,127185,40169,109838,6786,21958,11926,39892,18712,61850
210535,202106,3359,10803,3100,10426,135,464,2629,8923,2764,9387
210540,202106,15001,42330,12484,38838,1563,4299,8615,28308,10178,32607
210542,202106,6766,15419,5369,13892,482,919,4224,11700,4706,12619
210545,202106,2245,6880,2117,6675,38,156,1890,5901,1928,6057
210547,202106,3614,12735,3219,11998,272,968,2464,9413,2736,10381
210550,202106,6079,18173,4803,16159,330,1243,3400,11773,3730,13016
210560,202106,3743,11120,3326,10460,125,352,2811,8833,2936,9185
210565,202106,1495,4715,1247,4359,56,284,967,3393,1023,3677
210570,202106,10619,28587,9454,27167,308,804,8242,24231,8550,25035
210580,202106,3019,7965,2419,7177,142,331,1649,5149,1791,5480
210590,202106,4302,12669,3738,11954,60,322,3346,10645,3406,10967
210592,202106,2662,7748,2442,7397,21,96,2113,6340,2134,6436
210594,202106,2531,6750,1945,5842,100,284,1437,4490,1537,4774
210596,202106,2643,9156,2383,8669,152,541,1913,7054,2065,7595
210598,202106,1863,5278,1724,5068,50,150,1528,4466,1578,4616
210600,202106,3074,8135,2528,7366,141,356,1885,5588,2026,5944
210610,202106,2819,7620,2422,7144,55,209,2086,6154,2141,6363
210620,202106,2883,7425,2385,6820,70,165,2135,6175,2205,6340
210630,202106,3091,10092,2830,9657,110,470,2336,7905,2446,8375
210632,202106,4515,13985,4020,13279,215,861,3220,10564,3435,11425
210635,202106,1741,6135,1649,5977,101,331,1354,5027,1455,5358
210637,202106,2548,8267,2203,7775,133,584,1645,5917,1778,6501
210640,202106,4601,16213,4311,15882,58,265,3956,14635,4014,14900
210650,202106,7488,21120,6797,20229,142,422,6080,18177,6222,18599
210660,202106,8163,23924,7296,22529,246,1003,6201,18802,6447,19805
210663,202106,2737,7617,2504,7346,182,370,2039,6284,2221,6654
210667,202106,2012,6396,1807,6091,64,219,1592,5453,1656,5672
210670,202106,4886,15739,4449,15054,114,487,3918,13232,4032,13719
210675,202106,5171,13724,4419,12771,327,751,3526,10626,3853,11377
210680,202106,4715,11195,3989,10346,97,165,3627,9525,3724,9690
210690,202106,7654,23200,6385,21798,235,950,5614,19412,5849,20362
210700,202106,2795,7707,2212,6862,155,412,1586,5146,1741,5558
210710,202106,4966,15169,4385,14364,90,461,3908,12654,3998,13115
210720,202106,3084,9764,2736,9329,56,316,2427,8205,2483,8521
210725,202106,1306,4282,1130,4009,47,172,787,2914,834,3086
210730,202106,1212,3085,1022,2821,51,136,876,2407,927,2543
210735,202106,4768,13596,4068,12693,199,520,3477,11179,3676,11699
210740,202106,5289,13690,4573,12870,87,237,3925,11073,4012,11310
210745,202106,4453,11989,4136,11589,111,292,3754,10501,3865,10793
210750,202106,23579,60012,20442,56043,2249,5393,13799,40335,16048,45728
210760,202106,5955,15543,5031,14567,58,132,4746,13913,4804,14045
210770,202106,6184,15702,5350,14741,55,231,5048,13835,5103,14066
210780,202106,7612,23333,6632,21719,635,1742,5056,16965,5691,18707
210790,202106,4336,13526,3926,12994,212,471,3216,11203,3428,11674
210800,202106,4907,13034,4215,12124,89,335,3742,10669,3831,11004
210805,202106,4023,14303,3837,14034,114,539,3391,12395,3505,12934
210810,202106,4890,14113,4460,13559,333,774,3629,11429,3962,12203
210820,202106,6955,19621,5829,17827,677,2086,3458,10973,4135,13059
210825,202106,6858,20843,6189,19959,298,878,5261,17324,5559,18202
210830,202106,7904,21815,7207,20993,342,794,6301,18761,6643,19555
210840,202106,3163,8311,2849,7905,42,135,2556,7026,2598,7161
210845,202106,6497,17352,5808,16601,39,133,5533,15951,5572,16084
210850,202106,5883,19645,4898,18169,210,999,3900,14513,4110,15512
210860,202106,21645,53856,18017,49384,1137,2631,14107,40941,15244,43572
210870,202106,7525,19061,5997,17324,230,545,5269,15392,5499,15937
210880,202106,4261,12908,3815,12361,190,689,3034,9856,3224,10545
210890,202106,3924,11259,3545,10820,347,858,2741,8736,3088,9594
210900,202106,4636,13228,3606,11325,1439,4875,516,1888,1955,6763
210905,202106,2042,5469,1709,5047,49,89,1551,4697,1600,4786
210910,202106,7110,21346,5904,19395,711,2365,3892,12916,4603,15281
210920,202106,3195,10435,2771,9875,68,385,2480,8743,2548,9128
210923,202106,1608,4614,1370,4238,81,237,1004,3132,1085,3369
210927,202106,5141,16320,4511,15566,443,1445,3389,12155,3832,13600
210930,202106,2408,8230,2115,7668,143,554,1606,5819,1749,6373
210940,202106,4087,11379,3799,11047,103,409,3491,10035,3594,10444
210945,202106,6861,19129,6141,18280,251,671,5158,15806,5409,16477
210950,202106,5248,14388,4046,12724,584,1393,2659,9200,3243,10593
210955,202106,1561,4785,1351,4441,319,964,727,2584,1046,3548
210960,202106,9086,26506,7880,24697,1462,4215,4951,16408,6413,20623
210970,202106,1378,4104,1108,3650,92,269,820,2696,912,2965
210975,202106,1803,5475,1626,5194,95,318,1292,4162,1387,4480
210980,202106,9970,23232,8741,21961,101,236,8240,20824,8341,21060
210990,202106,16518,45427,12923,40721,692,2232,9535,31229,10227,33461
211000,202106,14764,42175,12326,39167,989,2938,9259,30953,10248,33891
211003,202106,5750,16697,4814,15560,124,463,4158,13759,4282,14222
211010,202106,6430,22485,5739,21592,114,522,5108,19518,5222,20040
211020,202106,8230,23428,7124,22166,243,819,6044,19409,6287,20228
211023,202106,1981,6376,1849,6208,90,295,1562,5255,1652,5550
211027,202106,3168,9803,3007,9557,232,577,2528,8236,2760,8813
211030,202106,3863,10514,3458,10016,260,629,2741,8207,3001,8836
211040,202106,4733,16601,4388,16013,110,653,3949,14279,4059,14932
211050,202106,9044,23323,8234,22265,77,273,7570,20465,7647,20738
211060,202106,6943,20829,6318,19988,164,640,5573,17633,5737,18273
211065,202106,2306,6176,1926,5703,82,210,1596,4843,1678,5053
211070,202106,8138,24755,6950,22988,491,1524,5551,18594,6042,20118
211080,202106,1322,3585,1064,3183,30,157,843,2398,873,2555
211085,202106,2121,5778,1800,5346,98,214,1502,4690,1600,4904
211090,202106,3178,8707,2862,8349,30,138,2655,7720,2685,7858
211100,202106,6803,16985,6286,16373,40,127,5844,15318,5884,15445
211102,202106,3216,10583,2943,10181,173,730,2487,8504,2660,9234
211105,202106,2411,7397,2016,6700,151,502,1459,4826,1610,5328
211107,202106,4842,14939,4152,13930,150,585,3258,11427,3408,12012
211110,202106,6080,16162,4759,14156,354,945,3543,10744,3897,11689
211120,202106,45082,108838,36921,99318,5643,13660,23278,67249,28921,80909
211125,202106,2102,6190,1777,5691,46,149,1502,4840,1548,4989
211130,202106,180151,424478,154243,391124,23683,55176,77820,222035,101503,277211
211140,202106,5063,14620,4445,13847,231,592,3720,11759,3951,12351
211150,202106,9494,25354,8013,23447,366,917,6702,19866,7068,20783
211153,202106,2447,7070,1956,6464,275,918,1266,4391,1541,5309
211157,202106,1168,3613,980,3274,29,129,717,2393,746,2522
211160,202106,4298,11753,3388,10471,133,455,2587,7896,2720,8351
211163,202106,1605,5115,1456,4899,40,167,1284,4344,1324,4511
211167,202106,1606,4903,1504,4751,26,91,1388,4378,1414,4469
211170,202106,6549,15864,6083,15334,73,144,5751,14490,5824,14634
211172,202106,2613,6936,2254,6404,98,275,1803,5024,1901,5299
211174,202106,2876,8233,2601,7926,31,157,2446,7425,2477,7582
211176,202106,4303,12008,3363,10623,149,607,2719,8551,2868,9158
211178,202106,5072,11160,4350,10393,19,79,4198,9952,4217,10031
211180,202106,4092,13331,3794,12898,213,757,3123,10677,3336,11434
211190,202106,3109,9008,2644,8326,31,168,2366,7394,2397,7562
211195,202106,1429,3927,1220,3609,124,233,956,2982,1080,3215
211200,202106,2190,6174,1755,5563,202,578,1212,3921,1414,4499
211210,202106,6331,19140,5715,18331,316,1148,4732,15146,5048,16294
211220,202106,38218,94332,31513,86146,3333,8169,22992,64803,26325,72972
211223,202106,5360,13883,4404,12617,391,1068,3172,9181,3563,10249
211227,202106,1764,5665,1584,5408,58,252,1242,4284,1300,4536
211230,202106,7899,22066,6936,20618,380,875,5673,17288,6053,18163
211240,202106,8029,25112,7624,24598,172,754,7035,22548,7207,23302
211245,202106,7054,17613,6255,16771,76,189,6031,16169,6107,16358
211250,202106,13337,41438,12063,39651,845,2895,9614,31699,10459,34594
211260,202106,8116,25921,7218,24740,228,930,6412,22171,6640,23101
211270,202106,10355,32655,8846,30633,354,1602,7179,25091,7533,26693
211280,202106,12430,33829,11178,32258,844,1932,9194,27594,10038,29526
211285,202106,1882,5956,1680,5681,123,446,1279,4436,1402,4882
211290,202106,7559,22294,6832,21337,206,713,5872,18381,6078,19094
211300,202106,7730,22143,6792,20636,245,777,5557,16693,5802,17470
211400,202106,11782,32570,9661,29684,1057,3156,6418,20905,7475,24061
220005,202106,1895,4765,1724,4536,35,106,1475,3818,1510,3924
220010,202106,1499,4221,1232,3749,22,91,957,2886,979,2977
220020,202106,3877,10248,3319,9479,133,425,2760,7844,2893,8269
220025,202106,2245,5043,1931,4589,28,68,1613,3727,1641,3795
220027,202106,1311,3220,1120,2963,20,62,964,2510,984,2572
220030,202106,3437,8459,3216,8172,92,228,2824,7108,2916,7336
220040,202106,7268,21686,6393,20036,1554,4415,3221,10750,4775,15165
220045,202106,1501,4485,1243,4063,24,122,1034,3329,1058,3451
220050,202106,4764,12762,4058,11855,56,263,3735,10794,3791,11057
220060,202106,2427,5015,2076,4610,27,63,1965,4354,1992,4417
220070,202106,2459,6092,2100,5568,75,133,1752,4672,1827,4805
220080,202106,747,2093,645,1948,21,68,552,1664,573,1732
220090,202106,1770,4199,1487,3796,13,39,1230,3267,1243,3306
220095,202106,659,1602,617,1559,36,58,546,1413,582,1471
220100,202106,1431,3819,1157,3386,43,136,937,2665,980,2801
220105,202106,2089,6297,1835,5818,108,373,1401,4427,1509,4800
220110,202106,3427,9401,3130,8901,34,166,2811,7892,2845,8058
220115,202106,2749,7810,2533,7531,70,202,2301,6832,2371,7034
220117,202106,1450,3383,1150,2974,3,15,972,2461,975,2476
220120,202106,13264,34688,12165,33338,82,247,11425,31281,11507,31528
220130,202106,1147,2979,974,2741,9,47,888,2458,897,2505
220140,202106,2172,4406,1841,4022,95,227,1614,3498,1709,3725
220150,202106,6507,18836,5947,17878,114,473,5057,14977,5171,15450
220155,202106,1218,3402,979,2977,36,104,707,2118,743,2222
220157,202106,1082,2593,916,2341,23,70,729,1813,752,1883
220160,202106,2906,7916,2506,7198,32,127,2050,5777,2082,5904
220170,202106,1652,4221,1413,3870,17,77,1257,3395,1274,3472
220173,202106,2241,6065,1763,5202,44,144,1427,4108,1471,4252
220177,202106,2050,5696,1947,5582,8,27,1923,5509,1931,5536
220180,202106,1140,2701,926,2347,5,19,734,1748,739,1767
220190,202106,7148,17448,6098,16021,350,916,4662,12554,5012,13470
220191,202106,1616,4715,1467,4467,75,244,1050,3158,1125,3402
220192,202106,2107,5451,1549,4471,27,82,1255,3576,1282,3658
220194,202106,1743,4890,1553,4589,48,176,1289,3771,1337,3947
220196,202106,2083,5285,1896,5007,32,120,1646,4277,1678,4397
220198,202106,1299,3500,1106,3250,7,16,1023,3041,1030,3057
220200,202106,5165,14750,4512,13910,53,232,3932,12110,3985,12342
220202,202106,2203,6116,1894,5616,23,114,1630,4752,1653,4866
220205,202106,2539,7179,2268,6682,49,182,1934,5615,1983,5797
220207,202106,787,2349,658,2128,54,181,442,1444,496,1625
220208,202106,1726,5152,1438,4611,181,625,861,2731,1042,3356
220209,202106,1605,4519,1399,4155,25,96,1160,3407,1185,3503
220210,202106,1819,4285,1582,3924,11,44,1386,3344,1397,3388
220211,202106,1667,4110,1530,3925,16,58,1337,3437,1353,3495
220213,202106,1844,4776,1596,4357,19,62,1304,3466,1323,3528
220217,202106,2303,6541,2163,6378,46,83,2004,6029,2050,6112
220220,202106,10871,27514,9098,24886,636,1431,6175,17853,6811,19284
220225,202106,1007,2634,827,2400,4,27,779,2235,783,2262
220230,202106,5692,14085,4876,12961,153,342,4205,11270,4358,11612
220240,202106,3094,8758,2812,8294,112,361,2318,6809,2430,7170
220245,202106,1834,4109,1405,3587,12,44,1278,3295,1290,3339
220250,202106,3029,8293,2662,7830,13,63,2493,7304,2506,7367
220253,202106,1624,4319,1464,4056,54,160,1244,3386,1298,3546
220255,202106,1993,4554,1718,4177,29,124,1500,3528,1529,3652
220260,202106,4521,13409,3957,12391,165,554,3120,9758,3285,10312
220265,202106,1372,4223,1238,4057,29,140,1049,3373,1078,3513
220270,202106,6050,19322,5730,18749,187,883,4802,15237,4989,16120
220271,202106,1506,3821,1317,3556,25,74,1152,3098,1177,3172
220272,202106,1768,5036,1577,4694,48,139,1188,3451,1236,3590
220273,202106,1268,3550,1063,3179,39,151,819,2402,858,2553
220275,202106,2323,5350,1857,4721,37,62,1633,4186,1670,4248
220277,202106,2219,5425,1903,4980,42,97,1591,4114,1633,4211
220280,202106,1703,3865,1417,3501,18,54,1211,2975,1229,3029
220285,202106,1472,3636,1268,3398,9,34,1178,3137,1187,3171
220290,202106,6777,18379,5393,16437,341,1074,3957,12419,4298,13493
220300,202106,2021,5699,1656,5220,31,153,1395,4374,1426,4527
220310,202106,3083,8069,2434,7321,36,167,2076,6222,2112,6389
220320,202106,3127,8915,2420,7614,60,275,1901,5823,1961,6098
220323,202106,1672,4735,1309,4166,53,174,1073,3368,1126,3542
220325,202106,1262,3677,1090,3395,24,112,909,2775,933,2887
220327,202106,1609,4367,1406,4054,33,128,1165,3269,1198,3397
220330,202106,4642,10807,3953,9979,58,181,3578,8987,3636,9168
220335,202106,1684,5018,1522,4805,31,91,1356,4311,1387,4402
220340,202106,1927,4967,1492,4255,54,162,1018,2825,1072,2987
220342,202106,1197,3402,1070,3210,54,159,839,2524,893,2683
220345,202106,3166,7024,2435,5995,16,43,2210,5430,2226,5473
220350,202106,3383,8446,2717,7472,136,360,1941,5404,2077,5764
220360,202106,1249,3165,990,2736,16,43,794,2187,810,2230
220370,202106,8661,24837,7904,23626,144,564,6875,20344,7019,20908
220375,202106,1648,4588,1470,4371,2,7,1403,4199,1405,4206
220380,202106,1505,3508,1240,3146,14,32,1093,2760,1107,2792
220385,202106,845,1981,696,1723,6,15,607,1488,613,1503
220390,202106,10744,27043,8284,23321,2022,5521,2985,9404,5007,14925
220400,202106,1545,3588,1186,3038,23,70,914,2259,937,2329
220410,202106,1181,3210,970,2850,46,123,787,2294,833,2417
220415,202106,840,2117,708,1908,23,54,570,1522,593,1576
220420,202106,2053,5631,1664,4901,61,167,1263,3673,1324,3840
220430,202106,2616,6705,2414,6420,53,166,2118,5559,2171,5725
220435,202106,1821,4606,1569,4238,42,136,1316,3479,1358,3615
220440,202106,2401,7343,2044,6794,72,325,1752,5725,1824,6050
220450,202106,2535,6499,2060,5911,52,172,1768,5086,1820,5258
220455,202106,1306,3976,1246,3892,7,37,1123,3508,1130,3545
220460,202106,1025,2457,955,2372,31,68,824,2033,855,2101
220465,202106,2397,7221,2115,6781,181,547,1564,5148,1745,5695
220470,202106,3588,9728,3244,9183,113,261,2643,7436,2756,7697
220480,202106,2882,7227,2326,6354,237,490,1493,4187,1730,4677
220490,202106,2516,6172,2176,5749,23,111,1901,4952,1924,5063
220500,202106,3041,7443,2652,6845,90,204,2085,5315,2175,5519
220510,202106,2635,7189,2118,6273,80,198,1674,5016,1754,5214
220515,202106,1696,4011,1570,3835,39,59,1370,3354,1409,3413
220520,202106,5062,12905,4587,12239,92,243,3996,10629,4088,10872
220525,202106,1435,3486,1242,3247,6,33,1143,2966,1149,2999
220527,202106,1328,3606,1149,3350,16,61,986,2918,1002,2979
220530,202106,1432,3531,1245,3292,31,90,1136,2990,1167,3080
220535,202106,807,2173,756,2104,30,75,610,1703,640,1778
220540,202106,3264,10226,3054,9826,136,452,2579,8276,2715,8728
220545,202106,1474,4292,1369,4125,56,216,1163,3460,1219,3676
220550,202106,8693,26397,7756,24763,446,1487,5919,18762,6365,20249
220551,202106,1440,3951,1282,3701,26,94,1051,2984,1077,3078
220552,202106,1675,4705,1376,4180,19,99,1118,3290,1137,3389
220553,202106,1797,4526,1482,4110,56,94,1208,3479,1264,3573
220554,202106,931,2352,690,1967,52,118,462,1309,514,1427
220555,202106,2560,7045,2219,6620,35,125,1856,5703,1891,5828
220556,202106,1222,3472,1066,3177,39,152,786,2259,825,2411
220557,202106,1705,5101,1428,4491,72,264,1046,3209,1118,3473
220558,202106,1410,3632,1111,3218,16,65,959,2751,975,2816
220559,202106,1844,4437,1569,4017,14,31,1287,3335,1301,3366
220560,202106,1767,3950,1455,3556,41,76,1318,3258,1359,3334
220570,202106,7494,21656,6848,20743,495,1344,5441,16738,5936,18082
220580,202106,7023,18667,6415,17700,96,260,5796,15953,5892,16213
220585,202106,2119,6481,1742,5808,43,113,1431,4818,1474,4931
220590,202106,1401,3709,1158,3353,85,219,834,2467,919,2686
220595,202106,2636,7051,2405,6737,16,74,2156,5989,2172,6063
220600,202106,1440,3127,1223,2867,75,93,1038,2508,1113,2601
220605,202106,1624,4683,1397,4277,17,94,1147,3411,1164,3505
220610,202106,2841,8101,2668,7840,26,122,2503,7326,2529,7448
220620,202106,8058,24255,7417,23389,144,733,6770,21147,6914,21880
220630,202106,387,1116,301,960,25,84,202,632,227,716
220635,202106,1802,5350,1615,4960,38,175,1272,3796,1310,3971
220640,202106,2452,6743,2089,6227,67,263,1703,5032,1770,5295
220650,202106,2133,5737,1840,5296,30,102,1501,4311,1531,4413
220660,202106,2585,8004,2199,7364,64,315,1850,6099,1914,6414
220665,202106,1275,3770,1080,3448,27,137,915,2859,942,2996
220667,202106,1660,5000,1498,4709,62,223,1212,3794,1274,4017
220669,202106,1681,4907,1612,4801,46,183,1444,4218,1490,4401
220670,202106,2237,5680,1795,5063,18,69,1557,4388,1575,4457
220672,202106,3287,7937,2670,7187,82,271,2384,6334,2466,6605
220675,202106,1325,3533,1185,3278,31,84,977,2691,1008,2775
220680,202106,2789,7378,2662,7204,115,221,2417,6655,2532,6876
220690,202106,1609,4178,1423,3903,59,175,1120,3067,1179,3242
220695,202106,928,2516,862,2398,20,57,752,2085,772,2142
220700,202106,10512,24885,8543,22228,334,824,6554,16977,6888,17801
220710,202106,937,2483,691,2030,29,79,526,1510,555,1589
220720,202106,2144,5012,1929,4729,16,60,1694,4103,1710,4163
220730,202106,1348,3671,1151,3351,14,65,982,2799,996,2864
220735,202106,1010,2271,799,1952,25,66,660,1565,685,1631
220740,202106,1387,3517,1119,3170,32,76,938,2702,970,2778
220750,202106,3911,9723,3449,9073,172,397,3035,8013,3207,8410
220755,202106,1388,3293,1154,2948,19,64,962,2406,981,2470
220760,202106,3144,8415,2766,7909,60,172,2521,7261,2581,7433
220770,202106,24343,70325,20667,64145,6090,19849,7182,23430,13272,43279
220775,202106,1196,2926,1061,2756,7,26,1023,2640,1030,2666
220777,202106,1634,4080,1254,3507,33,80,962,2708,995,2788
220779,202106,1281,3284,1112,3038,20,66,980,2648,1000,2714
220780,202106,5823,14174,5035,13006,214,604,4067,10323,4281,10927
220785,202106,1499,3291,1318,3061,7,21,1261,2909,1268,2930
220790,202106,10313,28796,9301,27345,167,709,7843,22850,8010,23559
220793,202106,940,2439,758,2127,7,10,633,1800,640,1810
220795,202106,1416,3586,1250,3367,22,67,1100,2967,1122,3034
220800,202106,18632,40293,15887,36742,583,1265,12475,28814,13058,30079
220810,202106,3085,8403,2609,7579,40,114,2161,6215,2201,6329
220820,202106,5052,12965,4420,12042,239,549,3427,9350,3666,9899
220830,202106,7357,19131,6604,18084,263,776,5462,14755,5725,15531
220840,202106,12317,36827,10318,32801,2243,6768,4889,16216,7132,22984
220850,202106,3198,9648,2884,9261,45,221,2573,8278,2618,8499
220855,202106,713,1766,623,1647,21,58,561,1476,582,1534
220860,202106,1064,2601,931,2397,15,61,846,2146,861,2207
220865,202106,2478,6440,1925,5467,69,260,1414,3893,1483,4153
220870,202106,3127,8348,2609,7675,26,122,2408,7076,2434,7198
220880,202106,5399,12547,4656,11628,70,251,4274,10565,4344,10816
220885,202106,1432,4185,1191,3788,58,183,935,3030,993,3213
220887,202106,1593,3352,1338,3030,14,31,1238,2791,1252,2822
220890,202106,1429,4255,1251,3995,45,148,1044,3388,1089,3536
220900,202106,2033,4769,1700,4346,32,73,1494,3815,1526,3888
220910,202106,1570,4179,1325,3818,59,153,1084,3159,1143,3312
220915,202106,987,2579,800,2242,17,56,615,1655,632,1711
220920,202106,1439,4401,1250,4157,53,211,1030,3463,1083,3674
220930,202106,1805,4734,1520,4329,21,61,1420,4037,1441,4098
220935,202106,1112,3162,904,2718,22,91,586,1666,608,1757
220937,202106,1534,3948,1322,3615,22,79,1065,2861,1087,2940
220940,202106,1593,4325,1273,3764,28,82,1001,2931,1029,3013
220945,202106,452,1537,393,1409,16,92,300,1044,316,1136
220950,202106,1435,3273,952,2533,20,56,754,1940,774,1996
220955,202106,1649,4103,1369,3626,26,65,1176,3079,1202,3144
220960,202106,811,2031,611,1693,26,74,437,1163,463,1237
220965,202106,1815,4882,1577,4533,17,104,1366,3850,1383,3954
220970,202106,2017,4689,1486,3911,24,56,1248,3258,1272,3314
220975,202106,697,1931,597,1806,11,62,535,1573,546,1635
220980,202106,1169,3239,1038,3061,32,115,872,2556,904,2671
220985,202106,1313,3300,1141,3052,54,125,929,2442,983,2567
220987,202106,1473,4295,1298,3988,53,178,1053,3222,1106,3400
220990,202106,1736,4722,1533,4421,14,80,1314,3738,1328,3818
220995,202106,1138,3308,947,2955,32,100,712,2231,744,2331
220997,202106,2388,7144,2206,6849,42,175,1972,6060,2014,6235
221000,202106,4554,12276,4018,11496,82,349,3453,9784,3535,10133
221005,202106,1509,3853,1380,3638,15,68,1199,3074,1214,3142
221010,202106,1271,2793,1001,2462,17,51,871,2106,888,2157
221020,202106,1543,4662,1430,4457,21,74,1096,3388,1117,3462
221030,202106,1707,4055,1460,3753,20,54,1274,3330,1294,3384
221035,202106,1535,3898,1351,3654,21,29,1201,3324,1222,3353
221037,202106,719,1905,599,1698,9,25,438,1187,447,1212
221038,202106,538,1489,421,1288,13,46,284,863,297,909
221039,202106,883,2371,758,2167,21,88,618,1712,639,1800
221040,202106,4253,12222,3729,11297,171,498,2988,9115,3159,9613
221050,202106,3968,10204,3512,9629,68,199,3165,8682,3233,8881
221060,202106,8863,24322,7362,21866,328,768,5890,17741,6218,18509
221062,202106,1145,3628,992,3378,37,157,801,2714,838,2871
221063,202106,1083,2897,934,2681,50,150,743,2106,793,2256
221065,202106,2685,6765,2360,6203,15,50,2078,5392,2093,5442
221070,202106,3471,10504,2811,9126,290,915,1735,5748,2025,6663
221080,202106,3541,8555,2916,7632,58,191,2405,6187,2463,6378
221090,202106,1437,3584,1182,3184,7,27,1010,2670,1017,2697
221093,202106,1406,3867,1282,3627,140,361,868,2433,1008,2794
221095,202106,880,2281,750,2083,8,21,639,1750,647,1771
221097,202106,876,2198,665,1822,22,54,498,1296,520,1350
221100,202106,120662,315446,100704,281814,10093,30013,65404,177995,75497,208008
221110,202106,9955,29335,9142,28275,130,628,8216,25225,8346,25853
221120,202106,4864,13242,4339,12414,156,440,3771,10838,3927,11278
221130,202106,5612,14129,4270,11590,812,2050,2114,5782,2926,7832
221135,202106,1777,4432,1592,4188,37,96,1432,3778,1469,3874
221140,202106,1359,3115,1147,2853,10,33,1040,2547,1050,2580
221150,202106,1112,2752,878,2354,23,103,677,1697,700,1800
221160,202106,749,1826,663,1719,26,34,534,1402,560,1436
221170,202106,1021,2865,938,2716,9,35,823,2345,832,2380
230010,202106,3087,7954,2549,7056,33,109,2110,5718,2143,5827
230015,202106,3123,9883,2767,9163,149,538,1964,6504,2113,7042
230020,202106,13056,40598,12237,39359,351,1357,10467,33580,10818,34937
230030,202106,13195,32291,11089,29557,232,608,9675,25832,9907,26440
230040,202106,4592,11595,3802,10310,40,183,3199,8541,3239,8724
230050,202106,2760,8419,2113,6938,334,1038,941,3023,1275,4061
230060,202106,2406,6485,1936,5643,25,103,1541,4419,1566,4522
230070,202106,4172,10637,3368,9136,210,592,2381,6379,2591,6971
230075,202106,8939,28790,8193,27494,535,2024,6443,21460,6978,23484
230080,202106,3072,6437,2345,5551,6,18,2143,5092,2149,5110
230090,202106,4466,10723,3800,9692,192,453,3037,7709,3229,8162
230100,202106,18606,46879,16324,43866,1374,3510,11652,31652,13026,35162
230110,202106,12860,37474,10793,33494,1742,5335,5616,17636,7358,22971
230120,202106,7896,20549,6920,19004,536,1268,5089,14177,5625,15445
230125,202106,3202,8373,2600,7418,88,284,2000,5619,2088,5903
230130,202106,5670,17244,4608,14947,394,1339,2981,9573,3375,10912
230140,202106,3450,10235,2948,9206,83,337,2260,6897,2343,7234
230150,202106,1653,4872,1360,4233,211,574,789,2539,1000,3113
230160,202106,6583,16730,5695,15383,136,430,4761,12678,4897,13108
230170,202106,6573,18220,5406,15886,328,848,3863,11269,4191,12117
230180,202106,1669,4561,1414,4070,18,79,1155,3221,1173,3300
230185,202106,4526,12509,3842,11379,292,905,2817,8357,3109,9262
230190,202106,14050,39975,11812,35864,1332,4095,6985,21075,8317,25170
230195,202106,5482,15711,4986,14797,399,1145,3715,11046,4114,12191
230200,202106,5089,13820,4278,12324,150,441,3297,9345,3447,9786
230205,202106,4281,12214,3761,11445,219,640,2847,8670,3066,9310
230210,202106,10247,24308,8657,22200,364,1073,6778,17128,7142,18201
230220,202106,14040,34904,12344,32495,577,1506,10182,26562,10759,28068
230230,202106,7030,20366,6286,18877,435,1245,4659,13987,5094,15232
230240,202106,12924,34353,11178,31359,256,1096,9262,25382,9518,26478
230250,202106,9092,24971,8436,23958,236,780,6833,18873,7069,19653
230260,202106,15003,43449,12986,39931,2146,6179,6993,22239,9139,28418
230270,202106,7848,20577,6028,17196,567,1550,3844,11097,4411,12647
230280,202106,20610,54227,16937,48123,438,1699,13360,36615,13798,38314
230290,202106,5068,13690,4189,12051,227,552,3204,9200,3431,9752
230300,202106,4919,12828,4451,12199,90,246,3924,10741,4014,10987
230310,202106,4744,13299,4028,12021,121,487,2921,8536,3042,9023
230320,202106,7988,22633,6711,20321,202,820,5198,15402,5400,16222
230330,202106,4810,12788,3832,10949,116,353,2920,8139,3036,8492
230340,202106,3885,11687,3334,10576,222,741,2361,7392,2583,8133
230350,202106,18261,49067,15938,45682,788,2545,10908,31437,11696,33982
230360,202106,3030,7811,2403,6718,123,335,1678,4626,1801,4961
230365,202106,3124,7581,2583,6787,51,228,2207,5706,2258,5934
230370,202106,60452,162990,51608,150136,6978,20457,31930,93546,38908,114003
230380,202106,6383,17374,5055,14968,111,425,3789,10944,3900,11369
230390,202106,3488,10060,3029,9324,81,312,2369,7224,2450,7536
230393,202106,3461,9869,2761,8445,74,381,2151,6314,2225,6695
230395,202106,5783,15669,5017,14409,344,954,3511,10106,3855,11060
230400,202106,5442,14807,4862,13864,73,357,3942,10967,4015,11324
230410,202106,13876,40553,11496,36233,890,2975,7859,24816,8749,27791
230420,202106,29796,79790,24338,70571,2839,8418,13904,39966,16743,48384
230423,202106,4895,14146,4297,12978,112,415,3481,10376,3593,10791
230425,202106,5778,17340,5272,16321,446,1408,3744,11522,4190,12930
230426,202106,2900,7399,2129,5920,26,92,1617,4392,1643,4484
230427,202106,1892,5180,1373,4118,78,233,885,2558,963,2791
230428,202106,9840,25730,8431,23655,1264,3422,4815,13542,6079,16964
230430,202106,5045,13898,3989,12078,159,518,2981,8914,3140,9432
230435,202106,6210,15782,5172,13978,719,1751,3045,8383,3764,10134
230440,202106,429347,1038395,358547,936251,32561,89486,238532,613456,271093,702942
230445,202106,4335,11328,3492,9859,190,505,2389,6587,2579,7092
230450,202106,3666,10271,3197,9597,229,827,2350,6865,2579,7692
230460,202106,2159,5910,1877,5466,48,197,1588,4587,1636,4784
230465,202106,4273,11641,3616,10401,110,387,2748,7605,2858,7992
230470,202106,11527,37249,10350,35097,879,3247,7265,24358,8144,27605
230480,202106,1498,4254,1251,3816,57,230,934,2743,991,2973
230490,202106,2646,7229,2253,6497,158,510,1450,3949,1608,4459
230495,202106,5763,16803,5092,15607,437,1482,3332,10143,3769,11625
230500,202106,9514,29877,8469,27991,236,950,6928,22912,7164,23862
230510,202106,1682,4812,1330,4080,163,524,712,2144,875,2668
230520,202106,4795,13001,4154,11896,343,880,2890,8324,3233,9204
230523,202106,15612,45177,12490,38656,2742,8452,3168,10468,5910,18920
230526,202106,3797,10594,3256,9693,188,489,2372,7155,2560,7644
230530,202106,5477,16880,4620,15212,305,1086,3344,10851,3649,11937
230533,202106,4701,10794,3847,9472,111,270,3209,7784,3320,8054
230535,202106,5282,14552,4479,13203,310,896,2984,8904,3294,9800
230540,202106,16213,43484,13906,40083,277,997,11544,33051,11821,34048
230550,202106,21743,55920,17544,48918,1484,4175,11417,31658,12901,35833
230560,202106,8116,19654,6617,17312,59,232,5695,14780,5754,15012
230565,202106,3101,8462,2613,7571,103,396,2006,5691,2109,6087
230570,202106,3452,8705,2951,8016,88,218,2420,6575,2508,6793
230580,202106,11423,28716,9820,26443,392,985,8076,21750,8468,22735
230590,202106,9146,25357,7659,22683,421,1379,5726,16456,6147,17835
230600,202106,3861,9586,3062,8223,92,221,2090,5670,2182,5891
230610,202106,6787,18377,6030,17115,437,1178,4768,13480,5205,14658
230620,202106,2156,5682,1688,4797,101,316,1063,2909,1164,3225
230625,202106,8478,23147,7156,20785,1938,5835,2242,6810,4180,12645
230630,202106,11225,32064,9800,29347,1277,3592,6075,18472,7352,22064
230640,202106,27670,82522,25067,78428,1133,4317,20147,62181,21280,66498
230650,202106,5383,14126,4561,12722,116,424,3738,10168,3854,10592
230655,202106,9383,31179,8829,30235,668,2224,7047,24457,7715,26681
230660,202106,6179,18042,5040,16051,133,700,4086,12747,4219,13447
230670,202106,6327,14714,4638,12058,120,374,3728,9449,3848,9823
230680,202106,2748,7322,2309,6547,120,296,1658,4732,1778,5028
230690,202106,7333,21153,6310,19175,393,1366,4061,12112,4454,13478
230700,202106,10559,26325,8587,22744,386,853,6335,16567,6721,17420
230710,202106,6960,21607,6107,19792,676,2042,4007,13027,4683,15069
230720,202106,1903,5514,1568,4865,106,292,1098,3346,1204,3638
230725,202106,4307,12276,3869,11523,384,1237,2386,6993,2770,8230
230730,202106,59059,154294,46498,135662,10421,32258,14636,45955,25057,78213
230740,202106,6217,16962,5282,15466,136,412,4217,12339,4353,12751
230750,202106,8522,22326,7112,20012,154,491,5695,15646,5849,16137
230760,202106,11231,29007,9754,26802,480,1523,7416,19878,7896,21401
230763,202106,5139,13468,4308,12009,107,462,3495,9421,3602,9883
230765,202106,42055,111307,34968,100002,5193,15308,18231,51462,23424,66770
230770,202106,25790,62260,21607,56809,2104,5423,14625,38604,16729,44027
230780,202106,6567,22532,5939,21055,854,2873,3431,12572,4285,15445
230790,202106,3171,8735,2853,8224,102,393,2213,6179,2315,6572
230800,202106,8367,26024,7351,23987,1002,3360,4199,13572,5201,16932
230810,202106,11177,33273,10041,31451,367,1321,7838,24194,8205,25515
230820,202106,3580,11276,2954,9922,257,988,1802,5746,2059,6734
230830,202106,7673,20512,6555,18673,116,472,5414,15016,5530,15488
230835,202106,4342,10108,3371,8603,94,257,2707,6808,2801,7065
230837,202106,3149,9377,2817,8816,110,429,2249,6910,2359,7339
230840,202106,9590,27250,8241,24944,1011,2772,5638,17327,6649,20099
230850,202106,9940,28033,8346,24936,356,1148,6099,17988,6455,19136
230860,202106,5539,13570,4606,12246,55,177,4070,10740,4125,10917
230870,202106,16506,39619,14231,35885,398,1072,11669,28898,12067,29970
230880,202106,2148,6353,1968,6065,43,221,1565,4700,1608,4921
230890,202106,4540,14332,4148,13575,321,1120,3048,9861,3369,10981
230900,202106,3084,8636,2673,7879,162,537,1856,5326,2018,5863
230910,202106,3223,8462,2612,7529,58,256,2111,6090,2169,6346
230920,202106,4841,13280,4077,12064,102,397,3253,9422,3355,9819
230930,202106,6849,18570,5756,16650,279,742,4053,11717,4332,12459
230940,202106,8370,20666,7271,19021,201,462,6097,15889,6298,16351
230945,202106,6667,18708,5715,16924,284,983,4078,11785,4362,12768
230950,202106,6314,15599,5582,14612,116,260,4802,12650,4918,12910
230960,202106,13805,38800,12120,35664,2112,6031,5832,17304,7944,23335
230970,202106,13935,36152,11652,32661,1618,4368,6890,19494,8508,23862
230980,202106,2751,7818,2434,7263,330,915,1558,4804,1888,5719
230990,202106,1703,4677,1405,4100,60,228,1005,2802,1065,3030
231000,202106,2596,6839,2115,5896,84,194,1569,4278,1653,4472
231010,202106,3745,8543,2949,7199,26,97,2582,6131,2608,6228
231020,202106,8118,24522,7251,22894,1199,3422,4290,14034,5489,17456
231025,202106,7703,20600,6702,18972,720,1917,4732,13566,5452,15483
231030,202106,7487,21767,5904,18462,988,2895,3023,9601,4011,12496
231040,202106,2956,8313,2570,7612,120,362,2014,5872,2134,6234
231050,202106,11923,29857,9773,26110,625,1537,7326,19242,7951,20779
231060,202106,2945,8172,2598,7617,55,162,2174,6376,2229,6538
231070,202106,8088,22930,6956,20956,629,1937,4699,14025,5328,15962
231080,202106,3996,11104,3393,10126,142,532,2567,7500,2709,8032
231085,202106,7036,16492,5619,14849,216,489,4424,11753,4640,12242
231090,202106,4615,11787,3412,9502,102,385,2317,6195,2419,6580
231095,202106,2301,6721,1829,5718,162,490,1213,3796,1375,4286
231100,202106,3273,9249,2689,8145,122,411,2014,6051,2136,6462
231110,202106,3731,10615,3406,10024,129,444,2581,7480,2710,7924
231120,202106,2385,6744,1985,6057,76,270,1445,4365,1521,4635
231123,202106,1960,4963,1653,4438,89,185,1195,3242,1284,3427
231126,202106,5558,14987,4560,13119,295,778,3258,9312,3553,10090
231130,202106,22189,54779,18440,50126,1048,3175,13782,36955,14830,40130
231135,202106,4233,11743,3520,10370,179,554,2498,7283,2677,7837
231140,202106,16731,46251,13508,40732,652,2305,9592,28327,10244,30632
231150,202106,6071,16061,4597,13295,642,1891,1968,5868,2610,7759
231160,202106,6380,19135,5689,17887,788,2391,3234,10471,4022,12862
231170,202106,4445,12561,3736,11250,231,716,2617,7648,2848,8364
231180,202106,14664,40681,11993,35193,2885,8261,4534,13632,7419,21893
231190,202106,4058,11150,3341,9861,64,244,2587,7487,2651,7731
231195,202106,5228,15164,4379,13468,279,907,3160,9692,3439,10599
231200,202106,7828,23972,6873,22062,179,880,5448,16974,5627,17854
231210,202106,5015,14314,4279,13099,149,512,3317,9950,3466,10462
231220,202106,12716,31916,10055,27020,469,1264,7379,19262,7848,20526
231230,202106,9206,29062,8137,27089,547,2029,5939,19858,6486,21887
231240,202106,11686,33450,10306,30884,1623,4628,6178,18847,7801,23475
231250,202106,2184,5480,1442,3872,114,316,853,2215,967,2531
231260,202106,3338,9153,2907,8468,270,722,1973,5913,2243,6635
231270,202106,6437,16552,5173,14476,151,545,3916,10682,4067,11227
231280,202106,1784,5396,1637,5135,89,246,1233,3868,1322,4114
231290,202106,38364,112260,31936,99525,5383,16522,14674,45428,20057,61950
231300,202106,4189,11296,3302,9558,156,515,2277,6420,2433,6935
231310,202106,7683,19214,6141,16424,538,1420,4164,10876,4702,12296
231320,202106,7832,21155,6148,18211,84,372,4845,14146,4929,14518
231325,202106,2535,6371,2092,5725,173,331,1463,4145,1636,4476
231330,202106,9812,28355,8170,25118,1570,4441,4303,13970,5873,18411
231335,202106,5744,14963,4900,13634,59,272,4330,11901,4389,12173
231340,202106,18453,54852,16659,51705,1204,3669,12504,39126,13708,42795
231350,202106,15979,43198,14624,41245,237,836,13184,36871,13421,37707
231355,202106,4427,12928,3998,12128,223,700,3131,9393,3354,10093
231360,202106,7824,22939,6787,21155,288,943,5401,16797,5689,17740
231370,202106,2206,6000,1766,5207,35,107,1347,3954,1382,4061
231375,202106,4311,13289,3938,12691,119,522,3299,10507,3418,11029
231380,202106,6104,16341,5521,15545,190,464,4503,12849,4693,13313
231390,202106,3493,9913,3147,9330,111,417,2356,6786,2467,7203
231395,202106,4210,11944,3508,10837,305,955,2258,6973,2563,7928
231400,202106,9860,27912,8266,25013,251,1061,6287,18616,6538,19677
231410,202106,14992,45470,13711,43368,643,2051,11087,34975,11730,37026
240010,202106,2646,6770,2062,5744,216,595,1206,3319,1422,3914
240020,202106,12949,35332,10824,31609,635,2182,7154,20623,7789,22805
240030,202106,3080,7179,2752,6699,110,289,2379,5746,2489,6035
240040,202106,844,2388,718,2152,30,111,491,1420,521,1531
240050,202106,3404,8938,2757,7778,45,122,2110,5851,2155,5973
240060,202106,1414,3718,1158,3257,21,71,949,2617,970,2688
240070,202106,2206,6201,1994,5756,195,571,1445,4077,1640,4648
240080,202106,2967,7869,2413,6901,63,217,1815,5111,1878,5328
240090,202106,2280,5565,1864,4876,19,54,1556,4014,1575,4068
240100,202106,10454,25100,8338,21382,189,552,6592,16328,6781,16880
240110,202106,4581,12820,3845,11486,178,642,2818,8232,2996,8874
240120,202106,3406,9267,2764,8481,182,585,1991,6238,2173,6823
240130,202106,3800,7696,3145,6855,31,81,2872,6192,2903,6273
240140,202106,1786,5305,1536,4816,159,549,1041,3224,1200,3773
240145,202106,6702,18285,5480,16199,846,2544,3125,9360,3971,11904
240150,202106,982,2781,864,2545,44,136,671,1930,715,2066
240160,202106,1477,4362,1241,3922,37,152,942,2978,979,3130
240165,202106,986,2648,821,2337,21,85,684,1903,705,1988
240170,202106,2709,7061,2281,6312,218,612,1518,4136,1736,4748
240180,202106,3032,8847,2417,7606,562,1692,1053,3521,1615,5213
240185,202106,1262,3848,1167,3681,54,185,982,3084,1036,3269
240190,202106,1087,3124,936,2877,19,79,794,2459,813,2538
240200,202106,11081,27651,8823,23855,918,2604,5007,13317,5925,15921
240210,202106,3378,8149,2740,7127,23,115,2312,5815,2335,5930
240220,202106,7395,21935,6650,20780,313,1310,5307,16363,5620,17673
240230,202106,5909,14783,4729,12860,229,553,3701,10136,3930,10689
240240,202106,1830,5217,1199,3774,117,384,406,1142,523,1526
240250,202106,3073,7819,2679,7278,72,213,2302,6201,2374,6414
240260,202106,13898,40737,12057,37672,1731,5023,7370,24276,9101,29299
240270,202106,2366,6885,2082,6414,115,339,1514,4814,1629,5153
240280,202106,1745,4341,1464,3885,61,145,1153,3032,1214,3177
240290,202106,1191,3426,969,2945,25,104,691,1988,716,2092
240300,202106,2350,5888,1695,4708,73,214,1048,2857,1121,3071
240310,202106,8524,22309,6707,19085,882,2642,3410,9533,4292,12175
240320,202106,2109,5606,1529,4488,30,127,1153,3236,1183,3363
240325,202106,32173,84085,25738,73036,4215,12222,11922,33779,16137,46001
240330,202106,1827,4878,1405,4085,58,187,970,2706,1028,2893
240340,202106,1997,4533,1632,3990,56,127,1342,3229,1398,3356
240350,202106,2265,5621,2029,5354,38,95,1833,4860,1871,4955
240360,202106,9719,26016,8612,24310,890,2452,5965,17101,6855,19553
240370,202106,2031,5121,1580,4222,57,149,1125,2922,1182,3071
240375,202106,941,2327,784,2054,26,86,624,1577,650,1663
240380,202106,2251,6332,1683,5084,143,394,963,2891,1106,3285
240390,202106,1079,2539,776,1982,23,42,502,1200,525,1242
240400,202106,1539,3670,1185,3065,32,107,846,2065,878,2172
240410,202106,601,1728,492,1518,41,141,315,922,356,1063
240420,202106,4693,15927,4155,14764,451,1847,2547,8867,2998,10714
240430,202106,3519,8807,2922,7784,169,499,2185,5644,2354,6143
240440,202106,2550,5519,2164,4982,138,261,1745,4052,1883,4313
240450,202106,4624,12275,3646,10490,353,1024,2132,5918,2485,6942
240460,202106,3033,8366,2690,7815,228,689,2111,6132,2339,6821
240470,202106,3645,10824,2757,8979,619,1893,1198,4164,1817,6057
240480,202106,605,1609,405,1171,32,83,192,530,224,613
240485,202106,2252,6109,1823,5354,120,333,1250,3687,1370,4020
240490,202106,1641,4147,1294,3511,84,181,940,2588,1024,2769
240500,202106,2209,5875,1915,5369,111,289,1526,4302,1637,4591
240510,202106,1712,4468,1483,4120,77,245,1192,3276,1269,3521
240520,202106,1556,3640,1196,3157,79,184,875,2391,954,2575
240530,202106,2311,6227,2077,5864,97,281,1728,4817,1825,5098
240540,202106,2374,5788,2086,5345,65,108,1793,4644,1858,4752
240550,202106,727,1965,657,1830,14,60,564,1520,578,1580
240560,202106,3299,8423,2792,7750,270,646,2021,5767,2291,6413
240570,202106,2883,7395,1943,5377,302,819,685,1799,987,2618
240580,202106,7985,23211,7069,21526,586,1653,5587,17226,6173,18879
240590,202106,800,1942,708,1795,11,33,563,1396,574,1429
240600,202106,1866,4929,1375,3931,43,119,927,2553,970,2672
240610,202106,4277,11195,3672,10125,118,362,2855,7717,2973,8079
240615,202106,1282,3246,1032,2809,111,282,701,1885,812,2167
240620,202106,1858,5070,1604,4648,107,265,1273,3702,1380,3967
240630,202106,2080,5738,1871,5383,135,273,1331,3997,1466,4270
240640,202106,983,2570,781,2237,26,91,576,1616,602,1707
240650,202106,4133,11369,3551,10190,238,652,2667,7575,2905,8227
240660,202106,3071,7770,2729,7338,49,148,2480,6678,2529,6826
240670,202106,2520,6924,2031,5930,142,415,1325,3786,1467,4201
240680,202106,1648,4307,1340,3789,66,182,999,2761,1065,2943
240690,202106,1069,2586,840,2208,15,63,676,1703,691,1766
240700,202106,2527,7171,2062,6310,76,247,1575,4767,1651,5014
240710,202106,16517,41728,13896,37334,1711,4497,8834,23614,10545,28111
240720,202106,5186,12526,4476,11540,400,1020,3314,8485,3714,9505
240725,202106,1170,3241,893,2717,39,117,599,1767,638,1884
240730,202106,2337,6347,1864,5423,51,161,1423,4081,1474,4242
240740,202106,1912,5079,1541,4348,48,174,1130,3030,1178,3204
240750,202106,2187,7006,1857,6314,242,858,1036,3574,1278,4432
240760,202106,1713,3831,1236,3124,68,90,954,2472,1022,2562
240770,202106,3275,8917,2766,8183,124,426,2250,6589,2374,7015
240780,202106,4683,12906,3866,11553,539,1581,2363,7267,2902,8848
240790,202106,906,2498,752,2210,19,84,568,1611,587,1695
240800,202106,50223,117377,39123,100795,5097,13147,20632,53103,25729,66250
240810,202106,93087,234857,79129,212237,8488,23485,52239,137594,60727,161079
240820,202106,6080,17676,5271,16231,719,2161,3235,10158,3954,12319
240830,202106,8845,24735,7847,23271,236,917,6508,19105,6744,20022
240840,202106,1122,2732,895,2373,25,63,647,1657,672,1720
240850,202106,1449,3869,1034,2990,60,171,580,1616,640,1787
240860,202106,1377,3563,1040,2965,12,53,806,2191,818,2244
240870,202106,1106,2752,839,2307,143,407,446,1257,589,1664
240880,202106,1281,3984,1127,3685,73,309,870,2765,943,3074
240890,202106,4509,12131,3466,10191,447,1413,1773,4991,2220,6404
240895,202106,2942,8816,2715,8456,192,557,2245,7136,2437,7693
240910,202106,3569,9347,3025,8392,51,170,2485,6753,2536,6923
240920,202106,1025,2594,822,2277,96,194,452,1347,548,1541
240930,202106,3733,8311,3077,7511,228,331,2247,5868,2475,6199
240933,202106,1697,4130,1432,3754,36,139,1255,3233,1291,3372
240940,202106,6130,14967,4796,12674,560,1450,2788,7243,3348,8693
240950,202106,1097,3184,957,2930,28,115,772,2298,800,2413
240960,202106,691,2106,620,1964,25,82,481,1503,506,1585
240970,202106,1903,4834,1529,4200,59,209,1247,3332,1306,3541
240980,202106,3364,9832,2969,9131,103,452,2422,7310,2525,7762
240990,202106,2676,7324,2365,6735,236,742,1689,4640,1925,5382
241000,202106,956,2471,751,2107,29,69,560,1543,589,1612
241010,202106,2887,8941,2623,8387,170,600,1932,6115,2102,6715
241020,202106,2218,5742,1685,4705,99,265,1148,3111,1247,3376
241025,202106,1816,5098,1455,4448,39,161,1063,3184,1102,3345
241030,202106,2504,7745,2020,6721,238,783,1274,4277,1512,5060
241040,202106,2312,7126,2015,6611,81,372,1581,5149,1662,5521
241050,202106,1406,3872,1160,3425,32,113,847,2425,879,2538
241060,202106,788,2163,690,1964,33,93,481,1332,514,1425
241070,202106,694,1826,595,1663,14,39,461,1246,475,1285
241080,202106,1136,3183,873,2653,26,79,631,1893,657,1972
241090,202106,1998,5752,1632,5125,50,224,1278,3961,1328,4185
241100,202106,1222,3308,939,2746,67,187,606,1731,673,1918
241105,202106,947,2847,778,2535,237,757,256,861,493,1618
241110,202106,1015,2774,762,2248,38,101,515,1472,553,1573
241120,202106,7741,21602,6544,19517,877,2537,3943,12096,4820,14633
241140,202106,3434,8915,2661,7390,140,390,1932,5254,2072,5644
241142,202106,806,2137,596,1745,29,91,352,984,381,1075
241150,202106,6131,15447,5435,14347,167,427,4428,11578,4595,12005
241160,202106,1196,3200,956,2761,141,412,591,1656,732,2068
241170,202106,1406,3488,1190,3114,34,105,980,2478,1014,2583
241180,202106,1082,2719,810,2199,95,262,394,1070,489,1332
241190,202106,1182,3037,986,2646,15,64,728,1876,743,1940
241200,202106,20367,51827,17628,47374,2715,7225,10282,27599,12997,34824
241210,202106,1471,3813,1064,3018,107,318,608,1690,715,2008
241220,202106,9327,26334,8165,24409,1690,5011,4035,12492,5725,17503
241230,202106,2986,7745,2645,7222,117,323,2176,5898,2293,6221
241240,202106,1272,3500,825,2533,78,240,333,1028,411,1268
241250,202106,5740,16054,4607,13949,155,645,3407,9938,3562,10583
241255,202106,2375,7148,2102,6601,120,412,1593,4924,1713,5336
241260,202106,5047,12853,4024,11177,92,348,3209,8732,3301,9080
241270,202106,1682,4817,1406,4293,106,338,1003,3073,1109,3411
241280,202106,2250,5511,1934,4946,67,161,1636,4126,1703,4287
241290,202106,3406,8244,2515,6811,73,219,1972,5223,2045,5442
241300,202106,1565,4071,1266,3560,34,109,866,2369,900,2478
241310,202106,2195,5316,1893,4891,20,55,1644,4298,1664,4353
241320,202106,956,3054,820,2796,83,337,535,1807,618,2144
241330,202106,1816,4561,1428,4046,15,82,1254,3524,1269,3606
241335,202106,3404,9303,2994,8563,120,366,2433,6882,2553,7248
241340,202106,1598,4396,1255,3711,240,771,539,1519,779,2290
241350,202106,2218,5978,1943,5491,114,303,1510,4248,1624,4551
241355,202106,1351,3583,1110,3125,11,29,851,2359,862,2388
241360,202106,2080,5316,1573,4304,41,108,1162,3104,1203,3212
241370,202106,1422,3794,1111,3153,51,148,795,2189,846,2337
241380,202106,710,1881,551,1583,74,188,277,814,351,1002
241390,202106,2743,7926,2445,7487,195,525,1868,5845,2063,6370
241400,202106,3637,9935,3241,9335,145,471,2614,7476,2759,7947
241410,202106,2487,7224,2024,6278,315,1002,1079,3366,1394,4368
241415,202106,1719,4917,1433,4373,50,168,1058,3185,1108,3353
241420,202106,2472,7434,2139,6877,432,1503,1165,3754,1597,5257
241430,202106,630,1664,442,1272,15,44,287,789,302,833
241440,202106,8005,23741,7160,22265,350,1164,5703,17732,6053,18896
241445,202106,1211,2952,1068,2762,40,81,919,2469,959,2550
241450,202106,2869,6778,2416,6067,369,779,1614,4204,1983,4983
241460,202106,3995,10549,3238,9002,208,539,2215,6035,2423,6574
241470,202106,1426,3730,1173,3351,24,80,970,2772,994,2852
241475,202106,1263,3427,1002,2933,21,95,758,2115,779,2210
241480,202106,3069,9360,2520,8172,759,2449,818,2959,1577,5408
241490,202106,679,1557,532,1351,20,39,411,1032,431,1071
241500,202106,805,2213,725,2115,4,11,679,2001,683,2012
250010,202106,2664,7786,2234,6900,53,190,1637,4954,1690,5144
250020,202106,1698,4393,1239,3519,54,99,882,2520,936,2619
250030,202106,7106,19049,6277,17759,558,1542,4660,13095,5218,14637
250040,202106,4218,12401,3661,11396,279,868,2675,8211,2954,9079
250050,202106,3672,9620,3318,9159,90,326,2797,7700,2887,8026
250053,202106,1248,3381,1145,3224,82,205,848,2401,930,2606
250057,202106,697,2332,649,2260,9,40,592,2085,601,2125
250060,202106,5663,14380,5103,13688,271,683,4262,11526,4533,12209
250070,202106,4127,11216,3472,10098,26,95,2811,7996,2837,8091
250073,202106,792,2050,644,1820,12,24,512,1430,524,1454
250077,202106,2333,5997,1779,5109,53,170,1377,3911,1430,4081
250080,202106,5250,12541,4439,11524,61,218,3932,10074,3993,10292
250090,202106,3506,8209,3054,7613,58,147,2636,6470,2694,6617
250100,202106,3693,10916,3318,10240,156,499,2595,7877,2751,8376
250110,202106,4938,13633,4463,12961,254,878,3473,9937,3727,10815
250115,202106,749,1847,552,1549,12,49,419,1153,431,1202
250120,202106,1901,5412,1591,4905,24,118,1271,3884,1295,4002
250130,202106,5707,15243,4819,13977,65,340,4128,11814,4193,12154
250135,202106,1238,3352,1079,3083,16,50,948,2717,964,2767
250140,202106,2348,6650,2185,6452,103,375,1893,5581,1996,5956
250150,202106,4811,14632,4306,13778,132,523,3464,10924,3596,11447
250153,202106,1399,3636,1162,3286,36,93,920,2584,956,2677
250157,202106,1886,5349,1707,5022,61,214,1378,3993,1439,4207
250160,202106,3963,9659,3158,8585,43,145,2764,7529,2807,7674
250170,202106,1894,4817,1704,4550,24,87,1482,3903,1506,3990
250180,202106,21128,49431,18078,45581,707,2079,14431,35518,15138,37597
250190,202106,4187,10911,3526,9950,312,906,2507,6945,2819,7851
250200,202106,2060,5275,1762,4875,69,174,1472,4106,1541,4280
250205,202106,885,2676,764,2491,8,35,625,2017,633,2052
250210,202106,1574,4651,1427,4426,54,225,1136,3464,1190,3689
250215,202106,1649,4353,1377,3974,79,235,796,2343,875,2578
250220,202106,671,1828,534,1617,25,84,353,1059,378,1143
250230,202106,1721,3797,1205,3037,18,53,969,2390,987,2443
250240,202106,2453,7163,2166,6647,33,150,1866,5637,1899,5787
250250,202106,4672,12718,4081,11870,88,268,3478,10172,3566,10440
250260,202106,1707,4689,1444,4234,51,118,1142,3340,1193,3458
250270,202106,1226,3643,1116,3506,53,189,850,2748,903,2937
250280,202106,3585,9423,3210,8886,150,342,2536,7066,2686,7408
250290,202106,1553,4059,1333,3741,16,48,1068,2976,1084,3024
250300,202106,5582,14578,5020,13921,154,669,4263,11448,4417,12117
250310,202106,1199,3298,1000,2970,34,112,758,2233,792,2345
250320,202106,12678,27712,10945,25741,251,656,9873,22942,10124,23598
250330,202106,2409,6528,2029,6001,175,413,1572,4752,1747,5165
250340,202106,1172,2898,1037,2725,13,34,952,2494,965,2528
250350,202106,4270,11774,3761,10903,212,460,2948,8837,3160,9297
250355,202106,2081,6099,1867,5814,26,132,1682,5237,1708,5369
250360,202106,1824,4883,1640,4637,37,123,1387,3881,1424,4004
250370,202106,14072,35060,11710,31522,216,728,9945,26366,10161,27094
250375,202106,1214,3074,977,2791,5,18,921,2651,926,2669
250380,202106,1670,4185,1535,4016,31,112,1357,3456,1388,3568
250390,202106,1894,4738,1599,4283,74,194,1284,3415,1358,3609
250400,202106,70601,170952,52267,142950,14404,42664,13903,40539,28307,83203
250403,202106,1816,4961,1625,4739,64,321,1285,3564,1349,3885
250407,202106,1377,3230,1071,2786,102,207,678,1917,780,2124
250410,202106,681,1770,583,1611,7,15,485,1308,492,1323
250415,202106,1920,5236,1676,4854,29,130,1439,4146,1468,4276
250420,202106,1234,3330,1107,3157,27,88,1001,2838,1028,2926
250430,202106,6365,15447,5408,14196,157,436,4433,11416,4590,11852
250435,202106,1588,4389,1283,3877,10,49,987,2940,997,2989
250440,202106,4718,12212,4088,11421,74,168,3623,10131,3697,10299
250450,202106,1838,4794,1518,4358,31,103,1245,3601,1276,3704
250460,202106,7337,19652,6525,18470,380,1102,5195,14693,5575,15795
250470,202106,1558,3983,1286,3561,49,153,1026,2792,1075,2945
250480,202106,4024,10802,3422,10079,39,125,3017,8972,3056,9097
250485,202106,745,1643,555,1378,47,77,389,952,436,1029
250490,202106,5283,12301,4706,11644,163,459,4183,10172,4346,10631
250500,202106,2053,5569,1836,5197,70,206,1489,4216,1559,4422
250510,202106,5533,13672,4774,12665,77,161,4166,11160,4243,11321
250520,202106,1902,5008,1625,4618,105,309,1192,3366,1297,3675
250523,202106,2215,5433,1946,5081,68,260,1631,4116,1699,4376
250527,202106,1701,4269,1528,4077,24,63,1352,3629,1376,3692
250530,202106,655,1645,562,1507,15,37,495,1329,510,1366
250535,202106,1418,4027,1277,3768,24,97,1028,2944,1052,3041
250540,202106,3133,6937,2612,6357,80,143,2296,5706,2376,5849
250550,202106,792,2494,700,2313,20,65,523,1714,543,1779
250560,202106,1794,4880,1579,4574,37,129,1341,3809,1378,3938
250570,202106,2744,7968,2356,7270,77,259,1839,5601,1916,5860
250580,202106,1080,2764,949,2583,44,155,802,2131,846,2286
250590,202106,875,2310,777,2169,19,56,654,1816,673,1872
250600,202106,8236,21094,6857,19283,241,737,5523,15431,5764,16168
250610,202106,3006,8383,2688,7915,107,379,2231,6508,2338,6887
250620,202106,859,2179,740,1984,17,44,532,1413,549,1457
250625,202106,2452,6979,2188,6546,42,203,1871,5462,1913,5665
250630,202106,10609,28466,8681,25190,916,2673,5596,15897,6512,18570
250640,202106,3614,9576,3233,9076,83,317,2821,7810,2904,8127
250650,202106,985,2329,831,2121,14,39,730,1839,744,1878
250660,202106,1680,4086,1343,3626,42,101,1102,2905,1144,3006
250670,202106,2403,7312,2188,6940,38,163,1918,5977,1956,6140
250680,202106,5975,13648,5344,12940,51,194,4983,11893,5034,12087
250690,202106,6862,15295,5771,13944,105,225,5088,12246,5193,12471
250700,202106,4392,12217,3829,11367,525,1511,2494,7496,3019,9007
250710,202106,4436,12569,3874,11768,274,831,2829,8626,3103,9457
250720,202106,2877,7534,2581,7114,27,134,2317,6329,2344,6463
250730,202106,4229,11040,3709,10354,108,423,3124,8487,3232,8910
250740,202106,2010,4865,1663,4416,99,217,1301,3490,1400,3707
250750,202106,109709,263388,93371,240654,7273,19733,68447,173398,75720,193131
250760,202106,2425,6061,2121,5571,67,177,1734,4448,1801,4625
250770,202106,4085,12129,3662,11569,419,1233,2584,8358,3003,9591
250780,202106,1801,4746,1520,4245,66,206,1182,3231,1248,3437
250790,202106,2580,7406,2238,6900,95,382,1632,4921,1727,5303
250800,202106,2487,6463,2181,5971,98,193,1766,4903,1864,5096
250810,202106,1310,3368,1098,3070,35,67,916,2613,951,2680
250820,202106,1999,5479,1839,5305,28,118,1668,4782,1696,4900
250830,202106,6054,17846,4968,15647,269,993,3336,10220,3605,11213
250840,202106,765,2403,661,2201,17,63,497,1670,514,1733
250850,202106,1815,5267,1624,4921,30,120,1349,4004,1379,4124
250855,202106,1045,2916,902,2689,56,177,696,2073,752,2250
250860,202106,3310,9587,2736,8623,455,1465,1571,5032,2026,6497
250870,202106,1047,2833,892,2583,38,129,721,2061,759,2190
250880,202106,1645,4181,1365,3768,87,251,1044,2873,1131,3124
250890,202106,10594,26468,9362,24853,446,1466,7505,19168,7951,20634
250900,202106,3052,8016,2640,7299,104,234,2213,6079,2317,6313
250905,202106,2573,6969,2378,6702,37,125,2180,6143,2217,6268
250910,202106,6301,15156,5210,13924,65,196,4571,12266,4636,12462
250915,202106,2176,4972,1525,4272,26,53,1338,3836,1364,3889
250920,202106,3659,9079,3222,8419,272,611,2478,6475,2750,7086
250930,202106,2360,6219,2126,5919,44,189,1837,4988,1881,5177
250933,202106,1222,3529,1086,3285,24,98,864,2559,888,2657
250937,202106,730,1951,610,1755,22,72,478,1394,500,1466
250939,202106,1885,4804,1650,4507,61,149,1294,3538,1355,3687
250940,202106,4099,10712,3600,10058,19,66,3227,9027,3246,9093
250950,202106,1780,4501,1437,4053,26,96,1169,3244,1195,3340
250960,202106,1132,3282,998,3068,21,107,827,2464,848,2571
250970,202106,8375,21262,7374,19663,213,641,6091,15963,6304,16604
250980,202106,2420,6349,2189,6019,24,107,1917,5148,1941,5255
250990,202106,2095,6214,1762,5651,57,233,1321,4193,1378,4426
251000,202106,2060,5757,1667,5079,34,145,1366,4136,1400,4281
251010,202106,2747,7484,2495,7095,23,83,2240,6374,2263,6457
251020,202106,1659,4457,1488,4191,30,127,1288,3561,1318,3688
251030,202106,1064,2762,874,2433,52,130,584,1626,636,1756
251040,202106,1881,5130,1585,4632,25,116,1324,3840,1349,3956
251050,202106,1057,2853,890,2534,45,148,638,1742,683,1890
251060,202106,1106,2316,839,1983,11,32,644,1499,655,1531
251065,202106,495,1325,379,1110,8,23,263,746,271,769
251070,202106,757,1909,632,1728,7,27,544,1447,551,1474
251080,202106,19176,47739,15533,42268,2210,6145,9327,25789,11537,31934
251090,202106,2920,8209,2465,7415,58,174,1946,5833,2004,6007
251100,202106,828,2587,732,2400,24,85,579,1833,603,1918
251110,202106,1788,4638,1518,4162,68,149,1154,3177,1222,3326
251120,202106,7709,20823,6528,19401,309,1014,5136,15343,5445,16357
251130,202106,3964,8669,3489,8137,51,141,3189,7389,3240,7530
251140,202106,4383,12004,3900,11328,67,273,3251,9347,3318,9620
251150,202106,2713,7679,2476,7292,69,296,2119,6091,2188,6387
251160,202106,2239,6402,1940,5967,32,155,1674,5059,1706,5214
251170,202106,1659,4363,1454,4100,20,65,1299,3634,1319,3699
251180,202106,2692,7048,2204,6360,146,402,1547,4487,1693,4889
251190,202106,4510,11583,4079,11099,37,198,3715,9916,3752,10114
251200,202106,4469,12773,3936,12101,73,290,3471,10694,3544,10984
251203,202106,993,3120,909,2928,21,89,688,2155,709,2244
251207,202106,1141,3021,864,2582,16,70,605,1770,621,1840
251210,202106,7927,19512,6509,17596,320,657,4907,13629,5227,14286
251220,202106,1297,3011,969,2582,68,137,718,1987,786,2124
251230,202106,4787,13079,4134,11920,115,372,3259,9186,3374,9558
251240,202106,3702,10089,3114,9100,169,438,2317,6737,2486,7175
251250,202106,10861,28538,9525,26286,670,1834,7115,19149,7785,20983
251260,202106,516,1415,468,1338,14,59,375,1040,389,1099
251270,202106,4344,13311,3894,12696,103,409,3184,10593,3287,11002
251272,202106,1334,3611,1216,3454,60,199,1009,2812,1069,3011
251274,202106,921,2525,736,2191,59,189,482,1377,541,1566
251275,202106,1229,3435,1043,3132,29,116,820,2392,849,2508
251276,202106,1342,3621,1168,3390,23,119,955,2679,978,2798
251278,202106,620,1664,560,1575,41,107,428,1219,469,1326
251280,202106,2284,6070,2079,5767,52,138,1750,4826,1802,4964
251290,202106,6272,14179,5695,13488,173,477,5020,11584,5193,12061
251300,202106,894,2589,808,2460,9,46,683,2065,692,2111
251310,202106,2853,7889,2485,7334,31,166,2077,6000,2108,6166
251315,202106,1797,5451,1630,5126,119,321,1215,3820,1334,4141
251320,202106,1660,4350,1220,3587,29,96,912,2637,941,2733
251330,202106,2140,4939,1771,4505,25,73,1580,4056,1605,4129
251335,202106,1128,3129,1010,2951,22,95,889,2548,911,2643
251340,202106,3829,8962,3065,7962,127,323,2359,6145,2486,6468
251350,202106,1084,3038,988,2880,29,88,810,2339,839,2427
251360,202106,1883,5144,1524,4630,10,58,1261,3835,1271,3893
251365,202106,772,2028,603,1702,5,14,482,1343,487,1357
251370,202106,25248,65159,21596,59986,3070,8389,12582,36167,15652,44556
251380,202106,1291,3510,1101,3188,14,82,941,2659,955,2741
251385,202106,777,1963,603,1650,23,61,448,1186,471,1247
251390,202106,6532,18626,5770,17440,528,1568,3833,11723,4361,13291
251392,202106,1010,2698,857,2465,27,106,676,1909,703,2015
251394,202106,640,1802,517,1589,29,88,371,1136,400,1224
251396,202106,668,1798,568,1617,14,37,398,1107,412,1144
251398,202106,1033,2552,731,2028,17,55,553,1502,570,1557
251400,202106,1324,3062,1044,2684,22,78,851,2117,873,2195
251410,202106,1588,3662,1280,3227,21,79,1083,2631,1104,2710
251420,202106,2003,5142,1646,4719,37,120,1318,3741,1355,3861
251430,202106,1589,4709,1430,4433,28,135,1235,3810,1263,3945
251440,202106,1114,3067,903,2675,42,95,697,2108,739,2203
251445,202106,1576,4314,1453,4144,30,90,1250,3517,1280,3607
251450,202106,4429,12931,3963,12218,80,292,3305,10119,3385,10411
251455,202106,880,2617,804,2477,17,68,649,1958,666,2026
251460,202106,972,2713,835,2506,14,45,687,2071,701,2116
251465,202106,465,1325,400,1203,6,26,304,888,310,914
251470,202106,1210,3269,917,2676,76,227,527,1481,603,1708
251480,202106,1035,2653,849,2328,13,47,659,1729,672,1776
251490,202106,1945,5022,1553,4476,74,204,1154,3357,1228,3561
251500,202106,2021,5535,1856,5329,36,129,1683,4823,1719,4952
251510,202106,2734,8005,2287,7131,119,388,1575,4804,1694,5192
251520,202106,1056,2664,820,2239,72,181,529,1414,601,1595
251530,202106,15032,35399,12116,31785,87,459,10769,27789,10856,28248
251540,202106,3118,8634,2796,8060,66,232,2380,6769,2446,7001
251550,202106,3954,9056,3188,8122,133,210,2629,6812,2762,7022
251560,202106,563,1699,502,1605,54,183,351,1090,405,1273
251570,202106,971,2686,798,2346,21,93,638,1828,659,1921
251580,202106,1997,4716,1790,4424,35,127,1541,3666,1576,3793
251590,202106,1640,3953,1386,3655,64,158,1149,2989,1213,3147
251593,202106,945,2736,850,2575,90,274,544,1648,634,1922
251597,202106,2138,5922,1918,5631,19,102,1720,4979,1739,5081
251600,202106,6470,17170,5645,15916,194,543,4633,12928,4827,13471
251610,202106,3160,8966,2740,8195,242,641,1866,5715,2108,6356
251615,202106,1331,3229,1071,2840,21,61,868,2228,889,2289
251620,202106,19601,43983,15044,38410,76,261,13028,33580,13104,33841
251630,202106,4897,11224,3944,9910,207,501,2956,7386,3163,7887
251640,202106,2287,6016,2045,5648,21,95,1830,4951,1851,5046
251650,202106,4014,10645,3483,9953,131,385,2923,8371,3054,8756
251660,202106,3620,10591,3200,9871,61,262,2665,8110,2726,8372
251670,202106,4197,11517,3711,10820,39,186,3342,9688,3381,9874
251675,202106,700,1875,631,1792,92,232,431,1256,523,1488
251680,202106,2611,6670,2186,6122,42,128,1797,5075,1839,5203
251690,202106,3152,8753,2690,7969,78,228,2058,6068,2136,6296
251700,202106,2263,6158,1881,5687,44,178,1598,4742,1642,4920
251710,202106,810,2049,570,1563,36,114,337,871,373,985
251720,202106,1345,3748,1092,3315,18,80,851,2503,869,2583
251740,202106,608,1684,485,1451,40,148,326,934,366,1082
260005,202106,30334,63447,25046,56674,1810,3940,19077,42429,20887,46369
260010,202106,10514,26988,8681,24053,485,1367,5160,14401,5645,15768
260020,202106,6977,16006,5885,14451,64,279,5029,12132,5093,12411
260030,202106,6999,17521,5902,15935,126,373,4818,12930,4944,13303
260040,202106,7820,19366,6603,17637,404,1045,4857,13149,5261,14194
260050,202106,14199,36294,11831,33682,214,676,10880,31130,11094,31806
260060,202106,4284,10208,3684,9271,279,553,2779,7182,3058,7735
260070,202106,10913,26791,9360,24596,293,991,7643,19550,7936,20541
260080,202106,6562,14856,5710,13728,111,338,4803,11362,4914,11700
260090,202106,4795,12087,4285,11390,389,1008,3225,8623,3614,9631
260100,202106,3012,8029,2535,7318,34,170,2129,6055,2163,6225
260105,202106,5067,13693,4547,12993,118,388,3871,10921,3989,11309
260110,202106,22636,61863,20183,58319,853,2822,16794,47891,17647,50713
260120,202106,14732,38234,12451,34900,1435,3867,8028,22865,9463,26732
260130,202106,3240,8028,2869,7491,236,556,2128,5522,2364,6078
260140,202106,12984,28907,11186,26795,501,1353,9480,22357,9981,23710
260150,202106,3593,8286,3109,7691,91,220,2735,6738,2826,6958
260160,202106,6658,17016,5657,15808,94,305,5133,14456,5227,14761
260170,202106,21099,48494,17948,44257,914,2162,14393,35174,15307,37336
260180,202106,3596,9335,3110,8674,71,252,2696,7409,2767,7661
260190,202106,18392,36592,15535,33247,200,465,13820,29077,14020,29542
260200,202106,11310,26630,9763,24664,504,1034,8159,20992,8663,22026
260210,202106,11675,32573,9935,29750,288,1019,7945,23679,8233,24698
260220,202106,10942,25192,10102,24135,173,454,9012,21243,9185,21697
260230,202106,11024,26315,9605,24443,191,506,8148,20459,8339,20965
260240,202106,2813,8248,2464,7587,90,303,1907,5802,1997,6105
260250,202106,2274,5780,1994,5343,123,237,1542,4162,1665,4399
260260,202106,12916,32872,11501,30747,370,1143,9219,24219,9589,25362
260270,202106,4432,10452,3895,9825,98,357,3314,8222,3412,8579
260280,202106,13031,38279,11754,36468,405,1646,10072,30797,10477,32443
260290,202106,42003,103770,36181,95510,3831,10242,24759,65149,28590,75391
260300,202106,9756,25851,8534,24211,166,667,7298,20621,7464,21288
260310,202106,5576,13659,4909,12827,345,750,3786,10102,4131,10852
260320,202106,7967,22466,6770,20447,226,650,5545,16807,5771,17457
260330,202106,2609,7858,2284,7195,59,193,1818,5595,1877,5788
260340,202106,2100,5517,1826,5117,23,96,1606,4405,1629,4501
260345,202106,26433,66335,22096,60131,3361,9610,11688,31223,15049,40833
260350,202106,5794,13187,5010,12297,51,143,4505,10987,4556,11130
260360,202106,2610,6600,2355,6148,44,144,1708,4371,1752,4515
260370,202106,5682,15850,4891,14545,204,600,3812,11268,4016,11868
260380,202106,5154,14737,4423,13545,166,485,3384,10280,3550,10765
260390,202106,4766,13915,3949,12262,221,597,2656,8155,2877,8752
260392,202106,3555,10954,3219,10539,88,528,2682,8755,2770,9283
260400,202106,19312,43350,16668,39934,449,1149,13331,30804,13780,31953
260410,202106,76020,179837,59356,156876,10569,28944,26430,72277,36999,101221
260415,202106,4485,11697,3872,10724,45,169,3235,8812,3280,8981
260420,202106,12680,26214,10791,24132,86,243,10049,22293,10135,22536
260430,202106,2813,8542,2419,7765,118,411,1687,5360,1805,5771
260440,202106,3817,9583,3398,8979,65,204,2914,7588,2979,7792
260450,202106,5870,14439,5253,13646,286,543,4372,11583,4658,12126
260460,202106,5383,15482,4593,14118,475,1595,2800,8468,3275,10063
260470,202106,4982,12928,4206,12039,76,154,3857,11197,3933,11351
260480,202106,4119,10582,3471,9670,256,769,2411,6803,2667,7572
260490,202106,5418,12315,4809,11444,28,126,4396,10297,4424,10423
260500,202106,6211,15161,5307,13903,405,927,3783,10079,4188,11006
260510,202106,10092,24395,8480,22146,92,338,7514,19443,7606,19781
260515,202106,4546,11814,3579,10046,152,370,2460,6718,2612,7088
260520,202106,16933,38512,14745,35762,698,1619,12143,29119,12841,30738
260530,202106,9974,28163,8508,25919,117,550,7366,22162,7483,22712
260540,202106,7370,15846,6517,14773,142,324,5884,13263,6026,13587
260545,202106,72,218,47,158,3,12,21,67,24,79
260550,202106,3216,8563,2617,7596,133,426,1821,5171,1954,5597
260560,202106,6119,15380,5151,13983,112,396,4345,11597,4457,11993
260570,202106,8003,21007,7079,19769,338,971,5733,16059,6071,17030
260580,202106,4570,10676,4114,10076,24,72,3770,9186,3794,9258
260590,202106,7200,15722,6091,14503,222,477,5207,12501,5429,12978
260600,202106,31995,80639,26138,71877,1019,2983,20086,54196,21105,57179
260610,202106,7668,19264,6844,18195,426,1107,5135,13687,5561,14794
260620,202106,17373,43415,15245,40418,1245,3615,11270,29289,12515,32904
260630,202106,2451,6491,2005,5805,42,133,1635,4654,1677,4787
260640,202106,22959,50221,19253,45984,805,1885,15777,37452,16582,39337
260650,202106,6427,16195,5177,14683,482,868,4141,12224,4623,13092
260660,202106,7124,18177,6191,16953,217,725,5314,14321,5531,15046
260670,202106,2314,5932,1913,5297,78,198,1355,3656,1433,3854
260680,202106,29639,69489,25009,62991,1860,4769,17554,43507,19414,48276
260690,202106,3601,9180,3012,8271,66,241,2390,6514,2456,6755
260700,202106,6439,17512,5952,16960,20,67,5773,16536,5793,16603
260710,202106,1394,3583,1189,3277,32,115,941,2595,973,2710
260720,202106,26486,61799,22461,56759,2148,5191,16240,41628,18388,46819
260730,202106,8093,22471,7087,21091,231,742,5979,17596,6210,18338
260740,202106,1341,3780,1133,3439,13,59,900,2797,913,2856
260750,202106,7275,19621,6008,18063,237,466,5239,16272,5476,16738
260760,202106,6024,13667,5195,12708,171,399,4373,10744,4544,11143
260765,202106,8482,23577,7379,22063,340,1277,5325,15597,5665,16874
260770,202106,4003,9946,3330,8839,116,351,2632,6883,2748,7234
260775,202106,5400,14026,4743,13061,174,587,3750,10007,3924,10594
260780,202106,3818,10992,3415,10357,399,1244,2109,6290,2508,7534
260790,202106,124219,272538,102898,245299,15440,35442,63852,152876,79292,188318
260795,202106,3053,7591,2615,7040,83,252,2093,5685,2176,5937
260800,202106,5499,12490,4963,11768,179,474,4318,9943,4497,10417
260805,202106,3757,10276,3193,9317,202,597,2347,6802,2549,7399
260810,202106,6745,17683,5943,16179,430,1045,4415,11846,4845,12891
260820,202106,4635,10517,4131,9939,94,290,3467,8208,3561,8498
260825,202106,3056,8805,2691,8173,109,340,2038,6136,2147,6476
260830,202106,4289,12227,3558,10938,481,1267,2228,7126,2709,8393
260840,202106,4304,10907,3852,10298,216,495,3242,8712,3458,9207
260845,202106,4631,11815,4102,10932,245,672,3099,8102,3344,8774
260850,202106,5322,14070,4462,12484,347,1017,2880,7789,3227,8806
260860,202106,3446,9652,2962,8835,99,319,2390,6974,2489,7293
260870,202106,4589,10848,3937,10057,64,234,3524,8893,3588,9127
260875,202106,7586,17876,6194,15870,537,1316,4313,11182,4850,12498
260880,202106,9871,27212,8598,25072,433,1252,6770,19732,7203,20984
260890,202106,13322,33208,11577,30597,667,1793,8411,21729,9078,23522
260900,202106,5578,15014,4599,13662,294,893,3147,9333,3441,10226
260910,202106,3340,8846,2908,8206,105,292,2300,6455,2405,6747
260915,202106,5120,14894,4493,14171,51,228,4110,12987,4161,13215
260920,202106,3576,8311,3037,7725,125,232,2577,6669,2702,6901
260930,202106,4076,12020,3531,11075,162,568,2722,8320,2884,8888
260940,202106,15328,35565,13357,32866,1094,2622,10002,24291,11096,26913
260950,202106,7404,19122,5992,16747,358,1179,3959,10496,4317,11675
260960,202106,73885,160151,59722,142283,6140,14737,38951,91744,45091,106481
260970,202106,5954,14968,5294,14091,271,547,3922,10737,4193,11284
260980,202106,4711,13351,4136,12639,54,169,3780,11662,3834,11831
260990,202106,18866,49566,16000,45667,816,2267,12618,35714,13434,37981
261000,202106,16885,38565,14229,35258,414,1202,11505,27913,11919,29115
261010,202106,2391,6152,2105,5776,93,195,1814,5036,1907,5231
261020,202106,6479,16652,5628,15271,248,674,4653,12329,4901,13003
261030,202106,4160,11796,3664,10930,112,424,2934,8517,3046,8941
261040,202106,5555,15555,4546,13685,145,518,3496,10228,3641,10746
261050,202106,8238,20428,7475,19293,398,690,5919,15401,6317,16091
261060,202106,14616,35719,12757,33496,250,763,10761,27950,11011,28713
261070,202106,67814,144501,56320,129548,3220,6959,42873,96691,46093,103650
261080,202106,6950,16203,6317,15437,142,314,5852,14295,5994,14609
261090,202106,20102,46093,17898,43254,350,1005,15729,37417,16079,38422
261100,202106,8783,23275,7693,21675,518,1440,5751,16249,6269,17689
261110,202106,70187,190408,59065,170456,7833,23639,35277,100425,43110,124064
261120,202106,3683,9109,3204,8449,72,168,2775,7313,2847,7481
261130,202106,7519,17928,6614,16741,123,357,5852,14680,5975,15037
261140,202106,3844,8646,3429,8105,193,466,2700,6299,2893,6765
261150,202106,5342,13754,4732,12847,86,283,4080,10964,4166,11247
261153,202106,1947,5764,1643,5178,59,185,1105,3510,1164,3695
261160,202106,222083,501346,180801,445457,43000,108854,76268,191672,119268,300526
261170,202106,6519,15372,5783,14351,249,508,4794,11841,5043,12349
261180,202106,9763,23749,8523,22148,486,1129,6216,16372,6702,17501
261190,202106,4741,13402,4255,12617,141,614,3428,9865,3569,10479
261200,202106,3441,7763,3045,7235,198,467,2497,5862,2695,6329
261210,202106,1965,4703,1686,4311,74,186,1394,3512,1468,3698
261220,202106,14173,38834,11928,34839,1414,4325,7014,20195,8428,24520
261230,202106,4156,11582,3479,10674,39,139,2925,9071,2964,9210
261240,202106,5586,13511,4919,12483,308,698,3997,10086,4305,10784
261245,202106,3890,10532,3255,9428,69,315,2616,7296,2685,7611
261247,202106,3090,8924,2580,8026,143,446,1827,5634,1970,6080
261250,202106,23653,52324,20565,48767,2627,5593,14479,35657,17106,41250
261255,202106,4230,12081,3478,10632,127,502,2691,8036,2818,8538
261260,202106,13072,34376,11420,32228,306,1114,9960,27811,10266,28925
261270,202106,4650,10980,4063,10253,194,444,3350,8455,3544,8899
261280,202106,2577,7079,2265,6553,60,203,1815,5109,1875,5312
261290,202106,3006,7642,2514,7086,58,207,2047,5832,2105,6039
261300,202106,12980,34997,11103,31889,505,1766,8351,23379,8856,25145
261310,202106,9247,22717,7924,20949,575,1625,5939,15386,6514,17011
261320,202106,6196,16968,5414,15693,75,294,4637,13267,4712,13561
261330,202106,5840,14108,5266,13364,112,395,4606,11458,4718,11853
261340,202106,4400,11879,3831,11161,122,436,3223,9274,3345,9710
261350,202106,8904,25769,7868,24013,114,453,6414,19384,6528,19837
261360,202106,8370,19593,7083,17786,240,620,5702,13960,5942,14580
261370,202106,24748,60223,20772,54840,2329,5761,13387,35863,15716,41624
261380,202106,4239,12354,3746,11523,424,1371,2519,7677,2943,9048
261390,202106,17256,47820,14612,43625,1154,3708,9809,28989,10963,32697
261400,202106,4716,14581,4131,13313,189,729,3107,9771,3296,10500
261410,202106,9905,24109,8159,21474,372,1077,6583,16891,6955,17968
261420,202106,7608,21993,6864,21086,686,2347,4989,15315,5675,17662
261430,202106,3569,9786,3041,8960,50,199,2570,7461,2620,7660
261440,202106,1508,4391,1257,3925,47,206,898,2691,945,2897
261450,202106,14987,39848,13252,37219,160,555,10976,30969,11136,31524
261460,202106,7871,20956,6916,19482,290,829,5552,15627,5842,16456
261470,202106,4252,10341,3673,9545,26,105,3193,8263,3219,8368
261480,202106,5229,15624,4511,14433,203,763,3509,11040,3712,11803
261485,202106,5135,14138,4462,13116,348,1098,3294,9566,3642,10664
261500,202106,6240,15467,5449,14397,396,874,3791,10451,4187,11325
261510,202106,1945,5657,1694,5246,59,212,1297,4040,1356,4252
261520,202106,2387,7184,2151,6707,59,199,1597,4954,1656,5153
261530,202106,12508,35318,10185,31212,828,2911,5434,15966,6262,18877
261540,202106,8670,23844,7842,22675,1220,3314,4399,13573,5619,16887
261550,202106,3769,9825,3260,9045,242,705,2348,6389,2590,7094
261560,202106,8146,23217,7102,21672,295,992,5573,17008,5868,18000
261570,202106,3561,9457,2842,8298,167,551,1975,5693,2142,6244
261580,202106,7024,18042,6075,16757,95,428,5479,14917,5574,15345
261590,202106,2795,7018,2283,6300,76,232,1723,4723,1799,4955
261600,202106,5460,13163,4650,11994,286,586,3332,8777,3618,9363
261610,202106,2179,6180,1747,5381,114,412,1157,3542,1271,3954
261618,202106,2607,6300,2283,5833,80,187,1848,4693,1928,4880
261620,202106,4264,11791,3881,11222,742,1903,2544,7684,3286,9587
261630,202106,6216,17275,5295,15563,370,1226,3533,10029,3903,11255
261640,202106,38511,84224,32839,77317,1963,3472,24842,60519,26805,63991
261650,202106,4325,10404,3684,9588,171,449,2800,7260,2971,7709
270010,202106,4518,14738,3913,13708,120,674,3168,10791,3288,11465
270020,202106,4007,9813,3515,9188,127,398,3021,7716,3148,8114
270030,202106,34837,92843,29072,83664,3317,9440,19896,57070,23213,66510
270040,202106,11282,28934,9715,27074,381,1147,8189,22723,8570,23870
270050,202106,5648,12876,4811,11930,351,671,4080,10361,4431,11032
270060,202106,2312,5734,1941,5309,167,381,1528,4270,1695,4651
270070,202106,4782,13201,4149,12325,111,409,3491,10192,3602,10601
270080,202106,1491,4000,1267,3623,45,130,983,2726,1028,2856
270090,202106,1827,5438,1645,5090,46,182,1382,4185,1428,4367
270100,202106,5804,14525,5032,13414,204,599,4213,11049,4417,11648
270110,202106,3359,7571,2727,6851,145,291,2170,5742,2315,6033
270120,202106,2702,7376,2349,6897,62,261,1983,5718,2045,5979
270130,202106,5227,13120,4545,12300,146,422,3903,10592,4049,11014
270135,202106,2067,4882,1752,4532,30,102,1617,4148,1647,4250
270140,202106,9821,22668,7897,20017,345,1005,6197,15044,6542,16049
270150,202106,2697,8073,2456,7727,3,19,2318,7277,2321,7296
270160,202106,6261,16628,5322,15560,108,367,4890,14354,4998,14721
270170,202106,3428,9849,2887,9096,164,733,2204,6663,2368,7396
270180,202106,2286,7021,2099,6785,37,181,1902,6077,1939,6258
270190,202106,1774,5023,1582,4791,21,102,1432,4313,1453,4415
270200,202106,2519,7488,2199,7040,84,270,1652,5290,1736,5560
270210,202106,5899,13556,5034,12570,56,196,4663,11492,4719,11688
270220,202106,1697,4276,1353,3784,177,502,854,2358,1031,2860
270230,202106,9571,25775,7984,23343,749,2252,5694,16664,6443,18916
270235,202106,6035,18121,5225,16844,130,474,4395,14059,4525,14533
270240,202106,11433,30193,9416,27417,930,2728,6712,19755,7642,22483
270250,202106,2934,7110,2585,6620,177,416,2100,5378,2277,5794
270255,202106,4576,12873,3618,11157,110,414,2797,8490,2907,8904
270260,202106,5620,16446,5091,15571,95,445,4464,13384,4559,13829
270270,202106,1089,2758,909,2535,106,282,667,1879,773,2161
270280,202106,3939,9345,3168,8385,516,771,2209,6375,2725,7146
270290,202106,7785,24092,7015,22845,125,626,6201,19953,6326,20579
270300,202106,4370,11098,3410,10055,188,448,2648,8036,2836,8484
270310,202106,7154,19593,6162,18067,72,384,5358,15367,5430,15751
270320,202106,5646,16375,4897,14938,329,1023,3571,10606,3900,11629
270330,202106,4104,12949,3646,12248,232,913,2883,9643,3115,10556
270340,202106,1621,4252,1400,3961,43,123,1202,3356,1245,3479
270350,202106,1923,4410,1568,4000,128,342,1137,2931,1265,3273
270360,202106,2724,6641,2435,6319,90,182,2243,5873,2333,6055
270370,202106,1440,4336,1316,4114,31,139,1133,3489,1164,3628
270375,202106,3176,7336,2649,6759,23,64,2485,6357,2508,6421
270380,202106,5686,15383,4799,14259,531,1442,3378,10386,3909,11828
270390,202106,1257,3111,1018,2834,16,60,860,2411,876,2471
270400,202106,6670,16904,5621,15353,235,545,4535,12343,4770,12888
270410,202106,4776,13493,4150,12551,133,455,3502,10546,3635,11001
270420,202106,5802,16697,5210,15838,115,493,4552,13591,4667,14084
270430,202106,138639,322272,109056,284571,20820,56019,52161,138678,72981,194697
270440,202106,4842,12756,4202,11977,78,298,3725,10518,3803,10816
270450,202106,7308,19065,6412,17985,274,783,5352,15286,5626,16069
270460,202106,3821,8370,3267,7710,164,297,2933,6968,3097,7265
270470,202106,11283,30743,9846,28732,607,1925,7724,22553,8331,24478
270480,202106,3018,7826,2546,7151,90,312,2090,5761,2180,6073
270490,202106,961,2602,840,2454,51,145,677,1976,728,2121
270500,202106,5023,15018,4465,14091,261,930,3554,11084,3815,12014
270510,202106,5779,14883,4872,13745,363,1221,3662,9999,4025,11220
270520,202106,4208,11595,3353,10168,710,2191,1354,4353,2064,6544
270530,202106,1342,3752,1132,3425,58,157,804,2477,862,2634
270540,202106,2312,6369,1991,5952,54,193,1742,5153,1796,5346
270550,202106,6961,17607,5557,16054,708,1623,3994,12116,4702,13739
270560,202106,3060,7712,2597,7088,162,477,2083,5622,2245,6099
270570,202106,4278,11602,3642,10661,240,623,2895,8528,3135,9151
270580,202106,2323,6452,2101,6139,110,319,1799,5230,1909,5549
270590,202106,1612,4831,1486,4660,14,69,1404,4393,1418,4462
270600,202106,2796,8508,2533,8113,43,210,2258,7160,2301,7370
270610,202106,3713,9507,3220,8856,95,250,2868,7868,2963,8118
270620,202106,1295,3797,1195,3613,22,83,1042,3068,1064,3151
270630,202106,17883,43029,15410,39652,651,1909,12895,32548,13546,34457
270640,202106,5556,15557,4871,14467,167,633,4054,11855,4221,12488
270642,202106,2577,8164,2286,7712,156,612,1742,5785,1898,6397
270644,202106,3760,9203,3106,8362,383,877,2227,6253,2610,7130
270650,202106,3279,9340,2874,8792,309,999,2158,6586,2467,7585
270660,202106,2031,5102,1741,4695,81,250,1333,3548,1414,3798
270670,202106,16990,38138,14187,34712,378,1023,12210,29200,12588,30223
270680,202106,5710,13288,5114,12642,122,181,4788,11989,4910,12170
270690,202106,9575,23136,8038,21202,356,951,6510,17037,6866,17988
270700,202106,537,1581,472,1469,34,108,349,1068,383,1176
270710,202106,5660,16566,5034,15601,255,868,4037,12397,4292,13265
270720,202106,3696,10534,3296,9869,57,287,2934,8628,2991,8915
270730,202106,8381,18029,7360,16941,320,518,5750,14731,6070,15249
270740,202106,2411,6226,2125,5893,84,269,1776,4875,1860,5144
270750,202106,5846,14973,5117,14061,59,238,4577,12484,4636,12722
270760,202106,3368,9302,2890,8661,52,222,2432,7239,2484,7461
270770,202106,21484,51912,17273,46738,2856,6854,10445,29971,13301,36825
270780,202106,1891,4948,1745,4744,55,177,1559,4191,1614,4368
270790,202106,1716,4520,1444,4144,112,331,1082,3083,1194,3414
270800,202106,11317,30064,10217,28505,355,1156,8786,24246,9141,25402
270810,202106,3432,9546,2724,8383,169,582,1920,5822,2089,6404
270820,202106,1648,4801,1403,4417,45,204,1120,3459,1165,3663
270830,202106,5203,12384,4217,11169,157,512,3439,8946,3596,9458
270840,202106,8507,24923,7584,23606,150,771,6642,20220,6792,20991
270850,202106,9113,21287,8051,20038,742,1871,6587,16296,7329,18167
270860,202106,14830,32096,11786,28687,579,1217,9613,23413,10192,24630
270870,202106,2289,6248,1885,5608,260,697,1187,3723,1447,4420
270880,202106,8173,24200,7298,22880,208,856,6124,18905,6332,19761
270890,202106,3093,8175,2597,7470,196,576,1789,5132,1985,5708
270895,202106,3243,9607,2927,9200,69,367,2611,8052,2680,8419
270900,202106,1795,4549,1368,3876,31,88,1086,3048,1117,3136
270910,202106,4080,11500,3536,10655,92,276,2957,8795,3049,9071
270915,202106,9940,27539,8063,24513,645,2183,5556,16519,6201,18702
270920,202106,5653,16440,5146,15619,86,385,4441,13141,4527,13526
270930,202106,17732,40121,13741,35495,1740,3959,9227,25273,10967,29232
270940,202106,6755,17210,5696,15935,186,696,4557,12375,4743,13071
280010,202106,695,1890,558,1610,15,62,400,1056,415,1118
280020,202106,5044,12484,4256,11247,395,993,2973,7886,3368,8879
280030,202106,79198,181511,63283,159298,12575,31465,29713,77448,42288,108913
280040,202106,3006,8081,2627,7514,257,699,1819,5228,2076,5927
280050,202106,4051,11328,3464,10432,640,1937,1923,5820,2563,7757
280060,202106,6276,15795,4987,13839,884,2572,2445,7039,3329,9611
280067,202106,7169,17184,6098,15552,293,752,4515,11366,4808,12118
280070,202106,1883,5542,1748,5329,116,359,1451,4394,1567,4753
280100,202106,4107,10604,3455,9593,344,955,2330,6503,2674,7458
280110,202106,1491,3829,1311,3562,15,59,1175,3118,1190,3177
280120,202106,7683,21686,6845,20356,779,2074,4934,15116,5713,17190
280130,202106,9171,21171,8018,19581,410,1042,6481,15723,6891,16765
280140,202106,5635,13117,4964,12204,258,678,4121,10081,4379,10759
280150,202106,4309,10605,3741,9833,456,1040,2734,7354,3190,8394
280160,202106,1211,3419,1024,3114,93,319,702,2083,795,2402
280170,202106,5318,13653,4775,12974,263,617,3841,10515,4104,11132
280190,202106,1342,2864,1199,2677,49,113,1014,2217,1063,2330
280200,202106,1293,3314,1076,3014,61,201,822,2264,883,2465
280210,202106,17635,42140,15355,38936,1693,4173,9878,25146,11571,29319
280220,202106,1751,4620,1501,4293,46,189,1243,3527,1289,3716
280230,202106,4545,11036,3784,9915,338,684,2605,6983,2943,7667
280240,202106,3392,8884,3019,8321,36,182,2626,7056,2662,7238
280250,202106,955,2223,793,1979,85,215,549,1338,634,1553
280260,202106,2295,5387,2016,5035,39,87,1828,4613,1867,4700
280270,202106,2506,6607,2226,6189,168,418,1780,4981,1948,5399
280280,202106,4227,12252,3760,11556,539,1411,2562,8294,3101,9705
280290,202106,18895,48155,16239,44432,1359,3800,10949,30176,12308,33976
280300,202106,12621,29026,11052,27345,339,766,8081,22134,8420,22900
280310,202106,1424,3596,1191,3214,41,120,900,2376,941,2496
280320,202106,8909,23390,7719,21620,990,2585,5115,14337,6105,16922
280330,202106,4796,11628,4090,10657,250,672,3005,7839,3255,8511
280340,202106,5677,11759,4720,10717,272,420,4037,9412,4309,9832
280350,202106,26650,61186,23455,56994,1067,2636,18709,44727,19776,47363
280360,202106,5717,15525,5011,14367,689,1973,2993,8797,3682,10770
280370,202106,2228,5345,1866,4754,87,165,1469,3716,1556,3881
280380,202106,1033,2664,876,2455,77,204,592,1694,669,1898
280390,202106,3773,8964,3202,8092,185,375,2514,6409,2699,6784
280400,202106,3968,9702,3448,9002,541,1236,2159,5933,2700,7169
280410,202106,2454,6495,2020,5826,162,460,1257,3566,1419,4026
280420,202106,4407,11446,4066,11017,69,249,3745,10093,3814,10342
280430,202106,2135,5061,1877,4728,63,194,1541,3766,1604,3960
280440,202106,4417,11325,3904,10571,137,431,3323,8777,3460,9208
280445,202106,2430,6051,2179,5633,52,123,1680,4196,1732,4319
280450,202106,10371,23934,8995,22079,1112,2323,5789,14972,6901,17295
280460,202106,7093,16285,6415,15370,413,855,5369,12846,5782,13701
280470,202106,1728,4774,1473,4304,86,265,1074,3081,1160,3346
280480,202106,45474,107334,39315,98706,3222,8345,27948,68760,31170,77105
280490,202106,3825,10726,3286,9810,95,369,2558,7427,2653,7796
280500,202106,1025,2381,884,2196,22,56,756,1851,778,1907
280510,202106,2690,6489,2331,6000,64,213,1852,4639,1916,4852
280520,202106,1742,4236,1534,3951,86,196,1217,3110,1303,3306
280530,202106,2504,6152,2188,5714,210,444,1630,4342,1840,4786
280540,202106,8949,23597,8150,22450,250,778,7150,19502,7400,20280
280550,202106,6662,15237,5523,13649,159,544,4609,10997,4768,11541
280560,202106,7513,20137,7051,19454,114,400,6281,17106,6395,17506
280570,202106,6586,15721,5345,14172,234,671,3947,10567,4181,11238
280580,202106,5882,14995,5141,13923,545,1256,3707,10216,4252,11472
280590,202106,2941,6569,2524,6080,116,390,2000,4621,2116,5011
280600,202106,3749,9537,3337,8969,286,674,2346,6389,2632,7063
280610,202106,2532,6075,2280,5704,134,334,1875,4650,2009,4984
280620,202106,5663,13405,4873,12371,426,894,3439,9121,3865,10015
280630,202106,3996,10711,3682,10286,204,585,2998,8371,3202,8956
280640,202106,2379,6266,2103,5954,48,138,1886,5370,1934,5508
280650,202106,1233,3200,1007,2863,85,281,727,1976,812,2257
280660,202106,3845,8168,3299,7540,275,436,2685,6337,2960,6773
280670,202106,20244,45309,17477,41760,1387,3187,13337,31858,14724,35045
280680,202106,2826,6635,2436,6086,237,436,1751,4483,1988,4919
280690,202106,999,2335,849,2148,53,121,678,1684,731,1805
280700,202106,1197,2938,1034,2697,21,55,821,2108,842,2163
280710,202106,15710,34531,13336,31835,617,1046,11197,27533,11814,28579
280720,202106,2718,6127,2266,5586,42,137,1682,4294,1724,4431
280730,202106,1115,2790,989,2596,60,155,736,1879,796,2034
280740,202106,14735,34643,12655,31521,902,2244,9138,22300,10040,24544
280750,202106,3710,10114,3222,9288,191,568,2334,6634,2525,7202
280760,202106,6716,17154,5859,15861,629,1511,3813,10718,4442,12229
290010,202106,3221,6683,2104,4964,5,17,1746,3960,1751,3977
290020,202106,5443,14203,4958,13596,342,624,4176,11866,4518,12490
290030,202106,4787,10626,3864,9620,186,407,3247,8215,3433,8622
290035,202106,5314,11249,4403,10080,354,520,3507,8364,3861,8884
290040,202106,4391,10334,3729,9541,132,317,2878,7866,3010,8183
290050,202106,2095,6611,1762,5902,101,407,1229,4014,1330,4421
290060,202106,1380,3155,1022,2612,135,316,634,1640,769,1956
290070,202106,38260,81990,32957,75460,1846,4319,25757,58299,27603,62618
290080,202106,5339,15381,4629,14328,479,1518,3190,10044,3669,11562
290090,202106,2208,4191,1552,3492,16,43,1413,3169,1429,3212
290100,202106,9958,25480,8060,22709,1398,3652,4239,12636,5637,16288
290110,202106,5289,13674,4683,12740,403,1052,3283,8927,3686,9979
290115,202106,4120,11789,3490,10670,272,806,2640,8119,2912,8925
290120,202106,6699,16177,5640,14706,132,421,4847,12419,4979,12840
290130,202106,4872,11608,3791,10186,176,422,2916,7908,3092,8330
290135,202106,4371,10116,3602,8884,142,362,2882,6873,3024,7235
290140,202106,4568,11709,3542,10361,82,302,3018,8799,3100,9101
290150,202106,2603,6446,2230,5994,140,338,1724,4703,1864,5041
290160,202106,3603,7850,3205,7311,236,449,2610,5973,2846,6422
290170,202106,3447,8567,3048,8136,105,237,2716,7374,2821,7611
290180,202106,3045,8190,2525,7342,71,246,2083,6003,2154,6249
290190,202106,4402,11890,3890,11206,100,363,3262,9253,3362,9616
290195,202106,2396,5779,1929,5174,26,99,1654,4416,1680,4515
290200,202106,4262,11562,3449,10196,162,505,2595,7588,2757,8093
290205,202106,3576,8936,3183,8375,165,479,2539,6526,2704,7005
290210,202106,13194,35806,11699,33536,792,2057,9187,26666,9979,28723
290220,202106,3007,7156,2639,6687,114,282,2169,5483,2283,5765
290225,202106,3289,6899,2513,6083,133,222,2152,5302,2285,5524
290230,202106,2582,6618,2363,6353,40,97,2133,5749,2173,5846
290240,202106,3807,9392,3018,8424,66,220,2554,7118,2620,7338
290250,202106,4005,11500,3340,10511,100,297,2749,8817,2849,9114
290260,202106,5558,13305,4690,12053,174,543,3923,9870,4097,10413
290265,202106,3645,10340,2968,9071,225,628,2065,6336,2290,6964
290270,202106,10816,36651,10093,35432,508,2174,8169,28496,8677,30670
290280,202106,6286,18399,5427,16692,291,1004,3916,11886,4207,12890
290290,202106,10199,28951,8345,25627,752,2471,5652,17106,6404,19577
290300,202106,4242,11471,3143,9392,152,477,2241,6694,2393,7171
290310,202106,1707,3965,1371,3564,34,145,1149,2911,1183,3056
290320,202106,25120,64127,20066,56563,4270,11653,9741,29108,14011,40761
290323,202106,3811,10280,3313,9508,112,334,2574,7457,2686,7791
290327,202106,4216,11943,3610,10788,272,748,2583,7695,2855,8443
290330,202106,2331,4717,1827,4180,45,60,1636,3802,1681,3862
290340,202106,5929,14301,4503,12584,411,1093,3288,9346,3699,10439
290350,202106,4881,13326,4080,11969,264,738,2895,8548,3159,9286
290360,202106,5122,13112,4488,12295,134,307,3856,10661,3990,10968
290370,202106,5361,12702,3933,10828,205,465,2759,7743,2964,8208
290380,202106,5749,14983,4764,13641,113,259,4071,11873,4184,12132
290390,202106,14959,41825,12448,37829,1407,4094,7998,24732,9405,28826
290395,202106,3033,8418,2441,7413,58,246,1869,5605,1927,5851
290400,202106,3862,10206,3142,9019,102,363,2442,6884,2544,7247
290405,202106,4794,13561,4077,12335,312,945,2762,8532,3074,9477
290410,202106,5829,15445,4472,13294,103,417,3392,9859,3495,10276
290420,202106,3194,8476,2654,7648,77,219,2118,6068,2195,6287
290430,202106,3351,8813,2750,7881,218,642,1924,5424,2142,6066
290440,202106,2941,7069,2130,5810,82,176,1503,4206,1585,4382
290450,202106,3668,8938,2905,7805,124,268,2199,5939,2323,6207
290460,202106,12264,34002,10320,30376,2128,6332,4394,13004,6522,19336
290470,202106,4733,11182,3491,9484,413,1147,2001,5541,2414,6688
290475,202106,6673,19066,5671,17326,64,344,4713,14132,4777,14476
290480,202106,1840,4541,1505,4063,66,215,1083,2783,1149,2998
290485,202106,4723,13361,4146,12562,98,455,3557,10639,3655,11094
290490,202106,9213,21302,8281,20040,470,963,6549,16098,7019,17061
290500,202106,4156,12127,3249,10229,525,1709,1446,4438,1971,6147
290510,202106,3639,8773,3041,8003,57,184,2695,7042,2752,7226
290515,202106,3726,10225,3235,9541,42,133,2924,8768,2966,8901
290520,202106,11837,33071,9221,28086,633,1982,5610,16937,6243,18919
290530,202106,5101,14353,4300,13058,110,441,3647,10997,3757,11438
290540,202106,3423,8796,3073,8412,41,128,2865,7839,2906,7967
290550,202106,4329,11251,3788,10612,11,60,3496,9901,3507,9961
290560,202106,6379,16250,4857,14048,368,1310,3225,9013,3593,10323
290570,202106,45149,109483,40075,103098,2270,5903,32468,82995,34738,88898
290580,202106,8161,23007,7062,21439,634,1733,5190,16244,5824,17977
290590,202106,7128,21603,6007,19616,146,524,4830,15877,4976,16401
290600,202106,19501,53011,17111,49157,744,2028,13729,39471,14473,41499
290610,202106,2640,7984,2076,6821,84,321,1464,4758,1548,5079
290620,202106,6200,17345,5367,15981,190,540,4522,13466,4712,14006
290630,202106,9646,22502,7721,20057,665,1617,5845,15422,6510,17039
290640,202106,2868,7151,2218,6224,119,304,1561,4563,1680,4867
290650,202106,13089,31853,11550,30129,2412,6044,7347,20001,9759,26045
290660,202106,3732,9457,3098,8499,55,149,2333,6584,2388,6733
290670,202106,6815,18350,5798,16717,378,1026,4443,13041,4821,14067
290680,202106,11164,30275,9363,27629,176,881,7780,22580,7956,23461
290682,202106,4870,12311,4230,11457,142,293,3558,9756,3700,10049
290685,202106,3547,7900,2556,6489,217,483,1529,4191,1746,4674
290687,202106,6686,17562,5467,15588,682,1842,3507,10244,4189,12086
290689,202106,2945,7962,2238,6668,186,574,1508,4510,1694,5084
290690,202106,5327,13754,4321,12363,278,868,3156,8879,3434,9747
290700,202106,2793,7182,2476,6785,44,160,2174,5932,2218,6092
290710,202106,8423,23237,7238,21610,226,670,6052,18200,6278,18870
290720,202106,18805,50662,17093,48047,900,2733,13809,38392,14709,41125
290730,202106,7106,16719,6054,15504,302,593,4737,12383,5039,12976
290740,202106,1062,2773,838,2414,27,85,710,2037,737,2122
290750,202106,11476,27890,9951,25499,639,1696,7426,18508,8065,20204
290755,202106,2042,5684,1664,5004,93,257,1151,3513,1244,3770
290760,202106,3832,10940,3156,9689,160,432,2184,6877,2344,7309
290770,202106,2728,8390,2493,8095,45,198,2104,6945,2149,7143
290780,202106,8291,20299,7156,18817,267,537,5557,15024,5824,15561
290790,202106,4857,13052,4232,12143,188,461,3478,10154,3666,10615
290800,202106,7135,14419,4997,11959,261,535,3759,9114,4020,9649
290810,202106,5359,13839,4340,12363,107,312,3320,9664,3427,9976
290820,202106,4926,13078,4452,12428,185,519,3353,9494,3538,10013
290830,202106,4578,10379,4052,9696,24,81,3534,8293,3558,8374
290840,202106,17869,45982,15268,41965,2032,4585,9714,28469,11746,33054
290850,202106,7054,16286,6284,15462,236,498,5426,13473,5662,13971
290860,202106,6216,17434,5404,16508,215,627,4555,14235,4770,14862
290870,202106,4759,12966,3617,10806,151,447,2530,7531,2681,7978
290880,202106,1432,3477,1155,3118,95,227,758,2171,853,2398
290890,202106,9538,18934,8580,17870,156,331,8009,16583,8165,16914
290900,202106,2507,6394,1947,5420,122,269,1194,3343,1316,3612
290910,202106,5293,12371,4046,10501,41,106,3458,8889,3499,8995
290920,202106,5244,12981,4721,12372,107,150,4402,11764,4509,11914
290930,202106,7627,20982,6191,18498,206,800,4814,14026,5020,14826
290940,202106,3635,10164,3064,9339,163,527,2458,7491,2621,8018
290950,202106,1476,3686,1206,3278,73,189,837,2290,910,2479
290960,202106,5846,14550,5228,13780,229,495,4396,11670,4625,12165
290970,202106,3285,9620,2693,8538,101,369,2085,6625,2186,6994
290980,202106,12848,29901,10819,26865,716,1899,6999,16870,7715,18769
290990,202106,9815,25705,8726,23975,264,994,7347,19582,7611,20576
291000,202106,3438,8672,2668,7702,114,327,2175,6359,2289,6686
291005,202106,15716,38103,13881,35753,1441,3275,10566,27609,12007,30884
291010,202106,3116,9290,2531,8024,141,489,1639,5060,1780,5549
291020,202106,1284,3083,1042,2670,29,90,765,1847,794,1937
291030,202106,2590,6166,1845,4908,116,276,1139,2978,1255,3254
291040,202106,5582,14868,4624,13520,158,519,3651,10665,3809,11184
291050,202106,8150,20273,6985,18703,719,1972,5062,13442,5781,15414
291060,202106,6446,18633,5487,17355,301,1174,4229,13283,4530,14457
291070,202106,16698,43766,13966,39421,386,1242,11396,31919,11782,33161
291072,202106,25814,63605,18839,52035,3231,9144,8491,23462,11722,32606
291075,202106,5583,13461,5040,12655,99,239,4253,10480,4352,10719
291077,202106,1703,4373,1332,3724,71,127,937,2655,1008,2782
291080,202106,118300,281766,93665,247885,25456,68143,28469,81900,53925,150043
291085,202106,5732,14201,4795,12781,171,496,4013,10656,4184,11152
291090,202106,2132,3906,1577,3291,39,68,1322,2729,1361,2797
291100,202106,3288,7038,2280,5845,98,253,1763,4492,1861,4745
291110,202106,6256,18073,5353,16574,292,1040,4173,12533,4465,13573
291120,202106,7896,18794,6676,17268,318,817,5154,13337,5472,14154
291125,202106,2314,3995,1750,3363,89,131,1425,2781,1514,2912
291130,202106,3359,9388,2496,7714,56,271,1882,5602,1938,5873
291140,202106,4968,13088,3592,10614,492,1296,2166,6433,2658,7729
291150,202106,2545,5458,1964,4808,4,16,1867,4568,1871,4584
291160,202106,5137,13888,4280,12671,380,1155,2876,8481,3256,9636
291165,202106,2229,5998,1661,4878,31,124,1197,3382,1228,3506
291170,202106,21348,53159,17794,47264,967,2744,11883,30941,12850,33685
291180,202106,6530,14635,4809,12384,231,559,3791,9766,4022,10325
291185,202106,3112,8083,2742,7502,108,286,2155,5935,2263,6221
291190,202106,7961,18983,6601,17249,271,705,5319,13953,5590,14658
291200,202106,2879,7727,2128,6307,68,216,1361,3862,1429,4078
291210,202106,7267,15256,5403,13129,126,411,4022,9823,4148,10234
291220,202106,4382,11923,3964,11317,238,685,3102,8840,3340,9525
291230,202106,4645,9713,3531,8497,39,89,3217,7795,3256,7884
291240,202106,4184,10639,3542,9563,60,205,3035,8091,3095,8296
291250,202106,3437,9916,2685,8537,146,429,1731,5538,1877,5967
291260,202106,1479,3424,1215,3081,28,85,997,2550,1025,2635
291270,202106,5758,14201,4505,12428,340,941,3266,9075,3606,10016
291280,202106,2726,6402,2012,5391,187,483,1279,3406,1466,3889
291290,202106,5847,15087,4480,12995,351,1046,3041,8786,3392,9832
291300,202106,3915,10413,3093,9051,113,347,2365,6830,2478,7177
291310,202106,5122,13507,4397,12210,163,471,3677,10128,3840,10599
291320,202106,6257,16998,4887,14482,1077,2995,2398,7525,3475,10520
291330,202106,1902,4730,1587,4221,70,178,1210,3137,1280,3315
291340,202106,4436,11141,3571,9667,101,280,2701,7233,2802,7513
291345,202106,2967,8673,2691,8252,99,325,2262,6960,2361,7285
291350,202106,7011,16850,5448,14996,53,156,4754,13286,4807,13442
291360,202106,37300,84058,29360,74624,2829,6844,19335,50655,22164,57499
291370,202106,8282,22057,7316,20564,550,1555,5446,15072,5996,16627
291380,202106,3580,9457,3127,8849,95,342,2640,7408,2735,7750
291390,202106,13505,28405,10421,25011,451,973,8617,20715,9068,21688
291400,202106,14431,35379,11955,31742,1384,3208,7514,21116,8898,24324
291410,202106,3072,7922,2408,6777,35,140,1781,4927,1816,5067
291420,202106,2024,4820,1575,4264,18,70,1406,3794,1424,3864
291430,202106,2786,7677,2405,7045,70,268,1926,5475,1996,5743
291440,202106,6618,18484,5750,17072,320,945,4474,13364,4794,14309
291450,202106,10100,23102,8324,21086,72,117,7389,19195,7461,19312
291460,202106,16036,41552,14051,38633,679,1997,10650,29017,11329,31014
291465,202106,9349,22533,7329,20230,119,521,6356,17404,6475,17925
291470,202106,18134,39301,15142,35870,865,1755,11184,27259,12049,29014
291480,202106,43804,94842,32749,80054,3662,9192,17920,43619,21582,52811
291490,202106,5646,13866,4872,12993,138,433,4399,11677,4537,12110
291500,202106,5197,12362,4368,11263,55,205,4006,10325,4061,10530
291510,202106,4468,10730,3298,9262,35,203,2784,7730,2819,7933
291520,202106,4658,10313,3517,8817,186,488,2725,6781,2911,7269
291530,202106,2401,5303,1713,4418,303,707,963,2721,1266,3428
291535,202106,3486,10054,3049,9277,161,430,2338,7353,2499,7783
291540,202106,2314,5036,1600,4187,77,205,1309,3421,1386,3626
291550,202106,5766,12931,4484,11317,423,857,3029,7883,3452,8740
291560,202106,18767,43791,13702,37135,1569,4009,7837,22343,9406,26352
291570,202106,2419,5649,1906,5022,53,148,1586,4316,1639,4464
291580,202106,6550,16496,5167,14663,258,709,3776,10702,4034,11411
291590,202106,2287,5360,2009,5047,74,234,1798,4432,1872,4666
291600,202106,5460,12452,4209,10570,361,953,2898,7062,3259,8015
291610,202106,5680,14520,5091,13872,61,221,4689,12748,4750,12969
291620,202106,3188,7078,2401,6214,115,282,1856,4920,1971,5202
291630,202106,3525,7562,2636,6435,236,609,1967,4770,2203,5379
291640,202106,16961,40113,12861,34301,1786,4423,6181,16909,7967,21332
291650,202106,9432,23215,8359,21955,561,1002,7012,18976,7573,19978
291660,202106,2092,5020,1547,4204,124,377,1026,2639,1150,3016
291670,202106,2074,5396,1741,4911,103,258,1306,3736,1409,3994
291680,202106,4109,9850,3325,8746,307,815,2343,6190,2650,7005
291685,202106,4964,11684,3996,10412,215,426,3049,8189,3264,8615
291690,202106,4243,9191,2978,7367,316,625,2185,5506,2501,6131
291700,202106,8981,25239,7918,23421,337,1074,6456,18782,6793,19856
291710,202106,5384,12461,4029,10601,301,790,2852,7477,3153,8267
291720,202106,4513,13352,3793,11929,646,2079,2172,6743,2818,8822
291730,202106,6435,15977,5546,14812,253,734,4643,12333,4896,13067
291733,202106,2809,7136,2392,6598,59,155,1753,5102,1812,5257
291735,202106,2990,7778,2405,6758,76,166,1851,5186,1927,5352
291740,202106,4057,10345,2995,8365,99,228,2078,5796,2177,6024
291750,202106,20619,47782,16819,42231,1785,4247,11003,28218,12788,32465
291760,202106,10689,29893,8387,26239,2488,8779,2257,7050,4745,15829
291770,202106,7398,19341,6211,17318,283,862,4774,12941,5057,13803
291780,202106,5261,13675,4737,12953,85,279,4151,11246,4236,11525
291790,202106,2765,7452,2507,7121,227,521,1894,5574,2121,6095
291800,202106,30801,75163,23174,64025,4033,10492,10776,31354,14809,41846
291810,202106,10667,24980,9027,22994,359,827,7529,19503,7888,20330
291820,202106,4027,10187,3505,9514,91,254,2855,7775,2946,8029
291830,202106,4676,10678,3829,9535,219,405,3018,7596,3237,8001
291835,202106,6659,19625,5264,16981,461,1544,3445,11292,3906,12836
291840,202106,48650,131019,42384,121376,3982,12158,30351,86274,34333,98432
291845,202106,2664,6678,2111,6003,101,277,1766,5088,1867,5365
291850,202106,4239,11425,3535,10284,142,385,2812,8289,2954,8674
291855,202106,2299,4377,1783,3808,31,81,1625,3463,1656,3544
291860,202106,2321,5966,1620,4622,38,85,1089,3012,1127,3097
291870,202106,1314,3257,882,2500,36,93,612,1714,648,1807
291875,202106,3012,8894,2594,8034,54,223,1930,5801,1984,6024
291880,202106,5769,16006,4913,14593,235,636,3643,10969,3878,11605
291890,202106,1634,3301,1058,2634,144,316,686,1738,830,2054
291900,202106,1384,3131,1056,2646,19,61,845,2062,864,2123
291905,202106,2476,6217,2050,5555,71,247,1598,4176,1669,4423
291910,202106,3103,7542,2621,6958,53,178,2249,6137,2302,6315
291915,202106,7424,20807,6051,18497,202,681,4541,14098,4743,14779
291920,202106,27363,69217,23267,63632,1998,5975,16637,44495,18635,50470
291930,202106,2582,6657,2216,6166,220,606,1536,4329,1756,4935
291940,202106,4009,9961,2699,7782,202,563,1589,4571,1791,5134
291950,202106,9194,27532,7785,24853,270,979,5438,17208,5708,18187
291955,202106,15808,39067,14049,36808,1159,3118,11105,29136,12264,32254
291960,202106,3332,8202,2809,7510,147,308,2222,6121,2369,6429
291970,202106,4695,11498,3943,10581,139,427,3011,8112,3150,8539
291980,202106,9945,27647,8022,24334,1020,2769,5098,15863,6118,18632
291990,202106,2387,6055,1949,5519,22,80,1808,5131,1830,5211
291992,202106,3987,9487,3238,8531,281,599,2552,6909,2833,7508
291995,202106,2211,5832,1815,5190,43,163,1426,3980,1469,4143
292000,202106,2707,6156,2206,5559,77,241,1777,4458,1854,4699
292010,202106,5836,13329,4766,11828,149,380,4030,9816,4179,10196
292020,202106,4762,13271,3987,11921,170,599,3053,8851,3223,9450
292030,202106,1960,5716,1776,5386,101,321,1163,3449,1264,3770
292040,202106,4612,11391,3610,9907,223,527,2746,7709,2969,8236
292045,202106,4249,10637,3170,9062,34,95,2834,8235,2868,8330
292050,202106,6681,18261,5429,16122,243,789,3530,10362,3773,11151
292060,202106,11393,25945,10514,24849,408,914,9277,21670,9685,22584
292070,202106,5842,14839,5093,13958,310,783,4323,11839,4633,12622
292080,202106,3277,7942,2689,7188,68,218,2412,6406,2480,6624
292090,202106,4630,9900,3253,8224,185,451,2491,6328,2676,6779
292100,202106,12127,28311,10455,26240,1423,3399,6549,16974,7972,20373
292105,202106,3745,8931,3266,8286,75,164,2762,7014,2837,7178
292110,202106,6174,14481,4398,11764,863,2365,2228,5949,3091,8314
292120,202106,7170,17928,5952,15923,345,933,4461,11753,4806,12686
292130,202106,3544,8297,2943,7556,126,359,2279,5767,2405,6126
292140,202106,5388,12064,4568,10887,191,434,3902,9261,4093,9695
292145,202106,2576,6953,2160,6249,94,224,1705,4971,1799,5195
292150,202106,15226,39553,13216,36354,264,954,10928,29476,11192,30430
292160,202106,3080,7242,2328,6285,34,81,1898,5407,1932,5488
292170,202106,8881,22696,7453,20429,360,1039,5722,15374,6082,16413
292180,202106,2952,7891,2187,6491,146,436,1381,4022,1527,4458
292190,202106,3002,7761,2565,7114,130,379,1957,5419,2087,5798
292200,202106,9073,21762,6767,18537,1217,3429,3201,9172,4418,12601
292205,202106,3821,10462,3320,9729,56,251,2892,8444,2948,8695
292210,202106,6746,15179,5478,13601,69,263,4986,12280,5055,12543
292220,202106,2265,5163,1980,4750,68,149,1556,3627,1624,3776
292225,202106,3312,9374,2932,8802,56,246,2568,7576,2624,7822
292230,202106,8897,20785,7976,19629,168,526,6907,16731,7075,17257
292240,202106,4868,13784,4299,12780,269,785,3098,9192,3367,9977
292250,202106,6091,15161,5478,14273,371,939,4207,10902,4578,11841
292260,202106,3448,8816,3074,8335,86,222,2682,7288,2768,7510
292265,202106,3542,9312,2977,8462,58,243,2422,6751,2480,6994
292270,202106,4364,9873,3480,8821,114,261,2884,7345,2998,7606
292273,202106,2876,6034,2297,5332,59,98,1666,4150,1725,4248
292275,202106,1644,4240,1293,3772,52,147,973,2885,1025,3032
292280,202106,2700,6210,2168,5598,88,142,1823,4870,1911,5012
292285,202106,2662,6249,2121,5519,76,158,1743,4573,1819,4731
292290,202106,7680,19624,6040,17366,158,530,4977,14276,5135,14806
292300,202106,10527,25721,8300,22785,808,2315,5718,15750,6526,18065
292303,202106,3003,8385,2609,7759,88,186,2161,6511,2249,6697
292305,202106,2315,6139,2141,5905,40,161,1931,5253,1971,5414
292310,202106,7089,17021,6149,15880,112,346,5463,13943,5575,14289
292320,202106,6253,16662,4988,14363,240,780,3706,10390,3946,11170
292330,202106,2757,5963,2242,5382,105,178,1731,4375,1836,4553
292335,202106,4939,12556,4386,11749,231,525,3690,10024,3921,10549
292340,202106,5520,15366,4580,13589,217,608,3374,9966,3591,10574
292350,202106,2571,6857,2149,6280,79,275,1752,5148,1831,5423
292360,202106,5105,13285,4256,11860,226,670,3011,8320,3237,8990
292370,202106,10353,24166,8930,22320,116,368,8307,20558,8423,20926
292380,202106,6914,19027,6192,17749,404,1145,4734,13448,5138,14593
292390,202106,4696,8793,3454,7367,121,219,3031,6466,3152,6685
292400,202106,22708,63032,19606,58167,1852,5405,13526,40471,15378,45876
292405,202106,4634,11000,3910,9864,90,218,3266,8110,3356,8328
292410,202106,2261,5308,1879,4826,71,148,1650,4276,1721,4424
292420,202106,3611,10307,3311,9865,114,436,2895,8471,3009,8907
292430,202106,5017,14600,3816,12410,287,927,2510,8207,2797,9134
292440,202106,8739,27176,8088,26193,108,526,7277,23448,7385,23974
292450,202106,4106,11482,3208,9768,89,329,2523,7630,2612,7959
292460,202106,5315,13747,4397,12258,234,603,3429,9515,3663,10118
292465,202106,2793,6904,2385,6389,94,198,1609,4735,1703,4933
292467,202106,1976,5344,1735,5020,273,659,1173,3574,1446,4233
292470,202106,3065,7589,2381,6543,71,114,1830,5065,1901,5179
292480,202106,6382,14805,5189,13356,70,238,4717,12047,4787,12285
292490,202106,2357,5665,1998,5150,103,196,1596,4169,1699,4365
292500,202106,6933,18061,5567,15750,410,1231,3772,10543,4182,11774
292510,202106,13993,36137,10946,31380,533,1551,7753,22201,8286,23752
292520,202106,7330,17904,6458,16628,419,1123,5096,12960,5515,14083
292525,202106,6189,14329,5081,13098,127,264,4450,11672,4577,11936
292530,202106,29992,76888,23385,66083,5115,14677,10189,29213,15304,43890
292540,202106,4596,8244,3631,7220,128,201,3289,6576,3417,6777
292550,202106,8446,21289,6511,18981,496,1309,4555,14279,5051,15588
292560,202106,4541,11157,3874,10237,108,256,2969,7834,3077,8090
292570,202106,3739,9632,3145,8552,49,168,2687,7136,2736,7304
292575,202106,6932,19468,6364,18727,418,1162,5073,15162,5491,16324
292580,202106,7666,19001,6332,17052,125,384,5362,14293,5487,14677
292590,202106,7536,19723,6376,17677,313,882,5111,13970,5424,14852
292593,202106,2924,7149,2423,6325,72,176,2042,5284,2114,5460
292595,202106,5609,14494,4802,13505,138,444,4092,11448,4230,11892
292600,202106,10870,29179,9399,26962,354,949,7524,21678,7878,22627
292610,202106,4386,11066,3746,9966,163,361,2896,7771,3059,8132
292620,202106,6473,17451,5349,16091,132,286,4823,14839,4955,15125
292630,202106,8955,21302,7203,18534,773,1912,4495,11750,5268,13662
292640,202106,8540,24189,7413,22345,204,687,5393,16406,5597,17093
292650,202106,4528,11067,4051,10446,108,271,3689,9426,3797,9697
292660,202106,11590,30698,9823,28120,461,1390,7415,21370,7876,22760
292665,202106,2212,6394,1905,5986,68,189,1582,5064,1650,5253
292670,202106,3636,9704,2825,8202,130,385,1908,5427,2038,5812
292680,202106,4115,10510,3256,9034,159,397,2431,6605,2590,7002
292690,202106,2691,6786,1871,5460,193,511,1140,3476,1333,3987
292700,202106,10243,27222,8952,25250,733,1712,6206,18147,6939,19859
292710,202106,2705,7846,2523,7606,38,100,2320,7021,2358,7121
292720,202106,9239,21456,7798,19791,208,537,6250,16182,6458,16719
292730,202106,5044,11231,4613,10583,345,569,3810,8977,4155,9546
292740,202106,321996,762920,277555,700651,37198,93268,175905,442468,213103,535736
292750,202106,6371,16403,5629,15358,215,561,4484,12443,4699,13004
292760,202106,4055,11253,3548,10375,185,558,2674,7766,2859,8324
292770,202106,6602,16574,5359,14856,726,2038,3545,10086,4271,12124
292780,202106,2175,4167,1622,3507,72,161,1306,2711,1378,2872
292790,202106,4091,8510,3100,7433,163,343,2563,6215,2726,6558
292800,202106,11609,28543,9927,26002,323,817,8300,21548,8623,22365
292805,202106,3791,8790,2991,7772,113,296,2382,6157,2495,6453
292810,202106,11184,27946,8963,24499,562,1346,6574,17762,7136,19108
292820,202106,7415,20291,5439,16957,364,1236,3857,11831,4221,13067
292830,202106,2988,6893,2548,6358,87,200,2172,5475,2259,5675
292840,202106,8771,22704,7454,20933,131,448,6559,18207,6690,18655
292850,202106,2514,6493,2106,5905,138,363,1485,4159,1623,4522
292860,202106,16880,36890,15174,34903,383,967,13207,30008,13590,30975
292870,202106,19249,46008,16660,42473,970,2376,11724,29509,12694,31885
292880,202106,11334,30370,9658,27858,252,954,7677,21461,7929,22415
292890,202106,7327,19655,6480,18459,163,630,5714,16191,5877,16821
292895,202106,3208,6594,2406,5424,103,216,1959,4370,2062,4586
292900,202106,2677,7012,2430,6633,46,176,2027,5386,2073,5562
292905,202106,4399,11051,3507,9728,95,302,2688,7372,2783,7674
292910,202106,4807,12898,4398,12327,186,490,3438,9583,3624,10073
292920,202106,9806,26695,9095,25721,265,950,7845,21862,8110,22812
292925,202106,5423,15164,4535,13575,224,619,3251,9724,3475,10343
292930,202106,6573,18770,5693,17206,481,1579,3696,10928,4177,12507
292935,202106,2536,6139,1981,5521,13,68,1786,5006,1799,5074
292937,202106,2862,7110,2485,6636,69,180,2061,5507,2130,5687
292940,202106,2970,7301,2361,6396,206,467,1678,4732,1884,5199
292950,202106,9685,24152,8481,22427,510,1140,6443,17025,6953,18165
292960,202106,5253,12588,4398,11386,132,321,3512,9041,3644,9362
292970,202106,3934,10906,3490,10246,70,276,2934,8652,3004,8928
292975,202106,4446,9392,3955,8850,114,184,3607,8164,3721,8348
292980,202106,3553,8092,2910,7167,73,211,2461,5950,2534,6161
292990,202106,11317,31024,9507,27842,522,1643,7104,20444,7626,22087
293000,202106,2742,6361,2361,5789,44,150,1919,4694,1963,4844
293010,202106,18727,46760,15160,41300,1842,5149,9382,25584,11224,30733
293015,202106,8706,25846,6916,22453,451,1509,4675,15470,5126,16979
293020,202106,10020,28584,9015,27158,121,427,8134,24565,8255,24992
293030,202106,5280,13658,4034,11740,98,286,2797,8374,2895,8660
293040,202106,4543,11503,3822,10484,60,198,3375,9221,3435,9419
293050,202106,23460,55458,20718,51423,1276,3034,15589,38290,16865,41324
293060,202106,3677,9590,2977,8278,235,689,2055,5595,2290,6284
293070,202106,25537,60449,22452,56569,1905,4947,16858,42321,18763,47268
293075,202106,3698,11215,3227,10420,109,495,2672,8587,2781,9082
293076,202106,3620,8648,3312,8289,64,132,2960,7498,3024,7630
293077,202106,6607,17684,5308,15632,471,1461,3262,10139,3733,11600
293080,202106,4865,14028,4169,12831,81,371,3403,10268,3484,10639
293090,202106,3306,9420,2556,8172,220,654,1656,5392,1876,6046
293100,202106,5892,15356,4892,13592,203,529,3888,10754,4091,11283
293105,202106,3862,12009,3370,10999,227,743,2377,7723,2604,8466
293110,202106,2463,5971,2052,5383,64,183,1681,4350,1745,4533
293120,202106,4681,12190,4203,11463,222,441,3470,9619,3692,10060
293130,202106,3813,10285,3334,9672,60,230,2927,8422,2987,8652
293135,202106,31133,71375,23151,60986,3329,9502,11149,29750,14478,39252
293140,202106,2520,5323,2194,4934,59,100,1885,4247,1944,4347
293150,202106,5518,16170,4542,14344,313,999,3138,9955,3451,10954
293160,202106,3777,9230,3222,8628,238,384,2717,7633,2955,8017
293170,202106,5081,10304,4451,9531,104,208,3935,8388,4039,8596
293180,202106,4472,12292,3725,10949,67,261,2993,8597,3060,8858
293190,202106,14453,38400,12811,36073,122,526,11459,32023,11581,32549
293200,202106,8861,21194,7197,18569,192,548,5892,15031,6084,15579
293210,202106,5274,13584,4536,12449,264,702,3554,9744,3818,10446
293220,202106,5250,13019,3874,10758,734,2011,1870,5288,2604,7299
293230,202106,4081,10043,3040,8604,209,596,2149,6157,2358,6753
293240,202106,4639,11936,3736,10472,73,153,2813,8264,2886,8417
293245,202106,3942,10426,3581,9899,154,422,3038,8330,3192,8752
293250,202106,6112,13901,4966,12433,183,453,4113,10291,4296,10744
293260,202106,4859,12465,4012,11145,139,342,2805,7900,2944,8242
293270,202106,7429,15987,5879,14335,434,590,4587,12123,5021,12713
293280,202106,4515,11678,3952,10883,240,579,3075,8611,3315,9190
293290,202106,15705,43349,13937,40604,1623,4756,9551,27977,11174,32733
293300,202106,5937,14083,5118,12895,298,709,3770,9550,4068,10259
293305,202106,4254,9919,3724,9267,65,138,3367,8407,3432,8545
293310,202106,2158,5393,1821,4888,42,125,1458,3855,1500,3980
293315,202106,4249,9768,3505,8666,196,418,2869,7085,3065,7503
293317,202106,2738,6277,2443,5866,166,291,1910,4621,2076,4912
293320,202106,12353,29046,10936,27483,207,574,9905,24749,10112,25323
293325,202106,1810,4370,1407,3842,199,521,875,2443,1074,2964
293330,202106,63491,172070,51919,152115,8616,26139,25376,73542,33992,99681
293340,202106,2239,6182,1848,5494,90,263,1300,3847,1390,4110
293345,202106,3739,9808,3004,8684,404,921,1890,6036,2294,6957
293350,202106,6555,18628,5655,17552,55,269,5166,16239,5221,16508
293360,202106,15121,37682,12878,34695,280,1167,11378,30104,11658,31271
310010,202106,980,2157,637,1689,41,142,243,598,284,740
310020,202106,2905,7564,2187,6312,439,1352,590,1651,1029,3003
310030,202106,1924,5291,1480,4525,211,713,960,2836,1171,3549
310040,202106,878,2245,695,1930,31,119,471,1205,502,1324
310050,202106,1507,4414,1263,4032,116,463,845,2605,961,3068
310060,202106,3173,8805,2751,8241,76,293,2297,6817,2373,7110
310070,202106,343,773,245,633,11,23,181,464,192,487
310080,202106,696,1825,507,1488,79,250,242,673,321,923
310090,202106,4858,12397,4005,11021,264,774,2995,8128,3259,8902
310100,202106,3629,9689,3065,8775,70,305,2563,7147,2633,7452
310110,202106,4799,12239,3725,10428,690,2114,1789,4794,2479,6908
310120,202106,647,1542,416,1177,46,149,248,652,294,801
310130,202106,369,945,312,860,26,100,238,629,264,729
310140,202106,277,759,192,618,39,146,74,215,113,361
310150,202106,5858,14790,4377,12130,500,1575,2195,5730,2695,7305
310160,202106,8656,21021,6328,17208,1082,3199,2492,6714,3574,9913
310163,202106,1072,3120,864,2728,181,631,279,807,460,1438
310170,202106,9688,23891,7754,20913,646,1726,5480,14795,6126,16521
310180,202106,1913,4569,1399,3747,161,470,830,2160,991,2630
310190,202106,2797,7891,2294,6996,511,1744,395,1128,906,2872
310200,202106,2022,5782,1511,4813,177,651,743,2301,920,2952
310205,202106,1152,3074,921,2706,118,391,544,1602,662,1993
310210,202106,2593,6868,2130,6038,117,334,1523,4212,1640,4546
310220,202106,1295,3451,1004,2889,74,227,669,1852,743,2079
310230,202106,2250,6069,1808,5258,214,672,1146,3115,1360,3787
310240,202106,1024,2985,874,2727,47,169,616,1859,663,2028
310250,202106,1066,2778,872,2461,17,66,638,1777,655,1843
310260,202106,3254,8221,2182,6358,603,2040,685,1641,1288,3681
310270,202106,2819,6682,2256,5927,85,255,1872,4916,1957,5171
310280,202106,2556,5782,2018,5021,230,603,1265,3031,1495,3634
310285,202106,1884,5858,1569,5298,153,551,968,3260,1121,3811
310290,202106,1202,3072,990,2709,182,579,541,1328,723,1907
310300,202106,1602,4481,1360,4074,136,511,812,2258,948,2769
310310,202106,326,774,212,579,39,103,102,272,141,375
310320,202106,539,1323,381,1084,19,73,224,604,243,677
310330,202106,492,1135,302,812,47,149,119,275,166,424
310340,202106,8339,21395,6732,18698,917,2499,3377,9584,4294,12083
310350,202106,13103,31039,9103,24694,1420,4123,4423,11498,5843,15621
310360,202106,543,1204,423,1052,13,31,294,721,307,752
310370,202106,1307,3946,1115,3590,211,751,350,1202,561,1953
310375,202106,897,2182,639,1801,92,268,363,1023,455,1291
310380,202106,399,902,220,621,33,97,101,271,134,368
310390,202106,491,1411,394,1228,77,248,128,356,205,604
310400,202106,11213,26916,8316,22566,718,2229,5288,13918,6006,16147
310410,202106,859,2445,563,1905,79,298,224,705,303,1003
310420,202106,4743,12033,3349,9480,455,1415,1444,3799,1899,5214
310430,202106,1611,4262,1093,3316,208,690,423,1127,631,1817
310440,202106,686,1760,474,1372,40,140,258,687,298,827
310445,202106,1418,3948,1038,3189,62,183,741,2239,803,2422
310450,202106,4604,11388,3499,9673,143,516,2681,7189,2824,7705
310460,202106,1816,4751,1388,3967,223,688,510,1345,733,2033
310470,202106,3747,8181,2928,7105,274,628,2102,5239,2376,5867
310480,202106,1018,2565,797,2206,94,274,491,1316,585,1590
310490,202106,2886,7699,2280,6717,249,875,1287,3541,1536,4416
310500,202106,1395,3799,1069,3257,177,610,575,1687,752,2297
310510,202106,2178,5565,1485,4316,254,806,579,1681,833,2487
310520,202106,1189,3063,874,2502,137,375,463,1340,600,1715
310530,202106,772,1926,525,1502,67,226,187,438,254,664
310540,202106,3064,8500,2533,7562,501,1586,1163,3296,1664,4882
310550,202106,1295,3202,929,2595,74,266,540,1377,614,1643
310560,202106,15563,39746,11157,32038,1416,4571,5024,12987,6440,17558
310570,202106,1065,2745,846,2442,50,180,641,1818,691,1998
310590,202106,4241,10987,3402,9417,213,647,2003,5219,2216,5866
310600,202106,1405,3981,1149,3460,139,471,622,1764,761,2235
310610,202106,485,1294,314,1016,116,380,49,146,165,526
310620,202106,186197,462582,137615,376090,17058,54092,71485,177518,88543,231610
310630,202106,4704,12562,3687,10581,414,1250,2217,6172,2631,7422
310640,202106,1184,3386,970,2977,165,554,455,1326,620,1880
310650,202106,2516,6845,1856,5589,152,492,1143,3307,1295,3799
310660,202106,1345,3574,1103,3244,27,90,937,2741,964,2831
310665,202106,1450,3630,1181,3260,17,61,971,2732,988,2793
310670,202106,60371,151855,51113,136316,4506,13499,35450,90104,39956,103603
310680,202106,790,1830,652,1637,17,62,557,1344,574,1406
310690,202106,2080,5221,1516,4289,110,352,905,2420,1015,2772
310700,202106,490,1058,384,926,22,70,304,714,326,784
310710,202106,5886,16286,4343,13982,844,3162,792,2263,1636,5425
310720,202106,1084,2458,845,2157,30,97,648,1593,678,1690
310730,202106,10522,27052,8982,24644,353,1175,6748,18053,7101,19228
310740,202106,6659,17784,4854,14165,667,2179,1939,5090,2606,7269
310750,202106,1289,3033,982,2595,101,309,557,1353,658,1662
310760,202106,679,1686,475,1376,34,104,258,751,292,855
310770,202106,1111,2927,773,2411,82,304,406,1168,488,1472
310780,202106,4315,10120,3600,9196,68,168,2967,7605,3035,7773
310790,202106,1858,5750,1599,5200,348,1202,274,772,622,1974
310800,202106,2430,7029,1786,5740,339,1324,106,264,445,1588
310810,202106,1342,3230,1110,2861,49,135,806,2007,855,2142
310820,202106,1266,3150,774,2330,163,502,177,555,340,1057
310825,202106,2669,7777,2150,6923,54,305,1761,5486,1815,5791
310830,202106,1970,5372,1437,4370,240,857,620,1774,860,2631
310840,202106,2167,5760,1632,4860,338,1158,448,1156,786,2314
310850,202106,1447,3959,1207,3615,35,169,938,2699,973,2868
310855,202106,3155,8185,2439,7027,159,535,1748,4918,1907,5453
310860,202106,6921,19737,5588,17221,539,1694,3447,10766,3986,12460
310870,202106,989,2332,781,2036,54,123,574,1499,628,1622
310880,202106,1006,2955,802,2547,110,356,450,1398,560,1754
310890,202106,2233,6305,1457,4764,255,903,223,628,478,1531
310900,202106,3987,10867,2782,8257,413,1281,1234,3411,1647,4692
310910,202106,2226,5334,1568,4304,135,433,350,889,485,1322
310920,202106,1926,4909,1474,4240,180,559,874,2461,1054,3020
310925,202106,981,2580,805,2293,46,156,582,1579,628,1735
310930,202106,5922,14969,4164,12172,794,2321,1887,5796,2681,8117
310940,202106,6843,15736,5537,13861,178,525,4329,10563,4507,11088
310945,202106,1327,3385,1050,2943,179,520,512,1398,691,1918
310950,202106,1939,5671,1293,4230,211,756,372,1027,583,1783
310960,202106,734,1923,406,1230,72,258,77,204,149,462
310970,202106,1160,3357,824,2664,210,739,131,382,341,1121
310980,202106,285,665,183,508,19,58,109,300,128,358
310990,202106,1338,3563,1057,3088,146,455,578,1654,724,2109
311000,202106,3938,10762,2885,9036,700,2295,1164,3595,1864,5890
311010,202106,938,2574,756,2234,195,646,357,1023,552,1669
311020,202106,1166,2908,744,2132,43,129,406,1126,449,1255
311030,202106,1748,4225,1253,3422,249,769,552,1435,801,2204
311040,202106,269,833,222,733,69,235,74,229,143,464
311050,202106,3087,7400,2314,6277,350,1073,1200,3093,1550,4166
311060,202106,3334,8350,2494,6831,329,1025,1020,2545,1349,3570
311070,202106,2399,5799,1752,4817,143,514,1026,2619,1169,3133
311080,202106,1186,2635,961,2286,58,152,749,1697,807,1849
311090,202106,2156,6650,1726,5848,381,1399,558,1856,939,3255
311100,202106,2506,6940,1501,4913,271,994,293,825,564,1819
311110,202106,3681,7450,2069,5198,387,1003,708,1833,1095,2836
311115,202106,1425,3076,1204,2788,70,148,971,2238,1041,2386
311120,202106,7065,18125,5456,15291,798,2475,2089,5159,2887,7634
311130,202106,1924,4945,1460,4302,105,387,867,2478,972,2865
311140,202106,1486,3634,1189,3231,65,201,863,2304,928,2505
311150,202106,1464,4608,1144,3982,174,682,624,2115,798,2797
311160,202106,3964,11144,2828,9049,700,2414,841,2577,1541,4991
311170,202106,903,2247,715,1997,42,117,447,1327,489,1444
311180,202106,1401,3100,893,2360,176,488,370,986,546,1474
311190,202106,891,2430,679,2024,113,390,275,706,388,1096
311200,202106,2119,5634,1528,4482,271,877,568,1507,839,2384
311205,202106,896,2565,739,2271,35,134,473,1372,508,1506
311210,202106,1027,2938,891,2744,114,308,624,1997,738,2305
311220,202106,766,2065,645,1847,39,137,439,1183,478,1320
311230,202106,8202,23872,6253,19978,1170,3871,2274,7388,3444,11259
311240,202106,1102,2791,860,2448,172,489,385,1104,557,1593
311250,202106,1200,3360,931,2843,185,550,375,1076,560,1626
311260,202106,2805,6704,1810,4996,242,761,813,1981,1055,2742
311265,202106,1313,3365,966,2783,40,155,669,1885,709,2040
311270,202106,3011,8847,2639,8246,130,554,1946,5848,2076,6402
311280,202106,1098,2790,549,1683,80,278,84,211,164,489
311290,202106,1910,5609,1741,5267,123,366,1207,3658,1330,4024
311300,202106,4840,13045,3988,11635,172,638,3195,9137,3367,9775
311310,202106,576,1572,490,1422,38,120,316,884,354,1004
311320,202106,3321,9874,2874,8921,311,1145,1494,4226,1805,5371
311330,202106,5464,13818,4350,12038,457,1321,2480,6983,2937,8304
311340,202106,10642,28980,8433,25127,2012,6475,2521,7075,4533,13550
311350,202106,2505,5999,1789,4720,173,465,972,2322,1145,2787
311360,202106,1138,2722,752,2169,195,634,267,760,462,1394
311370,202106,4798,11336,3559,9421,192,627,2372,5912,2564,6539
311380,202106,369,1094,269,887,62,205,127,434,189,639
311390,202106,1798,5341,1438,4842,607,2281,391,1204,998,3485
311400,202106,1606,4300,1172,3463,219,662,355,935,574,1597
311410,202106,1835,5188,1468,4615,214,754,845,2565,1059,3319
311420,202106,1549,4473,1100,3545,194,712,302,826,496,1538
311430,202106,4304,11040,2885,8300,462,1367,1028,2852,1490,4219
311440,202106,3047,8275,2321,7059,613,2159,486,1367,1099,3526
311450,202106,1815,5317,1320,4406,333,1263,328,921,661,2184
311455,202106,1023,2233,690,1743,161,420,280,735,441,1155
311460,202106,526,1563,343,1162,66,267,79,213,145,480
311470,202106,525,1575,354,1186,82,312,52,171,134,483
311480,202106,1114,2731,911,2418,65,152,691,1846,756,1998
311490,202106,251,732,191,618,31,126,92,262,123,388
311500,202106,480,1150,378,997,18,62,255,643,273,705
311510,202106,3341,8450,2345,6763,304,984,1035,2787,1339,3771
311520,202106,659,1775,579,1629,72,250,333,915,405,1165
311530,202106,8733,20051,5633,15135,1303,3875,1531,3900,2834,7775
311535,202106,826,2236,566,1697,90,276,202,564,292,840
311540,202106,510,1565,453,1459,60,222,327,1021,387,1243
311545,202106,2010,5652,1722,5205,91,309,1334,3991,1425,4300
311547,202106,1548,3780,1350,3481,49,112,999,2579,1048,2691
311550,202106,2904,7837,2336,6836,331,1087,1036,2842,1367,3929
311560,202106,317,671,204,501,74,172,56,134,130,306
311570,202106,1628,3712,1158,3060,36,105,916,2447,952,2552
311580,202106,2185,4073,1478,3233,175,309,971,2148,1146,2457
311590,202106,525,1359,421,1202,76,246,231,652,307,898
311600,202106,1728,3901,1441,3525,102,261,1164,2797,1266,3058
311610,202106,2310,7129,1927,6381,155,606,1186,3822,1341,4428
311615,202106,3351,9154,2726,8132,105,375,2183,6393,2288,6768
311620,202106,432,1081,370,1006,82,258,232,594,314,852
311630,202106,1364,3703,1124,3222,107,332,712,1986,819,2318
311640,202106,717,1888,580,1680,58,198,300,794,358,992
311650,202106,1986,4899,1614,4330,191,544,979,2544,1170,3088
311660,202106,2946,8320,2200,6865,340,1169,598,1546,938,2715
311670,202106,1605,4060,1190,3321,160,490,507,1391,667,1881
311680,202106,2237,6162,1702,5181,122,360,1206,3651,1328,4011
311690,202106,609,1287,481,1130,38,72,352,874,390,946
311700,202106,2248,5268,1788,4621,21,104,1526,3834,1547,3938
311710,202106,1540,4375,1132,3657,272,956,387,1255,659,2211
311720,202106,438,1252,348,1093,38,135,179,567,217,702
311730,202106,3619,9221,2415,6871,673,2057,535,1529,1208,3586
311740,202106,929,2346,777,2161,71,182,636,1834,707,2016
311750,202106,3973,11533,3202,10166,358,1239,1984,6072,2342,7311
311760,202106,668,1845,548,1637,64,233,289,759,353,992
311770,202106,2200,6104,1736,5303,288,893,792,2327,1080,3220
311780,202106,1399,3920,1024,3204,152,563,369,999,521,1562
311783,202106,2324,6117,1897,5407,31,148,1544,4230,1575,4378
311787,202106,844,2378,657,1953,92,310,294,754,386,1064
311790,202106,1513,4065,991,3092,223,766,282,833,505,1599
311800,202106,5016,14770,4068,12776,841,2740,602,1585,1443,4325
311810,202106,952,2808,753,2464,45,162,513,1650,558,1812
311820,202106,817,1938,610,1630,60,189,390,978,450,1167
311830,202106,8554,23905,5988,18453,1634,5382,756,2259,2390,7641
311840,202106,3778,9237,3066,8229,207,600,2320,6172,2527,6772
311850,202106,374,968,303,837,12,34,204,534,216,568
311860,202106,63267,155948,49026,131875,6334,18490,28509,72776,34843,91266
311870,202106,1928,5021,1358,4020,231,780,586,1581,817,2361
311880,202106,6569,16518,5514,15069,296,662,4145,11618,4441,12280
311890,202106,1729,4074,1336,3532,89,255,934,2345,1023,2600
311900,202106,763,1910,574,1652,52,168,366,1029,418,1197
311910,202106,4129,10439,3124,9122,534,1530,1586,4814,2120,6344
311920,202106,2156,5558,1740,4959,117,282,1106,3275,1223,3557
311930,202106,3956,9034,2876,7551,803,2300,950,2323,1753,4623
311940,202106,15995,40951,11842,33172,1581,4847,5484,14299,7065,19146
311950,202106,2354,6140,1803,5231,110,351,1111,3274,1221,3625
311960,202106,499,1216,396,1064,28,96,242,590,270,686
311970,202106,425,1330,315,1059,57,235,73,204,130,439
311980,202106,468,1234,250,815,21,71,93,297,114,368
311990,202106,540,1250,342,951,61,204,142,351,203,555
311995,202106,974,2656,518,1614,17,56,78,160,95,216
312000,202106,792,1925,592,1628,53,136,376,1058,429,1194
312010,202106,996,2663,777,2316,41,140,528,1506,569,1646
312015,202106,1403,3973,1246,3723,41,172,1022,2988,1063,3160
312020,202106,1725,5176,1272,4177,212,737,282,825,494,1562
312030,202106,2078,4974,1796,4666,14,55,1697,4405,1711,4460
312040,202106,851,2455,608,1981,73,238,268,848,341,1086
312050,202106,1218,3673,985,3229,211,838,339,988,550,1826
312060,202106,886,2114,587,1733,143,437,272,804,415,1241
312070,202106,936,2603,664,2056,30,107,392,1139,422,1246
312080,202106,2754,6652,2095,5684,114,328,1421,3698,1535,4026
312083,202106,931,2353,716,2023,52,183,516,1407,568,1590
312087,202106,2573,6552,2092,5813,50,151,1673,4673,1723,4824
312090,202106,10609,27154,8366,23670,1097,3414,4469,12157,5566,15571
312100,202106,1598,4520,1279,3934,85,324,796,2340,881,2664
312110,202106,1070,3215,883,2846,175,649,337,989,512,1638
312120,202106,1022,2723,703,2169,188,671,200,506,388,1177
312125,202106,1794,4468,1506,4075,98,285,1159,3041,1257,3326
312130,202106,1067,2573,810,2147,72,210,362,878,434,1088
312140,202106,718,2044,590,1786,114,385,262,729,376,1114
312150,202106,484,1312,418,1185,19,60,290,766,309,826
312160,202106,9340,24684,7213,20995,821,2625,3580,9998,4401,12623
312170,202106,910,2394,705,2002,38,134,464,1280,502,1414
312180,202106,1412,3710,1136,3200,147,428,606,1665,753,2093
312190,202106,690,1872,519,1563,73,250,207,589,280,839
312200,202106,4479,12039,3540,10529,833,2443,1501,4544,2334,6987
312210,202106,1412,3071,1033,2540,46,131,779,1875,825,2006
312220,202106,1604,4895,1388,4493,100,343,895,2914,995,3257
312230,202106,15133,38027,10413,29662,2275,7353,2503,5970,4778,13323
312235,202106,2005,4922,1581,4333,102,315,1132,3004,1234,3319
312240,202106,744,2321,572,1966,108,403,172,575,280,978
312245,202106,2753,6848,2271,6124,52,120,1916,5146,1968,5266
312247,202106,1027,2390,750,1996,115,323,428,1129,543,1452
312250,202106,971,2549,620,1856,74,231,226,649,300,880
312260,202106,972,2540,775,2241,35,134,605,1674,640,1808
312270,202106,745,2023,569,1671,32,120,314,849,346,969
312280,202106,428,1231,334,1063,89,301,56,164,145,465
312290,202106,833,2374,685,2113,121,415,229,664,350,1079
312300,202106,1018,3028,683,2210,162,575,132,352,294,927
312310,202106,978,2853,791,2476,116,397,382,1139,498,1536
312320,202106,2055,5166,1500,4224,325,948,343,949,668,1897
312330,202106,871,2492,713,2164,67,231,447,1316,514,1547
312340,202106,263,658,188,540,33,127,98,234,131,361
312350,202106,258,515,186,437,19,48,131,302,150,350
312352,202106,1589,4701,1405,4360,91,284,841,2796,932,3080
312360,202106,3076,8683,2288,7220,416,1455,819,2384,1235,3839
312370,202106,1946,4889,1595,4303,163,494,1000,2577,1163,3071
312380,202106,2195,4886,1831,4421,5,15,1644,3913,1649,3928
312385,202106,1274,3368,989,2866,172,521,401,1188,573,1709
312390,202106,1945,5439,1455,4551,194,715,521,1465,715,2180
312400,202106,2932,8174,2460,7382,682,2235,817,2437,1499,4672
312410,202106,12400,33127,10140,29436,1716,5047,5726,16395,7442,21442
312420,202106,3941,10256,3271,9171,617,1869,1717,4660,2334,6529
312430,202106,8035,20964,6606,18445,336,1079,4792,13049,5128,14128
312440,202106,969,3087,799,2709,371,1341,128,399,499,1740
312450,202106,1204,3484,923,2991,255,867,283,963,538,1830
312460,202106,464,1155,330,951,47,130,183,549,230,679
312470,202106,481,1146,298,816,31,95,107,256,138,351
312480,202106,1051,2554,742,2100,87,282,389,1034,476,1316
312490,202106,2251,5274,1779,4609,173,494,1038,2634,1211,3128
312500,202106,1066,2555,879,2301,41,142,646,1666,687,1808
312510,202106,4003,10548,2899,8469,703,2017,705,2053,1408,4070
312520,202106,261,665,202,575,44,143,88,237,132,380
312530,202106,646,1511,549,1397,26,63,457,1193,483,1256
312540,202106,1638,4415,1122,3420,142,454,634,1869,776,2323
312550,202106,815,2108,633,1758,46,148,413,1060,459,1208
312560,202106,1976,5091,1594,4487,72,201,1183,3346,1255,3547
312570,202106,2393,5577,1799,4843,457,1213,762,2172,1219,3385
312580,202106,621,1662,439,1295,58,195,194,520,252,715
312590,202106,1616,4600,1269,3897,79,328,803,2273,882,2601
312595,202106,2075,5855,1735,5296,259,717,1035,3340,1294,4057
312600,202106,1196,2822,696,1875,112,371,122,374,234,745
312610,202106,7207,17915,4855,13631,692,2127,1745,4418,2437,6545
312620,202106,2583,6516,1925,5588,53,178,1539,4560,1592,4738
312630,202106,307,845,214,674,31,117,81,254,112,371
312640,202106,510,1370,358,1110,37,131,158,488,195,619
312650,202106,2093,5179,1468,4038,69,200,1043,2730,1112,2930
312660,202106,1331,3204,1017,2672,93,246,683,1744,776,1990
312670,202106,5115,13127,4276,11809,174,645,3195,8444,3369,9089
312675,202106,1326,3325,1090,2985,58,166,893,2417,951,2583
312680,202106,1413,3901,1224,3598,43,175,1014,2912,1057,3087
312690,202106,3018,6231,2338,5429,43,110,1963,4565,2006,4675
312695,202106,983,2574,836,2344,48,99,651,1834,699,1933
312700,202106,2106,5436,1543,4423,141,480,905,2455,1046,2935
312705,202106,1463,3386,1265,3099,13,40,1165,2830,1178,2870
312707,202106,1403,3930,1080,3364,70,278,709,2110,779,2388
312710,202106,6593,14940,3997,10939,950,2798,1123,3208,2073,6006
312720,202106,1100,2831,823,2401,95,290,503,1420,598,1710
312730,202106,1665,3863,1180,3201,92,273,703,1849,795,2122
312733,202106,1399,3622,1057,2982,25,81,742,1976,767,2057
312735,202106,750,1937,611,1675,79,218,351,894,430,1112
312737,202106,810,1765,585,1453,60,162,395,957,455,1119
312738,202106,727,1795,524,1457,47,144,311,825,358,969
312740,202106,436,1082,257,784,47,164,60,130,107,294
312750,202106,1598,4503,1196,3749,183,615,550,1631,733,2246
312760,202106,1830,5273,1316,4209,229,752,488,1502,717,2254
312770,202106,45291,107093,28777,78970,5483,16261,9989,26466,15472,42727
312780,202106,2471,7161,2084,6530,236,756,1371,4310,1607,5066
312790,202106,251,582,138,401,4,15,41,85,45,100
312800,202106,5126,14077,3931,11819,834,2639,1541,4436,2375,7075
312810,202106,1554,4120,1049,3291,253,874,386,1111,639,1985
312820,202106,1779,4619,1447,4047,67,219,1082,2960,1149,3179
312825,202106,1394,3178,1218,2957,21,64,1055,2509,1076,2573
312830,202106,2852,7825,1749,5615,312,1130,463,1395,775,2525
312840,202106,1433,3722,1159,3269,65,243,706,1861,771,2104
312850,202106,992,2324,708,1910,19,72,446,1105,465,1177
312860,202106,1104,2811,758,2288,187,578,180,514,367,1092
312870,202106,6233,16402,3943,12060,583,1907,1032,2860,1615,4767
312880,202106,1486,3651,1149,3091,43,137,682,1856,725,1993
312890,202106,2301,5593,1714,4649,135,335,879,2421,1014,2756
312900,202106,1261,3167,1026,2860,147,457,490,1477,637,1934
312910,202106,1576,2867,857,1935,189,365,314,751,503,1116
312920,202106,1007,2626,707,2146,114,409,277,752,391,1161
312930,202106,2446,5891,1878,5056,392,1054,845,2353,1237,3407
312940,202106,1005,2703,798,2411,62,241,463,1340,525,1581
312950,202106,3109,7529,2087,5907,468,1473,735,1979,1203,3452
312960,202106,1867,4817,1586,4396,82,206,1204,3426,1286,3632
312965,202106,1657,4454,1383,4037,112,300,963,2809,1075,3109
312970,202106,1453,4004,1173,3558,143,507,728,2098,871,2605
312980,202106,25037,67049,20227,58564,3946,12211,9295,25298,13241,37509
312990,202106,520,1253,346,963,57,186,175,434,232,620
313000,202106,479,1361,362,1147,24,107,218,654,242,761
313005,202106,2598,7304,2198,6633,142,394,1586,4744,1728,5138
313010,202106,5347,14220,4275,12516,711,2260,2527,7272,3238,9532
313020,202106,1103,3238,801,2569,133,444,166,460,299,904
313030,202106,1192,2629,814,2101,67,221,545,1334,612,1555
313040,202106,831,2506,687,2222,39,165,420,1288,459,1453
313050,202106,1799,4858,1265,4061,197,759,414,1169,611,1928
313055,202106,1935,5077,1720,4774,66,195,1485,4102,1551,4297
313060,202106,977,2352,706,1891,139,442,150,373,289,815
313065,202106,1684,4872,1485,4552,44,150,1169,3497,1213,3647
313070,202106,959,2472,739,2109,72,218,430,1185,502,1403
313080,202106,399,1090,297,896,52,175,113,284,165,459
313090,202106,5324,13674,4518,12394,312,971,3116,8437,3428,9408
313100,202106,1349,3453,1043,3014,27,110,797,2250,824,2360
313110,202106,1488,3868,1108,3212,97,337,609,1643,706,1980
313115,202106,2825,7851,2251,6758,271,957,1215,3353,1486,4310
313120,202106,3874,9007,2842,7660,200,592,1916,5166,2116,5758
313130,202106,32390,81358,24721,67519,2427,7580,14226,36543,16653,44123
313140,202106,696,1464,440,1111,24,60,322,810,346,870
313150,202106,1393,3838,1046,3225,317,1051,177,501,494,1552
313160,202106,1253,3080,987,2686,21,71,756,1990,777,2061
313170,202106,11343,31605,8371,26092,1311,4479,3405,9873,4716,14352
313180,202106,2217,5777,1608,4538,254,685,900,2539,1154,3224
313190,202106,4455,12566,3258,10144,562,1879,1146,3312,1708,5191
313200,202106,1135,3074,989,2819,14,48,836,2313,850,2361
313210,202106,3988,11115,3267,9832,365,1141,1989,5830,2354,6971
313220,202106,1777,4593,1186,3425,156,503,503,1283,659,1786
313230,202106,3009,8217,2467,7547,44,152,2060,6435,2104,6587
313240,202106,10285,24735,6730,19142,964,3155,3148,8362,4112,11517
313250,202106,6282,18086,4796,14877,867,2654,2135,6383,3002,9037
313260,202106,688,1759,505,1437,62,227,255,661,317,888
313270,202106,5906,14264,4769,12715,529,1259,3327,9145,3856,10404
313280,202106,472,1305,308,967,38,138,126,376,164,514
313290,202106,1008,3046,759,2601,183,701,277,934,460,1635
313300,202106,1666,4370,1233,3623,295,931,336,875,631,1806
313310,202106,1242,3615,971,3053,148,551,299,815,447,1366
313320,202106,2127,5559,1537,4620,269,908,590,1818,859,2726
313330,202106,4245,10858,3218,9310,145,510,2110,6067,2255,6577
313340,202106,1435,3177,1032,2620,77,209,739,1851,816,2060
313350,202106,3021,8214,1985,5912,216,732,764,1960,980,2692
313360,202106,1557,3751,1070,2971,154,518,561,1437,715,1955
313370,202106,1533,4153,1254,3615,166,534,604,1589,770,2123
313375,202106,1856,4826,1200,3584,229,743,253,681,482,1424
313380,202106,6487,15915,4707,12715,744,2264,2302,5536,3046,7800
313390,202106,812,2560,709,2387,50,217,478,1541,528,1758
313400,202106,3737,9024,2892,7872,118,352,2241,5980,2359,6332
313410,202106,1370,3446,1057,2913,64,208,788,2113,852,2321
313420,202106,16047,35160,8460,22618,1920,5707,1114,2951,3034,8658
313430,202106,985,2797,764,2344,118,447,347,919,465,1366
313440,202106,6125,13178,4105,10556,357,960,2617,6731,2974,7691
313450,202106,749,1950,529,1529,89,283,188,465,277,748
313460,202106,2142,5984,1702,5286,341,1195,787,2315,1128,3510
313470,202106,2907,7250,2297,6358,205,566,1561,4377,1766,4943
313480,202106,1049,2944,619,1998,53,191,206,617,259,808
313490,202106,3018,7296,1581,4677,365,1178,382,1111,747,2289
313500,202106,549,1503,405,1196,34,104,168,457,202,561
313505,202106,10310,26713,8794,24649,320,1054,7077,19852,7397,20906
313507,202106,1510,3814,1238,3392,31,129,998,2648,1029,2777
313510,202106,14524,39231,11323,32926,1351,3853,5316,15206,6667,19059
313520,202106,15033,40939,12021,35808,563,1908,9045,26368,9608,28276
313530,202106,569,1641,431,1357,48,166,146,393,194,559
313535,202106,2435,6609,2003,5792,265,692,1246,3631,1511,4323
313540,202106,811,2358,653,1985,116,366,277,761,393,1127
313545,202106,1149,3752,976,3402,127,482,539,1809,666,2291
313550,202106,1836,5424,1528,4708,286,967,814,2408,1100,3375
313560,202106,2768,5327,2082,4495,55,89,1769,3852,1824,3941
313570,202106,1017,2865,832,2538,199,626,333,1001,532,1627
313580,202106,6022,15001,4723,12859,485,1355,2888,7818,3373,9173
313590,202106,1099,2986,889,2676,174,557,450,1436,624,1993
313600,202106,4207,10809,3505,9735,81,287,3003,8190,3084,8477
313610,202106,1097,2669,883,2311,82,239,578,1428,660,1667
313620,202106,5507,14279,4328,12170,481,1566,2578,6939,3059,8505
313630,202106,9019,21245,6449,17427,606,1908,3961,10412,4567,12320
313640,202106,1236,2611,762,2013,118,331,415,1088,533,1419
313650,202106,1724,5055,1363,4453,96,368,885,2920,981,3288
313652,202106,798,2412,718,2257,93,306,476,1453,569,1759
313655,202106,1154,2836,897,2518,53,147,663,1876,716,2023
313657,202106,1180,3058,945,2684,29,105,724,1947,753,2052
313660,202106,982,2723,801,2404,74,269,518,1492,592,1761
313665,202106,5117,13314,4078,11516,379,1201,2619,7040,2998,8241
313670,202106,50391,121453,32948,92278,4421,13630,15364,40554,19785,54184
313680,202106,1074,2780,889,2475,54,160,614,1661,668,1821
313690,202106,823,2477,643,2150,143,531,196,622,339,1153
313695,202106,1890,4924,1420,4149,101,298,915,2744,1016,3042
313700,202106,3009,9263,2631,8761,243,751,2014,6788,2257,7539
313710,202106,1509,3345,1076,2772,73,192,722,1873,795,2065
313720,202106,5928,16005,4253,12521,578,1802,1792,4866,2370,6668
313730,202106,1431,3091,1062,2616,84,177,696,1740,780,1917
313740,202106,1731,6067,1456,5358,297,1249,287,914,584,2163
313750,202106,2101,5451,1642,4666,281,893,823,2183,1104,3076
313753,202106,2254,5330,1507,4117,150,457,820,2159,970,2616
313760,202106,5737,15419,4414,12880,787,2588,2105,5671,2892,8259
313770,202106,4083,11231,3245,9905,156,468,2464,7626,2620,8094
313780,202106,4111,10624,3043,8877,241,794,941,2817,1182,3611
313790,202106,520,1529,464,1430,48,159,283,854,331,1013
313800,202106,1409,3101,1027,2582,98,272,555,1332,653,1604
313810,202106,1663,4115,1339,3657,45,157,1051,2795,1096,2952
313820,202106,18115,45585,11450,31536,1902,5369,2976,7969,4878,13338
313830,202106,407,1160,291,900,51,180,102,292,153,472
313835,202106,920,2633,764,2358,65,238,429,1241,494,1479
313840,202106,7658,19647,5931,16834,1301,3978,1305,3787,2606,7765
313850,202106,997,2393,788,2110,140,435,374,899,514,1334
313860,202106,2685,6955,2040,5770,272,895,947,2432,1219,3327
313862,202106,1321,2760,650,1786,41,113,302,827,343,940
313865,202106,2654,6863,2199,6141,89,248,1659,4552,1748,4800
313867,202106,1418,4208,1185,3782,218,687,605,2004,823,2691
313868,202106,1726,5154,1424,4584,47,200,1091,3398,1138,3598
313870,202106,974,2495,669,1949,94,284,258,686,352,970
313880,202106,1865,4726,1372,3885,167,538,703,1804,870,2342
313890,202106,2161,4513,1626,3818,30,95,1266,2882,1296,2977
313900,202106,4378,12256,3135,9761,760,2582,788,2210,1548,4792
313910,202106,710,2019,540,1698,92,314,122,377,214,691
313920,202106,3000,8858,2506,7842,494,1545,1263,3973,1757,5518
313925,202106,1630,4036,1326,3508,154,387,896,2379,1050,2766
313930,202106,4757,13895,3868,12289,276,952,2531,7935,2807,8887
313940,202106,9130,25805,6808,21796,675,2631,1718,6216,2393,8847
313950,202106,5441,11736,4127,10136,306,936,2697,6681,3003,7617
313960,202106,5848,13773,3949,10594,726,2199,1275,3112,2001,5311
313970,202106,1561,4108,1312,3696,21,68,850,2343,871,2411
313980,202106,1322,3391,881,2720,140,473,365,1066,505,1539
313990,202106,1963,6039,1436,4884,321,1271,531,1603,852,2874
314000,202106,10033,25071,8384,22282,630,2068,5549,14465,6179,16533
314010,202106,1491,3527,1183,3112,32,103,922,2353,954,2456
314015,202106,2017,5429,1556,4632,181,635,885,2535,1066,3170
314020,202106,529,1416,366,1136,85,314,69,237,154,551
314030,202106,781,2205,620,1902,61,186,332,996,393,1182
314040,202106,607,1627,499,1431,82,265,257,703,339,968
314050,202106,1938,5048,1432,4124,137,456,804,2158,941,2614
314053,202106,1885,5499,1547,4843,318,968,835,2715,1153,3683
314055,202106,2264,5914,1906,5371,42,162,1576,4422,1618,4584
314060,202106,1338,3445,1008,2931,31,102,726,2090,757,2192
314070,202106,4890,13014,3863,11219,728,2099,1750,5041,2478,7140
314080,202106,2164,5503,1503,4387,166,532,658,1749,824,2281
314085,202106,2321,6246,1898,5604,190,565,1151,3454,1341,4019
314090,202106,4954,12806,4259,11788,249,785,2838,8105,3087,8890
314100,202106,3065,7304,2377,6347,37,112,1781,4785,1818,4897
314110,202106,5090,13889,4165,12167,462,1492,2315,6301,2777,7793
314120,202106,731,1691,321,947,54,186,87,241,141,427
314130,202106,666,1743,434,1318,28,101,254,746,282,847
314140,202106,4627,12653,3712,10984,482,1474,1902,5539,2384,7013
314150,202106,1523,3736,1117,3041,59,146,765,2055,824,2201
314160,202106,2313,5870,1689,4723,215,646,725,2038,940,2684
314170,202106,937,2566,770,2239,39,149,515,1396,554,1545
314180,202106,5599,15129,4514,13389,342,1055,2770,8249,3112,9304
314190,202106,633,1554,471,1319,73,236,248,641,321,877
314200,202106,3058,8387,2536,7513,164,514,1763,5107,1927,5621
314210,202106,2123,5389,1678,4600,225,637,774,2080,999,2717
314220,202106,1460,3902,1088,3260,224,742,404,1116,628,1858
314225,202106,1095,3076,918,2781,69,171,666,2064,735,2235
314230,202106,834,2108,676,1903,83,244,432,1255,515,1499
314240,202106,1107,2915,856,2529,188,579,343,1022,531,1601
314250,202106,496,1379,314,991,47,131,112,334,159,465
314260,202106,1021,2644,791,2333,158,511,425,1224,583,1735
314270,202106,3312,9197,2729,8297,66,270,2041,6147,2107,6417
314280,202106,3538,8034,2402,6312,248,729,1377,3428,1625,4157
314290,202106,4537,11525,3766,10167,318,869,2581,6825,2899,7694
314300,202106,2071,5732,1349,4211,229,774,475,1341,704,2115
314310,202106,3976,10230,2665,7990,795,2661,413,1055,1208,3716
314315,202106,990,3151,844,2842,45,193,608,1983,653,2176
314320,202106,3157,8405,2095,6414,361,1212,785,2250,1146,3462
314330,202106,51214,140781,39090,119572,9902,31509,8395,26960,18297,58469
314340,202106,2535,6229,1604,4595,295,976,413,1023,708,1999
314345,202106,1470,4230,1181,3702,143,451,722,2249,865,2700
314350,202106,827,2215,540,1693,112,358,129,341,241,699
314360,202106,559,1617,363,1206,53,189,121,359,174,548
314370,202106,769,1994,621,1778,48,144,416,1158,464,1302
314380,202106,1145,3038,752,2343,170,602,168,497,338,1099
314390,202106,14522,35805,9783,27361,1476,4479,3448,8524,4924,13003
314400,202106,3938,11648,3024,9834,776,2638,1112,3777,1888,6415
314410,202106,2799,7721,1972,6182,252,923,614,1997,866,2920
314420,202106,854,2069,627,1702,34,124,428,1103,462,1227
314430,202106,8070,19145,5703,15300,814,2290,2718,6963,3532,9253
314435,202106,1932,5070,1507,4368,151,460,935,2641,1086,3101
314437,202106,919,2307,662,1889,72,216,339,967,411,1183
314440,202106,626,1761,448,1412,139,486,87,214,226,700
314450,202106,1472,3813,1234,3424,140,414,695,1861,835,2275
314460,202106,3208,9593,2357,7856,584,2077,578,1833,1162,3910
314465,202106,2255,6351,1917,5725,47,157,1499,4385,1546,4542
314467,202106,911,2374,770,2150,18,49,624,1703,642,1752
314470,202106,2413,6705,2000,5882,344,1082,939,2575,1283,3657
314480,202106,7464,20367,5627,16610,890,2915,2247,5876,3137,8791
314490,202106,1115,2867,818,2266,64,191,533,1435,597,1626
314500,202106,1678,3967,1218,3358,309,822,416,1203,725,2025
314505,202106,2094,5010,1720,4477,88,253,1288,3249,1376,3502
314510,202106,2059,5243,1462,4326,290,958,670,1927,960,2885
314520,202106,5287,15739,4072,13309,812,2918,664,1934,1476,4852
314530,202106,5510,17255,4947,16189,305,1180,3683,11789,3988,12969
314535,202106,2483,6410,2027,5754,77,283,1579,4461,1656,4744
314537,202106,1136,3170,876,2755,39,143,653,2012,692,2155
314540,202106,414,1024,286,812,22,64,168,453,190,517
314545,202106,2002,4662,1796,4426,32,85,1578,3971,1610,4056
314550,202106,736,1745,543,1452,35,115,321,784,356,899
314560,202106,4682,13597,3461,10956,475,1707,1290,3603,1765,5310
314570,202106,315,866,231,713,26,89,107,336,133,425
314580,202106,458,1353,365,1171,93,292,122,395,215,687
314585,202106,667,2024,510,1684,55,212,233,749,288,961
314587,202106,2144,5701,1641,4904,289,821,909,2757,1198,3578
314590,202106,4250,11219,3150,9208,402,1301,1476,3949,1878,5250
314600,202106,1949,5199,1180,3755,258,853,130,401,388,1254
314610,202106,9246,22484,6684,18756,948,3168,3046,8732,3994,11900
314620,202106,2312,5285,1841,4692,39,126,1553,3941,1592,4067
314625,202106,1578,4208,1359,3906,25,145,1179,3316,1204,3461
314630,202106,5574,13637,4563,12276,101,394,3818,10175,3919,10569
314640,202106,714,1661,528,1376,66,198,311,753,377,951
314650,202106,839,1922,529,1438,48,152,302,727,350,879
314655,202106,1587,4306,1140,3517,162,471,568,1790,730,2261
314660,202106,333,752,223,562,12,27,146,357,158,384
314670,202106,1657,3701,1155,2991,16,47,790,2010,806,2057
314675,202106,1750,4484,1486,4052,68,197,1175,3131,1243,3328
314690,202106,2093,5630,1584,4886,387,1304,564,1717,951,3021
314700,202106,10984,29599,7406,22872,1309,4446,2678,7929,3987,12375
314710,202106,8213,22610,6050,18096,935,3103,2286,5970,3221,9073
314720,202106,2211,6446,1555,5115,289,1028,362,1111,651,2139
314730,202106,2385,6092,1725,4933,288,898,642,1686,930,2584
314740,202106,3061,8463,2400,7278,315,995,1230,3622,1545,4617
314750,202106,280,763,215,631,26,89,131,340,157,429
314760,202106,2007,5817,1313,4267,220,802,335,840,555,1642
314770,202106,1106,3151,619,1967,61,207,192,549,253,756
314780,202106,368,886,254,710,41,134,142,353,183,487
314790,202106,12107,31486,8566,24994,1540,5088,3362,9084,4902,14172
314795,202106,1585,4075,1340,3658,27,115,1084,2845,1111,2960
314800,202106,11072,27831,7029,20480,1206,3789,1894,4931,3100,8720
314810,202106,9236,24067,6779,19871,1732,5371,2159,6204,3891,11575
314820,202106,1282,3033,1013,2620,68,216,641,1572,709,1788
314830,202106,1653,4798,1383,4299,207,704,706,2121,913,2825
314840,202106,854,2626,667,2297,48,212,457,1495,505,1707
314850,202106,2272,4992,1844,4458,51,134,1594,3849,1645,3983
314860,202106,3326,9422,2782,8453,153,604,2001,5905,2154,6509
314870,202106,6571,15770,4979,13737,235,646,3694,10354,3929,11000
314875,202106,1880,5476,1663,5191,163,399,1306,4235,1469,4634
314880,202106,840,2021,653,1729,38,111,400,1066,438,1177
314890,202106,428,1251,331,1055,53,184,142,421,195,605
314900,202106,785,2030,603,1712,80,261,279,766,359,1027
314910,202106,1697,4708,1263,4001,189,698,656,1947,845,2645
314915,202106,2202,6410,1853,5790,115,359,1228,3773,1343,4132
314920,202106,499,1289,335,1043,14,37,218,695,232,732
314930,202106,5685,15677,4332,13156,699,2385,1807,5038,2506,7423
314940,202106,421,1006,348,885,38,95,226,554,264,649
314950,202106,573,1420,398,1145,24,83,215,570,239,653
314960,202106,864,1996,664,1677,27,81,484,1152,511,1233
314970,202106,991,2888,763,2423,136,472,341,980,477,1452
314980,202106,1631,4079,1238,3504,205,652,632,1736,837,2388
314990,202106,2526,7215,1824,5651,357,1147,396,1105,753,2252
314995,202106,1653,4504,1320,3915,28,112,909,2542,937,2654
315000,202106,1130,2835,810,2340,60,176,529,1511,589,1687
315010,202106,381,1031,293,881,48,170,144,410,192,580
315015,202106,2325,6396,2021,5887,185,623,1367,3910,1552,4533
315020,202106,807,2324,575,1818,64,241,253,744,317,985
315030,202106,612,1605,415,1245,92,285,86,219,178,504
315040,202106,891,2381,727,2091,98,313,456,1264,554,1577
315050,202106,1266,3152,937,2636,50,176,518,1383,568,1559
315053,202106,1158,2958,888,2499,55,157,526,1408,581,1565
315057,202106,1797,5219,1461,4662,137,396,976,3227,1113,3623
315060,202106,603,1765,441,1437,91,299,112,350,203,649
315070,202106,537,1374,377,1100,82,268,122,327,204,595
315080,202106,3179,8505,2485,7255,151,483,1711,4741,1862,5224
315090,202106,818,2409,609,2014,85,314,260,819,345,1133
315100,202106,1369,3919,907,2890,125,471,402,1114,527,1585
315110,202106,2065,4804,1506,3974,137,354,767,2078,904,2432
315120,202106,12867,29288,9582,24417,1165,2684,5400,14255,6565,16939
315130,202106,1695,4544,1415,4069,141,464,600,1602,741,2066
315140,202106,2992,8143,2368,7049,438,1431,1183,3316,1621,4747
315150,202106,4440,10591,3165,8578,437,1375,1535,4055,1972,5430
315160,202106,1876,4503,1248,3518,254,779,563,1533,817,2312
315170,202106,1379,4297,983,3348,205,759,271,869,476,1628
315180,202106,17820,42488,10136,28596,1273,4060,3496,8617,4769,12677
315190,202106,2256,4883,1752,4227,226,541,1234,3027,1460,3568
315200,202106,4086,11294,3011,9438,816,2780,782,2363,1598,5143
315210,202106,8946,22694,6253,17179,681,2006,3188,7927,3869,9933
315213,202106,1132,2942,983,2736,21,75,816,2217,837,2292
315217,202106,2893,8098,2202,6939,77,290,1498,4544,1575,4834
315220,202106,8709,23229,6892,20077,996,3026,3250,9480,4246,12506
315230,202106,3068,7007,2572,6345,213,321,1839,4911,2052,5232
315240,202106,2459,7001,2052,6312,420,1348,993,3091,1413,4439
315250,202106,13972,36944,10275,30084,1553,4887,4399,12224,5952,17111
315260,202106,886,2383,487,1560,74,241,39,107,113,348
315270,202106,886,2510,647,2061,87,295,227,628,314,923
315280,202106,2882,7100,1813,5213,441,1354,320,902,761,2256
315290,202106,1184,2880,714,2132,186,616,204,593,390,1209
315300,202106,661,1597,471,1328,59,184,272,776,331,960
315310,202106,1254,3437,959,2889,70,224,560,1585,630,1809
315320,202106,673,1938,473,1535,67,245,191,568,258,813
315330,202106,768,2544,440,1666,65,278,148,495,213,773
315340,202106,2974,7100,2129,5860,337,941,1071,2915,1408,3856
315350,202106,1627,4324,1311,3835,155,527,783,2242,938,2769
315360,202106,1769,5104,1369,4302,186,615,598,1732,784,2347
315370,202106,548,1479,440,1280,73,203,204,578,277,781
315380,202106,268,747,196,591,32,112,28,71,60,183
315390,202106,1183,3265,957,2853,126,459,497,1358,623,1817
315400,202106,4124,10948,3271,9443,377,1162,1914,5254,2291,6416
315410,202106,2533,5641,1897,4705,403,1120,383,980,786,2100
315415,202106,1446,3869,1172,3444,251,857,421,1240,672,2097
315420,202106,1495,4121,1047,3284,182,601,239,709,421,1310
315430,202106,3709,8903,2628,7291,441,1430,1172,3074,1613,4504
315440,202106,1058,2760,839,2399,64,217,503,1340,567,1557
315445,202106,1983,4663,1438,3890,86,267,1072,2854,1158,3121
315450,202106,2355,6317,1934,5623,252,644,1197,3529,1449,4173
315460,202106,39683,106951,32872,94991,4305,14131,18902,51132,23207,65263
315470,202106,661,1811,472,1357,33,103,266,728,299,831
315480,202106,1149,3253,827,2577,144,460,277,839,421,1299
315490,202106,2965,7392,2092,5999,277,822,823,2226,1100,3048
315500,202106,532,1401,335,980,39,138,174,439,213,577
315510,202106,1290,3262,1091,2988,14,52,971,2617,985,2669
315520,202106,1015,2720,836,2430,44,147,655,1859,699,2006
315530,202106,627,1713,502,1486,113,389,271,742,384,1131
315540,202106,1572,4109,1103,3247,91,320,518,1468,609,1788
315550,202106,1906,4950,1252,3757,248,861,328,972,576,1833
315560,202106,6419,18923,5458,17210,319,962,3672,11752,3991,12714
315570,202106,2140,5615,1700,4878,152,475,889,2474,1041,2949
315580,202106,3133,7215,2426,6118,355,970,995,2410,1350,3380
315590,202106,933,2277,725,1962,52,172,466,1181,518,1353
315600,202106,2566,7749,1822,6296,293,910,890,3305,1183,4215
315610,202106,1010,2498,761,2058,101,338,358,839,459,1177
315620,202106,533,1375,408,1192,45,143,226,665,271,808
315630,202106,1077,2779,826,2327,115,358,409,1047,524,1405
315640,202106,352,852,261,738,28,104,163,437,191,541
315645,202106,1011,2570,707,2073,149,475,194,533,343,1008
315650,202106,1721,4083,1389,3623,38,116,1118,2843,1156,2959
315660,202106,2481,6071,1861,5003,90,268,1349,3499,1439,3767
315670,202106,14096,37594,10789,31717,1991,6139,5006,14042,6997,20181
315680,202106,3261,9086,2419,7503,256,938,1366,4014,1622,4952
315690,202106,3662,8765,2256,6403,478,1351,597,1844,1075,3195
315700,202106,8478,22748,6453,18824,966,2960,2890,8073,3856,11033
315710,202106,1873,4530,1351,3752,49,175,954,2571,1003,2746
315720,202106,4470,12210,3725,10868,184,694,2629,7368,2813,8062
315725,202106,2275,5762,1748,4920,219,581,1050,3110,1269,3691
315727,202106,574,1451,440,1236,53,179,190,507,243,686
315730,202106,595,1796,524,1655,91,326,173,482,264,808
315733,202106,1276,3180,944,2633,145,464,353,929,498,1393
315737,202106,1188,3237,939,2758,25,95,678,1908,703,2003
315740,202106,813,2228,656,1913,63,208,440,1202,503,1410
315750,202106,1274,3295,1021,2901,92,273,639,1831,731,2104
315760,202106,1169,2702,1020,2499,47,152,847,2021,894,2173
315765,202106,2001,5161,1651,4702,28,103,1464,4160,1492,4263
315770,202106,1031,2787,797,2459,315,1063,160,435,475,1498
315780,202106,31282,83266,26166,74229,1351,4700,18212,49153,19563,53853
315790,202106,3668,11075,3138,10099,312,1046,1919,6332,2231,7378
315800,202106,1321,4409,995,3599,132,538,357,1128,489,1666
315810,202106,1315,3259,1082,2859,58,181,840,2141,898,2322
315820,202106,2645,6887,2119,6150,194,589,1490,4342,1684,4931
315830,202106,1241,3607,839,2729,85,297,269,741,354,1038
315840,202106,900,2121,631,1653,45,149,336,796,381,945
315850,202106,1216,3457,961,3018,177,580,476,1419,653,1999
315860,202106,500,1400,353,1143,54,192,126,359,180,551
315870,202106,480,1263,384,1108,26,82,271,753,297,835
315880,202106,1139,2845,790,2229,94,289,226,597,320,886
315890,202106,1727,4803,1401,4353,343,1179,701,2149,1044,3328
315895,202106,6395,17009,4833,13986,444,1444,2527,6798,2971,8242
315900,202106,821,2079,707,1919,63,172,528,1397,591,1569
315910,202106,532,1427,447,1295,72,201,296,864,368,1065
315920,202106,1466,3677,841,2508,127,457,280,734,407,1191
315930,202106,1118,2439,764,1937,137,321,347,896,484,1217
315935,202106,889,2636,712,2298,134,465,261,827,395,1292
315940,202106,618,1657,491,1466,61,191,262,753,323,944
315950,202106,1153,3156,954,2831,88,251,741,2196,829,2447
315960,202106,5698,15669,3911,12093,1043,3523,506,1102,1549,4625
315970,202106,590,1548,470,1388,57,172,312,941,369,1113
315980,202106,4366,9223,2447,6141,445,1184,948,2167,1393,3351
315990,202106,3611,9155,2841,7827,319,900,1563,4162,1882,5062
316000,202106,643,1558,496,1344,52,171,261,668,313,839
316010,202106,824,2211,620,1854,52,173,328,878,380,1051
316020,202106,954,2787,765,2416,111,386,418,1232,529,1618
316030,202106,2786,7661,2148,6506,238,724,1373,4246,1611,4970
316040,202106,2547,7116,1899,5907,310,1113,545,1473,855,2586
316045,202106,2081,5291,1914,5090,76,145,1673,4556,1749,4701
316050,202106,407,1098,319,954,47,132,174,489,221,621
316060,202106,690,1673,506,1429,20,84,359,971,379,1055
316070,202106,5515,14932,4513,13064,796,2288,2098,5929,2894,8217
316080,202106,764,2335,596,1997,149,541,93,262,242,803
316090,202106,417,1161,325,981,41,128,170,474,211,602
316095,202106,1330,4046,1043,3326,268,912,377,1133,645,2045
316100,202106,2523,7186,1854,5803,302,1039,710,2014,1012,3053
316105,202106,849,2191,696,1947,44,140,475,1355,519,1495
316110,202106,14161,39482,11867,35653,827,2778,8217,24308,9044,27086
316120,202106,1276,3474,843,2499,126,387,273,632,399,1019
316130,202106,1266,2849,837,2144,64,185,506,1249,570,1434
316140,202106,1245,3259,792,2416,87,287,370,1109,457,1396
316150,202106,2120,4631,1694,4039,212,631,755,1695,967,2326
316160,202106,1043,2747,838,2375,36,117,597,1654,633,1771
316165,202106,884,2126,699,1844,110,328,395,983,505,1311
316170,202106,1230,3013,932,2572,34,110,664,1755,698,1865
316180,202106,1460,4055,1011,3165,154,560,226,633,380,1193
316190,202106,2748,7651,1652,5054,239,765,646,1749,885,2514
316200,202106,3319,9348,2547,8012,555,1868,787,2371,1342,4239
316210,202106,4743,13707,3406,10616,1135,3900,191,463,1326,4363
316220,202106,648,1933,443,1488,95,367,46,177,141,544
316225,202106,1595,3581,1196,2956,48,174,912,2099,960,2273
316230,202106,437,1170,340,1007,59,191,165,483,224,674
316240,202106,5665,16122,4960,14870,357,1156,3764,11126,4121,12282
316245,202106,3229,9952,2937,9472,106,573,2359,7282,2465,7855
316250,202106,10912,25676,8110,21275,1621,4587,3091,8009,4712,12596
316255,202106,2920,7951,2564,7397,108,313,1955,5717,2063,6030
316257,202106,1427,3375,1042,2714,97,263,657,1631,754,1894
316260,202106,2281,5507,1810,4766,212,544,963,2607,1175,3151
316265,202106,1152,3051,904,2632,16,61,686,1951,702,2012
316270,202106,3793,11355,3268,10244,481,1596,1676,5028,2157,6624
316280,202106,2967,8111,2536,7327,327,1022,1412,3951,1739,4973
316290,202106,3530,9639,2854,8370,337,1089,1174,3306,1511,4395
316292,202106,5241,13664,4240,12058,540,1602,2703,7414,3243,9016
316294,202106,864,2525,664,2184,125,483,172,520,297,1003
316295,202106,3387,9329,2765,8261,142,517,1951,5571,2093,6088
316300,202106,1035,2838,830,2515,33,113,605,1808,638,1921
316310,202106,809,2138,541,1663,116,414,105,269,221,683
316320,202106,698,1907,548,1674,57,203,269,799,326,1002
316330,202106,1099,2777,846,2354,52,167,646,1750,698,1917
316340,202106,1011,2671,754,2211,80,290,421,1175,501,1465
316350,202106,1322,3633,1093,3254,136,412,684,2017,820,2429
316360,202106,640,1675,532,1500,50,152,396,1113,446,1265
316370,202106,5588,14075,4285,11807,599,1913,2004,4904,2603,6817
316380,202106,1761,4203,1398,3679,58,120,970,2567,1028,2687
316390,202106,790,2104,565,1710,234,804,81,209,315,1013
316400,202106,1213,3377,800,2557,99,349,278,785,377,1134
316410,202106,1148,3115,962,2836,57,184,776,2237,833,2421
316420,202106,1991,5334,1739,5009,39,135,1448,4093,1487,4228
316430,202106,885,2256,593,1756,94,315,238,641,332,956
316440,202106,834,2521,671,2234,118,449,187,566,305,1015
316443,202106,556,1524,406,1236,97,337,100,287,197,624
316447,202106,2074,5399,1809,4974,24,79,1587,4310,1611,4389
316450,202106,2202,6489,1696,5442,239,809,983,3087,1222,3896
316460,202106,1296,3245,1061,2883,114,341,697,1811,811,2152
316470,202106,7148,20095,5201,16025,782,2668,2090,5867,2872,8535
316480,202106,201,533,171,493,52,141,75,216,127,357
316490,202106,333,882,235,701,39,124,81,204,120,328
316500,202106,1243,3776,824,2788,170,633,188,584,358,1217
316510,202106,815,2561,651,2236,105,367,335,1155,440,1522
316520,202106,1400,3317,1101,2834,120,376,598,1391,718,1767
316530,202106,1156,2960,834,2384,83,308,435,1107,518,1415
316540,202106,950,2360,764,2078,104,313,415,1022,519,1335
316550,202106,1355,3886,1171,3556,41,149,916,2760,957,2909
316553,202106,4513,13007,3267,10064,449,1505,1330,3624,1779,5129
316555,202106,2716,8110,2448,7742,95,325,2075,6602,2170,6927
316556,202106,530,1300,409,1081,26,74,251,597,277,671
316557,202106,1055,3188,920,2973,286,1006,341,1057,627,2063
316560,202106,343,940,243,791,39,143,96,294,135,437
316570,202106,1369,3839,1140,3420,284,845,385,1217,669,2062
316580,202106,401,840,250,600,35,92,128,287,163,379
316590,202106,1373,3446,963,2662,223,535,447,1224,670,1759
316600,202106,950,2870,811,2588,126,404,401,1282,527,1686
316610,202106,599,1854,489,1676,58,253,287,952,345,1205
316620,202106,2158,5511,1891,5134,82,241,1525,4128,1607,4369
316630,202106,1603,4689,1328,4174,348,1104,507,1765,855,2869
316640,202106,139,364,112,328,16,57,52,128,68,185
316650,202106,1077,3267,862,2929,85,314,539,1837,624,2151
316660,202106,191,466,79,238,11,36,12,24,23,60
316670,202106,1806,4505,1372,3827,348,1014,445,1219,793,2233
316680,202106,2326,5842,1732,4723,100,292,1295,3442,1395,3734
316690,202106,1447,3995,1096,3366,177,587,487,1441,664,2028
316695,202106,1038,2956,860,2641,24,88,604,1840,628,1928
316700,202106,403,917,332,836,16,45,263,634,279,679
316710,202106,3244,10262,2549,8843,432,1612,1142,3853,1574,5465
316720,202106,21388,57103,15966,46850,2624,8220,7052,19488,9676,27708
316730,202106,480,1236,385,1064,40,139,197,500,237,639
316740,202106,780,2205,674,2038,74,260,426,1301,500,1561
316750,202106,408,1161,313,981,73,237,128,382,201,619
316760,202106,3468,10954,2906,9842,1131,4180,707,2261,1838,6441
316770,202106,1649,3632,1255,3110,29,81,1021,2581,1050,2662
316780,202106,554,1606,440,1386,161,551,92,263,253,814
316790,202106,751,2001,542,1587,97,314,161,437,258,751
316800,202106,6503,17842,5233,15560,637,2070,2525,7313,3162,9383
316805,202106,1072,2316,865,2090,56,156,670,1622,726,1778
316810,202106,630,1727,454,1396,78,266,256,760,334,1026
316820,202106,312,747,169,487,19,71,72,186,91,257
316830,202106,824,2100,657,1835,71,200,409,1138,480,1338
316840,202106,2842,7142,2257,6180,175,590,1606,4187,1781,4777
316850,202106,1970,5079,1448,4151,228,707,661,1781,889,2488
316860,202106,20262,50721,14906,42713,2215,7356,6988,19430,9203,26786
316870,202106,8123,21598,6097,17733,861,2746,2825,7656,3686,10402
316880,202106,996,2619,816,2358,139,441,435,1201,574,1642
316890,202106,1184,2610,719,1996,84,303,468,1218,552,1521
316900,202106,2405,6328,1895,5326,386,1161,586,1549,972,2710
316905,202106,517,1522,415,1323,111,383,166,535,277,918
316910,202106,903,2313,551,1696,125,417,51,146,176,563
316920,202106,1819,4373,1305,3624,204,608,670,1817,874,2425
316930,202106,8200,22940,6190,19345,1410,4746,1724,5040,3134,9786
316935,202106,4219,11192,3101,9121,531,1705,1285,3538,1816,5243
316940,202106,6576,18917,5121,15964,723,2467,2190,6321,2913,8788
316950,202106,1954,4471,1522,3885,38,114,1278,3225,1316,3339
316960,202106,5198,11502,3749,9564,361,1000,2559,6383,2920,7383
316970,202106,3905,10733,3375,9762,492,1467,1476,4042,1968,5509
316980,202106,698,2064,530,1744,171,628,69,227,240,855
316990,202106,12573,33018,9362,26615,2220,6877,1590,4126,3810,11003
317000,202106,2518,7281,2208,6834,170,429,1646,5179,1816,5608
317005,202106,2619,7170,2094,6123,321,976,1149,3290,1470,4266
317010,202106,24770,57447,15764,43753,2895,8929,6310,17668,9205,26597
317020,202106,62771,147957,37627,104762,6711,20450,12330,31702,19041,52152
317030,202106,696,1807,546,1601,14,53,421,1221,435,1274
317040,202106,11227,27834,7923,22231,1656,5015,2832,8153,4488,13168
317043,202106,889,1970,639,1620,46,119,475,1183,521,1302
317047,202106,1193,2863,829,2288,69,212,535,1417,604,1629
317050,202106,1226,3723,894,2946,117,417,369,1055,486,1472
317052,202106,2415,6560,1951,5819,274,793,1199,3616,1473,4409
317057,202106,1977,4462,1461,3667,31,106,1028,2525,1059,2631
317060,202106,522,1328,332,952,42,128,135,341,177,469
317065,202106,1163,3382,958,2987,58,175,610,1813,668,1988
317070,202106,7522,20598,5483,16702,905,3074,1824,5210,2729,8284
317075,202106,949,2410,708,2009,86,275,364,942,450,1217
317080,202106,6351,14533,4728,11982,1180,3265,1708,4182,2888,7447
317090,202106,4891,13823,4339,12933,289,777,3221,9680,3510,10457
317100,202106,2696,6331,1763,4805,406,1134,644,1744,1050,2878
317103,202106,2324,5922,1986,5436,68,294,1593,4204,1661,4498
317107,202106,1486,3885,1134,3239,70,233,695,1788,765,2021
317110,202106,677,1566,352,1057,65,224,108,332,173,556
317115,202106,1090,3110,938,2824,67,183,622,1884,689,2067
317120,202106,16286,42721,13309,37982,1041,3540,8584,23301,9625,26841
317130,202106,11849,27089,7828,20557,1156,3362,2838,7335,3994,10697
317140,202106,932,2199,732,1891,50,141,506,1328,556,1469
317150,202106,983,2339,754,2048,29,90,599,1598,628,1688
317160,202106,3662,8582,2460,6704,140,412,1368,3837,1508,4249
317170,202106,1854,4571,1368,3753,171,560,674,1634,845,2194
317180,202106,2030,6210,1498,4935,276,959,419,1266,695,2225
317190,202106,1216,3246,898,2719,209,614,389,1181,598,1795
317200,202106,6158,16165,4641,13163,1008,3066,1126,2905,2134,5971
317210,202106,1226,2918,955,2551,25,94,706,1914,731,2008
317220,202106,264,797,228,731,49,168,98,321,147,489
320010,202106,4653,13346,3722,11486,426,1446,2304,6903,2730,8349
320013,202106,2124,5637,1483,4384,230,696,671,2061,901,2757
320016,202106,3046,7683,2419,6747,190,490,1757,4939,1947,5429
320020,202106,4090,10427,3040,8619,617,1941,1157,3353,1774,5294
320030,202106,1786,4914,1183,3689,217,729,419,1246,636,1975
320035,202106,1973,5275,1617,4677,386,1238,748,2082,1134,3320
320040,202106,4445,12326,3718,11022,498,1523,2087,5943,2585,7466
320050,202106,1776,4008,1536,3674,186,522,914,2110,1100,2632
320060,202106,13806,36903,10302,29866,1545,4833,4821,12989,6366,17822
320070,202106,1638,4481,1181,3578,199,676,454,1267,653,1943
320080,202106,5943,15039,4165,11510,813,2367,1518,3947,2331,6314
320090,202106,8870,23210,5927,17191,1311,4046,2104,5660,3415,9706
320100,202106,3261,8666,2677,7664,431,1319,1418,4056,1849,5375
320110,202106,2191,5021,1525,3970,194,533,812,2007,1006,2540
320115,202106,2045,6370,1746,5871,749,2643,485,1707,1234,4350
320120,202106,25462,63956,17992,50569,2445,7332,8519,22583,10964,29915
320130,202106,50557,136550,41756,120730,4992,15729,24967,69656,29959,85385
320140,202106,3758,10145,2538,7719,354,1257,1063,3131,1417,4388
320150,202106,14514,37064,10509,29498,2570,7947,1557,3908,4127,11855
320160,202106,6508,17704,4847,14554,760,2471,2129,6269,2889,8740
320170,202106,1799,5061,1311,4083,351,1066,484,1627,835,2693
320180,202106,709,2219,566,1941,193,718,157,481,350,1199
320190,202106,2992,9347,2314,7857,555,2017,574,1793,1129,3810
320200,202106,1386,3684,946,2889,208,711,330,984,538,1695
320210,202106,4450,11176,3428,9447,545,1611,1774,4662,2319,6273
320220,202106,3345,8448,2594,7221,366,1113,1462,3832,1828,4945
320225,202106,1422,4349,1020,3410,347,1263,204,666,551,1929
320230,202106,5353,14391,4086,12260,836,2721,1572,4576,2408,7297
320240,202106,17022,42406,12746,35591,3089,9378,3963,10906,7052,20284
320245,202106,3207,9276,2509,7880,859,2861,406,1236,1265,4097
320250,202106,2656,7192,1790,5191,405,1301,546,1376,951,2677
320255,202106,1951,5950,1670,5430,419,1412,768,2550,1187,3962
320260,202106,1470,4089,894,2815,174,583,215,577,389,1160
320265,202106,2519,7668,2029,6673,863,3069,299,950,1162,4019
320270,202106,2323,6532,1793,5486,453,1512,608,1854,1061,3366
320280,202106,7577,19848,6195,17487,1175,3604,3093,8437,4268,12041
320290,202106,1405,4121,917,2967,251,886,226,690,477,1576
320300,202106,3878,11388,3074,9760,844,2924,865,2557,1709,5481
320305,202106,5347,14836,4155,12502,733,2413,2036,5940,2769,8353
320310,202106,2338,6270,1647,4846,283,883,727,2009,1010,2892
320313,202106,2520,6136,1699,4646,340,1017,453,1100,793,2117
320316,202106,1558,4349,1277,3872,198,607,734,2228,932,2835
320320,202106,23132,59534,16531,48097,3768,11381,5817,16984,9585,28365
320330,202106,2996,8016,2338,6838,414,1243,1231,3634,1645,4877
320332,202106,8391,22249,6683,19091,1411,4309,2958,8218,4369,12527
320334,202106,1821,5029,1278,3931,269,994,312,725,581,1719
320335,202106,1572,4534,1115,3486,231,839,312,903,543,1742
320340,202106,5107,12439,4226,11144,518,1461,2460,6540,2978,8001
320350,202106,5624,13566,3992,10674,427,1272,2198,5438,2625,6710
320360,202106,1460,3731,1085,3039,138,382,520,1413,658,1795
320370,202106,2654,7981,1955,6481,582,2068,582,1899,1164,3967
320380,202106,2714,7088,2256,6350,252,763,1423,3909,1675,4672
320390,202106,7536,19810,5559,15926,1131,3473,2215,5939,3346,9412
320400,202106,3427,9521,2554,7672,709,2284,786,2225,1495,4509
320405,202106,5348,13664,4083,11461,571,1757,2116,5712,2687,7469
320410,202106,4941,12584,3730,10635,649,1798,1849,5497,2498,7295
320420,202106,3375,8600,2606,7289,539,1684,785,2085,1324,3769
320425,202106,2261,5370,1733,4477,137,355,1074,2719,1211,3074
320430,202106,3335,8245,2659,7065,359,1010,1630,4141,1989,5151
320435,202106,2178,6691,1692,5691,594,2136,504,1691,1098,3827
320440,202106,1585,4325,1169,3516,182,595,519,1473,701,2068
320450,202106,1850,5197,1441,4429,263,920,660,1889,923,2809
320455,202106,4555,13557,3103,10116,724,2540,776,2272,1500,4812
320460,202106,2187,6338,1576,5068,376,1321,430,1262,806,2583
320465,202106,1415,3826,1078,3209,157,467,568,1730,725,2197
320470,202106,3780,10218,2769,8128,572,1814,746,1976,1318,3790
320480,202106,1858,4874,1518,4311,167,531,966,2663,1133,3194
320490,202106,23493,59483,17650,49346,2879,8502,7707,21315,10586,29817
320495,202106,1366,3674,988,2939,227,777,322,873,549,1650
320500,202106,53614,140789,42984,122695,5695,17652,25091,68546,30786,86198
320501,202106,4706,13478,3512,11294,950,3443,1071,3344,2021,6787
320503,202106,2345,6688,1531,4992,421,1487,391,1233,812,2720
320506,202106,2775,8220,2048,6599,616,2136,182,603,798,2739
320510,202106,11027,29176,9007,25761,892,2917,5665,15567,6557,18484
320515,202106,1846,5032,1437,4194,371,1197,472,1292,843,2489
320517,202106,2225,6585,1788,5647,520,1780,571,1784,1091,3564
320520,202106,39116,99056,29553,83012,4737,14719,12902,34650,17639,49369
320530,202106,35253,90873,28046,78247,2348,7727,17971,47151,20319,54878
330010,202106,24494,62765,20354,56047,2250,6812,13927,37117,16177,43929
330015,202106,1426,3432,1127,3004,191,570,640,1634,831,2204
330020,202106,20175,49631,16979,45074,2313,6781,11755,30618,14068,37399
330022,202106,1941,5155,1513,4446,239,706,844,2475,1083,3181
330023,202106,5415,12531,4030,10634,590,1754,2389,6144,2979,7898
330025,202106,7181,16310,4319,11622,915,2715,966,2458,1881,5173
330030,202106,10687,27991,8185,23995,785,2690,5139,14337,5924,17027
330040,202106,15528,39469,12465,34404,975,3045,8627,22849,9602,25894
330045,202106,88039,203396,72688,184062,5438,13260,57890,146265,63328,159525
330050,202106,2682,6936,2007,5810,366,1135,1041,2869,1407,4004
330060,202106,5410,13831,4237,11752,794,2473,1821,4636,2615,7109
330070,202106,23907,58532,19323,52038,2741,7938,11856,31593,14597,39531
330080,202106,9123,22401,7771,20531,903,2553,5432,14140,6335,16693
330090,202106,3479,7196,2439,5776,142,358,1744,4116,1886,4474
330093,202106,2811,6596,2128,5662,122,337,1627,4303,1749,4640
330095,202106,1405,3813,1106,3284,104,325,646,1802,750,2127
330100,202106,73466,189626,62803,174151,3384,11033,48701,132957,52085,143990
330110,202106,2114,5791,1699,5111,248,812,999,2901,1247,3713
330115,202106,2600,6139,1830,4951,246,768,1054,2719,1300,3487
330120,202106,3662,7937,2767,6807,203,562,2004,4740,2207,5302
330130,202106,4546,12030,3711,10788,469,1421,2354,6798,2823,8219
330140,202106,3976,10013,3172,8868,376,1184,2124,5766,2500,6950
330150,202106,2329,6028,1791,5185,315,934,890,2522,1205,3456
330160,202106,1392,3715,1030,3072,195,624,539,1527,734,2151
330170,202106,116757,280279,94139,250002,12396,32152,63972,171976,76368,204128
330180,202106,1996,4701,1536,4070,87,257,1078,2790,1165,3047
330185,202106,10262,25149,8567,22816,445,1409,6924,18036,7369,19445
330187,202106,4658,11422,3675,9836,464,1339,2253,5930,2717,7269
330190,202106,35892,83952,30269,76319,1877,5105,24267,60394,26144,65499
330200,202106,16814,41314,13653,37443,2612,6636,8519,24311,11131,30947
330205,202106,2281,5510,1730,4630,109,326,1197,3069,1306,3395
330210,202106,3546,8576,2606,6970,329,937,1358,3422,1687,4359
330220,202106,12877,30974,9201,24919,1721,5240,3642,9125,5363,14365
330225,202106,4019,9881,3061,8456,199,667,2194,5906,2393,6573
330227,202106,17415,41192,14525,37712,581,1564,12422,31977,13003,33541
330230,202106,2222,4747,1464,3785,118,325,850,2205,968,2530
330240,202106,24638,62320,20541,56131,2125,6475,14345,38174,16470,44649
330245,202106,1817,4369,1100,3120,211,589,404,1134,615,1723
330250,202106,40417,100120,33345,89832,5104,14129,21225,56731,26329,70860
330260,202106,5098,11962,3870,10318,307,958,2841,7304,3148,8262
330270,202106,33390,74335,20602,53412,3053,8473,8622,21158,11675,29631
330280,202106,2443,6202,1841,5200,187,579,1109,3008,1296,3587
330285,202106,26392,61108,20867,53275,1221,3690,15969,39430,17190,43120
330290,202106,4127,9741,3333,8703,320,954,2436,6140,2756,7094
330300,202106,5975,13750,4384,11511,320,916,3103,7952,3423,8868
330310,202106,2780,6649,1987,5358,143,324,1334,3590,1477,3914
330320,202106,17940,40890,13831,35794,1594,3792,9906,26069,11500,29861
330330,202106,44072,93580,34335,80481,2799,7203,24901,56922,27700,64125
330340,202106,18730,43031,13471,35037,1861,5567,7213,17425,9074,22992
330350,202106,151558,340680,125398,309067,7395,18822,104192,254936,111587,273758
330360,202106,7541,18002,6436,16677,203,485,5479,14174,5682,14659
330370,202106,5201,14474,4024,12494,915,2897,1692,5431,2607,8328
330380,202106,5804,14900,4425,12518,618,2081,2450,6546,3068,8627
330385,202106,4190,11582,3428,10487,729,2445,1707,5119,2436,7564
330390,202106,27920,72745,21442,61923,2689,9011,12966,35178,15655,44189
330395,202106,3329,7990,2715,7220,138,427,2024,5244,2162,5671
330400,202106,3537,9024,3010,8209,141,514,2290,5874,2431,6388
330410,202106,3501,8980,2517,7307,493,1520,1140,3102,1633,4622
330411,202106,2864,7622,2228,6472,148,510,1548,4296,1696,4806
330412,202106,1652,4537,1349,4042,128,432,884,2522,1012,2954
330414,202106,24896,61179,20260,54879,1405,4080,15394,41005,16799,45085
330415,202106,4835,12748,3696,10757,367,1113,2121,6064,2488,7177
330420,202106,12798,30887,9162,25044,981,3090,5081,12866,6062,15956
330430,202106,9946,23361,8358,21221,273,860,6745,16654,7018,17514
330440,202106,2805,7181,2145,6084,270,878,1326,3610,1596,4488
330450,202106,1478,4056,1170,3542,141,457,659,1946,800,2403
330452,202106,18481,45705,14841,40139,1682,5159,9801,25490,11483,30649
330455,202106,575865,1333075,448906,1154084,57158,156802,296306,746634,353464,903436
330460,202106,1189,3150,894,2736,145,479,485,1450,630,1929
330470,202106,5280,12752,3787,10485,1127,3239,1064,3011,2191,6250
330475,202106,10124,25312,8189,22837,1190,3793,5338,14488,6528,18281
330480,202106,6151,15554,5162,14115,413,1226,3602,9531,4015,10757
330490,202106,116701,262686,94813,233470,10203,25839,67957,165734,78160,191573
330500,202106,7660,18412,6310,16595,601,1782,4555,11749,5156,13531
330510,202106,42651,102437,31825,87308,4666,13830,20092,54089,24758,67919
330513,202106,1306,3246,1056,2919,195,561,583,1640,778,2201
330515,202106,2596,6753,2086,6050,350,1126,1202,3372,1552,4498
330520,202106,11997,30673,9845,27411,1058,3291,6426,17366,7484,20657
330530,202106,1760,4184,1294,3500,249,727,609,1631,858,2358
330540,202106,2933,7593,2280,6486,562,1650,876,2444,1438,4094
330550,202106,9947,24361,7694,21447,1920,5934,3534,9589,5454,15523
330555,202106,19223,39402,15954,35594,722,1735,13261,29879,13983,31614
330560,202106,4210,10891,3411,9599,536,1511,2030,5598,2566,7109
330570,202106,2749,7358,2345,6772,347,1080,1567,4483,1914,5563
330575,202106,5687,14297,4897,12990,290,877,3961,10189,4251,11066
330580,202106,18673,48411,14677,41346,2310,7030,7621,20439,9931,27469
330590,202106,1494,3934,1233,3595,226,651,772,2296,998,2947
330600,202106,13126,33272,10616,29263,874,2797,6950,18503,7824,21300
330610,202106,9622,25119,7734,22190,627,2012,5309,14943,5936,16955
330615,202106,2171,5815,1726,5225,312,976,1081,3340,1393,4316
330620,202106,4249,11743,3347,10209,679,2214,1479,4246,2158,6460
330630,202106,25496,62593,20100,54299,1225,3906,14546,37958,15771,41864
350010,202106,2184,5686,1223,3655,240,776,252,558,492,1334
350020,202106,719,1818,410,1227,52,175,137,386,189,561
350030,202106,3579,9791,2712,8304,635,2160,1234,3509,1869,5669
350040,202106,765,2172,441,1479,58,222,139,363,197,585
350050,202106,1449,3487,957,2654,195,614,340,783,535,1397
350055,202106,953,2468,755,2160,81,244,452,1225,533,1469
350060,202106,241,604,140,399,16,52,62,168,78,220
350070,202106,3346,8726,2195,6648,432,1419,738,1981,1170,3400
350075,202106,623,1776,465,1466,172,574,62,197,234,771
350080,202106,666,1723,447,1341,57,190,180,490,237,680
350090,202106,614,1425,375,1027,67,198,158,401,225,599
350100,202106,2374,6178,1674,4964,115,436,1065,2950,1180,3386
350110,202106,498,1226,343,959,17,53,207,569,224,622
350115,202106,1226,3508,1005,3057,167,569,516,1414,683,1983
350120,202106,673,1554,378,1021,34,115,207,493,241,608
350130,202106,3218,8408,2533,7154,437,1246,1246,3336,1683,4582
350140,202106,799,2189,561,1743,48,194,294,839,342,1033
350150,202106,551,1643,445,1438,93,296,133,399,226,695
350160,202106,11599,29080,7916,22307,1007,3160,4701,12546,5708,15706
350170,202106,2471,6854,2038,5934,308,986,1017,2671,1325,3657
350180,202106,1019,2471,560,1633,93,285,169,456,262,741
350190,202106,2925,8162,2015,6205,344,1206,880,2318,1224,3524
350200,202106,467,1305,355,1093,20,76,230,658,250,734
350210,202106,6148,14053,4219,11064,471,1364,2628,6591,3099,7955
350220,202106,2995,8065,2046,6213,411,1293,676,1836,1087,3129
350230,202106,1012,2523,835,2279,146,427,482,1279,628,1706
350240,202106,663,1882,433,1349,102,316,107,296,209,612
350250,202106,2874,7926,2173,6757,605,2051,610,1852,1215,3903
350260,202106,849,1962,553,1470,53,157,341,860,394,1017
350270,202106,4697,12240,3746,10475,506,1580,2059,5322,2565,6902
350275,202106,2454,6491,1943,5717,299,960,1173,3305,1472,4265
350280,202106,19099,43008,11758,31154,1780,4968,4944,12420,6724,17388
350290,202106,3238,8829,2230,6775,398,1318,901,2538,1299,3856
350300,202106,657,1727,492,1423,58,170,280,755,338,925
350310,202106,966,2713,714,2223,113,402,297,833,410,1235
350315,202106,606,1484,401,1144,22,77,215,556,237,633
350320,202106,15920,40124,11741,32823,2249,6956,4812,12382,7061,19338
350330,202106,14432,34746,10439,27294,1048,3010,6658,16417,7706,19427
350335,202106,384,1078,298,914,38,128,135,393,173,521
350340,202106,1208,3046,751,2217,116,398,322,839,438,1237
350350,202106,768,1886,594,1696,65,213,369,1040,434,1253
350360,202106,1080,3155,818,2624,210,687,255,840,465,1527
350370,202106,704,1742,496,1348,161,413,157,416,318,829
350380,202106,4571,12345,3287,9723,933,2683,873,2642,1806,5325
350390,202106,11083,28476,8740,24567,1543,4574,4461,11965,6004,16539
350395,202106,446,1119,231,714,27,81,83,231,110,312
350400,202106,8299,20018,5791,15940,1432,4235,1595,4269,3027,8504
350410,202106,10379,28363,7651,23179,1481,4986,3050,8508,4531,13494
350420,202106,822,2182,562,1618,87,273,136,332,223,605
350430,202106,711,1875,573,1664,70,228,357,962,427,1190
350440,202106,2108,5168,1712,4582,129,359,1117,2928,1246,3287
350450,202106,6536,17825,5052,15249,1067,3565,2083,5895,3150,9460
350460,202106,1824,4657,1030,3073,146,455,364,988,510,1443
350470,202106,253,631,196,534,11,36,141,367,152,403
350480,202106,1029,2470,680,1889,132,429,188,418,320,847
350490,202106,2008,5150,1433,4216,314,957,469,1251,783,2208
350500,202106,674,1770,502,1465,60,191,242,656,302,847
350510,202106,1244,3123,931,2570,95,295,568,1479,663,1774
350520,202106,2248,6697,1754,5752,266,966,768,2269,1034,3235
350530,202106,2936,7290,2218,5939,233,709,1326,3282,1559,3991
350535,202106,1500,4023,1296,3736,180,566,812,2274,992,2840
350540,202106,2063,4726,1543,3979,181,462,986,2443,1167,2905
350550,202106,8609,20992,5983,16645,616,2057,3447,8822,4063,10879
350560,202106,3933,10837,3154,9506,267,864,2063,6004,2330,6868
350570,202106,25367,69378,20647,60477,3524,11452,10869,30348,14393,41800
350580,202106,2122,5599,1310,3944,337,1099,256,633,593,1732
350590,202106,5206,13813,3833,10805,489,1556,2272,5898,2761,7454
350600,202106,35707,81742,22393,58953,3234,9678,10389,25023,13623,34701
350610,202106,7098,19063,5103,15149,778,2556,2494,6937,3272,9493
350620,202106,435,1083,264,814,23,72,152,440,175,512
350630,202106,1512,3808,1117,3125,72,257,738,1906,810,2163
350635,202106,9736,23437,7310,19672,920,2735,4542,11651,5462,14386
350640,202106,925,2450,493,1504,69,201,142,389,211,590
350650,202106,8809,23072,6122,17841,1102,3487,2406,6487,3508,9974
350660,202106,4610,11822,3563,10104,558,1578,1935,5512,2493,7090
350670,202106,1798,4757,1468,4279,163,486,958,2803,1121,3289
350680,202106,1119,2974,776,2360,130,411,319,930,449,1341
350690,202106,1329,3385,941,2738,161,498,495,1402,656,1900
350700,202106,4951,12363,3597,10259,748,2437,1563,4252,2311,6689
350710,202106,2949,7929,2492,7136,445,1472,1323,3469,1768,4941
350715,202106,781,2209,653,1993,72,269,351,997,423,1266
350720,202106,160,421,118,349,19,59,42,105,61,164
350730,202106,640,1715,543,1546,24,84,406,1093,430,1177
350740,202106,1752,4572,1218,3512,198,607,429,1135,627,1742
350745,202106,591,1462,339,1007,30,112,142,384,172,496
350750,202106,10348,26482,7969,22408,1368,4482,3739,9425,5107,13907
350760,202106,15391,37595,11241,30509,2184,6590,4990,12151,7174,18741
350770,202106,1078,2625,656,1893,46,142,395,1106,441,1248
350775,202106,723,1657,499,1328,60,155,242,661,302,816
350780,202106,2418,5769,1731,4796,297,970,581,1875,878,2845
350790,202106,2109,5542,1354,4120,249,808,374,950,623,1758
350800,202106,3608,10162,3101,9292,244,839,2164,6279,2408,7118
350810,202106,2929,6977,2245,5982,402,994,1079,2933,1481,3927
350820,202106,965,2238,574,1552,69,207,272,661,341,868
350830,202106,890,2442,516,1623,78,250,157,409,235,659
350840,202106,3393,9759,2572,8237,558,2004,1158,3377,1716,5381
350850,202106,8059,21826,6371,18804,1172,3752,3172,8792,4344,12544
350860,202106,3704,9718,3188,9026,110,392,2464,6922,2574,7314
350870,202106,2615,7267,1951,6208,253,893,1112,3446,1365,4339
350880,202106,1364,3813,1077,3252,276,881,275,777,551,1658
350890,202106,558,1445,357,1024,53,164,131,325,184,489
350900,202106,7715,20432,5069,14978,963,3121,1981,5355,2944,8476
350910,202106,938,2242,810,2050,97,255,586,1455,683,1710
350920,202106,12576,30447,10684,27430,398,1263,8869,21961,9267,23224
350925,202106,4245,11299,3051,9186,550,1796,1493,4158,2043,5954
350930,202106,1523,3921,1073,3056,69,206,681,1891,750,2097
350940,202106,2297,5941,1764,5080,178,588,1113,3044,1291,3632
350945,202106,872,2421,665,2021,103,347,331,918,434,1265
350950,202106,92097,232610,71521,194726,8672,25787,44774,116326,53446,142113
350960,202106,6579,17547,5095,14802,606,2013,3046,8412,3652,10425
350970,202106,3606,9931,2582,8059,733,2518,568,1521,1301,4039
350980,202106,662,1788,528,1535,132,398,240,697,372,1095
350990,202106,1823,4988,1361,4252,314,1101,492,1451,806,2552
350995,202106,810,2491,731,2337,61,228,506,1559,567,1787
351000,202106,2859,7401,1983,5867,355,1091,719,2080,1074,3171
351010,202106,345,856,233,668,29,93,117,321,146,414
351015,202106,851,2523,693,2184,110,372,321,918,431,1290
351020,202106,8855,23704,6767,20144,1482,4382,3109,9106,4591,13488
351030,202106,2892,8416,2333,7356,328,1138,1281,3907,1609,5045
351040,202106,5191,12682,4356,11446,209,649,3587,9173,3796,9822
351050,202106,16913,40752,12306,33716,2302,6684,5647,15283,7949,21967
351060,202106,50327,124578,38809,105149,3752,11233,26419,68994,30171,80227
351070,202106,1384,3367,762,2322,185,611,126,367,311,978
351080,202106,2808,6664,2025,5744,200,684,1376,3709,1576,4393
351090,202106,330,941,243,784,47,154,70,231,117,385
351100,202106,2701,7194,1772,5355,378,1207,522,1610,900,2817
351110,202106,6344,15959,4202,12069,651,2070,1910,5131,2561,7201
351120,202106,753,1934,527,1546,67,217,201,574,268,791
351130,202106,1232,3101,576,1747,98,309,153,415,251,724
351140,202106,2275,6243,1695,5156,328,1132,738,1973,1066,3105
351150,202106,2778,7852,1905,5977,276,976,737,2078,1013,3054
351160,202106,1100,3359,802,2668,152,552,204,561,356,1113
351170,202106,1371,3716,1176,3377,81,261,845,2328,926,2589
351190,202106,1034,2829,704,2179,127,387,262,764,389,1151
351200,202106,1646,3870,1233,3271,90,276,874,2178,964,2454
351210,202106,1600,3884,1016,2801,76,246,590,1489,666,1735
351220,202106,3412,9389,2920,8588,290,868,1966,5698,2256,6566
351230,202106,1845,4884,1383,4078,243,817,669,1806,912,2623
351240,202106,2451,6128,1515,4226,329,1007,545,1360,874,2367
351250,202106,1116,2901,659,1995,77,254,253,742,330,996
351260,202106,929,2301,674,1838,139,392,252,645,391,1037
351270,202106,474,1263,375,1075,39,129,202,514,241,643
351280,202106,3924,10112,3039,8484,607,1713,1373,3711,1980,5424
351290,202106,1234,3009,866,2378,114,341,526,1377,640,1718
351300,202106,19119,50872,13348,39950,2244,7319,5946,16932,8190,24251
351310,202106,3543,8487,2705,7221,146,499,2029,5150,2175,5649
351320,202106,968,2741,715,2234,118,398,248,688,366,1086
351330,202106,500,1203,410,1038,21,66,289,653,310,719
351340,202106,6386,17771,5163,15617,1205,3792,2320,7006,3525,10798
351350,202106,11715,28837,9676,25656,898,2538,7150,18446,8048,20984
351360,202106,3878,10123,3188,9097,679,2106,1397,3671,2076,5777
351370,202106,2084,5708,1402,4301,315,1032,434,1208,749,2240
351380,202106,48945,116247,34704,91834,4081,11698,20412,51474,24493,63172
351385,202106,399,994,164,490,31,93,47,114,78,207
351390,202106,1373,3300,850,2533,113,397,494,1382,607,1779
351400,202106,965,2637,800,2310,104,301,514,1438,618,1739
351410,202106,2667,7274,1928,5853,326,987,777,2309,1103,3296
351420,202106,481,1144,274,778,33,93,159,416,192,509
351430,202106,970,2546,776,2226,59,172,544,1503,603,1675
351440,202106,3537,9194,2365,6825,414,1252,668,1660,1082,2912
351450,202106,1758,4579,1175,3514,231,773,220,500,451,1273
351460,202106,904,2319,719,2030,145,405,413,1159,558,1564
351470,202106,1229,3061,972,2640,83,291,646,1642,729,1933
351480,202106,2538,7323,2010,6430,362,1295,878,2603,1240,3898
351490,202106,2089,5744,1793,5224,59,240,1479,4169,1538,4409
351492,202106,356,948,294,814,7,21,226,609,233,630
351495,202106,189,478,146,398,15,34,85,232,100,266
351500,202106,39615,95498,30335,80271,4265,11936,18607,47131,22872,59067
351510,202106,13065,31836,9541,25912,1092,3407,6026,15576,7118,18983
351512,202106,495,1297,359,1003,63,183,127,329,190,512
351515,202106,3301,7325,2092,5451,368,1088,605,1641,973,2729
351518,202106,2499,6170,1648,4685,211,678,929,2364,1140,3042
351519,202106,687,1866,431,1361,81,257,70,198,151,455
351520,202106,1335,3262,584,1727,51,170,266,697,317,867
351530,202106,364,946,214,631,36,114,94,232,130,346
351535,202106,1866,4556,1352,3675,201,594,696,1769,897,2363
351540,202106,2713,6638,1814,5041,223,719,797,1946,1020,2665
351550,202106,7377,18050,5010,13784,472,1489,2858,7276,3330,8765
351560,202106,452,1286,346,1076,82,271,97,276,179,547
351565,202106,246,685,198,598,39,129,55,139,94,268
351570,202106,22067,57637,16922,47554,1650,5036,10743,28928,12393,33964
351580,202106,234,596,134,409,14,44,56,176,70,220
351590,202106,526,1186,285,767,24,93,166,393,190,486
351600,202106,1379,3632,1057,3028,116,366,588,1573,704,1939
351610,202106,783,1841,486,1313,25,71,283,718,308,789
351620,202106,23495,60869,17069,50029,2610,8718,7974,21173,10584,29891
351630,202106,29451,75481,23744,65873,2979,8867,15312,40888,18291,49755
351640,202106,18218,46746,14360,39932,1330,4318,9792,25917,11122,30235
351650,202106,367,967,182,580,22,68,55,163,77,231
351660,202106,745,2052,487,1497,74,231,98,255,172,486
351670,202106,6157,16239,4067,11776,837,2417,1695,4582,2532,6999
351680,202106,430,1205,279,880,38,128,71,177,109,305
351685,202106,393,1117,316,994,84,267,101,300,185,567
351690,202106,1144,2829,628,1810,89,288,281,721,370,1009
351700,202106,1321,3244,963,2648,188,529,476,1226,664,1755
351710,202106,785,2066,575,1685,49,166,322,848,371,1014
351720,202106,1461,3722,982,2900,155,505,409,1105,564,1610
351730,202106,970,2525,805,2271,61,209,510,1363,571,1572
351740,202106,3543,8788,2831,7443,478,1379,1457,3487,1935,4866
351750,202106,1401,3586,885,2700,143,463,381,1106,524,1569
351760,202106,3338,9236,2474,7549,482,1685,975,2663,1457,4348
351770,202106,1885,5365,1527,4696,256,831,864,2552,1120,3383
351780,202106,1216,3052,740,2171,103,360,285,759,388,1119
351790,202106,1397,3335,1113,2958,174,477,643,1739,817,2216
351800,202106,539,1220,270,713,33,93,106,233,139,326
351810,202106,1089,2830,912,2574,55,140,632,1703,687,1843
351820,202106,2675,7381,1894,5883,480,1620,448,1266,928,2886
351830,202106,4604,12148,3563,10352,314,1082,2271,6264,2585,7346
351840,202106,8954,24066,6746,20043,870,2925,3736,10300,4606,13225
351850,202106,1557,4234,1038,3209,153,538,370,968,523,1506
351860,202106,2741,7717,2111,6552,326,1143,1166,3587,1492,4730
351870,202106,24310,61008,18089,50868,4227,12337,7558,21394,11785,33731
351880,202106,139757,351610,105605,293912,21086,65246,53375,140441,74461,205687
351885,202106,950,2499,745,2161,54,194,496,1374,550,1568
351890,202106,873,2237,557,1706,109,361,109,286,218,647
351900,202106,1140,2978,887,2597,121,349,529,1527,650,1876
351905,202106,452,1224,320,969,25,85,163,431,188,516
351907,202106,21407,55184,16703,46962,1823,5693,10798,29093,12621,34786
351910,202106,1707,4335,1193,3253,79,243,705,1725,784,1968
351920,202106,909,2418,682,1976,104,336,282,740,386,1076
351925,202106,928,2397,710,2006,88,291,375,971,463,1262
351930,202106,3326,9091,2980,8463,549,1580,2019,5645,2568,7225
351940,202106,1120,2824,810,2286,126,381,397,1108,523,1489
351950,202106,1736,3882,1314,3264,58,174,955,2281,1013,2455
351960,202106,5158,12805,3754,10334,814,2392,1698,4345,2512,6737
351970,202106,7367,21223,5824,18578,864,3140,3252,9980,4116,13120
351980,202106,1018,2386,671,1826,94,295,374,919,468,1214
351990,202106,1517,3531,1100,2906,45,167,544,1290,589,1457
352000,202106,2733,7648,2360,6880,247,818,1570,4279,1817,5097
352010,202106,2366,6123,1923,5398,512,1600,418,1197,930,2797
352020,202106,1387,3744,1068,3220,145,494,542,1538,687,2032
352030,202106,5929,15403,4611,13237,817,2551,2340,6475,3157,9026
352040,202106,3474,8930,2465,6959,381,1171,924,2289,1305,3460
352042,202106,3120,7447,2101,5834,359,1147,1007,2644,1366,3791
352044,202106,2158,5598,1291,3975,199,690,263,750,462,1440
352050,202106,13116,34263,8709,25671,2031,6832,1756,4391,3787,11223
352060,202106,742,1963,553,1610,87,287,238,620,325,907
352070,202106,937,1882,605,1446,58,156,314,674,372,830
352080,202106,492,1232,284,819,31,102,95,244,126,346
352090,202106,1535,4462,1275,3954,153,546,624,1751,777,2297
352100,202106,3503,9660,2814,8366,572,1857,1242,3537,1814,5394
352110,202106,630,1791,478,1498,97,313,192,556,289,869
352115,202106,562,1483,463,1326,58,189,281,786,339,975
352120,202106,903,2598,737,2280,77,210,441,1293,518,1503
352130,202106,2130,5806,1429,4137,213,633,609,1624,822,2257
352140,202106,1179,3189,844,2532,145,450,379,1103,524,1553
352150,202106,900,2348,701,2019,73,225,497,1395,570,1620
352160,202106,1029,2495,745,2043,67,230,427,1111,494,1341
352170,202106,3023,7936,2402,6750,278,878,1527,4020,1805,4898
352180,202106,2415,6422,1825,5378,409,1373,569,1473,978,2846
352190,202106,1286,3413,1024,3010,179,469,531,1632,710,2101
352200,202106,324,960,231,772,36,141,84,272,120,413
352210,202106,20458,47303,16120,41571,908,2652,12686,31992,13594,34644
352215,202106,694,1738,580,1570,80,236,351,919,431,1155
352220,202106,21960,53184,15472,41977,2611,7828,7598,18915,10209,26743
352230,202106,15227,42755,11826,36457,2761,9444,4213,11920,6974,21364
352240,202106,10285,26120,7882,22193,1671,5267,3476,9108,5147,14375
352250,202106,23398,64117,18798,56362,2801,9021,11576,34019,14377,43040
352260,202106,5001,12266,3408,9242,489,1508,1973,4822,2462,6330
352265,202106,943,2583,834,2434,79,260,597,1682,676,1942
352270,202106,1447,4254,1077,3477,219,756,380,1157,599,1913
352280,202106,2468,6090,1856,5211,188,627,1127,2948,1315,3575
352290,202106,1217,3413,988,2988,129,444,535,1454,664,1898
352300,202106,877,2336,607,1774,79,268,322,872,401,1140
352310,202106,43260,113623,32362,94852,7684,23084,14182,41808,21866,64892
352320,202106,6784,17308,5276,14515,719,2215,2906,7184,3625,9399
352330,202106,2266,5889,1734,5150,275,970,991,2737,1266,3707
352340,202106,6298,16375,4692,13469,702,2296,2410,6355,3112,8651
352350,202106,2264,6322,1763,5227,162,594,1062,2895,1224,3489
352360,202106,1274,3343,1049,2953,81,273,786,2132,867,2405
352370,202106,1115,3083,966,2836,17,69,795,2286,812,2355
352380,202106,850,2259,633,1882,134,408,218,626,352,1034
352390,202106,15034,36529,10301,28252,1599,4790,5678,14716,7277,19506
352400,202106,3588,9805,2934,8603,601,2072,1391,3787,1992,5859
352410,202106,3399,8577,2589,7238,224,749,1608,4293,1832,5042
352420,202106,843,2041,600,1689,117,347,225,586,342,933
352430,202106,8472,20626,6163,16618,1088,3342,3147,7962,4235,11304
352440,202106,19014,50720,14380,41897,3402,10279,5285,14922,8687,25201
352450,202106,786,1881,406,1234,58,193,151,432,209,625
352460,202106,3054,8214,2142,6592,408,1375,888,2552,1296,3927
352470,202106,3402,8540,2590,7238,273,879,1646,4366,1919,5245
352480,202106,4162,9778,2796,7356,400,1239,1363,3139,1763,4378
352490,202106,793,2231,637,1957,103,353,290,830,393,1183
352500,202106,10519,26792,7142,20545,2802,8870,793,1316,3595,10186
352510,202106,3931,10589,2937,8838,551,1792,1401,4038,1952,5830
352520,202106,2977,7593,2319,6516,379,1220,1358,3470,1737,4690
352530,202106,10944,27716,7465,21206,1269,4131,2777,6758,4046,10889
352540,202106,601,1738,446,1404,67,225,157,440,224,665
352550,202106,1034,2813,734,2251,121,428,263,711,384,1139
352560,202106,581,1593,448,1340,71,234,234,646,305,880
352570,202106,2450,6851,1590,5010,372,1283,188,447,560,1730
352580,202106,648,1665,542,1473,44,136,374,967,418,1103
352585,202106,340,904,250,743,19,74,157,420,176,494
352590,202106,13282,34400,9323,26982,2193,6946,4320,11598,6513,18544
352600,202106,1930,5167,1517,4422,141,444,966,2676,1107,3120
352610,202106,2829,7757,2124,6557,415,1448,893,2577,1308,4025
352620,202106,5739,14308,4369,12356,1177,3397,1799,5124,2976,8521
352630,202106,854,2098,637,1791,111,346,300,788,411,1134
352640,202106,3087,7769,2237,6267,224,648,1294,3458,1518,4106
352650,202106,605,1684,422,1293,53,170,162,474,215,644
352660,202106,1108,3193,920,2818,95,309,572,1710,667,2019
352670,202106,9882,26253,6689,19988,1582,5178,2060,5614,3642,10792
352680,202106,3363,9755,2342,7449,369,1397,1095,3090,1464,4487
352690,202106,27965,69114,21971,59114,1271,4060,15835,40838,17106,44898
352700,202106,611,1505,466,1318,139,437,157,431,296,868
352710,202106,5282,13530,3784,10844,876,2745,1586,4201,2462,6946
352720,202106,8128,21613,6378,18420,2253,6728,1843,4943,4096,11671
352725,202106,588,1385,337,941,23,67,176,458,199,525
352730,202106,5553,15996,5044,14863,569,1806,2303,5916,2872,7722
352740,202106,2351,5573,1786,4753,179,553,1088,2720,1267,3273
352750,202106,430,1058,267,764,42,136,111,279,153,415
352760,202106,1758,4781,1375,4042,105,292,792,2327,897,2619
352770,202106,878,2340,613,1834,118,367,239,671,357,1038
352780,202106,651,1809,468,1439,99,273,120,392,219,665
352790,202106,452,1187,328,948,25,75,145,371,170,446
352800,202106,1256,3777,881,2902,234,789,116,334,350,1123
352810,202106,1190,2760,769,2034,129,357,451,1125,580,1482
352820,202106,471,1308,341,1076,69,211,70,216,139,427
352830,202106,601,1513,288,867,24,74,81,199,105,273
352840,202106,4043,11315,3313,10024,1000,3287,1165,3344,2165,6631
352850,202106,11155,26796,7750,21342,1977,5992,2661,6531,4638,12523
352860,202106,1076,2941,822,2493,143,461,311,903,454,1364
352870,202106,889,2185,620,1656,53,161,382,971,435,1132
352880,202106,1749,4115,1228,3214,210,571,595,1491,805,2062
352885,202106,309,837,236,716,24,75,140,409,164,484
352890,202106,703,1689,466,1202,45,133,270,605,315,738
352900,202106,18433,47429,12377,35630,2027,6204,5325,14395,7352,20599
352910,202106,420,1100,245,738,24,78,84,217,108,295
352920,202106,2674,6713,1969,5534,116,361,1375,3740,1491,4101
352930,202106,5871,15592,4422,12797,746,2408,2166,5831,2912,8239
352940,202106,22592,59906,16623,47762,3025,9453,7909,21367,10934,30820
352950,202106,569,1480,356,1091,91,283,70,193,161,476
352960,202106,754,1977,437,1328,67,222,126,301,193,523
352965,202106,226,627,144,466,39,122,37,109,76,231
352970,202106,3011,7150,2331,6028,225,637,1559,3943,1784,4580
352980,202106,1372,3568,1083,3142,251,807,560,1573,811,2380
352990,202106,4376,11777,3313,10020,637,2074,1640,4778,2277,6852
353000,202106,494,1326,288,849,41,135,73,170,114,305
353010,202106,2661,6518,1757,4871,327,1053,773,1924,1100,2977
353020,202106,3582,9156,2169,6286,296,956,753,2060,1049,3016
353030,202106,4618,11440,3186,8990,711,2178,941,2512,1652,4690
353040,202106,664,1486,466,1203,105,265,219,553,324,818
353050,202106,5265,14788,3751,11738,683,2304,1713,5103,2396,7407
353060,202106,49434,124670,40991,111290,2661,8557,31091,81547,33752,90104
353070,202106,10010,28120,7364,22473,1276,4277,3235,9040,4511,13317
353080,202106,4277,11520,2827,8712,497,1754,1121,3003,1618,4757
353090,202106,611,1783,489,1533,33,113,314,946,347,1059
353100,202106,291,778,139,440,23,75,40,105,63,180
353110,202106,7591,19688,6097,17591,1321,3913,3039,9138,4360,13051
353120,202106,409,998,313,846,39,126,159,378,198,504
353130,202106,2624,6073,1650,4414,396,1171,561,1352,957,2523
353140,202106,2760,6757,2009,5507,100,334,1442,3788,1542,4122
353150,202106,1640,3982,1174,3231,239,681,489,1274,728,1955
353160,202106,633,1618,463,1344,57,170,205,543,262,713
353170,202106,536,1407,402,1221,76,246,181,562,257,808
353180,202106,10331,24816,8174,21399,794,2288,5958,15096,6752,17384
353190,202106,3431,9086,2746,7725,357,1076,1613,4255,1970,5331
353200,202106,1831,4799,1024,3178,167,581,291,805,458,1386
353205,202106,412,1228,351,1093,55,177,167,501,222,678
353210,202106,919,2091,598,1579,23,63,418,1079,441,1142
353215,202106,381,1036,299,890,45,148,143,391,188,539
353220,202106,732,1930,476,1410,96,271,83,237,179,508
353230,202106,842,2269,658,1985,176,577,246,678,422,1255
353240,202106,2379,6356,1979,5720,270,902,1197,3308,1467,4210
353250,202106,1308,2924,823,2143,102,298,460,1137,562,1435
353260,202106,1208,2749,674,1884,90,277,321,849,411,1126
353270,202106,709,1809,603,1626,49,147,423,1077,472,1224
353280,202106,689,1836,488,1482,137,418,115,337,252,755
353282,202106,1860,5155,1563,4617,175,557,972,2736,1147,3293
353284,202106,364,817,202,527,19,70,100,225,119,295
353286,202106,177,441,109,331,18,57,39,108,57,165
353290,202106,1496,3930,932,2815,167,503,277,771,444,1274
353300,202106,2135,5614,1584,4545,255,841,715,1808,970,2649
353310,202106,411,992,297,796,21,72,200,508,221,580
353320,202106,660,1594,566,1469,7,26,493,1270,500,1296
353325,202106,705,2010,495,1550,102,319,169,508,271,827
353330,202106,583,1484,409,1170,52,148,210,559,262,707
353340,202106,2980,8014,2199,6487,423,1401,1091,2965,1514,4366
353350,202106,3816,9505,2695,7382,573,1618,860,2123,1433,3741
353360,202106,672,1839,516,1542,49,151,303,878,352,1029
353370,202106,576,1636,482,1489,43,130,341,1026,384,1156
353380,202106,291,848,245,760,22,69,130,373,152,442
353390,202106,6574,16009,4963,13353,434,1329,3081,7832,3515,9161
353400,202106,475,1254,364,1052,68,227,142,341,210,568
353410,202106,531,1414,401,1182,71,204,225,674,296,878
353420,202106,423,1088,261,763,60,175,20,53,80,228
353430,202106,2254,6101,1750,5181,315,1005,852,2399,1167,3404
353440,202106,66804,177072,48954,143231,7457,23808,26959,74408,34416,98216
353450,202106,371,915,248,702,32,104,120,309,152,413
353460,202106,3275,8762,2403,7151,207,664,1042,2974,1249,3638
353470,202106,8250,21218,6044,17199,962,3134,2726,7138,3688,10272
353475,202106,1596,4041,1135,3119,158,479,576,1467,734,1946
353480,202106,1633,4325,1308,3775,52,192,942,2628,994,2820
353490,202106,1116,2901,760,2240,105,342,355,983,460,1325
353500,202106,1090,2563,803,2127,170,464,442,1141,612,1605
353510,202106,828,2425,608,1903,138,443,168,459,306,902
353520,202106,1052,2710,674,2037,72,245,331,914,403,1159
353530,202106,2476,6441,1951,5496,259,824,1070,2793,1329,3617
353540,202106,2152,5713,1777,5117,277,837,1049,2925,1326,3762
353550,202106,5926,14979,4825,13229,734,2097,2811,7398,3545,9495
353560,202106,2372,6249,1813,5411,479,1537,563,1509,1042,3046
353570,202106,594,1536,440,1283,53,170,244,664,297,834
353580,202106,2181,5685,1646,4639,363,1025,729,2002,1092,3027
353590,202106,704,1811,485,1414,80,241,227,672,307,913
353600,202106,1724,4223,1302,3491,155,416,711,1863,866,2279
353610,202106,652,1922,484,1596,88,355,171,515,259,870
353620,202106,2752,7127,1977,5822,379,1243,691,1853,1070,3096
353625,202106,519,1290,353,1001,26,87,216,586,242,673
353630,202106,1381,4121,1166,3675,228,799,487,1404,715,2203
353640,202106,1380,3539,1105,3115,154,431,614,1715,768,2146
353650,202106,7782,20452,5946,17065,639,2025,3537,9567,4176,11592
353657,202106,396,1028,290,855,28,92,131,351,159,443
353660,202106,1306,2744,888,2190,333,831,291,694,624,1525
353670,202106,4152,11307,3218,9501,588,1947,1568,4251,2156,6198
353680,202106,709,1818,525,1558,66,229,317,875,383,1104
353690,202106,417,1087,203,620,23,78,43,108,66,186
353700,202106,2117,5410,1756,4828,114,375,1310,3449,1424,3824
353710,202106,5464,12173,3278,8319,387,1023,1730,3902,2117,4925
353715,202106,435,1134,259,808,4,19,94,281,98,300
353720,202106,2019,5187,1553,4487,217,660,886,2500,1103,3160
353730,202106,4496,11570,3430,9727,460,1539,1871,4832,2331,6371
353740,202106,2058,5336,1460,4295,335,1080,487,1287,822,2367
353750,202106,898,2674,655,2204,141,520,156,504,297,1024
353760,202106,12933,29424,9914,25421,2016,5235,5242,13276,7258,18511
353770,202106,687,2031,420,1391,67,232,48,142,115,374
353780,202106,5577,14889,4478,12880,958,3061,2206,5839,3164,8900
353790,202106,2793,8257,2045,6689,509,1844,412,1166,921,3010
353800,202106,19083,48899,15047,42449,2212,6491,8345,23480,10557,29971
353810,202106,1188,3146,768,2269,111,369,340,953,451,1322
353820,202106,1795,4762,1253,3693,257,814,417,1150,674,1964
353830,202106,660,1633,482,1343,82,243,211,568,293,811
353850,202106,1644,4449,1276,3775,262,785,476,1350,738,2135
353860,202106,2698,7258,2078,6220,465,1590,948,2547,1413,4137
353870,202106,30539,78671,22027,62509,2715,8565,11710,30408,14425,38973
353880,202106,3222,8747,2544,7491,217,730,1537,4332,1754,5062
353890,202106,2838,6047,2053,4914,144,381,1482,3315,1626,3696
353900,202106,758,2097,558,1707,78,266,228,647,306,913
353910,202106,2473,6727,2061,6090,201,678,1422,4119,1623,4797
353920,202106,1922,5223,1391,4204,315,1084,338,840,653,1924
353930,202106,4545,11855,3125,9197,511,1741,1349,3489,1860,5230
353940,202106,1143,3194,794,2503,134,454,276,781,410,1235
353950,202106,3352,8927,2571,7474,509,1590,1334,3625,1843,5215
353960,202106,810,2035,570,1594,103,276,231,617,334,893
353970,202106,652,1528,489,1280,39,116,343,878,382,994
353980,202106,16599,41206,13009,35080,780,2464,9499,24495,10279,26959
353990,202106,963,2325,589,1649,107,317,268,712,375,1029
354000,202106,2564,6075,1438,4000,318,912,242,642,560,1554
354010,202106,359,918,254,747,52,159,130,372,182,531
354020,202106,3744,9907,2982,8383,630,1926,1327,3392,1957,5318
354025,202106,722,2005,490,1551,71,251,139,413,210,664
354030,202106,516,1122,280,743,59,164,133,327,192,491
354040,202106,819,1870,530,1411,25,77,391,1004,416,1081
354050,202106,941,2643,668,2154,140,497,225,681,365,1178
354060,202106,3422,9511,2420,7427,466,1559,988,2734,1454,4293
354070,202106,3799,9800,2573,7413,424,1416,1168,2900,1592,4316
354075,202106,2774,7782,2209,6764,295,986,1278,3809,1573,4795
354080,202106,1356,3672,901,2796,180,579,266,749,446,1328
354085,202106,446,921,354,802,0,0,267,554,267,554
354090,202106,1679,4626,1447,4152,72,219,1135,3193,1207,3412
354100,202106,19965,53066,13805,42481,2954,9820,5306,16133,8260,25953
354105,202106,1419,3556,989,2785,123,357,464,1225,587,1582
354110,202106,447,1252,319,1004,52,167,108,328,160,495
354120,202106,1383,3681,945,2756,189,596,320,813,509,1409
354130,202106,5401,14084,3607,10678,854,2669,200,385,1054,3054
354140,202106,19759,48171,13487,36695,2125,6431,6008,14962,8133,21393
354150,202106,2971,6970,2277,5878,453,1215,932,2362,1385,3577
354160,202106,2849,8145,2146,6756,586,2011,609,1741,1195,3752
354165,202106,694,2037,532,1715,85,319,274,816,359,1135
354170,202106,1905,5213,1594,4636,103,341,982,2718,1085,3059
354180,202106,393,1077,284,848,46,143,127,342,173,485
354190,202106,1523,4204,1091,3344,70,235,546,1586,616,1821
354200,202106,878,2099,673,1791,68,204,443,1108,511,1312
354210,202106,880,2281,720,2021,48,156,509,1339,557,1495
354220,202106,3220,8528,2449,7020,347,1076,1326,3582,1673,4658
354230,202106,784,1917,630,1735,30,103,472,1257,502,1360
354240,202106,1746,4778,1179,3644,199,666,377,1034,576,1700
354250,202106,641,1560,403,1145,90,278,108,289,198,567
354260,202106,8177,21383,6241,18028,1203,3771,2777,7669,3980,11440
354270,202106,1020,3024,836,2666,173,540,336,1037,509,1577
354280,202106,805,1973,682,1795,58,179,458,1117,516,1296
354290,202106,942,2958,793,2654,128,426,405,1397,533,1823
354300,202106,3604,10391,3051,9382,788,2440,1276,3878,2064,6318
354310,202106,728,2137,598,1881,141,475,231,665,372,1140
354320,202106,995,2388,658,1834,97,307,256,631,353,938
354323,202106,497,1167,320,844,51,118,134,339,185,457
354325,202106,1527,4500,1072,3462,174,562,347,1068,521,1630
354330,202106,9662,24107,6613,18023,781,2388,3935,9966,4716,12354
354340,202106,34340,85173,23615,66577,3266,10400,13080,35134,16346,45534
354350,202106,1219,3089,963,2664,132,375,587,1560,719,1935
354360,202106,631,1596,383,1193,84,265,86,265,170,530
354370,202106,1018,2849,819,2536,122,409,496,1486,618,1895
354380,202106,675,1749,482,1438,87,348,132,304,219,652
354390,202106,14124,33654,9367,25381,1560,4547,4385,11154,5945,15701
354400,202106,1566,4941,1210,4112,201,742,453,1510,654,2252
354410,202106,6297,16521,4808,13608,915,2823,2323,6143,3238,8966
354420,202106,1528,3901,1134,3209,147,440,686,1842,833,2282
354425,202106,2768,6651,1963,5261,449,1212,813,2166,1262,3378
354430,202106,1550,4103,1208,3578,107,353,742,2092,849,2445
354440,202106,586,1534,392,1147,65,211,172,455,237,666
354450,202106,443,1141,255,779,34,104,87,227,121,331
354460,202106,864,2159,578,1654,83,250,307,868,390,1118
354470,202106,478,1184,335,916,25,79,168,400,193,479
354480,202106,1293,2881,838,2160,74,181,533,1318,607,1499
354490,202106,820,2391,605,1926,106,353,270,794,376,1147
354500,202106,2164,5938,1755,5320,528,1658,403,1261,931,2919
354510,202106,734,2013,596,1752,44,138,341,908,385,1046
354515,202106,357,1000,261,805,38,134,115,342,153,476
354520,202106,7124,19227,5047,14849,666,2252,2794,7613,3460,9865
354530,202106,4464,12523,3470,10606,879,2671,1184,3751,2063,6422
354540,202106,1351,3523,991,2892,214,644,363,1058,577,1702
354550,202106,604,1552,477,1315,67,202,272,713,339,915
354560,202106,2338,5582,1258,3528,147,422,644,1666,791,2088
354570,202106,1264,3123,508,1416,90,257,62,161,152,418
354580,202106,8496,22119,5586,16572,827,2648,2826,8070,3653,10718
354600,202106,2009,5157,1578,4394,146,461,1052,2785,1198,3246
354610,202106,457,1163,270,798,25,76,139,389,164,465
354620,202106,480,1310,308,985,47,187,120,348,167,535
354625,202106,311,835,184,594,28,91,36,87,64,178
354630,202106,2135,6244,1730,5438,583,1915,331,963,914,2878
354640,202106,3355,9452,2523,7801,366,1246,1038,2960,1404,4206
354650,202106,904,2325,733,2051,58,159,471,1298,529,1457
354660,202106,3648,8499,1940,5673,170,591,907,2420,1077,3011
354670,202106,1079,2937,761,2297,146,474,289,808,435,1282
354680,202106,5512,14075,4152,11889,889,2703,2117,6122,3006,8825
354690,202106,508,1578,369,1266,76,280,114,364,190,644
354700,202106,918,2446,659,1945,77,253,349,947,426,1200
354710,202106,517,1357,360,1036,45,137,154,376,199,513
354720,202106,288,690,133,390,56,168,23,69,79,237
354730,202106,9999,27826,7655,23331,984,3292,4416,12930,5400,16222
354740,202106,310,831,130,431,16,66,24,68,40,134
354750,202106,2746,6965,1825,5274,256,802,823,2116,1079,2918
354760,202106,2206,5766,1573,4601,334,1059,544,1408,878,2467
354765,202106,353,931,148,462,18,63,36,96,54,159
354770,202106,2487,6082,1837,4943,310,880,865,2187,1175,3067
354780,202106,56704,141288,43412,115635,3867,11702,28643,71646,32510,83348
354790,202106,1011,2741,785,2373,72,238,490,1421,562,1659
354800,202106,2606,6629,2057,5787,507,1441,922,2466,1429,3907
354805,202106,1364,3095,945,2487,110,281,542,1336,652,1617
354810,202106,651,1896,389,1345,48,195,109,343,157,538
354820,202106,964,2704,677,2161,107,380,188,479,295,859
354830,202106,471,1131,302,837,54,165,95,246,149,411
354840,202106,931,2300,575,1580,56,164,310,789,366,953
354850,202106,21114,54050,14754,42846,1576,5199,8938,24650,10514,29849
354860,202106,1769,4876,1095,3473,170,597,325,928,495,1525
354870,202106,59943,150194,46405,125340,4584,13568,29700,75883,34284,89451
354880,202106,5917,14445,2940,8248,324,1045,1162,2673,1486,3718
354890,202106,16045,39963,12446,33960,1666,5084,7255,19210,8921,24294
354900,202106,412,1029,264,766,58,181,69,158,127,339
354910,202106,5871,15211,3625,11135,833,2695,713,2048,1546,4743
354920,202106,520,1392,265,874,28,102,66,192,94,294
354925,202106,306,859,184,585,25,85,44,120,69,205
354930,202106,377,908,247,685,22,67,126,320,148,387
354940,202106,2403,6990,1726,5517,573,1978,383,1111,956,3089
354950,202106,1544,3886,1237,3467,53,200,937,2499,990,2699
354960,202106,937,2479,712,2140,67,230,402,1124,469,1354
354970,202106,4261,11620,3338,10064,362,1245,2151,6248,2513,7493
354980,202106,34192,80303,23382,61857,2379,7460,14504,35785,16883,43245
354990,202106,69670,173446,52384,141917,3969,12520,34891,88650,38860,101170
354995,202106,2897,6370,2182,5443,141,413,1633,3928,1774,4341
355000,202106,1614,3964,1214,3378,198,638,596,1506,794,2144
355010,202106,3864,10346,2360,7186,773,2416,311,973,1084,3389
355020,202106,3707,10159,2736,8449,529,1826,1141,3313,1670,5139
355030,202106,1402157,3413542,1024218,2691610,148214,428041,530323,1284372,678537,1712413
355040,202106,3060,7385,2378,6502,265,745,1739,4741,2004,5486
355050,202106,1016,2305,743,1920,175,511,298,688,473,1199
355060,202106,6294,16684,4590,13563,718,2457,2327,6230,3045,8687
355070,202106,9808,24554,8006,21713,923,2870,5142,13076,6065,15946
355080,202106,947,2675,607,2041,118,427,92,245,210,672
355090,202106,1208,3379,947,2941,203,643,368,1095,571,1738
355100,202106,22251,57423,17274,50096,2633,8056,10489,30103,13122,38159
355110,202106,844,2286,610,1929,163,595,100,289,263,884
355120,202106,743,1928,537,1623,48,151,256,757,304,908
355130,202106,850,1879,443,1148,33,106,278,665,311,771
355140,202106,1979,4395,1664,3966,80,212,1390,3234,1470,3446
355150,202106,4306,11207,3438,9682,370,1170,2251,6073,2621,7243
355160,202106,2146,5781,1559,4758,382,1278,403,1135,785,2413
355170,202106,11184,27751,8737,23661,1507,4411,4718,12343,6225,16754
355180,202106,2921,7615,2076,6215,383,1287,845,2296,1228,3583
355190,202106,1870,4860,1467,4220,389,1102,724,2213,1113,3315
355200,202106,811,2494,686,2292,190,697,281,899,471,1596
355210,202106,3053,8218,2366,6821,430,1383,1153,3116,1583,4499
355220,202106,46981,122482,37373,104218,7713,22893,16712,43231,24425,66124
355230,202106,1168,2924,637,1881,112,321,222,607,334,928
355240,202106,25723,67109,18059,51907,2174,6807,10051,27037,12225,33844
355250,202106,38081,100268,28454,81801,7085,21364,10858,29953,17943,51317
355255,202106,674,1674,374,1132,58,189,130,389,188,578
355260,202106,1579,3755,1113,3000,135,430,643,1606,778,2036
355270,202106,1163,3387,896,2853,202,675,335,970,537,1645
355280,202106,31983,80181,22951,63486,2906,8705,11989,31075,14895,39780
355290,202106,898,2411,696,2057,134,380,306,882,440,1262
355300,202106,1325,3860,1053,3334,178,611,380,1124,558,1735
355310,202106,953,2612,709,2207,101,301,396,1254,497,1555
355320,202106,531,1384,398,1144,73,236,160,380,233,616
355330,202106,2998,7511,2322,6354,118,414,1778,4634,1896,5048
355340,202106,4235,9320,3230,7985,389,883,2010,5073,2399,5956
355350,202106,1339,3769,996,3126,196,651,382,1154,578,1805
355360,202106,1232,3123,952,2700,117,372,566,1557,683,1929
355365,202106,355,932,198,653,42,134,29,96,71,230
355370,202106,5500,13970,4249,11972,1010,2613,1810,5656,2820,8269
355380,202106,2911,7705,2209,6443,371,1207,827,2087,1198,3294
355385,202106,1475,3849,1220,3477,104,360,786,2039,890,2399
355390,202106,830,2247,599,1750,129,407,237,626,366,1033
355395,202106,2001,5413,1410,4241,229,727,502,1339,731,2066
355400,202106,9255,25944,7327,22165,1683,5786,2731,7364,4414,13150
355410,202106,23162,63100,14383,44919,2813,9602,3989,12137,6802,21739
355420,202106,629,1972,526,1783,134,489,141,450,275,939
355430,202106,3749,9407,2811,7720,616,1701,1305,3523,1921,5224
355440,202106,772,2081,472,1450,76,242,139,394,215,636
355450,202106,3164,8064,2095,5992,337,1042,925,2406,1262,3448
355460,202106,506,1212,315,896,44,157,157,400,201,557
355465,202106,442,1143,345,988,43,134,196,546,239,680
355470,202106,1118,2854,647,1926,162,532,194,497,356,1029
355475,202106,342,801,276,711,16,35,205,519,221,554
355480,202106,4049,10979,3287,9841,442,1538,2163,6307,2605,7845
355490,202106,949,2495,539,1647,41,135,280,780,321,915
355495,202106,826,2269,598,1881,63,246,225,617,288,863
355500,202106,6916,17496,4214,12326,617,1961,1545,4177,2162,6138
355510,202106,1392,3348,892,2504,117,362,375,939,492,1301
355520,202106,371,828,182,524,34,91,57,164,91,255
355530,202106,395,921,145,425,15,53,56,147,71,200
355535,202106,520,1384,395,1183,75,283,185,508,260,791
355540,202106,11047,27104,9058,24324,1183,3498,6118,15869,7301,19367
355550,202106,621,1801,513,1596,60,204,282,814,342,1018
355560,202106,1155,2936,653,1981,147,517,32,86,179,603
355570,202106,249,687,128,419,24,84,28,76,52,160
355580,202106,1212,2905,768,2153,140,461,292,732,432,1193
355590,202106,179,449,138,384,14,44,87,232,101,276
355600,202106,1566,3797,1042,2918,161,481,387,1096,548,1577
355610,202106,1807,4394,1199,3345,129,395,647,1700,776,2095
355620,202106,5041,13214,3793,10795,381,1309,2181,5715,2562,7024
355630,202106,2428,6567,1728,5269,256,822,883,2609,1139,3431
355635,202106,895,2600,666,2150,114,397,198,569,312,966
355640,202106,3181,8668,2158,6629,424,1375,633,1892,1057,3267
355645,202106,4224,11731,3091,9747,455,1567,1656,5056,2111,6623
355650,202106,6473,17311,5001,14619,1296,3978,1499,3863,2795,7841
355660,202106,1356,3465,948,2743,158,472,282,799,440,1271
355670,202106,3840,10179,2601,7428,310,1033,1329,3347,1639,4380
355680,202106,2843,7725,1311,4156,323,1106,102,315,425,1421
355690,202106,801,2322,512,1754,123,466,11,21,134,487
355695,202106,260,729,156,491,13,58,32,75,45,133
355700,202106,7584,21312,6210,18299,967,3090,3470,9612,4437,12702
355710,202106,9287,21716,6148,16024,824,2426,3036,7001,3860,9427
355715,202106,487,1305,266,816,57,184,46,120,103,304
355720,202106,1468,4071,1159,3531,175,578,642,1831,817,2409
355730,202106,942,2577,777,2272,125,404,397,1084,522,1488
410010,202106,1311,3598,1010,2973,195,623,255,713,450,1336
410020,202106,1046,3101,806,2555,272,811,175,570,447,1381
410030,202106,1579,4217,1349,3864,188,572,750,2178,938,2750
410040,202106,13061,35658,9596,29140,2099,6829,2995,8399,5094,15228
410045,202106,828,2204,597,1746,92,299,228,608,320,907
410050,202106,2336,5797,1623,4572,263,824,594,1550,857,2374
410060,202106,2152,5969,1673,5045,368,1158,513,1474,881,2632
410070,202106,2015,5018,1502,4099,228,715,600,1454,828,2169
410080,202106,1375,3634,979,2911,276,856,203,607,479,1463
410090,202106,1137,2866,964,2594,110,277,547,1555,657,1832
410100,202106,1921,5445,1261,3895,183,645,126,369,309,1014
410105,202106,495,1234,285,828,31,88,105,286,136,374
410110,202106,3373,8349,2372,6477,291,861,1127,2887,1418,3748
410115,202106,583,1484,420,1200,52,161,167,443,219,604
410120,202106,2762,7458,2384,6905,459,1423,1324,3717,1783,5140
410130,202106,1269,3386,1096,3057,208,656,571,1476,779,2132
410140,202106,16647,40005,11083,30121,1971,5866,3015,7467,4986,13333
410150,202106,16906,39306,8671,23413,1452,4341,2121,5139,3573,9480
410160,202106,2967,8093,2368,7044,531,1688,795,2371,1326,4059
410165,202106,745,1959,610,1692,66,212,355,919,421,1131
410170,202106,2947,7535,1954,5436,412,1254,120,351,532,1605
410180,202106,14685,40398,11299,33597,1568,5128,5847,16151,7415,21279
410185,202106,429,1254,308,948,59,187,81,222,140,409
410190,202106,2203,5434,1605,4391,321,915,418,1075,739,1990
410200,202106,5700,12850,3175,8542,500,1530,424,1095,924,2625
410210,202106,3256,8026,2100,5997,338,1079,722,1779,1060,2858
410220,202106,540,1393,352,1046,54,170,81,230,135,400
410230,202106,1808,4744,1391,3934,201,614,616,1589,817,2203
410240,202106,5269,13639,3604,10431,746,2393,461,1183,1207,3576
410250,202106,2665,6268,1968,5164,143,452,969,2462,1112,2914
410260,202106,1861,4618,1172,3331,161,461,548,1497,709,1958
410270,202106,483,1268,347,1032,44,150,142,411,186,561
410275,202106,627,1738,455,1385,77,256,181,502,258,758
410280,202106,2389,6251,1597,4709,201,681,667,1792,868,2473
410290,202106,3452,9500,2391,7285,675,2025,601,1817,1276,3842
410300,202106,688,1699,552,1492,60,180,267,661,327,841
410302,202106,356,908,209,636,21,72,104,308,125,380
410304,202106,1298,3322,1078,2914,118,341,672,1750,790,2091
410305,202106,1764,4198,1239,3445,109,341,807,2164,916,2505
410310,202106,2638,7301,2139,6368,303,1001,1125,3278,1428,4279
410315,202106,643,1516,399,1127,138,397,99,285,237,682
410320,202106,1075,2955,733,2261,109,384,132,379,241,763
410322,202106,582,1518,334,969,39,122,145,367,184,489
410330,202106,1556,3735,1075,2839,175,482,305,803,480,1285
410335,202106,876,2309,667,1922,101,309,275,726,376,1035
410337,202106,849,2067,600,1585,81,223,214,519,295,742
410340,202106,525,1470,354,1059,20,59,172,441,192,500
410345,202106,2510,6466,1352,3963,260,786,366,919,626,1705
410347,202106,759,1932,563,1573,56,188,183,515,239,703
410350,202106,1622,3960,1176,3227,141,416,559,1420,700,1836
410360,202106,4377,10725,3344,8924,488,1371,1496,3871,1984,5242
410370,202106,14072,37429,9150,25918,1052,3235,3877,9617,4929,12852
410380,202106,1648,4104,1206,3306,178,513,401,996,579,1509
410390,202106,2719,6737,1821,5164,378,1195,600,1519,978,2714
410395,202106,933,2630,760,2265,156,469,291,886,447,1355
410400,202106,6839,17532,5210,14470,701,2078,2726,7119,3427,9197
410405,202106,899,2061,642,1689,109,331,307,748,416,1079
410410,202106,1323,3456,1242,3329,150,471,798,2210,948,2681
410420,202106,11266,30275,8569,24951,1291,4215,3639,9486,4930,13701
410425,202106,3398,9390,2342,7241,366,1217,845,2358,1211,3575
410430,202106,13401,33134,9445,26000,1402,4229,3504,8924,4906,13153
410440,202106,2333,6835,2000,6222,289,1013,1064,3223,1353,4236
410442,202106,2274,6806,1863,5908,465,1512,521,1557,986,3069
410445,202106,2295,6507,1676,5315,318,1140,281,980,599,2120
410450,202106,1508,3671,1126,3079,211,624,436,1133,647,1757
410460,202106,2226,5454,1676,4530,175,496,817,2120,992,2616
410465,202106,2823,8083,2241,6984,394,1284,763,2213,1157,3497
410470,202106,2118,5756,1501,4659,395,1399,207,693,602,2092
410480,202106,37998,90143,20775,59801,3144,10110,4725,11609,7869,21719
410490,202106,11462,31180,8333,24833,1429,4585,3463,9616,4892,14201
410500,202106,1924,4927,1325,3808,277,897,361,891,638,1788
410510,202106,1868,4649,1257,3521,233,630,382,1060,615,1690
410520,202106,3081,9531,2718,8802,962,3196,826,2751,1788,5947
410530,202106,1646,3945,789,2198,100,286,214,490,314,776
410540,202106,2882,7646,1998,5878,306,961,885,2465,1191,3426
410550,202106,7749,20392,5198,14927,858,2685,1426,3544,2284,6229
410560,202106,1491,3849,1116,3095,226,698,389,925,615,1623
410570,202106,2641,7052,1912,5767,542,1946,199,604,741,2550
410580,202106,26535,67891,19384,54989,3374,10275,8732,23127,12106,33402
410590,202106,1562,4405,1077,3279,144,469,320,814,464,1283
410600,202106,1808,4751,1404,3982,325,890,422,1267,747,2157
410610,202106,721,1842,547,1524,58,182,249,641,307,823
410620,202106,2563,7208,1725,5266,379,1254,252,717,631,1971
410630,202106,2555,6577,1676,4842,290,999,365,827,655,1826
410640,202106,4910,11376,3366,8710,714,2126,415,1093,1129,3219
410645,202106,1126,3133,922,2876,272,874,436,1371,708,2245
410650,202106,2381,6377,1645,4907,309,990,608,1657,917,2647
410655,202106,925,2202,647,1703,27,73,332,836,359,909
410657,202106,626,1687,384,1166,53,178,119,309,172,487
410660,202106,3537,8842,2090,5742,362,1011,635,1606,997,2617
410670,202106,1037,2540,641,1806,128,352,206,526,334,878
410680,202106,2627,7714,1809,5689,414,1308,271,893,685,2201
410685,202106,532,1349,399,1126,97,312,152,380,249,692
410690,202106,134764,323073,90962,243504,13581,41466,36776,86867,50357,128333
410700,202106,2526,6331,2095,5665,365,1003,991,2618,1356,3621
410710,202106,912,2275,600,1698,112,332,240,621,352,953
410712,202106,669,1861,556,1653,111,368,253,702,364,1070
410715,202106,845,2416,541,1755,74,249,206,635,280,884
410720,202106,3342,8372,2681,7165,395,1260,707,1838,1102,3098
410725,202106,1147,2799,672,1912,137,416,94,222,231,638
410730,202106,717,1897,562,1609,115,384,125,356,240,740
410740,202106,915,2543,673,2080,81,284,274,834,355,1118
410750,202106,1808,4498,1447,3843,220,640,673,1706,893,2346
410752,202106,377,922,203,585,26,76,95,257,121,333
410753,202106,333,982,230,745,36,136,53,154,89,290
410754,202106,1118,2838,928,2554,64,150,632,1822,696,1972
410755,202106,581,1487,414,1160,51,151,193,488,244,639
410760,202106,3680,9419,2668,7624,658,2156,604,1582,1262,3738
410765,202106,14586,40028,11400,33804,1921,6148,2721,7097,4642,13245
410770,202106,1084,2526,759,1984,65,176,395,1034,460,1210
410773,202106,1304,3430,1143,3187,114,358,735,1984,849,2342
410775,202106,1547,3770,1355,3491,63,188,921,2303,984,2491
410780,202106,653,1599,439,1194,67,190,128,325,195,515
410785,202106,737,1889,566,1601,90,286,180,509,270,795
410790,202106,888,2485,738,2202,181,582,67,141,248,723
410800,202106,3500,7698,2820,6727,50,152,1842,4244,1892,4396
410810,202106,447,1165,338,955,33,98,144,346,177,444
410820,202106,960,2669,519,1556,105,326,86,214,191,540
410830,202106,41349,98061,28612,77051,5395,16364,11231,28228,16626,44592
410832,202106,1048,2713,839,2348,92,289,507,1336,599,1625
410840,202106,8894,22120,5315,15356,964,2989,1410,3786,2374,6775
410845,202106,1170,2890,904,2487,169,475,354,967,523,1442
410850,202106,2276,6407,1996,5900,321,979,967,2811,1288,3790
410855,202106,781,1939,504,1408,53,143,240,621,293,764
410860,202106,4453,10736,3507,9230,281,877,2140,5314,2421,6191
410865,202106,1491,4269,1285,3881,124,409,754,2322,878,2731
410870,202106,1260,3342,1028,2952,97,288,669,1899,766,2187
410880,202106,4747,12423,3318,9822,532,1615,491,1564,1023,3179
410890,202106,1037,2865,790,2387,171,578,237,675,408,1253
410895,202106,1018,3176,862,2842,263,958,205,645,468,1603
410900,202106,876,2324,619,1822,104,321,141,348,245,669
410910,202106,417,965,258,665,13,42,139,321,152,363
410920,202106,886,2114,640,1713,80,234,322,834,402,1068
410930,202106,1738,4416,1200,3468,288,968,216,598,504,1566
410940,202106,23268,62199,16929,51036,3435,11331,5371,15761,8806,27092
410950,202106,1955,5652,1760,5369,57,179,1444,4379,1501,4558
410960,202106,7904,19197,5524,15273,1209,3749,2244,6107,3453,9856
410965,202106,1188,2980,812,2279,80,248,480,1317,560,1565
410970,202106,4150,10965,2951,8701,643,2246,416,1012,1059,3258
410975,202106,1392,3356,1051,2825,115,346,508,1314,623,1660
410980,202106,7873,19349,5111,14418,564,1737,2238,5707,2802,7444
410990,202106,1409,3387,965,2677,195,634,367,977,562,1611
411000,202106,678,1770,477,1404,61,205,145,355,206,560
411005,202106,480,1194,285,776,51,154,88,202,139,356
411007,202106,2282,6265,1845,5523,444,1404,616,1818,1060,3222
411010,202106,4234,12558,3336,10746,808,2842,363,1068,1171,3910
411020,202106,2399,6648,1938,5831,529,1655,508,1511,1037,3166
411030,202106,791,1912,559,1457,43,139,304,698,347,837
411040,202106,1019,2562,548,1550,76,235,173,415,249,650
411050,202106,2005,6138,1639,5340,406,1447,242,661,648,2108
411060,202106,2072,5481,1361,4010,280,915,255,691,535,1606
411065,202106,420,1066,277,790,32,95,123,334,155,429
411070,202106,7630,19052,6030,16427,728,2189,3136,8288,3864,10477
411080,202106,2119,5506,1684,4775,403,1329,349,945,752,2274
411090,202106,829,2181,543,1622,44,153,156,442,200,595
411095,202106,2807,6499,1548,4202,188,539,397,1007,585,1546
411100,202106,1249,3193,872,2518,89,295,307,901,396,1196
411110,202106,641,1647,306,941,34,101,20,51,54,152
411120,202106,1348,3633,1108,3194,315,1058,242,642,557,1700
411125,202106,5340,15367,4768,14342,1094,3239,2240,7072,3334,10311
411130,202106,747,1969,533,1573,106,285,182,591,288,876
411140,202106,2308,6956,1942,6207,597,2024,503,1592,1100,3616
411150,202106,4022,10064,2698,7375,504,1608,246,485,750,2093
411155,202106,1001,2533,613,1803,90,254,272,752,362,1006
411160,202106,374,857,260,688,26,74,70,189,96,263
411170,202106,761,2205,594,1832,136,438,210,613,346,1051
411180,202106,5687,14821,4459,12711,645,1994,2163,5795,2808,7789
411190,202106,1847,4658,1353,3753,202,608,533,1326,735,1934
411200,202106,4946,13267,3574,10727,851,2866,787,2035,1638,4901
411210,202106,3341,7386,2256,5626,395,1074,776,1836,1171,2910
411220,202106,892,2260,632,1762,147,452,173,447,320,899
411230,202106,860,2282,630,1837,125,381,219,616,344,997
411240,202106,1650,3898,1122,2961,129,411,556,1331,685,1742
411250,202106,2296,6014,1674,4902,314,1075,504,1394,818,2469
411260,202106,326,830,227,635,24,72,93,223,117,295
411270,202106,2071,5437,1539,4392,207,611,749,1986,956,2597
411275,202106,1487,3389,1029,2647,138,435,493,1170,631,1605
411280,202106,1336,3599,913,2790,233,724,124,359,357,1083
411290,202106,845,2187,538,1598,70,214,260,752,330,966
411295,202106,1279,3193,911,2477,113,318,408,1048,521,1366
411300,202106,1055,2622,695,1923,70,215,316,749,386,964
411310,202106,900,2051,694,1769,75,191,306,778,381,969
411320,202106,5619,14272,4102,11586,600,1811,1808,4624,2408,6435
411325,202106,1418,3987,1199,3598,221,620,649,2027,870,2647
411330,202106,3375,9020,2461,7353,539,1744,748,2268,1287,4012
411340,202106,846,2277,511,1549,82,250,146,420,228,670
411342,202106,1089,2603,612,1665,109,308,202,509,311,817
411345,202106,1134,2866,863,2424,63,180,630,1781,693,1961
411350,202106,2915,7706,1881,5614,447,1440,325,859,772,2299
411360,202106,733,1741,519,1408,78,230,182,458,260,688
411370,202106,61146,148681,44555,120436,3170,10134,26624,66833,29794,76967
411373,202106,1417,3555,1145,3151,115,354,614,1703,729,2057
411375,202106,1118,2793,816,2235,128,362,317,850,445,1212
411380,202106,1179,2682,802,1978,45,121,498,1132,543,1253
411390,202106,1524,4153,1194,3429,195,606,473,1173,668,1779
411400,202106,2385,5763,1793,4662,151,472,974,2378,1125,2850
411410,202106,2723,7442,2018,5967,421,1352,453,1259,874,2611
411420,202106,4459,10730,2432,6886,312,991,474,1011,786,2002
411430,202106,3605,9603,2753,8014,552,1751,995,2679,1547,4430
411435,202106,409,1121,261,816,56,172,77,208,133,380
411440,202106,2571,7065,2064,6105,447,1417,672,1904,1119,3321
411450,202106,2501,6662,1896,5645,247,731,1030,3123,1277,3854
411460,202106,4361,11039,2760,8036,406,1364,511,1345,917,2709
411470,202106,808,2040,604,1648,106,324,241,573,347,897
411480,202106,5241,13657,3841,11083,676,2341,1486,3815,2162,6156
411490,202106,1662,4257,1276,3614,148,484,552,1403,700,1887
411500,202106,1323,3500,893,2593,150,477,171,397,321,874
411510,202106,2379,5940,1921,5179,341,1077,533,1460,874,2537
411520,202106,33103,80177,19669,54226,2241,7126,7884,19350,10125,26476
411530,202106,978,2536,589,1790,95,321,88,233,183,554
411535,202106,519,1487,334,1055,43,154,93,259,136,413
411540,202106,2665,6464,1838,4979,124,402,1001,2648,1125,3050
411545,202106,928,2659,780,2400,71,231,495,1519,566,1750
411550,202106,731,1825,544,1488,85,247,101,300,186,547
411560,202106,1999,5350,1156,3562,150,525,61,149,211,674
411570,202106,7357,16905,4968,13350,1128,3296,905,2450,2033,5746
411573,202106,775,2081,651,1866,102,296,304,854,406,1150
411575,202106,2094,5614,1567,4548,270,836,413,1156,683,1992
411580,202106,4905,11221,2981,8273,426,1443,549,1342,975,2785
411585,202106,626,1852,298,960,61,197,57,174,118,371
411590,202106,409,1099,300,884,43,123,148,405,191,528
411600,202106,334,831,206,624,37,117,66,186,103,303
411605,202106,1593,3679,1039,2817,139,477,519,1388,658,1865
411610,202106,2624,6070,1874,4786,65,222,1301,3099,1366,3321
411620,202106,2759,7284,2350,6646,380,1131,1288,3640,1668,4771
411630,202106,818,2061,518,1512,65,227,194,502,259,729
411640,202106,473,1209,326,902,43,128,106,256,149,384
411650,202106,218,616,143,455,27,94,30,68,57,162
411660,202106,924,2345,671,1884,55,163,274,723,329,886
411670,202106,1455,3450,994,2590,105,286,504,1205,609,1491
411680,202106,1456,3873,1093,3158,165,538,466,1307,631,1845
411690,202106,4052,10103,3065,8420,679,1860,828,2455,1507,4315
411695,202106,653,1927,447,1398,47,158,188,542,235,700
411700,202106,1735,4416,1176,3358,258,754,200,545,458,1299
411705,202106,1956,5892,1656,5373,289,870,993,3425,1282,4295
411710,202106,2038,5074,1403,3904,302,841,319,851,621,1692
411720,202106,1084,2480,777,1958,140,368,302,733,442,1101
411721,202106,1015,2485,767,2030,140,356,229,597,369,953
411722,202106,915,2413,534,1566,97,308,185,451,282,759
411725,202106,1217,3330,819,2563,196,662,163,493,359,1155
411727,202106,1534,4182,1000,3040,219,681,137,383,356,1064
411729,202106,681,1632,390,1062,45,159,145,342,190,501
411730,202106,5433,14172,4249,11908,794,2395,1935,5279,2729,7674
411740,202106,533,1352,279,806,69,186,60,160,129,346
411745,202106,818,2314,574,1767,68,237,139,343,207,580
411750,202106,5720,14872,4185,11890,547,1655,2011,5379,2558,7034
411760,202106,6823,18002,5295,15413,1630,4946,1013,3347,2643,8293
411770,202106,3115,8869,2281,7064,505,1683,385,1071,890,2754
411780,202106,2699,7488,2348,6851,675,2056,781,2330,1456,4386
411790,202106,2895,6901,1645,4657,319,1029,396,966,715,1995
411800,202106,1060,2999,788,2365,134,433,158,417,292,850
411810,202106,1628,4169,1211,3344,195,558,533,1366,728,1924
411820,202106,11813,33186,9651,29477,2242,7383,4281,12660,6523,20043
411830,202106,564,1385,414,1112,90,266,63,173,153,439
411840,202106,12581,32998,8713,25092,1429,4423,2472,6370,3901,10793
411845,202106,599,1678,357,1123,49,179,85,237,134,416
411850,202106,7431,18714,5102,14670,1255,4000,926,2436,2181,6436
411860,202106,710,1929,512,1519,84,263,120,303,204,566
411870,202106,596,1703,419,1304,92,315,95,268,187,583
411880,202106,2350,5697,1716,4706,233,707,665,1706,898,2413
411885,202106,1128,2905,816,2340,122,408,248,639,370,1047
411890,202106,1430,3771,1017,3003,176,584,105,302,281,886
411900,202106,797,2181,505,1559,111,368,98,274,209,642
411910,202106,1065,3118,790,2555,181,687,299,884,480,1571
411915,202106,15586,37983,10830,29433,1509,4555,4628,11317,6137,15872
411920,202106,1187,3391,986,2978,205,713,363,1008,568,1721
411925,202106,495,1290,356,1041,76,225,142,393,218,618
411930,202106,4951,14821,4169,13381,1868,6505,239,926,2107,7431
411940,202106,3366,9698,2626,8134,623,1959,867,2434,1490,4393
411950,202106,14828,39453,12284,35251,1550,5051,7395,20259,8945,25310
411960,202106,6155,16109,4839,13500,833,2500,1991,5307,2824,7807
411965,202106,484,1324,352,1064,48,156,151,430,199,586
411970,202106,1217,2734,948,2371,185,434,409,1187,594,1621
411980,202106,1498,3625,1081,2951,275,742,391,1061,666,1803
411990,202106,38495,99561,24866,74928,4465,14808,8774,24957,13239,39765
411995,202106,3837,9277,2922,7856,836,2453,752,1960,1588,4413
412000,202106,1878,4323,1304,3362,33,104,902,2164,935,2268
412010,202106,624,1892,473,1563,77,262,126,359,203,621
412015,202106,556,1550,454,1366,67,209,262,782,329,991
412020,202106,453,1252,291,915,46,171,118,332,164,503
412030,202106,623,1740,460,1445,71,218,155,483,226,701
412033,202106,960,2513,690,1969,83,251,260,636,343,887
412035,202106,748,2010,475,1511,54,195,250,761,304,956
412040,202106,645,1712,383,1165,57,172,57,163,114,335
412050,202106,1621,4014,1111,3074,248,759,252,699,500,1458
412060,202106,7398,21210,6163,18761,1591,5472,1719,5026,3310,10498
412065,202106,638,1742,472,1410,100,324,108,320,208,644
412070,202106,1240,3182,973,2671,128,385,374,922,502,1307
412080,202106,2315,6303,1605,4902,236,748,460,1265,696,2013
412085,202106,315,737,111,330,11,33,26,66,37,99
412090,202106,6268,15926,4604,12872,1034,3061,1705,4795,2739,7856
412100,202106,1714,4567,1301,3798,423,1385,286,883,709,2268
412110,202106,832,2225,581,1718,79,252,188,531,267,783
412120,202106,2078,5840,1591,4914,328,1120,409,1062,737,2182
412125,202106,664,1868,457,1431,78,254,107,331,185,585
412130,202106,823,2040,565,1563,90,248,144,408,234,656
412135,202106,636,1672,301,900,49,162,93,237,142,399
412140,202106,1759,4197,1198,3228,189,633,258,656,447,1289
412150,202106,2868,7327,2442,6588,342,1061,1489,3799,1831,4860
412160,202106,895,2751,504,1690,60,218,71,193,131,411
412170,202106,4416,11958,3700,10809,691,2256,1549,4156,2240,6412
412175,202106,1333,3729,1115,3358,234,743,483,1448,717,2191
412180,202106,1692,4608,1237,3763,145,509,557,1564,702,2073
412190,202106,3423,8448,2522,6889,306,893,1083,2937,1389,3830
412200,202106,1746,5073,1235,3930,304,1060,180,527,484,1587
412210,202106,665,1567,417,1143,53,162,164,406,217,568
412215,202106,3455,9205,2667,7673,628,1753,1112,3512,1740,5265
412217,202106,1028,2621,860,2320,44,116,608,1579,652,1695
412220,202106,5652,15684,4635,13847,1312,3808,1425,4589,2737,8397
412230,202106,2735,7901,2155,6784,344,1242,541,1442,885,2684
412240,202106,7696,19621,4910,14120,839,2598,1470,3754,2309,6352
412250,202106,2064,5243,1530,4229,361,1045,312,779,673,1824
412260,202106,1276,3337,952,2669,142,409,293,770,435,1179
412265,202106,946,2525,739,2162,155,465,297,824,452,1289
412270,202106,1046,2832,676,2053,81,274,267,722,348,996
412280,202106,405,1112,318,963,80,246,92,271,172,517
412290,202106,1054,2658,734,2087,107,326,244,637,351,963
412300,202106,1687,4346,1188,3473,252,771,268,811,520,1582
412310,202106,753,2133,583,1781,106,371,178,498,284,869
412320,202106,815,2068,521,1464,45,150,154,433,199,583
412330,202106,1629,4274,1122,3334,231,726,376,1152,607,1878
412340,202106,1210,3253,792,2347,96,333,116,316,212,649
412350,202106,3036,7862,1969,5766,359,1128,333,888,692,2016
412360,202106,262,710,190,558,7,33,120,330,127,363
412370,202106,867,2442,590,1854,111,383,74,232,185,615
412380,202106,1564,4214,1118,3342,282,875,114,387,396,1262
412382,202106,494,1186,331,926,37,133,152,350,189,483
412385,202106,2220,6005,1824,5248,587,1590,563,1800,1150,3390
412390,202106,2555,6059,2045,5267,341,894,731,1863,1072,2757
412395,202106,710,2019,513,1574,71,206,220,682,291,888
412400,202106,941,2448,676,1947,124,398,198,549,322,947
412402,202106,2302,5595,1614,4486,432,1201,209,630,641,1831
412405,202106,3150,8235,2067,6217,508,1779,115,308,623,2087
412410,202106,6349,16183,4664,13437,758,2540,1567,4197,2325,6737
412420,202106,551,1375,367,1006,28,88,174,409,202,497
412430,202106,607,1517,322,927,33,104,133,356,166,460
412440,202106,2818,7448,1884,5689,435,1409,377,1144,812,2553
412450,202106,509,1438,346,1041,42,126,33,72,75,198
412460,202106,1104,2824,864,2418,166,501,383,1038,549,1539
412470,202106,1570,4890,1299,4287,299,1045,279,915,578,1960
412480,202106,1082,2837,734,2104,115,360,251,635,366,995
412490,202106,1351,3262,1081,2780,142,370,536,1293,678,1663
412500,202106,2010,5006,1528,4120,316,887,425,1031,741,1918
412510,202106,1950,5840,1338,4316,316,1080,156,450,472,1530
412520,202106,1203,3063,682,1958,164,445,67,200,231,645
412530,202106,719,1886,521,1481,74,236,117,333,191,569
412535,202106,832,2135,567,1631,105,334,113,269,218,603
412540,202106,1199,3003,872,2419,87,303,295,855,382,1158
412545,202106,697,1792,484,1371,80,244,141,389,221,633
412550,202106,34441,90431,24703,71188,3812,11893,10167,26639,13979,38532
412555,202106,300,767,204,564,21,64,68,147,89,211
412560,202106,4852,13712,3705,11111,651,2171,1111,3297,1762,5468
412570,202106,4541,11300,2636,7646,483,1598,313,957,796,2555
412575,202106,1054,2633,843,2278,112,336,446,1134,558,1470
412580,202106,1470,3746,1049,2969,72,231,587,1584,659,1815
412590,202106,406,1064,230,708,32,104,23,65,55,169
412600,202106,1706,4516,1302,3720,191,600,597,1584,788,2184
412610,202106,853,2231,608,1703,79,240,273,662,352,902
412620,202106,1275,3296,972,2840,186,616,303,829,489,1445
412625,202106,8774,22923,5391,16204,740,2492,340,970,1080,3462
412627,202106,1164,3233,761,2398,142,488,211,661,353,1149
412630,202106,2926,8408,2123,6713,377,1229,626,1788,1003,3017
412635,202106,402,1074,269,793,30,101,89,218,119,319
412640,202106,1050,2752,609,1826,76,236,179,477,255,713
412650,202106,1704,4557,1355,3874,220,698,528,1306,748,2004
412660,202106,2527,6457,1824,5115,260,784,611,1525,871,2309
412665,202106,405,1011,318,858,62,174,144,378,206,552
412667,202106,1850,4778,1369,3854,189,574,597,1599,786,2173
412670,202106,885,2057,569,1536,111,339,151,378,262,717
412680,202106,2105,5503,1465,4295,176,589,523,1347,699,1936
412690,202106,1158,3033,833,2406,142,446,297,812,439,1258
412700,202106,1966,5134,1642,4632,205,640,898,2469,1103,3109
412710,202106,5875,16782,4389,13629,809,2815,1166,3133,1975,5948
412720,202106,1176,3399,908,2824,138,449,207,537,345,986
412730,202106,2562,6651,1794,5131,310,1000,682,1811,992,2811
412740,202106,1940,5338,1329,4109,215,763,186,575,401,1338
412750,202106,4051,10441,3310,9387,254,856,2199,5925,2453,6781
412760,202106,2980,7948,2478,7112,465,1504,1323,3553,1788,5057
412770,202106,10564,26721,5802,17383,769,2480,1287,3211,2056,5691
412780,202106,1201,3153,911,2636,198,630,346,965,544,1595
412785,202106,2158,5039,1543,4021,139,379,1055,2692,1194,3071
412788,202106,1421,3948,1166,3500,322,978,452,1304,774,2282
412790,202106,1363,3566,795,2430,108,375,244,642,352,1017
412795,202106,1269,3237,680,2050,90,294,123,341,213,635
412796,202106,2175,6165,1795,5470,351,1136,598,1674,949,2810
412800,202106,3761,9027,2632,6959,278,862,1275,2973,1553,3835
412810,202106,12296,31079,8023,22532,960,3127,3147,7824,4107,10951
412820,202106,6335,17192,4501,13494,1070,3425,1278,3777,2348,7202
412830,202106,354,994,254,782,34,100,75,213,109,313
412840,202106,1915,4676,1375,3646,146,437,657,1573,803,2010
412850,202106,2811,7278,2039,5955,301,941,876,2513,1177,3454
412853,202106,1531,3799,1280,3369,168,493,680,1586,848,2079
412855,202106,1341,3455,817,2356,120,400,214,541,334,941
412860,202106,760,1855,515,1467,76,232,270,713,346,945
412862,202106,669,1630,454,1264,95,265,166,433,261,698
412863,202106,1275,3789,1135,3538,265,855,520,1612,785,2467
412865,202106,716,1942,529,1564,145,421,128,417,273,838
412870,202106,863,2227,630,1840,175,556,140,458,315,1014
412880,202106,869,2328,577,1739,99,342,106,289,205,631
420005,202106,416,1211,250,828,30,98,118,394,148,492
420010,202106,3298,7993,2223,6191,124,373,1635,4601,1759,4974
420020,202106,434,1340,294,977,45,176,69,168,114,344
420030,202106,91,323,55,226,13,60,19,72,32,132
420040,202106,506,1501,315,1074,65,242,28,69,93,311
420050,202106,712,1606,477,1196,70,195,293,659,363,854
420055,202106,161,490,88,316,20,91,24,75,44,166
420060,202106,100,266,60,171,7,23,13,28,20,51
420070,202106,711,2114,532,1745,107,352,212,677,319,1029
420075,202106,80,197,41,120,7,26,14,22,21,48
420080,202106,368,1025,288,840,67,221,116,326,183,547
420090,202106,412,1263,262,909,58,219,46,132,104,351
420100,202106,1274,3262,1065,2945,59,187,858,2331,917,2518
420110,202106,249,791,222,730,39,138,115,363,154,501
420120,202106,600,1591,409,1183,61,198,205,522,266,720
420125,202106,355,1071,251,842,57,215,95,303,152,518
420127,202106,311,798,124,369,15,48,45,125,60,173
420130,202106,3602,9761,2740,8345,395,1413,1293,3617,1688,5030
420140,202106,3711,9854,2696,8087,737,2491,473,1430,1210,3921
420150,202106,676,1702,467,1343,46,151,278,771,324,922
420160,202106,192,456,69,217,8,28,19,56,27,84
420165,202106,151,425,89,291,21,68,27,78,48,146
420170,202106,282,880,188,636,26,96,64,181,90,277
420180,202106,165,522,102,360,16,57,29,91,45,148
420190,202106,203,618,122,417,29,110,44,141,73,251
420195,202106,1448,3647,1083,3075,275,921,254,626,529,1547
420200,202106,4943,11812,3047,8321,394,1308,1310,3080,1704,4388
420205,202106,1834,4853,1229,3621,177,542,663,1934,840,2476
420207,202106,1879,4836,1173,3478,205,699,486,1340,691,2039
420208,202106,322,913,187,651,58,211,41,122,99,333
420209,202106,155,482,99,309,15,50,50,142,65,192
420210,202106,3200,8050,2207,6438,353,1186,1118,3102,1471,4288
420213,202106,785,2368,665,2135,142,488,335,1058,477,1546
420215,202106,206,614,146,481,40,151,41,129,81,280
420220,202106,282,804,173,576,28,109,77,231,105,340
420230,202106,5235,13966,4006,11698,569,1803,2162,6030,2731,7833
420240,202106,14135,38716,9105,27176,1083,3693,4437,11569,5520,15262
420243,202106,396,1103,325,968,50,171,207,589,257,760
420245,202106,1404,3555,1030,2917,75,257,650,1735,725,1992
420250,202106,441,1211,370,1095,53,177,220,608,273,785
420253,202106,468,1132,330,930,32,93,192,539,224,632
420257,202106,156,399,97,294,14,53,51,152,65,205
420260,202106,1121,2873,820,2465,115,405,548,1608,663,2013
420270,202106,546,1410,280,808,42,132,117,314,159,446
420280,202106,1231,3616,972,3076,169,604,385,1147,554,1751
420285,202106,121,263,59,168,7,34,24,51,31,85
420287,202106,438,1007,318,846,83,226,120,323,203,549
420290,202106,4873,13651,3761,11179,521,1746,2189,6016,2710,7762
420300,202106,7439,20789,4360,13505,735,2523,1428,3826,2163,6349
420310,202106,779,1772,401,1098,37,113,219,559,256,672
420315,202106,780,2167,533,1740,90,321,242,776,332,1097
420320,202106,5237,13915,3762,11482,1013,3392,995,2817,2008,6209
420325,202106,332,917,237,727,31,94,100,285,131,379
420330,202106,978,2812,622,2058,101,376,188,569,289,945
420340,202106,918,2530,693,2131,149,467,135,379,284,846
420350,202106,1178,3003,873,2471,63,216,627,1730,690,1946
420360,202106,2909,7872,1588,5030,286,993,117,357,403,1350
420370,202106,1189,3103,981,2768,76,257,712,1939,788,2196
420380,202106,4372,11373,2946,8781,601,1903,1139,3230,1740,5133
420390,202106,1066,2570,740,1919,128,390,303,553,431,943
420395,202106,1151,3215,798,2511,126,451,127,298,253,749
420400,202106,998,2745,697,2127,110,391,308,879,418,1270
420410,202106,578,1518,450,1258,33,99,321,879,354,978
420415,202106,284,822,212,670,52,180,86,281,138,461
420417,202106,599,1738,468,1476,126,417,178,570,304,987
420419,202106,137,487,111,429,40,165,9,36,49,201
420420,202106,11537,29567,7800,22800,2035,6775,2285,6014,4320,12789
420425,202106,632,1683,431,1265,35,116,219,621,254,737
420430,202106,3118,8249,1860,5533,409,1278,610,1668,1019,2946
420435,202106,252,653,132,424,16,55,67,208,83,263
420440,202106,699,1870,428,1307,128,415,125,362,253,777
420445,202106,259,625,171,469,32,87,77,195,109,282
420450,202106,740,2144,538,1709,90,357,196,540,286,897
420455,202106,1997,4796,1457,3988,206,604,709,1866,915,2470
420460,202106,9211,24251,6951,20101,947,3105,3631,10018,4578,13123
420470,202106,579,1490,315,978,59,214,61,159,120,373
420475,202106,66,174,25,82,6,21,2,6,8,27
420480,202106,5228,12749,3248,9494,600,1929,1183,3419,1783,5348
420490,202106,356,983,254,772,55,193,97,281,152,474
420500,202106,1357,3689,882,2814,139,499,403,1260,542,1759
420510,202106,152,427,81,265,11,46,20,56,31,102
420515,202106,69,183,44,125,6,25,16,41,22,66
420517,202106,757,2066,639,1842,61,179,431,1247,492,1426
420519,202106,289,702,203,576,20,64,121,347,141,411
420520,202106,274,724,141,464,19,66,10,31,29,97
420530,202106,801,2325,552,1787,79,314,220,615,299,929
420535,202106,230,672,97,329,15,56,39,127,54,183
420540,202106,37696,89272,24963,68105,3496,10809,9250,21873,12746,32682
420543,202106,208,606,158,492,17,53,84,243,101,296
420545,202106,1247,3700,946,3036,162,581,352,1007,514,1588
420550,202106,3514,9216,2299,7176,346,1283,1008,3180,1354,4463
420555,202106,295,844,208,660,22,76,122,372,144,448
420560,202106,388,953,260,759,46,147,156,451,202,598
420570,202106,2381,6288,1869,5329,298,979,876,2389,1174,3368
420580,202106,1806,4590,1292,3807,289,916,435,1313,724,2229
420590,202106,2740,7273,1637,4904,273,972,463,1082,736,2054
420600,202106,1043,2945,807,2510,94,359,483,1418,577,1777
420610,202106,342,981,215,694,51,162,73,248,124,410
420620,202106,765,1871,512,1460,113,338,197,554,310,892
420630,202106,904,2713,663,2126,73,253,395,1204,468,1457
420640,202106,485,1292,245,809,76,252,34,105,110,357
420650,202106,3595,9382,2255,6616,308,984,899,2307,1207,3291
420660,202106,426,1087,273,762,60,169,57,144,117,313
420665,202106,643,1652,420,1279,73,252,187,509,260,761
420670,202106,1226,3380,785,2450,123,468,290,788,413,1256
420675,202106,181,495,108,351,19,83,57,166,76,249
420680,202106,306,701,157,493,29,97,73,219,102,316
420690,202106,855,2518,541,1795,76,301,145,417,221,718
420700,202106,2589,6742,1962,5701,205,654,1190,3345,1395,3999
420710,202106,1000,2783,774,2299,69,274,497,1333,566,1607
420720,202106,1154,3188,839,2645,139,471,448,1344,587,1815
420730,202106,3127,8079,2343,6788,373,1203,1264,3506,1637,4709
420740,202106,485,1424,269,947,54,213,20,81,74,294
420750,202106,1926,5485,1244,3922,207,758,517,1484,724,2242
420757,202106,85,203,37,109,4,6,17,53,21,59
420760,202106,311,902,170,527,32,112,51,140,83,252
420765,202106,456,1302,220,725,26,94,103,322,129,416
420768,202106,1341,3714,1167,3430,139,401,873,2563,1012,2964
420770,202106,441,1204,214,743,34,136,76,241,110,377
420775,202106,264,773,181,587,30,108,72,192,102,300
420780,202106,898,2490,549,1721,107,367,93,263,200,630
420785,202106,197,515,140,394,14,50,71,165,85,215
420790,202106,1021,3029,763,2511,121,467,433,1348,554,1815
420800,202106,647,1605,336,990,71,244,138,375,209,619
420810,202106,1426,4330,1158,3801,310,1187,441,1232,751,2419
420820,202106,12569,31031,9131,25481,1590,4927,4319,11184,5909,16111
420830,202106,4298,11121,3230,9225,542,1629,1438,3971,1980,5600
420840,202106,478,1406,231,847,61,225,19,76,80,301
420845,202106,2422,6086,1512,4461,275,973,639,1769,914,2742
420850,202106,1070,3358,673,2325,111,410,146,443,257,853
420860,202106,348,886,197,616,33,117,52,135,85,252
420870,202106,759,2106,566,1737,154,529,210,584,364,1113
420880,202106,1046,3116,803,2617,161,627,305,900,466,1527
420890,202106,8132,21868,5095,15648,693,2307,1817,4965,2510,7272
420895,202106,173,501,108,332,27,84,34,106,61,190
420900,202106,1507,3705,920,2685,120,428,427,1089,547,1517
420910,202106,31176,81450,19943,59908,2859,9731,8159,21651,11018,31382
420915,202106,496,1778,366,1406,52,194,203,794,255,988
420917,202106,429,1043,197,527,33,89,96,256,129,345
420920,202106,75,205,33,115,2,5,5,18,7,23
420930,202106,16407,42201,11727,34011,1984,6371,5309,14624,7293,20995
420940,202106,3108,7525,1878,5420,424,1374,404,955,828,2329
420945,202106,130,368,102,310,23,80,42,113,65,193
420950,202106,345,990,195,635,28,112,53,152,81,264
420960,202106,1043,2536,747,2034,119,373,337,827,456,1200
420970,202106,2328,6292,1646,5048,462,1458,481,1487,943,2945
420980,202106,275,905,237,823,107,383,61,220,168,603
420985,202106,310,885,164,568,42,169,45,135,87,304
420990,202106,311,966,182,648,28,105,42,147,70,252
421000,202106,550,1632,402,1313,87,309,95,272,182,581
421003,202106,465,1095,158,457,3,10,16,34,19,44
421005,202106,63,179,48,157,10,34,22,72,32,106
421010,202106,3267,8873,2359,7188,452,1554,651,1731,1103,3285
421020,202106,369,1142,292,1002,42,170,147,481,189,651
421030,202106,760,2240,576,1871,166,600,197,590,363,1190
421040,202106,625,1491,393,1137,29,100,243,687,272,787
421050,202106,1024,2706,682,1964,128,407,268,673,396,1080
421055,202106,173,474,99,303,15,50,60,166,75,216
421060,202106,657,1884,470,1489,84,306,234,672,318,978
421070,202106,657,1957,416,1350,67,241,163,489,230,730
421080,202106,516,1473,425,1303,41,151,253,767,294,918
421085,202106,378,1054,151,509,14,44,28,77,42,121
421090,202106,269,691,152,428,13,46,48,118,61,164
421100,202106,773,1725,327,981,76,259,82,200,158,459
421105,202106,1560,4180,1083,3255,163,515,526,1507,689,2022
421110,202106,1099,2816,902,2556,23,71,650,1933,673,2004
421120,202106,1016,3013,739,2402,112,403,223,615,335,1018
421125,202106,285,733,203,585,70,228,74,181,144,409
421130,202106,4812,13810,3967,12174,887,3109,2032,5843,2919,8952
421140,202106,342,928,210,641,38,113,76,215,114,328
421145,202106,435,1180,277,837,70,220,94,261,164,481
421150,202106,591,1598,388,1198,59,216,202,573,261,789
421160,202106,514,1398,386,1152,56,185,237,662,293,847
421165,202106,223,664,136,451,29,98,52,167,81,265
421170,202106,1001,2742,855,2508,139,391,524,1590,663,1981
421175,202106,958,2368,588,1794,110,379,264,777,374,1156
421180,202106,381,998,213,660,37,147,97,256,134,403
421185,202106,314,815,215,612,21,69,132,360,153,429
421187,202106,274,839,171,581,26,82,60,204,86,286
421189,202106,345,996,272,853,46,156,109,313,155,469
421190,202106,11167,29855,7703,23299,1337,4333,2955,8242,4292,12575
421200,202106,681,1913,565,1710,80,294,337,962,417,1256
421205,202106,189,498,138,416,25,89,64,178,89,267
421210,202106,1064,2644,604,1863,116,374,228,691,344,1065
421220,202106,1358,4008,1057,3381,231,810,346,1014,577,1824
421223,202106,315,859,195,634,44,136,96,312,140,448
421225,202106,841,2430,716,2223,113,417,444,1342,557,1759
421227,202106,639,1802,415,1331,75,261,192,624,267,885
421230,202106,567,1457,366,1082,65,224,141,406,206,630
421240,202106,285,824,139,479,13,58,28,86,41,144
421250,202106,2069,5139,1455,4155,146,473,891,2442,1037,2915
421260,202106,204,626,49,177,10,43,5,14,15,57
421265,202106,674,1776,597,1664,19,50,509,1410,528,1460
421270,202106,341,912,144,510,26,87,45,156,71,243
421280,202106,1970,5158,1492,4374,204,720,856,2376,1060,3096
421290,202106,954,2541,498,1498,101,320,111,305,212,625
421300,202106,268,681,130,416,12,50,18,54,30,104
421310,202106,182,509,122,393,28,94,62,193,90,287
421315,202106,228,582,150,426,44,118,37,116,81,234
421320,202106,629,1975,336,1125,34,97,33,59,67,156
421330,202106,594,1737,427,1387,90,330,117,353,207,683
421335,202106,348,1041,281,927,61,222,118,380,179,602
421340,202106,1389,3799,1006,3112,163,575,486,1384,649,1959
421350,202106,1484,3806,992,2949,191,628,388,1095,579,1723
421360,202106,2236,5909,1334,4063,243,875,506,1331,749,2206
421370,202106,721,2293,445,1563,77,289,125,372,202,661
421380,202106,831,2143,716,1966,82,254,430,1132,512,1386
421390,202106,165,444,63,218,14,42,23,68,37,110
421400,202106,330,1013,241,807,44,167,123,382,167,549
421410,202106,174,492,82,298,22,87,22,70,44,157
421415,202106,178,507,115,345,23,78,29,62,52,140
421420,202106,559,1517,457,1327,50,167,283,803,333,970
421430,202106,97,308,74,248,8,28,18,56,26,84
421440,202106,617,1653,370,1184,66,204,156,480,222,684
421450,202106,452,1289,258,857,32,111,41,139,73,250
421460,202106,351,1040,192,707,16,62,22,61,38,123
421470,202106,289,801,176,565,32,102,63,217,95,319
421480,202106,2730,7257,1836,5467,336,1179,739,2011,1075,3190
421490,202106,116,397,71,268,11,39,14,47,25,86
421500,202106,2064,5978,1414,4622,352,1351,339,968,691,2319
421505,202106,293,801,244,731,31,115,163,464,194,579
421507,202106,425,1181,238,785,51,190,84,248,135,438
421510,202106,344,959,222,661,30,98,116,322,146,420
421520,202106,495,1302,320,915,30,86,179,464,209,550
421530,202106,285,836,155,537,25,109,30,76,55,185
421535,202106,374,987,237,747,38,145,133,399,171,544
421540,202106,303,722,167,503,25,80,56,152,81,232
421545,202106,617,1810,461,1537,98,399,227,698,325,1097
421550,202106,2053,5376,1657,4790,312,914,943,2730,1255,3644
421555,202106,166,498,68,238,6,22,9,18,15,40
421560,202106,86,287,58,217,10,42,20,67,30,109
421565,202106,900,2297,603,1833,147,507,181,529,328,1036
421567,202106,402,1258,261,880,82,295,74,222,156,517
421568,202106,329,977,232,737,42,155,88,266,130,421
421569,202106,150,419,71,225,9,28,39,123,48,151
421570,202106,1266,3433,892,2657,189,626,275,733,464,1359
421575,202106,287,826,216,635,32,103,100,272,132,375
421580,202106,4250,11391,2764,8335,386,1360,1087,2802,1473,4162
421590,202106,161,476,116,379,28,100,41,127,69,227
421600,202106,569,1517,390,1135,72,235,130,324,202,559
421605,202106,739,1910,535,1580,95,239,279,888,374,1127
421610,202106,1023,2744,692,2113,110,370,228,671,338,1041
421620,202106,3747,9830,2298,7197,430,1601,731,2125,1161,3726
421625,202106,126,350,62,190,11,31,17,50,28,81
421630,202106,2554,6624,1666,4932,280,994,638,1583,918,2577
421635,202106,263,698,185,542,13,43,120,323,133,366
421640,202106,663,1785,478,1507,102,367,200,619,302,986
421650,202106,2369,6456,1615,5061,343,1255,527,1432,870,2687
421660,202106,10235,28155,7233,22370,1047,3644,3316,9343,4363,12987
421670,202106,755,2127,533,1606,95,320,249,714,344,1034
421680,202106,1069,2842,827,2428,155,491,490,1335,645,1826
421690,202106,1312,3679,893,2810,159,541,307,962,466,1503
421700,202106,503,1459,351,1130,73,261,122,372,195,633
421710,202106,197,631,100,344,22,77,27,89,49,166
421715,202106,116,307,94,260,21,58,51,138,72,196
421720,202106,1913,5155,1153,3530,286,928,295,781,581,1709
421725,202106,252,609,135,406,23,74,64,168,87,242
421730,202106,390,1070,224,637,30,93,121,317,151,410
421740,202106,745,2087,504,1577,106,363,155,433,261,796
421750,202106,868,2021,419,1204,93,286,159,416,252,702
421755,202106,165,455,95,287,15,56,45,119,60,175
421760,202106,984,2557,682,2009,117,380,246,612,363,992
421770,202106,2323,6062,1683,4952,447,1280,581,1839,1028,3119
421775,202106,214,552,130,391,16,50,56,157,72,207
421780,202106,807,2351,530,1770,106,400,222,671,328,1071
421790,202106,858,2316,499,1633,110,376,214,677,324,1053
421795,202106,172,470,120,345,21,66,39,104,60,170
421800,202106,2561,6815,1879,5568,223,771,1101,3085,1324,3856
421810,202106,633,1713,429,1332,43,154,251,766,294,920
421820,202106,946,2731,574,1827,110,389,190,496,300,885
421825,202106,1331,3650,1182,3424,104,324,864,2447,968,2771
421830,202106,1982,5730,1619,5064,336,1121,638,1956,974,3077
421835,202106,221,534,144,408,31,106,53,137,84,243
421840,202106,204,644,143,505,24,92,31,98,55,190
421850,202106,364,996,208,689,51,197,52,129,103,326
421860,202106,298,812,170,550,22,76,61,177,83,253
421870,202106,4422,10971,3260,8816,483,1558,1729,4132,2212,5690
421875,202106,284,821,122,370,16,48,32,79,48,127
421880,202106,672,1876,461,1417,94,317,128,373,222,690
421885,202106,221,613,142,434,32,100,42,111,74,211
421890,202106,828,2447,618,2031,100,388,343,1065,443,1453
421895,202106,397,996,342,923,38,106,235,665,273,771
421900,202106,1025,2689,785,2198,94,302,393,991,487,1293
421910,202106,309,889,196,626,30,122,47,118,77,240
421915,202106,365,1022,212,667,45,134,41,124,86,258
421917,202106,576,1323,329,1009,111,357,87,290,198,647
421920,202106,362,1090,261,893,96,340,79,269,175,609
421930,202106,2549,6348,1371,4123,277,958,501,1305,778,2263
421935,202106,395,1204,315,1033,59,197,183,588,242,785
421940,202106,366,1054,178,566,28,96,35,90,63,186
421950,202106,3032,7525,1759,5129,344,1087,457,1167,801,2254
421960,202106,181,440,95,278,14,54,31,66,45,120
421970,202106,1864,4756,1162,3312,218,735,470,1151,688,1886
421985,202106,299,818,188,589,24,85,74,216,98,301
422000,202106,1907,4857,1556,4317,144,473,1083,2968,1227,3441
430003,202106,571,1515,377,1171,64,211,171,533,235,744
430005,202106,265,698,168,523,22,76,85,252,107,328
430010,202106,1717,4074,1369,3540,210,555,902,2293,1112,2848
430020,202106,584,1324,439,1132,44,133,294,727,338,860
430030,202106,926,2180,505,1425,118,379,161,418,279,797
430040,202106,10411,24277,6313,17239,1627,4728,928,2643,2555,7371
430045,202106,460,1148,327,905,25,79,220,595,245,674
430047,202106,233,502,95,255,22,55,26,73,48,128
430050,202106,863,2179,511,1473,104,317,132,360,236,677
430055,202106,274,662,139,385,16,60,75,178,91,238
430057,202106,79,163,30,78,8,24,7,15,15,39
430060,202106,17532,45791,13635,39703,2656,8177,6529,18767,9185,26944
430063,202106,810,2228,662,1930,131,384,355,1033,486,1417
430064,202106,1102,2935,813,2361,194,589,353,996,547,1585
430066,202106,96,194,68,152,6,14,53,114,59,128
430070,202106,728,1856,123,406,21,87,17,35,38,122
430080,202106,877,2151,536,1488,82,272,291,691,373,963
430085,202106,894,1956,534,1384,100,278,228,575,328,853
430087,202106,815,1931,681,1757,59,157,481,1228,540,1385
430090,202106,509,1343,203,653,18,76,56,160,74,236
430100,202106,848,2006,515,1389,90,281,163,378,253,659
430105,202106,1216,3134,813,2445,115,398,400,1161,515,1559
430107,202106,181,522,103,319,21,64,26,72,47,136
430110,202106,2249,5511,1677,4677,304,890,843,2308,1147,3198
430120,202106,1216,3508,815,2513,146,463,368,1110,514,1573
430130,202106,3506,7838,2571,6529,841,2191,463,1444,1304,3635
430140,202106,1000,2527,714,2014,165,436,367,1016,532,1452
430150,202106,566,1432,311,919,71,224,95,276,166,500
430155,202106,241,608,114,341,21,59,23,63,44,122
430160,202106,20359,46348,16004,40347,1738,4717,9806,24345,11544,29062
430163,202106,3183,7345,2249,5875,79,271,1690,4309,1769,4580
430165,202106,306,751,96,299,12,27,14,42,26,69
430170,202106,975,2536,341,1140,56,193,41,119,97,312
430175,202106,651,1890,553,1678,135,411,261,792,396,1203
430180,202106,652,1563,500,1306,67,158,321,854,388,1012
430185,202106,669,1667,351,1003,95,244,51,146,146,390
430187,202106,757,1608,548,1348,67,175,327,810,394,985
430190,202106,1425,3611,1138,3173,241,715,527,1414,768,2129
430192,202106,125,330,41,119,5,15,9,21,14,36
430195,202106,408,1184,58,204,4,17,5,11,9,28
430200,202106,1038,3032,833,2660,288,956,227,755,515,1711
430205,202106,453,1168,406,1084,13,46,361,937,374,983
430210,202106,6032,15344,4090,11260,678,2003,1273,2793,1951,4796
430215,202106,305,787,195,569,38,113,73,217,111,330
430220,202106,655,1614,207,674,24,87,46,119,70,206
430222,202106,190,523,144,429,18,61,51,147,69,208
430223,202106,251,644,198,556,15,36,119,327,134,363
430225,202106,16,32,10,23,0,0,7,16,7,16
430230,202106,1978,5259,1629,4719,138,447,1193,3388,1331,3835
430235,202106,369,1010,236,737,39,134,58,154,97,288
430237,202106,511,1178,382,972,17,47,291,723,308,770
430240,202106,1339,3077,758,2073,81,268,399,998,480,1266
430245,202106,716,1962,558,1667,131,408,281,856,412,1264
430250,202106,943,2248,678,1833,234,675,38,92,272,767
430258,202106,138,369,100,290,6,15,54,151,60,166
430260,202106,672,1745,468,1358,55,180,266,779,321,959
430265,202106,217,620,147,484,29,92,52,177,81,269
430270,202106,2955,7124,2337,6174,359,1033,1462,3735,1821,4768
430280,202106,5153,11863,3612,9279,676,1765,1620,4077,2296,5842
430290,202106,2247,5066,1837,4597,50,153,1581,3863,1631,4016
430300,202106,10317,25281,7780,20959,1136,3365,4238,11001,5374,14366
430310,202106,12208,29581,8321,22540,1041,3120,4141,10435,5182,13555
430320,202106,1028,2549,572,1666,54,161,337,976,391,1137
430330,202106,704,1679,422,1124,76,212,162,394,238,606
430340,202106,604,1409,397,1071,64,161,236,632,300,793
430350,202106,8067,19732,6159,16461,684,1992,3844,9764,4528,11756
430355,202106,301,794,111,356,15,50,13,33,28,83
430360,202106,848,2004,565,1514,99,299,243,611,342,910
430367,202106,315,694,181,471,29,92,105,253,134,345
430370,202106,528,1374,221,648,30,86,61,145,91,231
430380,202106,713,1719,340,1033,75,264,95,279,170,543
430390,202106,3269,7775,2018,5530,403,1246,311,634,714,1880
430400,202106,1026,2175,784,1855,68,180,457,1045,525,1225
430410,202106,544,1264,380,1002,54,139,241,633,295,772
430420,202106,2625,6904,2014,5632,438,1314,1006,2652,1444,3966
430430,202106,569,1416,264,795,60,174,57,181,117,355
430435,202106,1520,3778,1179,3232,194,577,637,1739,831,2316
430440,202106,3849,10240,3040,8877,284,927,1941,5632,2225,6559
430450,202106,6810,16592,5422,14158,1035,2905,2601,6537,3636,9442
430460,202106,34741,85636,26057,71582,4176,12627,13662,35902,17838,48529
430461,202106,231,600,75,227,14,49,29,68,43,117
430462,202106,274,734,161,507,30,99,52,159,82,258
430463,202106,6211,15867,4603,13005,877,2776,2157,5765,3034,8541
430465,202106,450,1130,357,953,60,180,224,575,284,755
430466,202106,4265,10531,3348,9071,738,2089,1600,4103,2338,6192
430467,202106,504,1183,354,958,48,157,195,477,243,634
430468,202106,1288,3125,1023,2743,73,224,721,1885,794,2109
430469,202106,532,1401,81,252,9,29,19,42,28,71
430470,202106,5610,14235,3754,10951,1065,3368,945,2603,2010,5971
430471,202106,543,1493,443,1310,66,210,264,749,330,959
430480,202106,677,1876,439,1355,59,196,104,276,163,472
430485,202106,172,438,64,189,22,60,6,21,28,81
430490,202106,369,940,205,609,25,94,108,282,133,376
430495,202106,400,1065,266,809,39,126,120,338,159,464
430500,202106,998,2523,693,2006,227,703,192,506,419,1209
430510,202106,27393,69292,19701,54810,3110,9715,9419,24152,12529,33867
430511,202106,322,917,140,446,18,58,17,54,35,112
430512,202106,990,2167,770,1844,172,417,291,709,463,1126
430513,202106,801,1957,373,1063,59,183,175,459,234,642
430515,202106,379,1053,276,843,36,106,150,452,186,558
430517,202106,1196,3491,899,2818,154,477,468,1480,622,1957
430520,202106,1297,3230,706,1979,128,381,167,427,295,808
430530,202106,986,2429,411,1219,70,205,116,334,186,539
430535,202106,3549,8978,2582,7223,351,1010,1321,3549,1672,4559
430537,202106,359,1150,328,1074,19,54,266,872,285,926
430540,202106,614,1449,334,961,64,181,156,447,220,628
430543,202106,925,1579,552,1163,60,128,222,548,282,676
430544,202106,758,2094,522,1574,125,383,168,491,293,874
430545,202106,2440,6071,1821,5152,311,898,997,2832,1308,3730
430550,202106,346,958,255,766,48,150,98,276,146,426
430558,202106,117,269,55,149,7,14,20,55,27,69
430560,202106,286,653,143,408,21,65,52,135,73,200
430570,202106,860,2076,618,1642,105,326,312,753,417,1079
430580,202106,829,2045,591,1685,153,463,243,700,396,1163
430583,202106,199,488,35,105,4,12,10,22,14,34
430585,202106,224,537,116,317,17,56,50,113,67,169
430587,202106,197,526,148,437,22,70,59,163,81,233
430590,202106,1379,3296,1140,2940,58,176,932,2351,990,2527
430593,202106,21,64,15,43,2,4,6,17,8,21
430595,202106,437,1087,129,412,12,47,19,44,31,91
430597,202106,461,1154,245,717,24,74,79,182,103,256
430600,202106,1991,5063,875,2482,131,383,212,551,343,934
430605,202106,1304,3349,949,2703,110,351,477,1303,587,1654
430607,202106,538,1234,449,1102,28,72,329,794,357,866
430610,202106,5853,13396,3927,10525,1060,3289,897,2285,1957,5574
430613,202106,284,658,84,249,11,29,24,57,35,86
430620,202106,659,1578,493,1277,73,217,294,680,367,897
430630,202106,411,1115,122,390,23,73,29,74,52,147
430632,202106,451,1153,200,587,32,89,83,235,115,324
430635,202106,559,1278,423,1052,45,121,311,763,356,884
430637,202106,460,1079,348,911,35,105,236,591,271,696
430640,202106,1093,2849,728,2107,115,338,285,761,400,1099
430642,202106,359,983,269,781,46,135,137,374,183,509
430645,202106,154,359,60,161,10,28,20,47,30,75
430650,202106,1691,4654,1342,4073,387,1168,560,1839,947,3007
430655,202106,279,689,172,483,27,84,84,207,111,291
430660,202106,5328,13273,4082,11249,848,2451,1842,4982,2690,7433
430670,202106,652,1557,501,1309,38,98,291,778,329,876
430673,202106,539,1206,234,643,35,100,90,227,125,327
430675,202106,240,692,53,190,6,19,17,61,23,80
430676,202106,5210,12610,4163,11026,508,1433,2618,6794,3126,8227
430680,202106,1063,2762,621,1849,167,510,138,382,305,892
430690,202106,2832,7515,2237,6451,764,2340,614,1701,1378,4041
430692,202106,218,665,171,586,14,44,126,446,140,490
430693,202106,934,2411,569,1702,103,364,150,411,253,775
430695,202106,413,1030,257,727,30,78,136,372,166,450
430697,202106,405,1014,318,883,68,170,163,488,231,658
430700,202106,7610,18297,4707,12965,905,2686,1205,2985,2110,5671
430705,202106,405,941,199,561,18,49,84,215,102,264
430710,202106,1688,3535,1189,2872,145,395,721,1690,866,2085
430720,202106,691,1644,370,1094,45,129,192,569,237,698
430730,202106,1004,2694,703,2122,83,255,382,1119,465,1374
430740,202106,651,1723,342,1092,61,198,90,288,151,486
430745,202106,347,928,231,685,56,187,73,185,129,372
430750,202106,1478,3643,995,2797,296,860,382,1047,678,1907
430755,202106,451,1091,291,771,23,71,162,398,185,469
430760,202106,2069,4994,1592,4271,312,920,775,1965,1087,2885
430770,202106,6466,15869,5026,13696,602,1879,3251,8533,3853,10412
430780,202106,1901,4641,1170,3401,201,664,513,1418,714,2082
430781,202106,474,1304,281,860,64,179,81,224,145,403
430783,202106,352,798,212,581,27,77,131,339,158,416
430786,202106,36,129,26,100,5,20,4,16,9,36
430790,202106,4557,10878,3215,8578,346,1086,1980,4922,2326,6008
430800,202106,767,1729,578,1453,43,111,379,947,422,1058
430805,202106,341,875,224,634,12,43,151,413,163,456
430807,202106,494,1216,272,792,35,114,119,309,154,423
430810,202106,726,1716,324,941,41,147,128,324,169,471
430820,202106,1172,3123,725,2267,127,406,227,675,354,1081
430825,202106,266,651,88,241,10,24,32,82,42,106
430830,202106,1725,4756,1399,4135,102,297,984,2868,1086,3165
430840,202106,1071,2550,728,1984,110,281,466,1296,576,1577
430843,202106,178,421,83,221,7,22,33,76,40,98
430845,202106,480,1118,318,858,50,144,148,374,198,518
430850,202106,2261,5771,1536,4399,232,726,584,1713,816,2439
430860,202106,858,1997,398,1122,49,167,185,435,234,602
430865,202106,526,1312,379,1056,100,283,113,313,213,596
430870,202106,583,1542,262,827,42,149,75,205,117,354
430880,202106,1505,3356,1027,2630,167,429,559,1396,726,1825
430885,202106,168,441,88,286,5,16,55,176,60,192
430890,202106,1010,2441,681,1893,51,211,145,377,196,588
430900,202106,3141,6770,2199,5446,174,541,1482,3436,1656,3977
430905,202106,869,2120,553,1524,98,295,235,617,333,912
430910,202106,2072,5526,1566,4495,237,780,735,1841,972,2621
430912,202106,503,1404,350,1092,31,92,218,694,249,786
430915,202106,481,1422,367,1211,133,419,94,329,227,748
430920,202106,23012,57440,17621,48627,2210,6677,10741,28924,12951,35601
430925,202106,88,200,36,111,4,12,19,56,23,68
430930,202106,10462,24356,6799,18757,1289,3534,2791,8106,4080,11640
430940,202106,939,2406,574,1652,118,354,204,527,322,881
430950,202106,810,1785,523,1308,35,114,348,797,383,911
430955,202106,389,1005,105,291,24,67,31,64,55,131
430957,202106,166,556,152,528,19,69,103,355,122,424
430960,202106,1329,3103,765,2091,147,425,335,862,482,1287
430965,202106,1596,3750,1233,3182,67,174,936,2467,1003,2641
430970,202106,359,848,192,527,26,82,96,231,122,313
430975,202106,514,1472,395,1199,74,241,208,602,282,843
430980,202106,390,875,227,609,26,81,104,250,130,331
430990,202106,537,1516,355,1102,53,172,156,482,209,654
430995,202106,553,1381,422,1171,55,160,242,652,297,812
431000,202106,1355,3191,586,1692,118,367,40,101,158,468
431010,202106,2268,5918,1521,4592,303,978,429,1171,732,2149
431020,202106,7628,16477,4573,11952,971,2922,1643,3729,2614,6651
431030,202106,359,966,173,575,33,125,22,67,55,192
431033,202106,3867,8844,2538,6788,533,1470,946,2504,1479,3974
431036,202106,338,738,71,210,8,26,23,54,31,80
431040,202106,889,2212,574,1672,65,211,290,781,355,992
431041,202106,447,1029,320,833,29,68,190,496,219,564
431043,202106,317,795,188,560,40,138,91,258,131,396
431046,202106,107,281,44,135,5,12,9,25,14,37
431050,202106,1350,3238,963,2607,180,526,440,1221,620,1747
431053,202106,658,1719,392,1168,73,243,130,333,203,576
431055,202106,586,1399,491,1247,60,134,352,894,412,1028
431057,202106,225,643,125,409,29,96,32,96,61,192
431060,202106,5654,13887,3817,10810,866,2701,1121,3035,1987,5736
431065,202106,405,992,293,807,42,124,150,407,192,531
431070,202106,419,1118,251,751,54,175,76,220,130,395
431075,202106,222,632,132,425,32,111,39,124,71,235
431080,202106,591,1591,414,1214,65,221,153,424,218,645
431085,202106,797,2033,507,1384,55,152,274,731,329,883
431087,202106,398,1094,322,943,23,72,229,677,252,749
431090,202106,401,938,158,484,28,95,42,129,70,224
431100,202106,3375,7276,2337,5942,286,730,1281,3298,1567,4028
431110,202106,1432,3250,984,2477,231,620,417,944,648,1564
431112,202106,624,1662,516,1467,49,166,354,951,403,1117
431113,202106,404,1071,338,947,58,175,186,504,244,679
431115,202106,961,2670,754,2290,79,303,474,1342,553,1645
431120,202106,2676,6851,1866,5341,481,1516,477,1256,958,2772
431123,202106,392,1045,253,747,57,151,131,407,188,558
431125,202106,971,2704,781,2338,282,832,269,852,551,1684
431127,202106,200,530,64,212,8,28,12,34,20,62
431130,202106,2961,7377,2214,6173,322,1004,1234,3349,1556,4353
431140,202106,5780,13437,3564,9327,419,1188,1613,3680,2032,4868
431142,202106,513,1329,389,1117,47,140,243,701,290,841
431150,202106,1047,2729,759,2209,139,445,339,951,478,1396
431160,202106,646,1825,426,1329,81,268,120,368,201,636
431162,202106,513,1228,308,865,33,105,163,414,196,519
431164,202106,165,373,41,125,8,25,7,22,15,47
431170,202106,448,1216,319,952,96,295,93,269,189,564
431171,202106,658,1529,538,1372,117,259,303,808,420,1067
431173,202106,395,1017,296,872,80,273,125,341,205,614
431175,202106,1316,3003,837,2203,133,348,323,811,456,1159
431177,202106,812,2135,640,1867,113,398,415,1149,528,1547
431179,202106,334,722,102,289,18,49,26,69,44,118
431180,202106,2177,5466,1363,3880,313,909,431,1174,744,2083
431190,202106,598,1507,275,790,32,91,90,217,122,308
431198,202106,389,1087,312,942,90,286,104,331,194,617
431200,202106,365,903,91,246,17,49,10,28,27,77
431205,202106,213,579,115,364,34,112,35,119,69,231
431210,202106,615,1472,497,1312,135,363,213,590,348,953
431213,202106,259,686,196,572,12,41,103,298,115,339
431215,202106,614,1458,297,860,26,82,146,390,172,472
431217,202106,157,403,110,317,15,51,59,152,74,203
431220,202106,529,1350,329,960,30,109,188,502,218,611
431225,202106,1507,3505,1161,2945,120,314,791,2001,911,2315
431230,202106,670,1871,538,1591,73,213,326,940,399,1153
431235,202106,150,383,20,70,2,4,4,19,6,23
431237,202106,332,1028,265,873,46,169,131,408,177,577
431238,202106,33,92,27,79,5,16,13,31,18,47
431240,202106,4551,10964,3621,9517,401,1219,2316,5744,2717,6963
431242,202106,253,642,220,589,41,117,130,331,171,448
431244,202106,316,753,168,466,19,71,63,144,82,215
431245,202106,1320,3018,840,2201,66,187,470,1183,536,1370
431247,202106,281,702,173,484,30,95,80,193,110,288
431250,202106,1731,4225,1274,3615,281,799,646,1974,927,2773
431260,202106,269,719,175,545,24,89,59,182,83,271
431261,202106,262,775,209,683,15,49,117,367,132,416
431262,202106,338,943,175,567,13,39,115,376,128,415
431265,202106,1609,3751,663,1903,79,267,223,548,302,815
431267,202106,250,620,164,442,7,28,119,294,126,322
431270,202106,2828,6252,1525,4077,319,855,514,1420,833,2275
431275,202106,112,319,62,203,22,67,10,36,32,103
431280,202106,237,637,77,243,5,18,12,27,17,45
431290,202106,345,991,222,693,41,129,38,96,79,225
431295,202106,69,165,20,57,3,8,4,10,7,18
431300,202106,290,758,60,184,10,26,19,51,29,77
431301,202106,299,840,66,205,9,24,6,20,15,44
431303,202106,588,1493,364,1033,24,80,166,424,190,504
431306,202106,2325,5417,1430,3946,190,573,628,1550,818,2123
431308,202106,25,76,23,72,10,34,10,31,20,65
431310,202106,549,1467,387,1119,46,129,181,487,227,616
431320,202106,636,1735,354,1134,60,180,86,248,146,428
431330,202106,1726,4027,875,2478,143,461,357,907,500,1368
431333,202106,217,559,118,342,19,52,42,105,61,157
431335,202106,37,108,21,74,5,12,0,0,5,12
431337,202106,2572,6650,1939,5623,311,1039,1127,3122,1438,4161
431339,202106,419,1074,314,890,90,264,115,317,205,581
431340,202106,18860,45227,13322,36023,1979,5904,6419,16227,8398,22131
431342,202106,423,935,310,755,28,53,250,612,278,665
431344,202106,389,984,235,696,9,30,124,359,133,389
431346,202106,235,577,95,301,17,58,22,59,39,117
431349,202106,670,1703,401,1120,85,226,157,441,242,667
431350,202106,4195,10493,3149,8736,394,1273,1767,4673,2161,5946
431360,202106,554,1305,274,766,86,244,65,185,151,429
431365,202106,2082,4757,1650,4175,119,335,1267,3167,1386,3502
431370,202106,4558,10783,3322,8806,621,1738,1716,4605,2337,6343
431380,202106,818,2160,663,1916,47,145,464,1335,511,1480
431390,202106,2640,6393,1680,4713,153,516,879,2170,1032,2686
431395,202106,1338,3206,965,2651,184,526,478,1337,662,1863
431400,202106,314,877,178,568,34,103,37,120,71,223
431402,202106,894,1951,663,1604,79,185,457,1097,536,1282
431403,202106,199,547,155,458,25,74,69,195,94,269
431405,202106,4784,12330,3728,10587,578,1831,1935,5185,2513,7016
431406,202106,539,1502,387,1173,71,205,200,627,271,832
431407,202106,462,1237,328,956,67,220,174,482,241,702
431410,202106,17545,42868,12030,33352,1626,5205,6520,16706,8146,21911
431413,202106,211,555,55,178,5,15,11,40,16,55
431415,202106,680,1627,434,1215,75,253,216,544,291,797
431417,202106,566,1242,381,949,60,178,202,482,262,660
431420,202106,1634,3596,1231,3043,153,386,731,1764,884,2150
431430,202106,563,1429,279,849,44,148,90,242,134,390
431440,202106,30072,68938,20954,54879,3338,9571,8688,21072,12026,30643
431442,202106,134,379,65,222,10,40,8,25,18,65
431445,202106,387,1081,107,342,14,39,12,32,26,71
431446,202106,252,723,186,590,29,111,89,272,118,383
431447,202106,756,1954,429,1258,86,262,138,411,224,673
431449,202106,784,2015,481,1395,90,241,179,537,269,778
431450,202106,2299,4649,1791,3936,67,158,1420,3048,1487,3206
431454,202106,38,121,31,101,8,23,10,29,18,52
431455,202106,587,1368,292,770,36,98,143,340,179,438
431460,202106,2914,6884,2034,5349,531,1459,507,1344,1038,2803
431470,202106,1415,3885,1036,3086,176,529,445,1337,621,1866
431475,202106,236,632,56,188,5,18,7,15,12,33
431477,202106,385,993,237,692,39,106,99,264,138,370
431478,202106,221,582,52,162,10,26,6,13,16,39
431480,202106,3415,8270,2744,7258,646,1706,1394,3713,2040,5419
431490,202106,108260,250333,82368,211362,5468,16692,60426,148836,65894,165528
431500,202106,489,1226,366,1000,66,192,189,490,255,682
431505,202106,255,610,174,486,12,40,124,342,136,382
431507,202106,333,777,136,395,46,146,35,91,81,237
431510,202106,1618,4063,1099,3061,265,788,366,1022,631,1810
431513,202106,213,468,118,313,8,15,76,203,84,218
431514,202106,113,288,84,237,3,10,58,154,61,164
431515,202106,463,1147,346,939,80,220,196,495,276,715
431517,202106,55,163,44,136,4,11,22,66,26,77
431520,202106,394,984,164,505,15,55,73,196,88,251
431530,202106,4670,9836,2745,6955,585,1432,867,2262,1452,3694
431531,202106,211,504,135,363,19,44,53,135,72,179
431532,202106,551,1267,339,888,66,196,150,375,216,571
431535,202106,237,619,108,333,23,78,23,59,46,137
431540,202106,1799,5662,1670,5484,52,197,1361,4492,1413,4689
431545,202106,355,896,71,210,7,22,21,58,28,80
431550,202106,2146,5314,1548,4215,243,696,778,2036,1021,2732
431555,202106,675,1514,399,1054,31,90,233,608,264,698
431560,202106,23452,55522,16053,44051,3197,9014,5596,16129,8793,25143
431570,202106,4307,10366,3617,9364,437,1244,2572,6405,3009,7649
431575,202106,283,674,228,589,72,161,94,253,166,414
431580,202106,587,1510,377,1095,42,142,204,563,246,705
431590,202106,595,1629,446,1333,87,270,174,535,261,805
431595,202106,364,979,246,731,43,124,96,264,139,388
431600,202106,1411,3263,997,2656,211,606,419,1090,630,1696
431610,202106,1415,3522,963,2711,148,390,486,1405,634,1795
431620,202106,483,1226,226,646,39,115,87,230,126,345
431630,202106,1325,3213,634,1822,97,282,245,671,342,953
431640,202106,6337,14640,5363,13414,458,1207,4102,10284,4560,11491
431642,202106,587,1397,367,973,38,97,161,400,199,497
431643,202106,383,919,181,510,16,42,53,152,69,194
431645,202106,1861,4084,1466,3565,50,157,1205,2886,1255,3043
431647,202106,300,718,94,271,9,20,26,66,35,86
431650,202106,127,342,89,282,7,24,45,128,52,152
431660,202106,883,2285,429,1332,63,235,115,300,178,535
431670,202106,1169,2742,707,1904,110,305,341,862,451,1167
431673,202106,238,607,90,305,6,23,15,39,21,62
431675,202106,414,1072,113,375,7,26,20,56,27,82
431680,202106,8027,19959,5886,16079,1292,3657,2565,6817,3857,10474
431690,202106,24766,59461,16871,45505,3152,9060,7350,19518,10502,28578
431695,202106,184,443,111,325,21,71,56,145,77,216
431697,202106,473,1096,365,932,51,124,215,562,266,686
431700,202106,1349,3408,1111,2976,181,438,649,1759,830,2197
431710,202106,13593,31486,9585,25795,1424,4125,5144,13860,6568,17985
431720,202106,6695,16162,4066,11234,949,2746,840,2095,1789,4841
431725,202106,27,75,21,65,3,10,9,24,12,34
431730,202106,4002,9297,2518,7008,552,1598,824,2464,1376,4062
431740,202106,5278,12203,3514,9310,877,2696,945,2192,1822,4888
431750,202106,7547,19205,5724,16325,1334,3982,2192,6226,3526,10208
431755,202106,318,851,79,262,14,42,9,26,23,68
431760,202106,5464,12112,3760,9427,405,1137,2354,5601,2759,6738
431770,202106,1952,4443,1513,3863,121,309,1111,2787,1232,3096
431775,202106,203,514,102,317,20,65,14,36,34,101
431780,202106,2186,5254,1431,3893,220,646,602,1592,822,2238
431790,202106,783,2072,553,1631,100,282,253,758,353,1040
431795,202106,232,588,120,364,28,77,31,92,59,169
431800,202106,8282,19311,5193,14510,1245,4159,490,1433,1735,5592
431805,202106,291,682,84,278,10,40,12,28,22,68
431810,202106,3341,7681,2098,5470,391,1060,902,2243,1293,3303
431820,202106,2123,5576,1656,4837,476,1475,578,1753,1054,3228
431830,202106,8974,19286,6634,16152,1697,4893,1588,3798,3285,8691
431840,202106,2659,6711,2136,5885,288,816,1409,3858,1697,4674
431842,202106,522,1283,181,548,25,86,73,197,98,283
431843,202106,331,856,244,685,30,88,118,317,148,405
431844,202106,201,534,70,231,15,55,21,74,36,129
431845,202106,501,1314,354,1023,36,103,208,598,244,701
431846,202106,278,707,238,649,13,38,209,571,222,609
431848,202106,145,365,77,223,10,31,16,34,26,65
431849,202106,406,980,76,218,8,21,13,26,21,47
431850,202106,4176,11039,3209,9163,713,2203,1104,3072,1817,5275
431860,202106,639,1487,348,936,53,153,203,526,256,679
431861,202106,92,253,56,173,9,28,19,59,28,87
431862,202106,455,1413,376,1277,70,260,187,610,257,870
431870,202106,21086,52114,16987,45822,1786,5497,10771,27873,12557,33370
431880,202106,3966,10015,2827,8020,400,1309,1396,3737,1796,5046
431890,202106,4612,11455,2890,8177,799,2440,500,1594,1299,4034
431900,202106,962,2362,623,1764,91,281,325,864,416,1145
431910,202106,753,1772,287,788,36,109,90,205,126,314
431912,202106,483,1282,377,1097,74,230,214,624,288,854
431915,202106,1109,2588,875,2224,29,81,684,1713,713,1794
431920,202106,1245,2817,1031,2540,35,74,874,2148,909,2222
431930,202106,675,1753,467,1365,170,471,161,492,331,963
431935,202106,85,218,61,170,15,42,14,35,29,77
431936,202106,310,866,176,537,35,112,80,221,115,333
431937,202106,141,345,90,245,11,30,41,93,52,123
431940,202106,3098,7165,1802,4831,161,465,971,2495,1132,2960
431950,202106,1879,4821,1497,4190,360,1062,646,1753,1006,2815
431960,202106,2963,7075,2224,5759,590,1628,642,1631,1232,3259
431970,202106,399,997,176,508,37,116,39,89,76,205
431971,202106,86,211,38,115,4,16,8,17,12,33
431973,202106,478,1516,390,1340,43,138,278,965,321,1103
431975,202106,108,216,21,63,2,7,5,13,7,20
431980,202106,939,2427,724,2080,144,436,347,961,491,1397
431990,202106,5738,13521,4043,11097,428,1430,2240,5916,2668,7346
432000,202106,11802,27557,8669,22753,1919,5105,3954,10408,5873,15513
432010,202106,2471,5781,1729,4558,306,844,860,2116,1166,2960
432020,202106,1769,4561,1096,3128,227,682,377,1034,604,1716
432023,202106,515,1218,265,736,34,98,117,293,151,391
432026,202106,942,2586,693,2106,183,539,205,640,388,1179
432030,202106,373,914,223,618,16,49,127,337,143,386
432032,202106,335,837,230,626,24,71,132,326,156,397
432035,202106,654,1814,568,1668,169,463,252,790,421,1253
432040,202106,1064,2486,412,1255,54,182,166,456,220,638
432045,202106,153,435,100,324,20,62,37,123,57,185
432050,202106,550,1331,409,1093,76,213,182,492,258,705
432055,202106,566,1509,375,1159,128,403,67,192,195,595
432057,202106,185,501,146,397,12,29,70,180,82,209
432060,202106,428,1017,133,410,31,103,37,106,68,209
432065,202106,201,554,144,435,34,108,54,165,88,273
432067,202106,723,2044,614,1801,59,198,463,1306,522,1504
432070,202106,1696,4258,1155,3239,207,659,477,1205,684,1864
432080,202106,4893,11184,3722,9410,577,1703,1785,4285,2362,5988
432085,202106,371,972,267,811,59,190,124,378,183,568
432090,202106,2110,5133,1252,3506,216,642,581,1523,797,2165
432100,202106,982,2411,485,1440,103,316,86,213,189,529
432110,202106,2052,5302,1425,4199,330,1075,170,454,500,1529
432120,202106,2972,7793,2343,6770,396,1283,1091,2984,1487,4267
432130,202106,2624,6471,2185,5828,638,1726,937,2544,1575,4270
432132,202106,178,511,109,358,21,70,53,152,74,222
432135,202106,974,2276,651,1732,40,124,473,1243,513,1367
432140,202106,1630,4752,1243,3978,174,597,771,2440,945,3037
432143,202106,1377,3569,1052,3073,60,196,701,2030,761,2226
432145,202106,1729,4492,1102,3204,162,499,356,884,518,1383
432146,202106,103,291,74,245,25,93,24,69,49,162
432147,202106,469,1270,287,899,95,308,72,207,167,515
432149,202106,447,1071,230,641,25,72,102,250,127,322
432150,202106,3282,8075,2437,6621,469,1366,1084,2867,1553,4233
432160,202106,5179,13196,3785,10991,835,2751,1335,3695,2170,6446
432162,202106,228,487,35,95,6,19,10,20,16,39
432163,202106,110,268,22,61,0,0,3,4,3,4
432166,202106,648,1764,514,1496,100,334,191,486,291,820
432170,202106,1532,4058,1058,3187,192,639,443,1254,635,1893
432180,202106,3120,7269,1708,4648,297,847,678,1611,975,2458
432183,202106,354,1017,249,782,57,201,78,222,135,423
432185,202106,825,2105,479,1431,40,130,238,669,278,799
432190,202106,1979,4688,1369,3735,161,507,818,2097,979,2604
432195,202106,839,2104,568,1611,135,353,219,647,354,1000
432200,202106,3457,8486,2512,7010,354,1029,1487,4133,1841,5162
432210,202106,400,1041,252,753,47,164,117,300,164,464
432215,202106,607,1765,554,1685,48,118,418,1301,466,1419
432218,202106,249,606,117,326,13,42,54,127,67,169
432220,202106,3584,8290,2616,6757,507,1306,1283,3318,1790,4624
432225,202106,96,264,73,220,10,28,45,139,55,167
432230,202106,736,1718,394,1088,41,114,178,439,219,553
432232,202106,474,1161,300,868,63,189,103,268,166,457
432234,202106,258,644,116,341,18,50,18,48,36,98
432235,202106,44,125,18,57,5,17,4,13,9,30
432237,202106,308,793,274,738,12,23,227,603,239,626
432240,202106,16237,39009,11892,33242,908,2506,7679,22453,8587,24959
432250,202106,5484,15280,4076,12504,1029,3273,1706,5220,2735,8493
432252,202106,420,999,273,734,32,90,145,364,177,454
432253,202106,868,2575,583,1858,139,470,53,151,192,621
432254,202106,699,1620,205,595,33,84,43,120,76,204
432255,202106,99,248,56,164,4,13,27,72,31,85
432260,202106,4950,12445,3694,10106,1005,2818,1329,3494,2334,6312
432270,202106,1922,5142,1560,4459,477,1477,409,1103,886,2580
432280,202106,1446,3530,767,2219,99,316,280,665,379,981
432285,202106,142,427,22,67,2,6,3,7,5,13
432290,202106,334,910,188,574,60,189,35,79,95,268
432300,202106,26549,65520,19991,55078,2620,8195,12068,31883,14688,40078
432310,202106,844,2213,610,1788,63,193,410,1199,473,1392
432320,202106,201,463,81,244,8,28,29,79,37,107
432330,202106,227,504,71,225,9,20,12,41,21,61
432335,202106,159,446,60,205,7,26,14,43,21,69
432340,202106,309,753,140,441,12,41,45,129,57,170
432345,202106,737,1607,633,1486,13,34,535,1238,548,1272
432350,202106,338,852,181,552,31,91,67,213,98,304
432360,202106,233,689,45,153,3,6,15,51,18,57
432370,202106,296,724,201,565,16,54,139,380,155,434
432375,202106,477,1173,359,945,81,210,163,427,244,637
432377,202106,170,534,35,125,4,17,5,10,9,27
432380,202106,1820,4786,1257,3780,183,592,669,1971,852,2563
500020,202106,2703,6857,2034,5762,206,661,1267,3491,1473,4152
500025,202106,1190,2903,755,2089,79,217,399,1071,478,1288
500060,202106,8136,22623,5578,17317,674,2194,3264,10316,3938,12510
500070,202106,4412,11061,3140,8911,571,1654,1409,4052,1980,5706
500080,202106,1662,3988,1022,2832,188,595,401,967,589,1562
500085,202106,2009,4961,1413,3949,354,1027,628,1671,982,2698
500090,202106,2195,5687,1491,4468,221,701,482,1555,703,2256
500100,202106,3666,9227,2798,7826,415,1304,1448,3803,1863,5107
500110,202106,8359,20902,5506,16489,1080,3554,1715,6006,2795,9560
500124,202106,2112,6001,1679,5294,290,824,875,2925,1165,3749
500150,202106,1368,3025,874,2320,131,374,367,934,498,1308
500190,202106,5028,12919,3224,9417,624,1830,858,2393,1482,4223
500200,202106,2583,5984,1815,4702,172,448,1108,2779,1280,3227
500210,202106,4755,11078,3377,9267,957,2534,1457,4148,2414,6682
500215,202106,1419,3835,1038,3155,100,339,591,1779,691,2118
500220,202106,2889,7844,1957,6117,313,1001,657,1996,970,2997
500230,202106,2037,4664,1556,4000,182,450,1056,2681,1238,3131
500240,202106,4095,11813,2925,9399,433,1474,1239,4069,1672,5543
500260,202106,3378,7112,2192,5530,289,733,1212,2933,1501,3666
500270,202106,140040,324750,86218,235285,13245,39854,33940,86031,47185,125885
500280,202106,1428,3519,962,2807,173,516,439,1280,612,1796
500290,202106,3749,8971,2236,6322,333,1076,730,1793,1063,2869
500295,202106,3663,8702,2355,6415,399,1183,936,2217,1335,3400
500310,202106,1003,2043,691,1657,94,207,369,905,463,1112
500315,202106,3910,10498,3148,9371,244,734,2292,6951,2536,7685
500320,202106,19930,52310,13817,42315,3521,11096,4524,15054,8045,26150
500325,202106,4913,10790,3409,8753,329,822,2186,5678,2515,6500
500330,202106,6766,15132,4474,11852,361,1012,2362,6509,2723,7521
500345,202106,2074,5036,1384,3951,307,927,482,1347,789,2274
500348,202106,2396,6106,1797,5078,230,700,1053,2995,1283,3695
500350,202106,1336,3595,750,2333,85,259,300,900,385,1159
500370,202106,27610,69485,19888,57073,2363,7786,10794,30392,13157,38178
500375,202106,2520,6522,1698,4865,263,823,587,1525,850,2348
500380,202106,3422,8469,2382,6705,678,2057,446,1287,1124,3344
500390,202106,643,1337,391,1025,53,158,234,596,287,754
500400,202106,1588,3977,1046,2946,170,524,353,908,523,1432
500410,202106,2445,5870,1725,4811,179,463,989,2896,1168,3359
500430,202106,2678,6500,1851,5292,257,822,783,2380,1040,3202
500440,202106,1233,2951,776,2254,121,378,279,863,400,1241
500450,202106,1549,3770,911,2628,140,444,250,649,390,1093
500460,202106,3565,9427,2175,6704,339,1191,671,2016,1010,3207
500470,202106,2477,6558,1538,4656,416,1389,316,836,732,2225
500480,202106,2107,6391,1786,5902,162,516,1331,4483,1493,4999
500490,202106,1096,2492,651,1818,117,395,177,501,294,896
500500,202106,4305,11196,2782,8739,806,2971,304,982,1110,3953
500510,202106,723,1799,476,1347,38,106,293,813,331,919
500515,202106,1720,4393,1332,3771,172,530,769,2059,941,2589
500520,202106,3352,9781,2606,8462,661,2106,1055,3778,1716,5884
500525,202106,953,2710,757,2424,63,221,497,1581,560,1802
500540,202106,4583,11792,2727,8472,640,2542,237,662,877,3204
500560,202106,5579,14875,4504,13537,290,849,3665,11228,3955,12077
500568,202106,4401,9516,2709,7045,706,1824,878,2385,1584,4209
500570,202106,8039,18399,5121,13572,824,2383,2147,5294,2971,7677
500580,202106,3101,8061,2275,6615,547,1616,959,2822,1506,4438
500600,202106,3450,8517,2473,6967,548,1605,1016,2924,1564,4529
500620,202106,8142,20916,5510,15963,1031,3116,2247,6216,3278,9332
500625,202106,542,1451,354,1073,62,192,88,245,150,437
500627,202106,779,1973,479,1456,91,296,134,378,225,674
500630,202106,7341,16368,4136,11134,816,2388,1182,3145,1998,5533
500635,202106,3006,9241,2298,8310,155,566,1584,6331,1739,6897
500640,202106,1729,3745,1161,2996,41,124,796,2026,837,2150
500660,202106,18823,46789,12957,38366,3805,12892,3381,10258,7186,23150
500690,202106,2475,6646,1571,5085,517,1979,108,281,625,2260
500710,202106,2918,7639,2250,6516,586,1817,727,1954,1313,3771
500720,202106,4980,12389,3301,9591,752,2310,1027,3081,1779,5391
500730,202106,1116,2723,613,1805,116,329,139,430,255,759
500740,202106,4698,11083,3184,8723,424,1209,1570,4205,1994,5414
500750,202106,1020,2555,712,2031,87,224,291,794,378,1018
500755,202106,946,2407,538,1646,99,335,115,319,214,654
500769,202106,5320,12896,3028,8622,554,1692,444,1134,998,2826
500770,202106,1419,3787,945,2973,164,580,307,946,471,1526
500780,202106,1202,2858,774,2159,149,487,212,524,361,1011
500790,202106,6754,17882,5201,15262,1062,3364,2455,7223,3517,10587
500793,202106,2053,5130,1479,4165,350,1058,498,1286,848,2344
500795,202106,2714,6634,2179,5959,122,294,1709,4948,1831,5242
500797,202106,774,1947,502,1462,145,426,145,443,290,869
500800,202106,3370,7483,2080,5588,611,1957,266,785,877,2742
500830,202106,18394,45175,12698,34914,2636,7681,4490,11669,7126,19350
500840,202106,1429,3437,914,2463,128,340,373,945,501,1285
510010,202106,1853,4121,1272,3396,110,232,918,2488,1028,2720
510020,202106,4005,9874,2119,6190,380,1207,560,1424,940,2631
510025,202106,6703,15954,4160,11947,583,1814,1867,5165,2450,6979
510030,202106,2920,6305,1959,4913,336,831,927,2259,1263,3090
510035,202106,1249,3231,803,2531,114,376,437,1484,551,1860
510040,202106,2434,5330,1808,4524,193,445,1123,2959,1316,3404
510050,202106,2211,4509,1489,3608,202,504,984,2377,1186,2881
510060,202106,1366,3370,861,2470,168,531,212,551,380,1082
510080,202106,1361,3463,906,2743,201,627,397,1138,598,1765
510100,202106,671,1537,480,1240,59,153,273,682,332,835
510120,202106,277,497,157,356,10,20,117,265,127,285
510125,202106,2043,5051,1609,4413,150,540,904,2326,1054,2866
510130,202106,1561,3857,1080,3094,221,672,361,1060,582,1732
510140,202106,3105,7813,2092,6540,772,2725,712,2223,1484,4948
510160,202106,1729,4440,1282,3860,147,414,939,2909,1086,3323
510170,202106,4805,12394,3575,10395,828,2505,1470,4261,2298,6766
510180,202106,14984,33024,9802,25670,2027,5833,3226,9373,5253,15206
510185,202106,1777,4534,1139,3622,456,1486,245,1046,701,2532
510190,202106,2054,5777,1309,4539,347,1331,232,882,579,2213
510250,202106,17550,43384,13010,36608,2418,7100,6437,18768,8855,25868
510260,202106,1835,7774,1530,7251,244,1257,953,4910,1197,6167
510263,202106,3209,8907,1983,6370,329,1148,384,1069,713,2217
510267,202106,5307,14887,3022,9781,496,1738,437,1227,933,2965
510268,202106,1244,3058,954,2606,111,291,602,1626,713,1917
510269,202106,1014,2702,621,1953,141,490,203,591,344,1081
510270,202106,3063,8521,2098,6821,335,1241,846,2741,1181,3982
510279,202106,1789,4549,1081,3325,173,590,420,1202,593,1792
510285,202106,1129,2929,754,2282,222,765,183,490,405,1255
510300,202106,3736,9269,2766,7978,404,1174,1619,4936,2023,6110
510305,202106,1427,3904,891,2873,175,597,207,762,382,1359
510310,202106,941,2284,646,1800,179,508,188,541,367,1049
510320,202106,3668,8925,2539,7043,532,1650,550,1501,1082,3151
510325,202106,4267,12426,3137,10347,873,3081,871,2939,1744,6020
510330,202106,2611,7783,1757,6288,310,1122,634,2661,944,3783
510335,202106,4925,13955,3736,12067,550,1872,2064,6807,2614,8679
510336,202106,439,1226,319,1042,47,151,166,608,213,759
510337,202106,1444,4115,918,3183,346,1319,191,674,537,1993
510340,202106,94087,207112,61603,160924,14267,43255,19359,48192,33626,91447
510343,202106,1114,2911,730,2223,117,405,323,932,440,1337
510345,202106,1276,3590,958,2956,152,465,428,1308,580,1773
510350,202106,2991,7527,2036,5946,416,1237,927,2713,1343,3950
510360,202106,2026,4049,1265,3165,74,119,879,2401,953,2520
510370,202106,1739,4841,1292,4127,178,620,760,2530,938,3150
510380,202106,564,1361,322,959,50,175,135,400,185,575
510385,202106,1216,4020,911,3457,85,374,603,2369,688,2743
510390,202106,1308,3352,876,2833,274,875,271,1080,545,1955
510395,202106,732,1604,500,1266,26,64,324,867,350,931
510410,202106,4795,12951,3508,10758,662,2100,1757,5683,2419,7783
510420,202106,2541,5191,1711,4099,109,255,1156,2781,1265,3036
510450,202106,426,1057,263,755,69,204,36,120,105,324
510452,202106,824,2287,611,1897,73,234,369,1115,442,1349
510454,202106,979,2663,758,2287,83,237,478,1515,561,1752
510455,202106,953,2565,681,2041,111,360,293,815,404,1175
510460,202106,1815,4502,1333,3784,126,410,827,2270,953,2680
510480,202106,4922,11555,3340,8760,587,1699,1351,3360,1938,5059
510490,202106,1714,4351,1280,3810,241,699,762,2305,1003,3004
510500,202106,1556,3796,957,2859,188,611,302,893,490,1504
510510,202106,3623,10191,2638,8480,620,2241,872,2934,1492,5175
510515,202106,5221,13118,3461,10033,749,2465,1045,2672,1794,5137
510517,202106,1082,3022,808,2561,250,897,153,430,403,1327
510520,202106,2254,4499,1267,3263,106,282,600,1679,706,1961
510523,202106,1287,2981,901,2401,158,427,551,1486,709,1913
510525,202106,7587,20358,5632,16572,845,2656,2701,7538,3546,10194
510530,202106,556,1420,411,1207,27,90,271,786,298,876
510550,202106,2279,6676,1667,5627,340,1212,784,2662,1124,3874
510558,202106,2371,6244,1729,5250,227,636,804,2705,1031,3341
510560,202106,1519,4309,933,3172,176,649,218,795,394,1444
510562,202106,5804,14397,4242,11750,972,2891,1460,4320,2432,7211
510590,202106,3010,7433,2216,6394,152,436,1620,4814,1772,5250
510600,202106,1422,3145,946,2458,153,395,475,1211,628,1606
510610,202106,2576,6131,1752,5072,189,605,1091,3156,1280,3761
510615,202106,2714,6611,1905,5341,286,862,1096,3101,1382,3963
510617,202106,1017,3061,799,2715,80,312,555,1940,635,2252
510618,202106,1214,3184,866,2615,195,644,389,1133,584,1777
510619,202106,806,2003,490,1445,72,204,101,268,173,472
510620,202106,1455,3250,678,1979,170,597,33,68,203,665
510621,202106,1578,4143,951,2955,208,716,275,756,483,1472
510622,202106,4812,13161,3289,10013,1047,3467,445,1248,1492,4715
510623,202106,2733,6736,1993,5571,462,1439,664,1850,1126,3289
510624,202106,1625,4133,804,2607,98,363,179,511,277,874
510625,202106,3085,7382,1711,4970,285,938,402,1186,687,2124
510626,202106,1437,3484,907,2646,231,773,200,607,431,1380
510627,202106,633,1608,350,1070,81,277,91,287,172,564
510628,202106,1472,3354,985,2726,222,646,369,1007,591,1653
510629,202106,1608,4483,1157,3666,214,733,402,1290,616,2023
510630,202106,3456,9377,2038,6707,460,1623,369,1346,829,2969
510631,202106,577,1366,420,1135,14,32,317,886,331,918
510637,202106,3752,8714,2656,7125,623,1854,818,2227,1441,4081
510642,202106,5432,15173,4141,13242,924,3282,1923,6164,2847,9446
510645,202106,1023,1976,627,1492,186,402,259,656,445,1058
510650,202106,7165,17969,5668,16324,653,1676,3788,12273,4441,13949
510665,202106,1841,3943,1172,2895,258,595,421,1145,679,1740
510670,202106,432,914,248,651,30,83,132,350,162,433
510675,202106,6328,17125,4372,13556,1186,4051,848,2511,2034,6562
510677,202106,2167,5449,1489,4453,205,714,809,2369,1014,3083
510680,202106,699,1763,397,1202,69,235,100,248,169,483
510682,202106,1498,4278,1106,3646,379,1414,280,846,659,2260
510685,202106,486,1390,346,1114,51,169,180,578,231,747
510700,202106,4055,9518,2829,7856,250,756,2132,5913,2382,6669
510704,202106,10982,25562,7363,19471,1699,4816,1820,4680,3519,9496
510706,202106,2129,6220,1478,5142,297,1067,749,2823,1046,3890
510710,202106,2712,6647,1777,4891,391,1136,577,1525,968,2661
510715,202106,615,1294,440,1065,28,71,250,589,278,660
510718,202106,2359,5325,1405,4042,345,980,547,1886,892,2866
510719,202106,458,955,271,708,27,80,157,384,184,464
510720,202106,847,1963,575,1560,107,321,266,692,373,1013
510724,202106,842,2259,582,1770,80,261,304,885,384,1146
510726,202106,1060,1928,576,1340,70,170,284,664,354,834
510729,202106,620,1436,289,826,35,113,74,226,109,339
510730,202106,2973,7052,2029,5630,241,778,1066,2841,1307,3619
510735,202106,1083,2996,831,2655,65,238,629,1997,694,2235
510740,202106,1008,2464,654,1816,109,306,321,870,430,1176
510757,202106,478,1524,376,1367,110,451,145,491,255,942
510760,202106,44359,96047,26813,69604,5434,16167,8483,20180,13917,36347
510770,202106,4283,9532,2938,7839,193,466,2050,5730,2243,6196
510774,202106,342,851,240,696,36,108,123,369,159,477
510775,202106,642,1668,402,1276,93,320,76,225,169,545
510776,202106,544,1319,385,1048,73,207,156,417,229,624
510777,202106,1556,4073,1120,3512,138,442,758,2390,896,2832
510779,202106,724,1905,566,1659,55,150,341,1076,396,1226
510780,202106,3812,9652,2831,8244,679,1925,1209,3987,1888,5912
510785,202106,1984,5090,1162,3632,322,1068,179,662,501,1730
510787,202106,2708,7581,1831,5803,528,1743,212,692,740,2435
510788,202106,598,1376,413,1099,65,175,193,589,258,764
510790,202106,18465,46370,11816,34618,2767,8997,1915,5090,4682,14087
510792,202106,9427,25647,5909,18865,1204,4288,982,2856,2186,7144
510794,202106,1191,3197,844,2615,291,984,155,424,446,1408
510795,202106,8755,22411,5842,17265,1250,4073,1604,4624,2854,8697
510800,202106,1633,4115,1073,3197,320,972,135,383,455,1355
510805,202106,1523,4160,1083,3372,224,767,419,1211,643,1978
510810,202106,615,1230,393,936,110,261,144,375,254,636
510820,202106,781,1454,440,1030,29,83,239,566,268,649
510830,202106,884,2071,670,1803,30,63,524,1487,554,1550
510835,202106,561,1339,377,1080,45,147,236,650,281,797
510840,202106,58461,121933,40071,99582,7753,18052,19748,53966,27501,72018
510850,202106,1826,4352,1093,3210,332,1120,177,459,509,1579
510860,202106,2362,6055,1480,4599,454,1701,148,433,602,2134
510880,202106,750,2079,570,1755,138,454,197,604,335,1058
510885,202106,657,1534,428,1202,81,231,131,381,212,612
510890,202106,714,2035,536,1725,134,469,233,738,367,1207
510895,202106,1316,3322,866,2583,154,549,388,1085,542,1634
520005,202106,2933,7340,2260,6492,656,1901,874,2975,1530,4876
520010,202106,2407,6669,1739,5383,397,1366,584,1624,981,2990
520013,202106,3140,7765,2062,5840,477,1366,578,1800,1055,3166
520015,202106,514,1261,376,1063,88,243,150,453,238,696
520017,202106,1228,3036,907,2556,224,654,387,1067,611,1721
520020,202106,435,963,331,842,25,78,265,658,290,736
520025,202106,33718,92496,28826,85726,2953,9246,20556,61127,23509,70373
520030,202106,5748,14241,4639,12723,291,856,3400,9276,3691,10132
520050,202106,408,951,245,659,17,45,154,431,171,476
520055,202106,1860,4394,1217,3184,153,333,657,1734,810,2067
520060,202106,1458,3840,1083,3184,247,854,299,847,546,1701
520080,202106,1820,4691,1387,4100,245,738,672,2186,917,2924
520082,202106,945,2353,725,1995,75,214,383,1089,458,1303
520085,202106,915,2313,708,1995,124,371,347,967,471,1338
520090,202106,882,1727,617,1438,83,145,440,1089,523,1234
520110,202106,37873,100276,26270,81001,7467,26304,2576,7263,10043,33567
520120,202106,201,480,116,339,11,34,48,142,59,176
520130,202106,3943,9325,3076,8000,622,1668,1311,3450,1933,5118
520140,202106,41502,108541,28558,86498,9822,32341,3559,11281,13381,43622
520145,202106,617,1383,422,1115,75,219,238,580,313,799
520150,202106,646,1482,476,1276,74,210,250,674,324,884
520160,202106,798,1820,570,1454,111,267,218,609,329,876
520170,202106,4839,9708,3216,7869,180,526,2471,5993,2651,6519
520180,202106,2413,6374,1963,5723,331,1065,1067,3056,1398,4121
520215,202106,1747,4124,1242,3364,281,801,443,1151,724,1952
520235,202106,695,1535,440,1160,44,131,225,583,269,714
520250,202106,1534,3834,1094,3122,324,996,262,847,586,1843
520260,202106,833,1890,533,1428,99,255,206,565,305,820
520280,202106,804,1865,630,1604,116,287,318,861,434,1148
520310,202106,1007,2153,657,1634,143,400,250,658,393,1058
520320,202106,1737,4578,1316,3892,162,481,749,2226,911,2707
520330,202106,4546,11700,3395,9824,492,1624,1745,4928,2237,6552
520340,202106,2527,5451,1566,4139,171,412,923,2559,1094,2971
520350,202106,2754,6494,1969,5344,554,1597,786,2165,1340,3762
520355,202106,1910,5139,1366,4078,449,1422,208,524,657,1946
520357,202106,746,1750,543,1456,38,85,394,1100,432,1185
520360,202106,704,1805,540,1540,138,417,170,502,308,919
520380,202106,1436,3539,870,2518,113,332,387,1056,500,1388
520390,202106,1058,2309,628,1766,187,576,192,583,379,1159
520393,202106,569,1304,376,1006,57,154,161,418,218,572
520396,202106,875,2191,734,1980,38,113,545,1449,583,1562
520400,202106,1626,3906,1251,3400,133,405,884,2380,1017,2785
520410,202106,2126,4564,1392,3473,178,482,733,1720,911,2202
520420,202106,381,864,302,744,21,54,242,570,263,624
520425,202106,1522,3676,837,2371,223,681,150,419,373,1100
520430,202106,2336,5249,1348,3732,232,763,58,158,290,921
520440,202106,2900,6928,1746,4914,411,1270,433,1155,844,2425
520450,202106,12081,28141,8208,22433,2518,7628,1769,5019,4287,12647
520455,202106,711,1933,513,1623,143,469,135,464,278,933
520460,202106,1049,2389,823,2104,76,167,655,1714,731,1881
520465,202106,801,2005,659,1817,63,207,498,1332,561,1539
520470,202106,2106,5263,1598,4592,465,1413,614,1901,1079,3314
520480,202106,892,2417,623,1969,188,615,155,481,343,1096
520485,202106,1557,4416,1286,4040,161,500,895,2812,1056,3312
520490,202106,4029,10872,3023,9283,914,2939,1208,3820,2122,6759
520495,202106,1600,3480,1215,2960,64,158,969,2370,1033,2528
520500,202106,1323,3427,926,2692,184,578,427,1229,611,1807
520505,202106,784,1697,546,1402,60,154,363,934,423,1088
520510,202106,7450,18257,5042,14599,1048,3416,1605,4844,2653,8260
520520,202106,1195,2917,893,2452,200,602,343,934,543,1536
520530,202106,2171,5929,1666,5082,377,1243,781,2434,1158,3677
520540,202106,2983,7677,1952,5695,348,1106,552,1509,900,2615
520545,202106,1061,2676,821,2283,182,461,347,1008,529,1469
520547,202106,904,2367,736,2095,155,455,383,1070,538,1525
520549,202106,14314,37069,11975,33797,1429,4238,8292,23177,9721,27415
520551,202106,4587,12085,3804,10936,396,1298,2707,7634,3103,8932
520552,202106,830,2101,681,1909,147,387,374,1138,521,1525
520570,202106,546,1214,358,925,83,176,127,380,210,556
520580,202106,2221,4963,1680,4331,148,399,1189,3061,1337,3460
520590,202106,1267,3095,872,2454,247,710,259,735,506,1445
520620,202106,8042,21290,6348,18799,1455,4472,3041,9223,4496,13695
520630,202106,767,1940,553,1570,78,243,229,630,307,873
520640,202106,2420,5822,1839,4836,412,1073,793,2170,1205,3243
520650,202106,1004,2193,711,1785,116,297,371,989,487,1286
520660,202106,551,1332,299,882,45,144,86,266,131,410
520670,202106,941,2516,792,2308,62,190,534,1533,596,1723
520680,202106,697,1738,532,1478,88,244,282,800,370,1044
520690,202106,307,710,211,565,64,159,61,182,125,341
520710,202106,411,995,297,811,18,46,196,522,214,568
520725,202106,1472,3443,1011,2688,114,354,638,1643,752,1997
520735,202106,766,1869,504,1431,103,269,203,618,306,887
520740,202106,2314,5029,1770,4395,346,784,957,2644,1303,3428
520750,202106,677,1605,471,1279,77,218,216,575,293,793
520753,202106,1247,3369,943,2783,165,512,374,1033,539,1545
520760,202106,1231,2736,1082,2559,29,53,987,2374,1016,2427
520780,202106,1511,3499,1087,2909,117,297,563,1515,680,1812
520790,202106,3509,8208,2466,6537,352,948,1301,3597,1653,4545
520800,202106,16616,42143,13005,36864,1772,5168,7881,22917,9653,28085
520810,202106,1303,2702,987,2345,145,339,649,1652,794,1991
520815,202106,556,1676,420,1392,80,271,116,400,196,671
520830,202106,1899,3983,1345,3348,75,158,1081,2677,1156,2835
520840,202106,2725,7179,2219,6516,859,2790,597,1850,1456,4640
520850,202106,686,1672,505,1410,148,485,156,436,304,921
520860,202106,6967,18354,5117,15285,1303,4224,1902,5533,3205,9757
520870,202106,112395,257657,76359,203429,15690,45015,28288,73770,43978,118785
520880,202106,7049,19916,5426,16991,1152,3788,2011,6295,3163,10083
520890,202106,4138,9641,2871,7692,482,1430,1349,3517,1831,4947
520910,202106,4675,11538,2998,8685,681,2165,740,2065,1421,4230
520915,202106,719,1976,437,1355,85,276,141,415,226,691
520920,202106,4524,9951,3203,8325,442,1172,1630,4510,2072,5682
520929,202106,689,1606,528,1381,52,114,300,841,352,955
520940,202106,968,2520,758,2224,51,115,575,1692,626,1807
520945,202106,519,1115,381,936,14,34,260,628,274,662
520960,202106,1096,2554,861,2211,256,598,382,1056,638,1654
520970,202106,2592,6907,2030,6014,428,1459,544,1742,972,3201
520980,202106,774,1858,569,1585,99,282,236,642,335,924
520990,202106,3022,7864,2427,7113,334,919,1623,4854,1957,5773
520993,202106,1162,2696,801,2129,136,401,424,1089,560,1490
520995,202106,2358,5895,1764,5053,264,772,699,2102,963,2874
521000,202106,8825,22808,5805,17262,1083,3333,1677,4907,2760,8240
521010,202106,3600,9260,2697,7690,264,750,1575,4472,1839,5222
521015,202106,788,1941,551,1522,41,138,348,912,389,1050
521020,202106,3458,8600,2046,5911,554,1798,178,547,732,2345
521030,202106,518,1129,355,884,61,134,171,453,232,587
521040,202106,7565,18235,5589,15151,1212,3411,2250,6320,3462,9731
521056,202106,931,2409,724,2106,238,669,197,657,435,1326
521060,202106,978,2594,719,2100,135,416,271,783,406,1199
521080,202106,1116,2367,579,1545,84,247,250,591,334,838
521090,202106,3174,8376,2118,6280,520,1689,255,791,775,2480
521100,202106,1779,4047,1325,3407,226,553,807,2122,1033,2675
521120,202106,4648,10964,3448,9467,187,477,1690,5440,1877,5917
521130,202106,1007,2224,576,1502,19,51,293,819,312,870
521140,202106,1376,3485,1022,2860,99,281,554,1550,653,1831
521150,202106,12446,26932,7791,20311,1336,3996,3618,9693,4954,13689
521160,202106,653,1333,461,1066,75,142,278,648,353,790
521170,202106,1054,2442,776,2026,62,172,493,1247,555,1419
521180,202106,7584,20426,6234,18130,1030,3209,3229,9151,4259,12360
521190,202106,10924,26618,6471,19312,1585,5047,1336,4233,2921,9280
521200,202106,707,1670,497,1343,46,128,313,840,359,968
521205,202106,642,1550,489,1308,18,51,382,985,400,1036
521210,202106,676,1725,397,1168,73,227,91,212,164,439
521220,202106,3618,8578,2387,6695,367,1140,1024,2867,1391,4007
521225,202106,398,833,288,710,60,139,165,420,225,559
521230,202106,1357,3372,1191,3172,353,942,596,1734,949,2676
521250,202106,31314,81076,24455,71150,8689,26127,7258,22922,15947,49049
521260,202106,538,1236,400,1024,62,160,229,577,291,737
521270,202106,1822,4457,1591,4189,83,188,1240,3284,1323,3472
521280,202106,1782,4729,1336,3988,307,990,560,1694,867,2684
521290,202106,503,1138,355,953,42,128,226,590,268,718
521295,202106,1125,2430,887,2176,71,127,742,1878,813,2005
521300,202106,1916,4650,1503,4065,284,716,899,2541,1183,3257
521305,202106,726,1676,523,1390,83,203,302,821,385,1024
521308,202106,4816,12577,3353,9876,303,889,1989,5738,2292,6627
521310,202106,8505,21457,6030,17292,1161,3679,2694,7378,3855,11057
521340,202106,412,948,297,778,22,61,202,526,224,587
521350,202106,2038,5071,1560,4368,136,437,1110,3018,1246,3455
521370,202106,1225,3072,744,2261,213,743,91,312,304,1055
521375,202106,1288,3098,872,2478,189,539,258,831,447,1370
521377,202106,1546,3218,1142,2725,121,199,886,2261,1007,2460
521380,202106,6310,16414,4085,12339,435,1416,1058,3431,1493,4847
521385,202106,663,1578,521,1400,49,123,300,869,349,992
521390,202106,719,1752,503,1432,150,478,163,494,313,972
521400,202106,2754,6256,2194,5592,240,570,1527,4007,1767,4577
521405,202106,1356,3430,978,2772,151,447,512,1428,663,1875
521410,202106,776,2063,578,1721,93,267,289,911,382,1178
521440,202106,1150,2796,839,2336,273,846,243,680,516,1526
521450,202106,3955,11527,2870,9409,765,2482,642,2336,1407,4818
521460,202106,5592,14302,3947,11430,1174,3559,1061,3128,2235,6687
521470,202106,698,1803,449,1327,64,176,170,508,234,684
521480,202106,388,960,240,692,56,148,74,216,130,364
521483,202106,2363,5528,1647,4469,332,946,699,1899,1031,2845
521486,202106,1803,4271,1364,3659,91,212,960,2611,1051,2823
521487,202106,408,966,290,807,44,117,159,460,203,577
521490,202106,919,2398,693,2030,38,135,483,1370,521,1505
521500,202106,2227,5357,1672,4540,100,330,1205,3186,1305,3516
521520,202106,721,1656,516,1365,80,208,221,599,301,807
521523,202106,12145,35977,9969,32556,2650,9386,2838,9511,5488,18897
521525,202106,1077,2409,819,2062,74,194,586,1466,660,1660
521530,202106,2308,5844,1421,4092,295,857,395,1123,690,1980
521540,202106,834,2072,576,1661,78,246,270,813,348,1059
521550,202106,1627,4073,906,2630,166,545,216,640,382,1185
521560,202106,4575,11617,3124,9659,583,1891,1455,4912,2038,6803
521565,202106,667,1568,502,1330,78,190,295,780,373,970
521570,202106,3394,9227,2332,7162,452,1651,159,523,611,2174
521580,202106,499,1196,296,847,42,130,102,269,144,399
521590,202106,661,1508,486,1266,75,211,295,750,370,961
521600,202106,434,1127,285,844,32,77,132,393,164,470
521630,202106,1696,3642,1060,2743,221,616,352,883,573,1499
521640,202106,2007,4565,1308,3538,247,697,463,1247,710,1944
521645,202106,571,1454,369,1087,77,207,120,353,197,560
521680,202106,1090,3247,838,2769,234,859,144,511,378,1370
521690,202106,552,1311,459,1195,61,172,288,739,349,911
521710,202106,3253,7919,2119,6086,364,1183,615,1625,979,2808
521720,202106,2271,5089,1486,3931,219,606,794,2119,1013,2725
521730,202106,3635,9856,2807,8468,741,2640,829,2089,1570,4729
521740,202106,3947,10030,2996,8673,725,2261,1030,3125,1755,5386
521760,202106,15188,40292,11811,35215,2723,8881,4546,14513,7269,23394
521770,202106,3119,7262,2058,5596,576,1711,532,1500,1108,3211
521800,202106,6648,17340,4839,14399,1054,3195,2003,6490,3057,9685
521805,202106,720,1562,508,1289,140,330,220,610,360,940
521810,202106,658,1537,475,1291,73,189,281,789,354,978
521830,202106,5547,15057,4415,13328,265,972,3253,9616,3518,10588
521839,202106,805,1904,584,1533,86,265,343,816,429,1081
521850,202106,5853,13296,3714,10145,809,2347,650,1807,1459,4154
521860,202106,1537,4058,1064,3201,178,583,355,1015,533,1598
521870,202106,689,1896,494,1525,96,336,125,340,221,676
521878,202106,702,1775,493,1369,57,183,277,700,334,883
521880,202106,18860,45548,12875,36204,3352,9883,4441,12627,7793,22510
521890,202106,3156,8065,2106,6220,554,1804,445,1178,999,2982
521900,202106,1488,3441,827,2405,243,687,71,210,314,897
521910,202106,1329,2747,906,2253,98,234,504,1354,602,1588
521920,202106,496,1312,360,1081,57,199,170,487,227,686
521925,202106,776,1967,560,1632,84,270,310,890,394,1160
521930,202106,5514,13011,3635,10200,958,2530,1329,4241,2287,6771
521935,202106,1071,2508,728,1927,69,195,413,1041,482,1236
521940,202106,1323,2820,837,2159,182,533,351,880,533,1413
521945,202106,669,1736,522,1487,96,279,276,809,372,1088
521950,202106,769,1839,532,1470,117,333,226,613,343,946
521960,202106,743,1885,502,1437,48,155,277,746,325,901
521970,202106,2569,6190,2022,5531,171,444,1531,4281,1702,4725
521971,202106,758,1773,536,1431,149,365,132,369,281,734
521973,202106,1493,3761,1230,3411,56,120,1002,2793,1058,2913
521975,202106,12072,31246,9883,28232,1704,4921,6063,17460,7767,22381
521980,202106,2569,5917,1974,5137,150,381,1492,3983,1642,4364
521990,202106,1089,3012,881,2647,188,599,346,1024,534,1623
522000,202106,2723,6966,2148,6255,386,1147,1216,3733,1602,4880
522005,202106,324,769,237,637,47,136,110,292,157,428
522010,202106,4186,10035,2993,8123,578,1713,1204,3174,1782,4887
522015,202106,1060,2698,776,2258,241,670,285,877,526,1547
522020,202106,5593,12999,3630,9947,764,2233,1363,3922,2127,6155
522026,202106,772,2034,520,1591,91,303,178,503,269,806
522028,202106,434,1068,315,874,69,198,116,322,185,520
522040,202106,3351,7314,2421,6080,257,726,1695,4156,1952,4882
522045,202106,17694,48087,13128,40127,3018,9914,3677,10962,6695,20876
522050,202106,1188,3021,825,2387,175,565,309,809,484,1374
522060,202106,2987,7685,2099,6238,205,603,1181,3630,1386,4233
522068,202106,1813,4525,1445,4088,110,272,1154,3320,1264,3592
522070,202106,692,1626,567,1447,11,31,494,1239,505,1270
522100,202106,735,1837,503,1485,71,229,259,730,330,959
522108,202106,1096,2598,861,2264,55,138,694,1793,749,1931
522119,202106,1722,4058,1346,3569,184,498,774,2145,958,2643
522130,202106,428,1073,303,902,26,73,213,657,239,730
522140,202106,20204,51698,14196,41100,3409,10572,4046,11160,7455,21732
522145,202106,789,1919,543,1553,149,417,206,603,355,1020
522150,202106,1097,2636,776,2114,205,566,222,633,427,1199
522155,202106,1099,2724,854,2354,169,397,484,1405,653,1802
522157,202106,652,1457,532,1312,24,66,428,1075,452,1141
522160,202106,5922,15067,3848,11308,1024,3239,322,1044,1346,4283
522170,202106,2592,6531,1950,5592,286,827,1117,3270,1403,4097
522180,202106,574,1337,363,945,60,164,91,255,151,419
522185,202106,20237,48776,14359,40760,5384,16808,3062,9358,8446,26166
522190,202106,760,1780,519,1373,105,274,199,522,304,796
522200,202106,1635,4545,1104,3561,226,796,217,664,443,1460
522205,202106,1752,4038,1312,3437,148,397,793,2082,941,2479
522220,202106,1324,3154,980,2649,118,304,596,1662,714,1966
522230,202106,1237,3031,995,2693,187,601,532,1393,719,1994
530010,202106,177979,471454,145070,423523,20654,65738,88162,252819,108816,318557
110001,202105,4040,11114,2716,8650,601,2068,1018,3314,1619,5382
110002,202105,13346,34036,9770,28054,2650,8084,2662,7800,5312,15884
110003,202105,604,1782,453,1470,117,393,124,378,241,771
110004,202105,12165,30968,8198,24097,1668,5287,2468,7319,4136,12606
110005,202105,2534,6472,1767,5238,346,1102,476,1536,822,2638
110006,202105,1773,4921,1103,3501,177,625,229,702,406,1327
110007,202105,1292,3262,827,2483,249,804,207,758,456,1562
110008,202105,3457,9176,2570,7875,303,877,1675,5537,1978,6414
110009,202105,4391,12085,2861,9336,589,2057,1141,3753,1730,5810
110010,202105,8064,24737,5951,20710,1153,4038,2927,11120,4080,15158
110011,202105,7233,18898,4887,14682,1613,5161,649,2021,2262,7182
110012,202105,15801,39131,9517,28209,2055,6687,829,2644,2884,9331
110013,202105,5297,15076,3713,11895,1451,4955,426,1525,1877,6480
110014,202105,3987,10296,2755,7986,526,1642,1224,3442,1750,5084
110015,202105,5844,14776,3558,10442,732,2372,919,2442,1651,4814
110018,202105,3841,9564,2237,6765,395,1392,576,1754,971,3146
110020,202105,75476,177726,54776,149746,12186,34402,22166,67315,34352,101717
110025,202105,5333,12665,3605,9749,655,1909,1675,4491,2330,6400
110026,202105,533,1325,381,1105,85,286,154,475,239,761
110028,202105,7174,17807,4405,12910,1017,3291,613,1801,1630,5092
110029,202105,1572,3797,922,2659,188,556,344,1043,532,1599
110030,202105,12938,29360,7982,22061,1666,5322,1302,4014,2968,9336
110032,202105,3313,9144,2015,6418,645,2038,369,1303,1014,3341
110033,202105,3555,10852,2697,9313,960,3333,686,2676,1646,6009
110034,202105,3353,7761,2226,6220,680,2168,715,2182,1395,4350
110037,202105,1668,4845,1247,4101,290,941,569,1946,859,2887
110040,202105,2964,8062,2143,6575,559,1866,692,2060,1251,3926
110045,202105,4959,14054,3634,11630,926,3190,1207,4017,2133,7207
110050,202105,1837,4925,1296,3984,477,1662,216,657,693,2319
110060,202105,902,2643,613,1964,178,618,111,347,289,965
110070,202105,1528,4710,1120,3818,330,1205,238,751,568,1956
110080,202105,6426,14714,4856,12854,743,1799,3108,8849,3851,10648
110090,202105,599,1586,413,1254,78,253,157,471,235,724
110092,202105,1263,3584,885,2865,160,526,424,1496,584,2022
110094,202105,2839,8370,2115,6955,849,2996,237,826,1086,3822
110100,202105,1686,4913,1349,4266,372,1245,541,1756,913,3001
110110,202105,1773,4749,1274,3950,449,1437,247,880,696,2317
110120,202105,1337,3784,1023,3174,225,762,370,1126,595,1888
110130,202105,2871,7083,1696,4853,126,375,192,478,318,853
110140,202105,2105,6107,1456,4788,326,1136,460,1550,786,2686
110143,202105,1370,3715,968,2923,282,857,171,527,453,1384
110145,202105,900,2321,558,1691,117,358,225,711,342,1069
110146,202105,494,1241,351,1021,71,181,171,539,242,720
110147,202105,761,1967,488,1445,61,206,188,479,249,685
110148,202105,764,2089,458,1487,122,462,63,194,185,656
110149,202105,3147,8390,2167,6827,729,2416,471,1598,1200,4014
110150,202105,2824,6812,1821,5371,515,1693,447,1585,962,3278
110155,202105,744,2152,523,1628,118,398,176,510,294,908
110160,202105,1487,4501,1087,3620,292,1004,270,928,562,1932
110170,202105,2156,5443,1359,3977,233,725,718,2029,951,2754
110175,202105,1854,5194,1278,4049,199,652,500,1663,699,2315
110180,202105,1481,3961,1043,3088,137,442,559,1619,696,2061
120001,202105,3367,9708,2754,8803,442,1481,1723,5637,2165,7118
120005,202105,1966,7383,1791,7139,146,628,1445,5862,1591,6490
120010,202105,5450,15864,4629,14660,414,1216,3437,11250,3851,12466
120013,202105,2126,7276,1868,6966,368,1302,1225,4872,1593,6174
120017,202105,2570,8017,2246,7528,377,1261,1392,4967,1769,6228
120020,202105,15554,58074,14334,55765,970,4194,11564,45303,12534,49497
120025,202105,3195,8786,2567,8040,332,1020,1823,5909,2155,6929
120030,202105,6477,25399,6002,24514,408,1995,4661,19278,5069,21273
120032,202105,1791,7718,1707,7566,89,559,1457,6339,1546,6898
120033,202105,4235,15294,3984,14850,104,614,3512,12920,3616,13534
120034,202105,2750,9789,2358,9119,97,562,1976,7540,2073,8102
120035,202105,3829,14704,3630,14359,273,1277,3017,11925,3290,13202
120038,202105,2733,8583,2312,7905,495,1734,1267,4432,1762,6166
120039,202105,2046,8699,1919,8457,106,663,1562,6844,1668,7507
120040,202105,45113,138125,38490,127553,5024,17481,24535,82351,29559,99832
120042,202105,3433,12379,3193,11944,118,629,2739,10142,2857,10771
120043,202105,1468,5858,1341,5662,34,208,1235,5214,1269,5422
120045,202105,6153,15671,5325,14745,128,514,4833,13222,4961,13736
120050,202105,9460,33713,8681,32526,362,1857,7327,27537,7689,29394
120060,202105,9589,37355,8779,36179,344,2137,7674,31400,8018,33537
120070,202105,3279,10213,2839,9627,255,840,2074,7294,2329,8134
120080,202105,4414,13708,3935,13010,453,1523,2916,9866,3369,11389
130002,202105,3246,12111,2901,11600,166,593,2536,10359,2702,10952
130006,202105,2535,9103,2116,8370,180,685,1613,6460,1793,7145
130008,202105,2761,9518,2455,9076,62,309,2147,7944,2209,8253
130010,202105,4022,11556,3384,10835,84,213,3092,10083,3176,10296
130014,202105,3433,9754,2655,8535,439,1426,1646,5398,2085,6824
130020,202105,2952,11178,2636,10696,102,601,2214,8941,2316,9542
130030,202105,10797,33482,9850,32389,349,860,8838,29724,9187,30584
130040,202105,4310,12245,3563,11259,301,810,2833,9209,3134,10019
130050,202105,7695,27770,6435,26131,175,812,5824,23962,5999,24774
130060,202105,7875,30300,6754,28869,397,2057,5674,24284,6071,26341
130063,202105,6598,21232,5899,20467,192,813,5391,18810,5583,19623
130068,202105,3989,13397,3374,12550,192,1040,2601,9566,2793,10606
130070,202105,7828,21395,6447,19896,304,786,5328,17118,5632,17904
130080,202105,7474,26131,6561,25090,239,1231,5651,22011,5890,23242
130083,202105,2828,9042,2517,8662,135,532,2124,7427,2259,7959
130090,202105,3614,11040,3211,10552,47,200,2882,9667,2929,9867
130100,202105,8233,24373,6987,23083,101,177,6551,22298,6652,22475
130110,202105,8631,24329,7078,22424,1049,2650,5059,17422,6108,20072
130115,202105,5256,16341,4521,15514,102,349,4019,14012,4121,14361
130120,202105,14210,49784,12512,47557,1053,4345,10161,39112,11214,43457
130130,202105,5706,17372,4359,15572,397,1428,3144,11416,3541,12844
130140,202105,7410,25491,6503,24454,189,1029,5703,21578,5892,22607
130150,202105,3735,13762,3511,13512,64,402,3248,12542,3312,12944
130160,202105,5370,18527,4624,17583,288,1026,3928,15383,4216,16409
130165,202105,3309,12265,3106,12022,119,503,2815,11000,2934,11503
130170,202105,11758,33842,9513,31239,697,2465,7685,25774,8382,28239
130180,202105,4548,14612,4318,14354,41,195,4170,13848,4211,14043
130185,202105,18976,45954,15529,42270,1126,1921,12856,37475,13982,39396
130190,202105,19188,62319,15451,56837,1587,5747,11154,42617,12741,48364
130195,202105,2534,8964,2046,8302,84,401,1713,6967,1797,7368
130200,202105,2733,7394,2226,6745,88,332,1903,5736,1991,6068
130210,202105,1371,5108,1242,4957,97,567,1020,3949,1117,4516
130220,202105,2291,7744,1942,7309,54,265,1718,6528,1772,6793
130230,202105,4967,19565,4327,18668,198,1213,3793,16329,3991,17542
130240,202105,12731,37361,10386,34307,148,839,9418,31158,9566,31997
130250,202105,26807,78764,23006,74494,1560,4390,18743,63151,20303,67541
130255,202105,4748,15304,4130,14235,126,521,3404,11774,3530,12295
130260,202105,261590,714686,212950,646336,57593,184403,96901,307924,154494,492327
130270,202105,9980,34412,8291,31811,1417,5267,5273,21338,6690,26605
130280,202105,3605,14281,3317,13962,79,397,3106,13223,3185,13620
130290,202105,13822,44606,12051,42381,634,2245,10295,37009,10929,39254
130300,202105,4970,16643,4501,16014,138,740,3962,14075,4100,14815
130310,202105,6567,21300,5697,20196,264,1138,4909,17424,5173,18562
130320,202105,3490,11245,2903,10473,373,1291,2133,7997,2506,9288
130330,202105,4720,14891,3803,13794,206,895,3249,11825,3455,12720
130340,202105,24538,73484,21152,69657,1450,3785,17843,60939,19293,64724
130350,202105,4079,14480,3680,13979,146,728,3249,12314,3395,13042
130353,202105,7582,20081,6083,18205,771,2168,4381,13660,5152,15828
130356,202105,5418,16811,4489,15385,805,2644,2689,9879,3494,12523
130360,202105,3042,9909,2647,9364,82,343,2360,8339,2442,8682
130370,202105,5835,22974,5053,21882,319,1721,4037,17529,4356,19250
130380,202105,7427,30586,6907,29844,385,2125,5901,25337,6286,27462
130390,202105,6034,24880,5371,23789,551,2654,4173,18664,4724,21318
130395,202105,2445,7615,2118,7104,187,602,1669,5676,1856,6278
130400,202105,2862,8635,2457,8108,90,249,2207,7437,2297,7686
130406,202105,11152,37916,9325,35712,1758,6594,6156,24807,7914,31401
130410,202105,4513,15476,3866,14407,1100,4276,1793,6915,2893,11191
130420,202105,14205,48352,11827,45400,950,4293,9233,35901,10183,40194
130423,202105,4539,13804,3981,13169,188,725,3504,11531,3692,12256
130426,202105,2781,11060,2586,10831,59,321,2398,10122,2457,10443
130430,202105,4408,12132,3808,11345,212,706,3292,9747,3504,10453
130440,202105,5145,15656,4341,14695,76,329,4043,13757,4119,14086
140002,202105,2344,6757,2046,6395,101,351,1702,5433,1803,5784
140005,202105,3339,9225,2908,8726,134,343,2474,7664,2608,8007
140010,202105,55924,147311,44902,131081,11017,34029,18881,56637,29898,90666
140015,202105,3909,11397,3326,10689,219,663,2899,9520,3118,10183
140017,202105,4473,12208,3878,11450,265,686,3182,9734,3447,10420
140020,202105,5352,15274,4622,14332,250,966,3808,11744,4058,12710
140023,202105,2547,7445,2084,6785,204,655,1588,5307,1792,5962
140028,202105,2004,5133,1698,4750,78,248,1375,3854,1453,4102
140030,202105,5481,13705,4877,13013,325,603,4295,11845,4620,12448
140040,202105,2713,10294,2512,10030,83,509,2310,9086,2393,9595
140045,202105,2634,9618,2191,9003,368,1279,1419,6415,1787,7694
140047,202105,6380,17846,5348,16379,565,1755,3875,12070,4440,13825
140050,202105,1462,4235,1238,3920,117,339,937,3088,1054,3427
140060,202105,1748,4479,1523,4162,111,282,1252,3493,1363,3775
140070,202105,1921,9896,1857,9770,111,787,1584,8234,1695,9021
150010,202105,45699,113860,41261,108162,984,2179,37011,97202,37995,99381
150013,202105,2033,5059,1701,4700,145,265,1353,3995,1498,4260
150020,202105,14582,43219,13470,41782,1830,4693,10496,34100,12326,38793
150030,202105,8893,33101,8085,32120,495,1955,6997,28217,7492,30172
150034,202105,4396,10409,3611,9455,238,538,3015,8085,3253,8623
150040,202105,16447,42323,14490,40157,1260,1886,12161,36640,13421,38526
150050,202105,7181,24379,6569,23577,126,535,6063,21988,6189,22523
150060,202105,22479,60035,18113,53604,2676,8041,11805,35729,14481,43770
150070,202105,7112,25813,6254,24785,242,1062,5604,22466,5846,23528
150080,202105,93724,208581,77450,186381,19678,51986,20088,59766,39766,111752
150085,202105,8171,22977,7441,22122,114,340,6984,20940,7098,21280
150090,202105,10260,36364,9687,35273,788,2682,7832,28945,8620,31627
150095,202105,5922,16551,5188,15653,275,533,4478,14068,4753,14601
150100,202105,2891,9951,2552,9396,212,658,2017,7658,2229,8316
150110,202105,4432,17896,4117,17542,171,766,3801,16329,3972,17095
150120,202105,8230,25239,7804,24749,272,674,6953,22707,7225,23381
150125,202105,796,2012,582,1725,100,358,352,1023,452,1381
150130,202105,22927,64882,19784,60139,3819,10365,12124,39852,15943,50217
150140,202105,271083,608955,228840,551644,34278,78612,131993,331413,166271,410025
150145,202105,4344,13392,3662,12306,1034,3242,1718,6589,2752,9831
150150,202105,16858,42015,14705,39328,642,1797,12275,32797,12917,34594
150157,202105,3633,9692,2920,8773,308,871,2051,6485,2359,7356
150160,202105,3157,8869,2940,8554,483,1293,1912,5779,2395,7072
150170,202105,25167,79905,22078,74774,3965,12566,13512,48994,17477,61560
150172,202105,5185,13802,4162,12375,295,714,3124,9695,3419,10409
150175,202105,1696,5203,1420,4690,240,827,839,2804,1079,3631
150178,202105,10577,28063,8796,26006,240,526,7846,23646,8086,24172
150180,202105,23018,79359,20796,76842,1284,3551,18194,69449,19478,73000
150190,202105,6958,22401,6468,21812,186,777,5883,19788,6069,20565
150195,202105,5273,16372,4957,15890,198,669,4414,14143,4612,14812
150200,202105,5912,17170,5402,16607,60,156,5104,15800,5164,15956
150210,202105,27031,91263,25306,89063,1604,5150,21052,76770,22656,81920
150215,202105,8484,23436,7378,21807,1217,3529,4467,13683,5684,17212
150220,202105,12897,35423,11270,33123,1101,2963,7821,23631,8922,26594
150230,202105,12911,35849,11454,33909,1270,3337,7834,24330,9104,27667
150240,202105,33503,90685,27925,81402,7010,20955,10302,30340,17312,51295
150250,202105,4322,16117,4022,15784,593,2270,3145,12659,3738,14929
150260,202105,2784,8796,2512,8393,127,397,2059,6972,2186,7369
150270,202105,9251,25767,6536,20920,2023,6833,1541,5339,3564,12172
150275,202105,7084,21945,6452,21060,226,784,5581,18213,5807,18997
150276,202105,2414,6274,2085,5882,261,643,1394,4424,1655,5067
150277,202105,5281,13544,4225,12317,351,934,3159,9858,3510,10792
150280,202105,7082,27820,6830,27418,405,1585,5947,24118,6352,25703
150285,202105,3289,11418,2888,10790,265,961,2107,8087,2372,9048
150290,202105,10445,28032,9427,26947,308,589,8519,25013,8827,25602
150293,202105,9540,23115,7413,20360,1018,2701,4590,13325,5608,16026
150295,202105,7704,20485,5592,17587,1798,5999,1901,6944,3699,12943
150300,202105,2400,7077,2174,6797,32,109,2008,6311,2040,6420
150304,202105,4339,12467,3596,11339,610,1747,2259,7577,2869,9324
150307,202105,6153,19440,5665,18637,289,963,4614,15310,4903,16273
150309,202105,6491,18814,5230,16693,850,2685,3013,10062,3863,12747
150310,202105,7496,29366,7165,28979,190,1003,6434,26282,6624,27285
150320,202105,9376,25384,8570,24217,362,1074,6721,18969,7083,20043
150330,202105,13947,44004,12902,42410,1174,3507,9771,33315,10945,36822
150340,202105,2581,7466,2293,7038,340,975,1578,5023,1918,5998
150345,202105,8542,24000,7678,22861,410,1267,6633,19802,7043,21069
150350,202105,9101,22549,8342,21561,641,1119,6926,18436,7567,19555
150360,202105,24473,65850,19596,59753,2144,4857,13804,45489,15948,50346
150370,202105,11215,33092,9236,30423,1053,2832,6694,23912,7747,26744
150375,202105,3729,14817,3382,14332,206,967,2932,12551,3138,13518
150380,202105,11480,28703,9483,26107,104,398,8450,23222,8554,23620
150390,202105,7848,31060,7037,29818,1074,3877,5030,22750,6104,26627
150400,202105,6779,23763,6501,23248,230,790,5760,20711,5990,21501
150405,202105,9347,24196,8165,22786,504,1005,6626,19171,7130,20176
150410,202105,2004,6084,1708,5587,268,706,1065,3706,1333,4412
150420,202105,40492,109716,31159,96177,8405,27116,11006,39671,19411,66787
150430,202105,8716,24609,7930,23599,918,1876,6184,19451,7102,21327
150440,202105,5878,18054,5323,17296,970,2760,3472,12080,4442,14840
150442,202105,27547,63303,22832,57544,2392,5729,15970,41154,18362,46883
150445,202105,6485,19479,5691,18297,203,636,4919,15895,5122,16531
150450,202105,5357,22060,4952,21525,378,1817,4196,18289,4574,20106
150460,202105,8493,27572,7759,26635,226,840,6708,23850,6934,24690
150470,202105,21421,55430,19110,52813,328,932,18030,49836,18358,50768
150475,202105,5162,15687,4433,14612,484,1418,3354,11429,3838,12847
150480,202105,14011,43724,12568,41622,2290,6465,8381,29962,10671,36427
150490,202105,8520,29249,7796,28352,338,1227,6780,24913,7118,26140
150495,202105,5431,18013,5188,17683,99,461,4750,16118,4849,16579
150497,202105,2835,8887,2282,7946,490,1741,1211,4527,1701,6268
150500,202105,3385,8471,3010,7950,287,692,2282,6036,2569,6728
150503,202105,4909,12385,3364,10390,957,3171,1065,3809,2022,6980
150506,202105,10708,30966,8959,28601,1878,5253,5531,19739,7409,24992
150510,202105,9909,35561,8613,33216,1376,4871,5502,22610,6878,27481
150520,202105,7358,28200,7050,27822,174,1026,6423,25260,6597,26286
150530,202105,12309,41509,10638,39168,1337,3928,7815,30613,9152,34541
150540,202105,5036,13428,4316,12359,264,711,3586,10291,3850,11002
150543,202105,7202,19203,5910,17598,440,1265,4606,14375,5046,15640
150548,202105,10310,31852,9270,30429,224,870,8269,27248,8493,28118
150549,202105,2011,5787,1720,5379,43,137,1445,4565,1488,4702
150550,202105,21221,60933,17624,55093,4509,14180,7224,24271,11733,38451
150553,202105,32323,89328,25632,77773,7391,22493,9800,31270,17191,53763
150555,202105,2056,5336,1612,4636,184,405,1086,3324,1270,3729
150560,202105,1961,5734,1745,5321,306,857,1006,3229,1312,4086
150563,202105,2668,7770,2217,7014,427,1382,1247,4021,1674,5403
150565,202105,4536,14167,4043,13407,96,405,3396,11355,3492,11760
150570,202105,6467,19903,6037,19318,333,994,5196,16776,5529,17770
150580,202105,10593,40902,9046,39187,548,2775,7293,33030,7841,35805
150590,202105,8431,28476,7230,27047,144,835,6640,24778,6784,25613
150600,202105,9762,31884,9089,31083,209,801,8456,29092,8665,29893
150610,202105,2932,8403,2623,7926,86,328,2237,6697,2323,7025
150611,202105,3356,9011,2998,8527,93,291,2667,7563,2760,7854
150613,202105,13827,37173,10479,31576,1877,5981,5275,15831,7152,21812
150616,202105,3637,9842,2643,8178,579,1849,1155,3580,1734,5429
150618,202105,7070,20024,5757,18028,532,1605,3686,12209,4218,13814
150619,202105,6854,18511,5676,16896,234,582,4788,14507,5022,15089
150620,202105,6886,22469,5930,20881,651,2134,4011,14622,4662,16756
150630,202105,6542,16993,5982,16312,302,761,5197,14232,5499,14993
150635,202105,4980,13411,4185,12151,581,1537,2719,8149,3300,9686
150640,202105,2293,6688,2096,6443,38,98,1957,6090,1995,6188
150650,202105,11628,31487,10082,29067,2840,7728,4458,14161,7298,21889
150655,202105,5736,16350,5194,15564,192,584,4514,13543,4706,14127
150658,202105,4591,12836,3564,11230,632,2069,1941,6458,2573,8527
150660,202105,5854,16314,5188,15396,555,1523,3589,10941,4144,12464
150670,202105,9053,20129,7204,18039,679,1272,5803,15332,6482,16604
150680,202105,70903,203036,54849,177848,13097,41232,24010,88853,37107,130085
150690,202105,2816,6817,2420,6370,81,165,2152,5804,2233,5969
150700,202105,6137,17890,5474,17041,364,869,4338,13977,4702,14846
150710,202105,3830,12566,3478,12013,299,968,2620,9287,2919,10255
150715,202105,5083,14213,4164,12821,284,784,3293,10363,3577,11147
150720,202105,6960,24118,6483,23410,432,1540,5391,19829,5823,21369
150730,202105,12521,37022,10745,34493,1180,3875,8045,26543,9225,30418
150740,202105,4109,11162,3598,10367,314,747,2717,8041,3031,8788
150745,202105,5136,14266,4133,12807,668,2132,2791,8831,3459,10963
150746,202105,1780,5088,1615,4860,71,164,1363,4171,1434,4335
150747,202105,5092,15451,4509,14543,680,1808,3101,10625,3781,12433
150750,202105,3793,11591,3183,10660,226,792,2432,8405,2658,9197
150760,202105,11842,34630,10738,33092,1504,4161,7511,24053,9015,28214
150770,202105,6672,23180,6265,22729,208,522,5693,21379,5901,21901
150775,202105,1017,2715,803,2440,127,414,474,1453,601,1867
150780,202105,4526,13642,4011,13033,154,411,3600,12041,3754,12452
150790,202105,6071,16465,5227,15553,296,721,3858,13214,4154,13935
150795,202105,14702,43708,12787,40816,2938,8781,7344,25058,10282,33839
150796,202105,3985,9408,3473,8824,235,480,2913,7599,3148,8079
150797,202105,4199,12461,3642,11705,162,361,3093,10212,3255,10573
150800,202105,13598,41925,12240,40132,1535,4652,9040,30834,10575,35486
150803,202105,7496,22829,7007,22087,441,1110,5951,19131,6392,20241
150805,202105,3630,10828,3084,10051,271,821,2333,7834,2604,8655
150808,202105,6172,17313,4557,14671,1696,6005,679,2567,2375,8572
150810,202105,21189,54317,16119,48233,3255,9922,8114,27260,11369,37182
150812,202105,5711,15437,5034,14350,422,1267,3816,10694,4238,11961
150815,202105,9946,28321,8311,26406,660,1984,6863,22269,7523,24253
150820,202105,11961,32269,10136,30017,1143,2780,7602,23867,8745,26647
150830,202105,12321,43459,11399,42341,479,1770,9762,37706,10241,39476
150835,202105,2518,7867,2152,7279,321,1074,1358,4629,1679,5703
150840,202105,7827,21453,6317,19091,991,3239,3651,10939,4642,14178
160005,202105,1237,3295,1093,3116,65,214,924,2647,989,2861
160010,202105,2463,6468,2294,6285,18,97,2226,6032,2244,6129
160015,202105,2888,8157,2558,7759,72,222,2358,7196,2430,7418
160020,202105,2124,6574,1850,6236,159,473,1433,5071,1592,5544
160021,202105,1251,4541,1154,4421,53,272,927,3608,980,3880
160023,202105,1354,4555,1197,4294,143,465,814,3125,957,3590
160025,202105,1851,5538,1741,5412,12,41,1686,5252,1698,5293
160027,202105,8918,24710,7952,23480,687,1882,6315,19092,7002,20974
160030,202105,77974,214826,63242,194986,13229,38175,33333,114075,46562,152250
160040,202105,5946,19611,5428,18962,70,297,5100,17938,5170,18235
160050,202105,4938,14429,3862,13009,1447,4688,1343,5730,2790,10418
160053,202105,3938,11804,3553,11327,291,777,2860,9538,3151,10315
160055,202105,958,2719,924,2681,27,84,851,2486,878,2570
160060,202105,26168,66329,21318,60881,1151,3173,16658,50377,17809,53550
160070,202105,2644,9956,2361,9523,186,727,1863,7794,2049,8521
160080,202105,3391,10565,3003,10130,24,128,2827,9599,2851,9727
170025,202105,657,1672,480,1406,80,219,252,798,332,1017
170030,202105,1286,3774,998,3282,158,477,458,1580,616,2057
170035,202105,1488,3794,1097,3183,79,242,710,2058,789,2300
170040,202105,1959,5336,1555,4766,105,333,991,3122,1096,3455
170070,202105,1938,4463,1386,3764,91,273,821,2350,912,2623
170100,202105,2480,6994,2061,6308,238,642,1274,4056,1512,4698
170105,202105,735,2084,513,1616,147,427,154,514,301,941
170110,202105,997,2924,773,2516,106,363,412,1305,518,1668
170130,202105,1315,3819,960,3150,172,596,479,1589,651,2185
170190,202105,1442,3950,1059,3340,306,1049,280,980,586,2029
170200,202105,2117,4938,1396,3777,210,571,569,1551,779,2122
170210,202105,25652,68265,19511,58098,6050,19737,2916,9509,8966,29246
170215,202105,1334,3518,1068,3152,43,174,848,2500,891,2674
170220,202105,5975,18123,4990,16356,1375,4322,1820,6760,3195,11082
170230,202105,1239,3588,912,2953,261,860,153,537,414,1397
170240,202105,2645,7230,2108,6370,142,466,1530,4547,1672,5013
170255,202105,4046,11424,2931,9450,600,1907,1259,4211,1859,6118
170270,202105,958,2301,649,1856,55,149,379,1077,434,1226
170290,202105,2874,8374,2495,7877,134,400,1943,6344,2077,6744
170300,202105,2090,5493,1694,4903,191,498,1151,3427,1342,3925
170305,202105,666,1791,563,1625,83,242,277,823,360,1065
170307,202105,979,3215,797,2872,97,356,461,1679,558,2035
170310,202105,1612,3964,1151,3245,168,506,552,1580,720,2086
170320,202105,1057,2712,793,2293,77,221,499,1488,576,1709
170330,202105,935,2806,847,2680,42,174,704,2172,746,2346
170360,202105,548,1453,387,1200,20,72,257,756,277,828
170370,202105,1275,3339,922,2752,256,731,268,890,524,1621
170380,202105,1832,5162,1386,4481,86,303,827,2760,913,3063
170382,202105,555,1610,466,1464,29,124,354,1068,383,1192
170384,202105,1643,5614,1350,5067,274,1024,688,2686,962,3710
170386,202105,1014,2721,632,1996,72,262,237,713,309,975
170388,202105,624,1742,442,1430,59,209,206,671,265,880
170389,202105,1064,3217,869,2893,52,193,631,2153,683,2346
170390,202105,1796,4008,1351,3477,32,71,1135,2998,1167,3069
170410,202105,594,1642,439,1368,23,85,287,861,310,946
170460,202105,376,988,312,889,40,116,210,607,250,723
170510,202105,960,2647,705,2204,42,154,458,1350,500,1504
170550,202105,6563,17187,4828,14419,1298,4170,1035,3358,2333,7528
170555,202105,1427,3759,1125,3295,81,232,550,1702,631,1934
170560,202105,1049,2876,802,2539,71,207,509,1729,580,1936
170600,202105,1302,3468,1055,3121,273,686,488,1624,761,2310
170610,202105,1621,4219,1178,3561,86,273,736,2204,822,2477
170625,202105,432,1143,288,860,39,106,110,323,149,429
170650,202105,1259,3666,1002,3244,114,382,614,2030,728,2412
170700,202105,3427,9982,2589,8366,510,1655,1148,3766,1658,5421
170710,202105,1491,3840,1162,3330,160,462,707,2072,867,2534
170720,202105,1767,4390,1347,3709,336,925,603,1723,939,2648
170730,202105,1109,2927,832,2475,129,310,442,1407,571,1717
170740,202105,2145,6887,1853,6362,164,622,1329,4544,1493,5166
170755,202105,897,2420,632,1978,81,259,269,844,350,1103
170765,202105,1167,2990,824,2442,150,436,348,1091,498,1527
170770,202105,1912,5347,1545,4785,151,484,1053,3283,1204,3767
170820,202105,3348,9951,2623,8633,534,1793,1191,4081,1725,5874
170825,202105,1037,2364,849,2119,99,223,612,1550,711,1773
170830,202105,1413,3695,1152,3291,229,602,689,2061,918,2663
170900,202105,2811,8618,2367,7980,219,644,1849,6407,2068,7051
170930,202105,3766,10233,2877,8582,662,2091,909,2732,1571,4823
170950,202105,11334,30940,7931,24832,2130,7639,865,2957,2995,10596
170980,202105,471,1227,369,1066,30,97,242,677,272,774
171050,202105,1670,5126,1455,4765,51,221,1214,3950,1265,4171
171070,202105,1363,3824,1170,3541,315,901,505,1827,820,2728
171090,202105,1084,2659,857,2345,85,241,548,1470,633,1711
171110,202105,582,1541,411,1228,81,228,179,508,260,736
171150,202105,1081,2643,681,1968,66,213,420,1207,486,1420
171180,202105,793,2116,527,1615,99,274,223,691,322,965
171190,202105,1873,6062,1633,5657,250,905,1013,3630,1263,4535
171195,202105,807,2503,648,2208,75,287,401,1349,476,1636
171200,202105,606,1649,454,1397,105,346,160,479,265,825
171215,202105,392,1064,326,957,32,109,216,604,248,713
171240,202105,810,2583,642,2277,29,159,437,1519,466,1678
171245,202105,738,2085,578,1772,47,156,373,1100,420,1256
171250,202105,1017,2700,748,2296,133,432,344,1077,477,1509
171270,202105,495,1692,391,1478,84,325,167,687,251,1012
171280,202105,897,2636,722,2323,71,246,441,1458,512,1704
171320,202105,4077,11235,3189,9689,643,1854,1197,3892,1840,5746
171330,202105,2815,7666,2184,6546,506,1516,920,2889,1426,4405
171360,202105,1445,4084,1152,3657,89,278,824,2711,913,2989
171370,202105,711,1770,543,1536,44,118,375,1073,419,1191
171380,202105,1491,3957,1254,3630,156,429,834,2556,990,2985
171395,202105,1012,2690,707,2141,60,202,453,1329,513,1531
171420,202105,2014,5741,1465,4664,258,812,648,2131,906,2943
171430,202105,1064,3062,899,2756,52,159,630,1874,682,2033
171488,202105,2400,6909,1911,6111,308,1001,985,3225,1293,4226
171500,202105,990,2435,746,2063,67,163,515,1452,582,1615
171510,202105,847,2662,734,2452,43,170,537,1774,580,1944
171515,202105,490,1217,372,1049,39,116,225,600,264,716
171525,202105,757,2033,574,1749,36,114,354,1047,390,1161
171550,202105,354,994,271,865,37,136,148,452,185,588
171570,202105,1146,3398,972,3097,127,394,580,1914,707,2308
171575,202105,1779,4743,1152,3625,132,428,507,1604,639,2032
171610,202105,5796,15894,4321,13392,877,3059,1116,3793,1993,6852
171620,202105,2628,7333,2231,6761,102,407,1837,5535,1939,5942
171630,202105,1049,2624,812,2305,84,229,569,1668,653,1897
171650,202105,2091,5801,1621,5028,395,1321,478,1657,873,2978
171660,202105,2400,5973,1675,4778,220,557,938,2713,1158,3270
171665,202105,1252,3480,987,3046,178,614,477,1470,655,2084
171670,202105,1938,5097,1488,4356,217,660,760,2275,977,2935
171700,202105,1225,3395,897,2796,108,320,487,1538,595,1858
171720,202105,805,2033,637,1780,56,164,466,1289,522,1453
171750,202105,1340,3706,928,2939,219,721,129,508,348,1229
171780,202105,1229,3091,906,2627,85,266,629,1796,714,2062
171790,202105,1425,4511,1172,4000,187,644,572,1970,759,2614
171800,202105,732,1952,557,1701,64,235,323,968,387,1203
171820,202105,11613,32012,8652,26976,2074,6761,2398,8157,4472,14918
171830,202105,1594,4954,1364,4556,128,494,882,2959,1010,3453
171840,202105,782,2047,605,1770,21,61,393,1157,414,1218
171845,202105,666,1606,506,1374,45,161,331,861,376,1022
171850,202105,910,2940,779,2650,69,277,545,1819,614,2096
171855,202105,1073,3222,914,2925,55,166,598,1882,653,2048
171865,202105,424,1257,359,1157,57,190,192,586,249,776
171870,202105,839,2256,590,1808,75,217,299,935,374,1152
171875,202105,1326,3725,1066,3315,37,151,817,2526,854,2677
171880,202105,1239,3605,1091,3412,42,116,868,2787,910,2903
171884,202105,896,2534,671,2144,143,505,234,764,377,1269
171886,202105,1419,3750,1030,3139,279,967,224,698,503,1665
171888,202105,721,2003,501,1596,30,112,310,956,340,1068
171889,202105,375,1145,299,998,67,246,117,380,184,626
171890,202105,1210,3334,880,2803,160,485,494,1592,654,2077
171900,202105,554,1854,419,1542,76,245,177,692,253,937
172000,202105,600,1726,501,1557,62,183,275,843,337,1026
172010,202105,991,3370,851,3100,65,264,535,1954,600,2218
172015,202105,382,1288,289,1103,53,192,120,478,173,670
172020,202105,2822,7742,2487,7309,161,476,1828,5625,1989,6101
172025,202105,708,1935,530,1650,38,133,384,1201,422,1334
172030,202105,1269,3678,1072,3361,63,193,812,2548,875,2741
172049,202105,1329,3143,897,2550,183,469,435,1376,618,1845
172065,202105,1452,3637,1148,3254,99,206,908,2771,1007,2977
172080,202105,2390,6955,1942,6176,117,379,1295,4125,1412,4504
172085,202105,482,1297,312,940,59,173,108,309,167,482
172090,202105,4090,10033,3190,8848,132,347,2447,6902,2579,7249
172093,202105,478,1408,345,1168,20,96,204,659,224,755
172097,202105,692,1782,488,1435,67,201,210,610,277,811
172100,202105,50014,121486,36151,100065,6051,18273,13606,38459,19657,56732
172110,202105,1622,5787,1402,5444,114,468,1051,4213,1165,4681
172120,202105,5180,14945,4066,13124,523,1739,2227,7427,2750,9166
172125,202105,398,1057,307,912,23,77,187,532,210,609
172130,202105,632,1527,496,1307,22,78,355,861,377,939
172208,202105,2638,6271,2118,5600,241,472,1495,4140,1736,4612
172210,202105,2730,6785,2100,5986,293,888,1237,3710,1530,4598
210005,202105,19185,53797,14467,46075,4046,13341,5568,18617,9614,31958
210010,202105,1949,5938,1763,5714,73,292,1545,5032,1618,5324
210015,202105,3336,9844,2953,9349,151,456,2456,7830,2607,8286
210020,202105,7372,17313,6294,16060,83,244,5800,14861,5883,15105
210030,202105,4646,15309,4285,14764,282,1059,3580,12441,3862,13500
210040,202105,1939,4445,1724,4181,49,110,1476,3505,1525,3615
210043,202105,6064,17254,5169,15990,374,1133,4086,12830,4460,13963
210047,202105,6566,20193,5382,18630,126,639,4677,16198,4803,16837
210050,202105,2219,7351,1768,6521,194,743,1197,4494,1391,5237
210055,202105,1888,5978,1712,5710,60,207,1459,4912,1519,5119
210060,202105,7409,26981,6615,25604,707,2678,4574,18358,5281,21036
210070,202105,7105,19970,6654,19364,41,179,6304,18300,6345,18479
210080,202105,4323,14302,4107,14069,38,219,3799,13103,3837,13322
210083,202105,5686,15939,4737,14925,84,251,4440,14134,4524,14385
210087,202105,3010,8120,2585,7556,101,276,2172,6405,2273,6681
210090,202105,9124,28370,8533,27344,523,1324,7227,23467,7750,24791
210095,202105,6582,20873,6027,20175,277,1007,5054,17383,5331,18390
210100,202105,6745,20543,6002,19339,470,1541,4550,14806,5020,16347
210110,202105,2927,9280,2699,9008,56,304,2432,8083,2488,8387
210120,202105,23373,62423,19355,57237,1942,4466,13134,41700,15076,46166
210125,202105,4445,11863,3862,11176,761,1784,2645,8229,3406,10013
210130,202105,4351,11178,3613,10266,160,334,3061,8814,3221,9148
210135,202105,1560,4353,1321,3985,68,148,1077,3339,1145,3487
210140,202105,19765,50772,15261,44985,2988,8157,8359,26469,11347,34626
210150,202105,4372,10417,3904,9779,148,328,3316,8233,3464,8561
210160,202105,16949,48348,14608,45435,1319,4109,10348,33662,11667,37771
210170,202105,15498,46999,14409,45620,847,2148,12549,40418,13396,42566
210173,202105,2288,8699,2144,8448,100,572,1844,7197,1944,7769
210177,202105,3492,9556,3035,8995,206,484,2553,7883,2759,8367
210180,202105,1447,3821,1258,3592,23,61,1147,3282,1170,3343
210190,202105,5431,14328,4598,13219,81,299,3972,11320,4053,11619
210193,202105,1355,3883,1190,3619,35,108,884,2754,919,2862
210197,202105,2121,6478,1958,6259,156,450,1599,5246,1755,5696
210200,202105,7824,24747,6959,23325,394,1437,5546,18614,5940,20051
210203,202105,7106,20792,6048,19373,352,1161,4872,15929,5224,17090
210207,202105,3984,9550,3061,8561,162,321,2548,7344,2710,7665
210210,202105,8037,25729,7338,24744,141,797,6313,21123,6454,21920
210215,202105,2530,7893,2172,7362,115,553,1632,5462,1747,6015
210220,202105,6184,21139,5881,20697,145,966,5208,17979,5353,18945
210230,202105,5225,15542,4758,14847,509,1261,3854,12460,4363,13721
210232,202105,11229,34651,9209,31572,1661,5545,5568,20578,7229,26123
210235,202105,3377,10148,2982,9588,157,600,2502,8058,2659,8658
210237,202105,3047,9513,2617,9001,26,141,2437,8386,2463,8527
210240,202105,2623,8077,2418,7729,69,226,2025,6380,2094,6606
210250,202105,5885,17431,5361,16772,61,347,4929,15380,4990,15727
210255,202105,2600,7791,2217,7132,252,802,1498,4802,1750,5604
210260,202105,5511,16219,4864,15281,248,854,4129,12977,4377,13831
210270,202105,5031,13646,4497,12970,85,354,4040,11571,4125,11925
210275,202105,3465,8788,3026,8244,88,241,2509,6836,2597,7077
210280,202105,5697,15866,4588,14190,243,890,3454,10541,3697,11431
210290,202105,7504,19427,6727,18461,106,314,6299,17309,6405,17623
210300,202105,32534,88515,26598,80000,2406,7512,17974,56448,20380,63960
210310,202105,3130,7850,2772,7333,121,257,2427,6492,2548,6749
210312,202105,2790,6871,2483,6543,21,83,2363,6191,2384,6274
210315,202105,3039,8347,2625,7885,85,224,2318,7136,2403,7360
210317,202105,4120,12877,3732,12420,107,521,3342,11071,3449,11592
210320,202105,19292,57055,17643,54903,360,1544,15714,48759,16074,50303
210325,202105,3693,10300,3169,9621,112,314,2741,8560,2853,8874
210330,202105,24191,67260,19369,61151,5350,15088,9729,35361,15079,50449
210340,202105,10252,29441,9126,27945,741,2105,6993,22112,7734,24217
210350,202105,9100,26051,8029,24754,130,439,7208,22338,7338,22777
210355,202105,4284,13998,3796,13239,95,445,3232,11346,3327,11791
210360,202105,14000,42782,12482,40576,531,2309,9539,30467,10070,32776
210370,202105,10992,24427,8513,21818,247,407,7790,20451,8037,20858
210375,202105,3243,8560,2471,7492,697,2202,951,3204,1648,5406
210380,202105,5469,13853,4719,12972,235,569,4001,11113,4236,11682
210390,202105,2748,9073,2548,8734,106,455,2199,7501,2305,7956
210400,202105,4534,13605,4021,12996,128,374,3576,11773,3704,12147
210405,202105,6936,18361,5621,16516,1093,2877,3139,9976,4232,12853
210407,202105,2032,6558,1728,6029,74,289,1380,4764,1454,5053
210408,202105,2633,9545,2462,9300,145,644,1969,7493,2114,8137
210409,202105,3881,13078,3535,12606,95,470,2972,10724,3067,11194
210410,202105,3513,10360,3011,9541,126,457,2394,7519,2520,7976
210420,202105,3858,12125,3490,11480,200,575,2929,9779,3129,10354
210430,202105,2265,6567,2008,6235,98,265,1700,5375,1798,5640
210440,202105,4342,11647,3770,10930,82,249,3420,9893,3502,10142
210450,202105,2371,6978,2042,6508,90,284,1685,5376,1775,5660
210455,202105,4480,11525,3416,10184,926,2789,1605,5081,2531,7870
210460,202105,3768,10606,3187,9853,58,225,2795,8613,2853,8838
210462,202105,1681,5016,1436,4625,38,144,1167,3791,1205,3935
210465,202105,2754,7901,2400,7406,76,338,1938,5847,2014,6185
210467,202105,5937,18595,5193,17632,274,1020,4323,14903,4597,15923
210470,202105,1992,5262,1480,4534,108,243,1118,3595,1226,3838
210480,202105,16387,47694,13600,44265,1167,3376,9924,35049,11091,38425
210490,202105,3680,9133,2984,8184,69,171,2544,6976,2613,7147
210500,202105,6418,24147,5905,23282,391,1770,4836,19001,5227,20771
210510,202105,5935,19378,5189,18577,109,491,4682,16992,4791,17483
210515,202105,3767,11008,3268,10437,190,644,2667,8740,2857,9384
210520,202105,2530,7267,2270,6926,67,243,1938,5863,2005,6106
210530,202105,51622,126469,39882,109213,6771,21980,11782,39541,18553,61521
210535,202105,3343,10767,3087,10393,136,470,2616,8886,2752,9356
210540,202105,14851,42115,12340,38622,1529,4257,8536,28188,10065,32445
210542,202105,6726,15324,5350,13824,460,856,4233,11732,4693,12588
210545,202105,2238,6861,2110,6656,37,157,1885,5884,1922,6041
210547,202105,3597,12713,3204,11977,270,965,2463,9422,2733,10387
210550,202105,6079,18177,4803,16166,334,1273,3397,11761,3731,13034
210560,202105,3699,11029,3296,10387,128,367,2788,8771,2916,9138
210565,202105,1496,4716,1249,4360,55,274,966,3387,1021,3661
210570,202105,10569,28477,9412,27066,308,808,8202,24127,8510,24935
210580,202105,3009,7951,2411,7168,135,311,1653,5149,1788,5460
210590,202105,4289,12662,3730,11955,59,320,3337,10641,3396,10961
210592,202105,2660,7742,2441,7392,20,93,2115,6344,2135,6437
210594,202105,2524,6724,1942,5822,99,283,1435,4473,1534,4756
210596,202105,2624,9112,2368,8626,143,507,1914,7053,2057,7560
210598,202105,1855,5264,1718,5058,50,150,1522,4458,1572,4608
210600,202105,3036,8053,2500,7304,124,311,1902,5633,2026,5944
210610,202105,2826,7631,2430,7155,58,222,2090,6162,2148,6384
210620,202105,2871,7417,2379,6823,64,153,2142,6209,2206,6362
210630,202105,3058,10034,2799,9601,111,474,2317,7879,2428,8353
210632,202105,4455,13938,3965,13238,213,872,3166,10514,3379,11386
210635,202105,1740,6144,1648,5987,101,336,1353,5031,1454,5367
210637,202105,2522,8216,2191,7743,138,601,1635,5887,1773,6488
210640,202105,4591,16209,4300,15877,59,274,3939,14605,3998,14879
210650,202105,7477,21110,6789,20228,142,427,6079,18184,6221,18611
210660,202105,8132,23880,7278,22503,248,1012,6195,18817,6443,19829
210663,202105,2714,7598,2485,7330,163,339,2065,6337,2228,6676
210667,202105,2007,6394,1803,6091,62,217,1597,5475,1659,5692
210670,202105,4716,15167,4287,14492,100,434,3774,12714,3874,13148
210675,202105,5155,13695,4408,12748,316,738,3527,10616,3843,11354
210680,202105,4693,11162,3977,10324,98,166,3622,9528,3720,9694
210690,202105,7630,23148,6365,21751,230,943,5611,19398,5841,20341
210700,202105,2782,7683,2202,6843,154,422,1585,5152,1739,5574
210710,202105,4891,15045,4313,14240,91,485,3836,12517,3927,13002
210720,202105,3063,9754,2720,9325,56,320,2413,8209,2469,8529
210725,202105,1290,4268,1122,4011,47,178,787,2919,834,3097
210730,202105,1210,3085,1020,2821,51,135,874,2408,925,2543
210735,202105,4751,13566,4057,12669,194,507,3472,11179,3666,11686
210740,202105,5276,13688,4571,12881,85,235,3934,11112,4019,11347
210745,202105,4441,11970,4125,11575,111,303,3748,10493,3859,10796
210750,202105,23495,59824,20373,55889,2206,5304,13786,40299,15992,45603
210760,202105,5947,15523,5026,14552,46,104,4756,13933,4802,14037
210770,202105,6144,15654,5316,14695,54,230,5020,13800,5074,14030
210780,202105,7559,23222,6591,21623,630,1735,5037,16945,5667,18680
210790,202105,4312,13489,3911,12972,207,462,3210,11198,3417,11660
210800,202105,4895,12999,4205,12090,90,349,3740,10646,3830,10995
210805,202105,4007,14273,3825,14012,109,539,3394,12404,3503,12943
210810,202105,4870,14073,4446,13526,331,762,3629,11431,3960,12193
210820,202105,6918,19549,5794,17754,659,2045,3437,10919,4096,12964
210825,202105,6796,20730,6138,19864,283,849,5220,17241,5503,18090
210830,202105,7878,21763,7186,20949,329,757,6294,18757,6623,19514
210840,202105,3154,8290,2843,7889,44,144,2545,6991,2589,7135
210845,202105,6482,17326,5799,16583,36,123,5530,15949,5566,16072
210850,202105,5854,19611,4879,18154,206,999,3886,14504,4092,15503
210860,202105,21570,53768,17960,49317,1119,2595,14074,40905,15193,43500
210870,202105,7484,19009,5965,17286,236,558,5232,15342,5468,15900
210880,202105,4254,12922,3816,12390,191,713,3040,9882,3231,10595
210890,202105,3873,11173,3504,10746,326,819,2727,8717,3053,9536
210900,202105,4602,13166,3587,11283,1437,4874,510,1869,1947,6743
210905,202105,2026,5457,1694,5036,45,77,1544,4706,1589,4783
210910,202105,7095,21326,5898,19391,716,2396,3883,12886,4599,15282
210920,202105,3183,10411,2761,9855,70,398,2468,8713,2538,9111
210923,202105,1588,4584,1350,4209,79,234,986,3103,1065,3337
210927,202105,5129,16305,4511,15565,412,1366,3434,12277,3846,13643
210930,202105,2383,8191,2095,7639,140,546,1596,5821,1736,6367
210940,202105,4081,11369,3794,11038,101,407,3486,10021,3587,10428
210945,202105,6804,19028,6093,18193,254,676,5117,15732,5371,16408
210950,202105,5227,14358,4034,12710,585,1396,2664,9234,3249,10630
210955,202105,1548,4768,1340,4422,299,912,746,2646,1045,3558
210960,202105,9048,26464,7851,24665,1436,4142,4974,16513,6410,20655
210970,202105,1364,4091,1100,3643,96,286,810,2676,906,2962
210975,202105,1799,5467,1624,5191,95,313,1298,4179,1393,4492
210980,202105,9952,23203,8728,21939,101,236,8227,20804,8328,21040
210990,202105,16462,45407,12915,40763,688,2225,9543,31298,10231,33523
211000,202105,14669,42076,12249,39088,927,2827,9251,31011,10178,33838
211003,202105,5722,16668,4800,15548,123,463,4149,13756,4272,14219
211010,202105,6408,22456,5721,21571,115,526,5087,19488,5202,20014
211020,202105,8212,23386,7107,22127,238,809,6032,19379,6270,20188
211023,202105,1964,6346,1835,6183,88,290,1549,5225,1637,5515
211027,202105,3126,9744,2968,9501,224,563,2500,8202,2724,8765
211030,202105,3840,10490,3441,9998,249,602,2753,8250,3002,8852
211040,202105,4724,16600,4380,16014,110,655,3946,14291,4056,14946
211050,202105,9003,23276,8212,22238,75,268,7549,20436,7624,20704
211060,202105,6931,20799,6312,19967,163,642,5573,17618,5736,18260
211065,202105,2296,6162,1918,5691,86,222,1581,4811,1667,5033
211070,202105,8051,24646,6870,22886,494,1549,5472,18473,5966,20022
211080,202105,1315,3580,1057,3179,31,163,838,2392,869,2555
211085,202105,2106,5770,1794,5350,100,223,1500,4699,1600,4922
211090,202105,3176,8705,2862,8349,30,138,2661,7736,2691,7874
211100,202105,6799,16981,6282,16368,40,127,5838,15307,5878,15434
211102,202105,3192,10564,2924,10170,157,693,2502,8595,2659,9288
211105,202105,2404,7420,2011,6715,157,533,1449,4818,1606,5351
211107,202105,4821,14838,4142,13854,152,598,3249,11357,3401,11955
211110,202105,6023,16068,4706,14068,345,942,3513,10703,3858,11645
211120,202105,44932,108637,36799,99161,5540,13427,23307,67431,28847,80858
211125,202105,2102,6189,1779,5695,44,148,1506,4846,1550,4994
211130,202105,180404,425479,154322,392016,23747,55715,77569,221803,101316,277518
211140,202105,5025,14579,4411,13810,221,590,3704,11743,3925,12333
211150,202105,9439,25273,7964,23370,354,906,6681,19835,7035,20741
211153,202105,2440,7055,1951,6453,263,881,1279,4431,1542,5312
211157,202105,1161,3605,973,3265,27,126,713,2387,740,2513
211160,202105,4207,11591,3309,10320,123,433,2543,7816,2666,8249
211163,202105,1607,5122,1460,4911,41,177,1288,4351,1329,4528
211167,202105,1599,4892,1498,4741,26,92,1382,4365,1408,4457
211170,202105,6523,15838,6057,15308,74,150,5727,14470,5801,14620
211172,202105,2599,6918,2246,6401,102,289,1789,5001,1891,5290
211174,202105,2876,8228,2600,7920,31,157,2445,7419,2476,7576
211176,202105,4274,11960,3339,10584,145,592,2698,8525,2843,9117
211178,202105,5061,11147,4340,10382,21,82,4182,9928,4203,10010
211180,202105,4062,13246,3779,12841,219,771,3126,10688,3345,11459
211190,202105,3104,8994,2639,8312,29,158,2362,7386,2391,7544
211195,202105,1425,3922,1218,3607,119,221,960,2997,1079,3218
211200,202105,2185,6162,1758,5560,208,593,1217,3938,1425,4531
211210,202105,6328,19110,5716,18308,312,1129,4742,15151,5054,16280
211220,202105,37991,93971,31317,85822,3269,8073,22923,64743,26192,72816
211223,202105,5335,13827,4387,12576,387,1072,3167,9155,3554,10227
211227,202105,1757,5650,1578,5393,58,258,1229,4239,1287,4497
211230,202105,7870,22052,6909,20605,384,895,5641,17245,6025,18140
211240,202105,8034,25150,7631,24638,167,737,7050,22614,7217,23351
211245,202105,7043,17608,6256,16789,74,187,6052,16257,6126,16444
211250,202105,13316,41431,12049,39665,827,2848,9628,31773,10455,34621
211260,202105,8124,25943,7227,24763,229,931,6419,22191,6648,23122
211270,202105,10360,32685,8852,30664,358,1631,7185,25112,7543,26743
211280,202105,12375,33789,11124,32219,842,1939,9142,27542,9984,29481
211285,202105,1874,5939,1672,5666,122,447,1278,4437,1400,4884
211290,202105,7537,22256,6813,21305,204,718,5860,18357,6064,19075
211300,202105,7723,22138,6796,20656,240,764,5579,16776,5819,17540
211400,202105,11706,32500,9605,29642,1053,3185,6386,20858,7439,24043
220005,202105,1881,4745,1715,4524,35,106,1466,3804,1501,3910
220010,202105,1497,4221,1231,3748,22,91,960,2896,982,2987
220020,202105,3855,10229,3306,9476,135,430,2748,7835,2883,8265
220025,202105,2240,5042,1926,4587,30,78,1610,3724,1640,3802
220027,202105,1302,3207,1114,2959,20,62,961,2513,981,2575
220030,202105,3431,8453,3218,8177,93,230,2835,7150,2928,7380
220040,202105,7181,21446,6318,19824,1512,4282,3216,10729,4728,15011
220045,202105,1495,4476,1237,4054,25,128,1027,3310,1052,3438
220050,202105,4755,12743,4055,11843,55,260,3734,10786,3789,11046
220060,202105,2421,5012,2072,4609,27,63,1961,4352,1988,4415
220070,202105,2451,6086,2099,5570,72,131,1752,4677,1824,4808
220080,202105,745,2089,646,1948,21,68,552,1662,573,1730
220090,202105,1766,4189,1485,3790,14,40,1232,3270,1246,3310
220095,202105,655,1599,614,1557,34,56,544,1411,578,1467
220100,202105,1421,3804,1150,3378,42,129,931,2663,973,2792
220105,202105,2081,6288,1827,5810,107,368,1395,4417,1502,4785
220110,202105,3399,9334,3112,8848,33,163,2800,7860,2833,8023
220115,202105,2739,7803,2525,7525,69,201,2298,6832,2367,7033
220117,202105,1445,3372,1147,2966,3,15,974,2464,977,2479
220120,202105,13221,34637,12136,33305,81,248,11398,31249,11479,31497
220130,202105,1143,2978,972,2742,9,47,886,2460,895,2507
220140,202105,2160,4388,1828,4003,94,225,1603,3482,1697,3707
220150,202105,6464,18775,5911,17828,112,472,5027,14940,5139,15412
220155,202105,1214,3398,975,2973,36,105,704,2115,740,2220
220157,202105,1078,2582,913,2331,22,69,729,1810,751,1879
220160,202105,2903,7911,2507,7204,31,125,2054,5791,2085,5916
220170,202105,1638,4202,1404,3856,17,77,1251,3386,1268,3463
220173,202105,2225,6041,1777,5236,37,142,1437,4129,1474,4271
220177,202105,2038,5683,1936,5570,8,27,1912,5497,1920,5524
220180,202105,1134,2698,923,2350,5,19,731,1750,736,1769
220190,202105,7081,17356,6045,15945,356,941,4613,12450,4969,13391
220191,202105,1611,4714,1465,4470,76,246,1050,3160,1126,3406
220192,202105,2104,5432,1551,4462,27,78,1256,3570,1283,3648
220194,202105,1735,4878,1548,4583,50,183,1288,3774,1338,3957
220196,202105,2070,5260,1885,4987,31,117,1635,4255,1666,4372
220198,202105,1296,3489,1103,3239,7,17,1021,3033,1028,3050
220200,202105,5152,14710,4503,13874,59,262,3923,12069,3982,12331
220202,202105,2201,6111,1896,5618,24,117,1629,4747,1653,4864
220205,202105,2532,7158,2268,6678,49,187,1936,5613,1985,5800
220207,202105,787,2347,658,2126,54,181,444,1450,498,1631
220208,202105,1697,5111,1413,4575,179,619,839,2697,1018,3316
220209,202105,1601,4504,1396,4142,25,96,1159,3403,1184,3499
220210,202105,1812,4273,1577,3915,11,44,1379,3333,1390,3377
220211,202105,1661,4103,1529,3926,15,56,1343,3454,1358,3510
220213,202105,1834,4760,1589,4344,18,58,1302,3470,1320,3528
220217,202105,2288,6527,2148,6366,43,80,1994,6027,2037,6107
220220,202105,10805,27461,9042,24840,623,1409,6143,17846,6766,19255
220225,202105,1007,2629,826,2394,4,27,779,2234,783,2261
220230,202105,5679,14056,4865,12935,148,331,4201,11259,4349,11590
220240,202105,3080,8738,2801,8280,109,355,2309,6803,2418,7158
220245,202105,1827,4106,1404,3590,12,44,1277,3298,1289,3342
220250,202105,3024,8285,2659,7824,13,63,2490,7298,2503,7361
220253,202105,1621,4319,1461,4056,55,167,1241,3383,1296,3550
220255,202105,1972,4529,1701,4158,27,121,1488,3521,1515,3642
220260,202105,4476,13337,3926,12348,166,557,3096,9728,3262,10285
220265,202105,1352,4185,1219,4017,31,153,1030,3330,1061,3483
220270,202105,6049,19315,5730,18743,192,904,4801,15225,4993,16129
220271,202105,1504,3817,1316,3553,26,81,1152,3096,1178,3177
220272,202105,1759,5036,1568,4693,46,135,1186,3467,1232,3602
220273,202105,1267,3543,1062,3172,39,150,819,2401,858,2551
220275,202105,2306,5333,1850,4719,39,75,1625,4177,1664,4252
220277,202105,2205,5404,1890,4958,41,93,1579,4092,1620,4185
220280,202105,1697,3858,1415,3499,18,54,1208,2971,1226,3025
220285,202105,1455,3613,1259,3388,10,38,1168,3122,1178,3160
220290,202105,6738,18317,5366,16391,349,1093,3939,12392,4288,13485
220300,202105,2008,5671,1644,5194,31,153,1386,4350,1417,4503
220310,202105,3074,8047,2425,7298,36,166,2063,6190,2099,6356
220320,202105,3117,8903,2414,7612,63,294,1902,5841,1965,6135
220323,202105,1672,4742,1311,4173,52,173,1076,3374,1128,3547
220325,202105,1261,3683,1089,3400,24,112,908,2778,932,2890
220327,202105,1602,4354,1400,4041,31,123,1166,3275,1197,3398
220330,202105,4610,10772,3925,9948,55,178,3553,8958,3608,9136
220335,202105,1685,5030,1524,4819,31,95,1358,4323,1389,4418
220340,202105,1925,4963,1492,4254,55,164,1020,2830,1075,2994
220342,202105,1197,3401,1070,3209,54,159,839,2523,893,2682
220345,202105,3152,7004,2431,5987,16,43,2203,5414,2219,5457
220350,202105,3372,8433,2708,7462,130,353,1939,5408,2069,5761
220360,202105,1249,3169,990,2740,16,43,794,2191,810,2234
220370,202105,8657,24824,7904,23626,145,565,6874,20340,7019,20905
220375,202105,1640,4570,1463,4353,2,7,1395,4180,1397,4187
220380,202105,1483,3481,1219,3120,14,34,1071,2728,1085,2762
220385,202105,839,1975,688,1710,6,15,602,1483,608,1498
220390,202105,10661,26957,8227,23252,2020,5540,2947,9358,4967,14898
220400,202105,1542,3591,1184,3041,24,74,912,2261,936,2335
220410,202105,1171,3187,966,2838,47,127,784,2287,831,2414
220415,202105,841,2120,710,1914,23,54,571,1525,594,1579
220420,202105,2050,5627,1657,4888,60,164,1260,3674,1320,3838
220430,202105,2595,6689,2407,6417,53,167,2110,5553,2163,5720
220435,202105,1819,4604,1568,4236,41,134,1316,3482,1357,3616
220440,202105,2392,7336,2041,6794,73,331,1750,5719,1823,6050
220450,202105,2530,6494,2058,5912,52,174,1764,5079,1816,5253
220455,202105,1303,3969,1243,3885,7,37,1120,3503,1127,3540
220460,202105,1019,2448,949,2363,36,75,813,2018,849,2093
220465,202105,2366,7190,2089,6755,185,580,1530,5078,1715,5658
220470,202105,3554,9681,3216,9148,102,244,2627,7411,2729,7655
220480,202105,2863,7208,2309,6334,222,463,1487,4183,1709,4646
220490,202105,2513,6156,2174,5733,22,109,1899,4940,1921,5049
220500,202105,3017,7398,2641,6822,88,201,2079,5297,2167,5498
220510,202105,2608,7181,2094,6266,82,211,1645,4987,1727,5198
220515,202105,1693,4008,1567,3832,39,59,1368,3355,1407,3414
220520,202105,5045,12880,4572,12217,93,244,3984,10617,4077,10861
220525,202105,1419,3462,1227,3223,6,33,1135,2949,1141,2982
220527,202105,1315,3583,1137,3327,15,60,974,2894,989,2954
220530,202105,1428,3526,1243,3290,31,88,1136,2992,1167,3080
220535,202105,807,2177,756,2108,29,74,610,1705,639,1779
220540,202105,3260,10224,3053,9827,132,433,2580,8286,2712,8719
220545,202105,1465,4277,1361,4115,55,210,1154,3452,1209,3662
220550,202105,8651,26317,7727,24716,452,1514,5902,18737,6354,20251
220551,202105,1436,3943,1279,3695,27,97,1046,2973,1073,3070
220552,202105,1659,4682,1361,4158,22,112,1105,3267,1127,3379
220553,202105,1792,4520,1479,4107,55,92,1206,3477,1261,3569
220554,202105,930,2352,687,1966,52,116,458,1306,510,1422
220555,202105,2517,6995,2190,6587,35,125,1833,5672,1868,5797
220556,202105,1218,3467,1063,3173,42,172,783,2252,825,2424
220557,202105,1684,5065,1417,4485,59,227,1058,3251,1117,3478
220558,202105,1410,3635,1112,3224,16,65,959,2754,975,2819
220559,202105,1840,4431,1566,4014,14,31,1283,3329,1297,3360
220560,202105,1763,3942,1452,3551,40,75,1318,3257,1358,3332
220570,202105,7432,21562,6796,20667,487,1341,5407,16683,5894,18024
220580,202105,7008,18659,6407,17702,98,274,5788,15947,5886,16221
220585,202105,2110,6472,1735,5794,45,122,1427,4817,1472,4939
220590,202105,1395,3703,1156,3354,82,214,833,2468,915,2682
220595,202105,2620,7025,2390,6711,15,73,2144,5965,2159,6038
220600,202105,1422,3112,1208,2856,75,94,1026,2500,1101,2594
220605,202105,1622,4686,1396,4280,16,93,1145,3404,1161,3497
220610,202105,2831,8084,2658,7823,26,122,2493,7309,2519,7431
220620,202105,8019,24205,7383,23348,144,743,6746,21122,6890,21865
220630,202105,384,1111,298,955,26,87,199,627,225,714
220635,202105,1786,5327,1603,4946,37,179,1265,3790,1302,3969
220640,202105,2452,6746,2093,6238,68,270,1706,5036,1774,5306
220650,202105,2107,5697,1822,5267,30,106,1486,4287,1516,4393
220660,202105,2579,7993,2194,7354,68,329,1844,6076,1912,6405
220665,202105,1265,3748,1072,3429,27,137,907,2840,934,2977
220667,202105,1655,5011,1493,4720,59,215,1215,3821,1274,4036
220669,202105,1663,4892,1595,4788,44,182,1430,4206,1474,4388
220670,202105,2232,5673,1794,5061,19,78,1559,4397,1578,4475
220672,202105,3276,7917,2660,7171,82,279,2373,6305,2455,6584
220675,202105,1322,3532,1181,3275,30,84,977,2695,1007,2779
220680,202105,2786,7369,2662,7201,115,221,2415,6645,2530,6866
220690,202105,1601,4162,1415,3888,55,164,1118,3068,1173,3232
220695,202105,922,2505,856,2387,20,60,749,2078,769,2138
220700,202105,10440,24826,8481,22176,331,832,6521,16968,6852,17800
220710,202105,934,2466,688,2013,29,78,524,1497,553,1575
220720,202105,2139,5004,1924,4721,16,60,1690,4097,1706,4157
220730,202105,1325,3638,1134,3321,12,61,963,2761,975,2822
220735,202105,1008,2266,799,1952,25,66,660,1565,685,1631
220740,202105,1378,3505,1115,3168,31,76,936,2701,967,2777
220750,202105,3871,9663,3411,9016,177,411,2991,7943,3168,8354
220755,202105,1384,3283,1152,2940,19,64,960,2398,979,2462
220760,202105,3133,8402,2761,7902,61,173,2514,7252,2575,7425
220770,202105,24165,69919,20518,63790,6062,19802,7124,23271,13186,43073
220775,202105,1186,2924,1052,2754,7,27,1015,2639,1022,2666
220777,202105,1632,4074,1252,3501,33,80,962,2708,995,2788
220779,202105,1271,3261,1104,3019,19,63,975,2640,994,2703
220780,202105,5809,14157,5028,12997,219,621,4067,10326,4286,10947
220785,202105,1499,3291,1318,3061,7,21,1261,2909,1268,2930
220790,202105,10279,28747,9276,27300,171,725,7820,22801,7991,23526
220793,202105,939,2439,757,2127,6,9,633,1801,639,1810
220795,202105,1403,3561,1236,3341,22,72,1087,2936,1109,3008
220800,202105,18528,40146,15813,36634,585,1269,12424,28744,13009,30013
220810,202105,3071,8379,2600,7556,40,114,2155,6196,2195,6310
220820,202105,4904,12735,4293,11840,243,578,3287,9078,3530,9656
220830,202105,7320,19056,6579,18034,259,772,5450,14734,5709,15506
220840,202105,12210,36856,10237,32869,2184,6690,4893,16358,7077,23048
220850,202105,3191,9638,2879,9253,46,231,2571,8272,2617,8503
220855,202105,708,1751,619,1632,19,56,559,1463,578,1519
220860,202105,1058,2606,925,2402,16,66,837,2140,853,2206
220865,202105,2469,6417,1921,5450,71,265,1413,3886,1484,4151
220870,202105,3115,8336,2604,7671,26,122,2404,7074,2430,7196
220880,202105,5383,12521,4644,11609,72,261,4260,10535,4332,10796
220885,202105,1425,4175,1185,3779,58,188,932,3024,990,3212
220887,202105,1590,3359,1338,3040,14,31,1238,2801,1252,2832
220890,202105,1427,4251,1250,3994,45,150,1042,3379,1087,3529
220900,202105,2033,4777,1700,4355,32,73,1493,3820,1525,3893
220910,202105,1552,4157,1309,3797,54,144,1074,3150,1128,3294
220915,202105,980,2572,801,2251,14,45,613,1657,627,1702
220920,202105,1432,4386,1243,4141,53,221,1026,3442,1079,3663
220930,202105,1803,4739,1519,4335,21,60,1419,4044,1440,4104
220935,202105,1109,3156,904,2720,22,90,587,1672,609,1762
220937,202105,1520,3925,1310,3596,21,78,1056,2847,1077,2925
220940,202105,1588,4317,1273,3762,29,84,999,2922,1028,3006
220945,202105,449,1531,391,1406,16,93,298,1040,314,1133
220950,202105,1433,3273,954,2536,20,56,757,1944,777,2000
220955,202105,1648,4096,1369,3621,26,65,1178,3078,1204,3143
220960,202105,811,2033,610,1693,25,71,437,1164,462,1235
220965,202105,1808,4863,1574,4523,18,110,1362,3835,1380,3945
220970,202105,2018,4696,1488,3920,24,56,1247,3258,1271,3314
220975,202105,695,1932,598,1811,11,62,534,1571,545,1633
220980,202105,1170,3248,1039,3070,33,121,871,2556,904,2677
220985,202105,1306,3287,1135,3040,52,123,926,2434,978,2557
220987,202105,1470,4294,1295,3987,53,178,1051,3223,1104,3401
220990,202105,1737,4722,1534,4421,14,80,1315,3738,1329,3818
220995,202105,1132,3288,945,2946,33,105,706,2209,739,2314
220997,202105,2375,7128,2195,6838,40,168,1960,6048,2000,6216
221000,202105,4529,12225,4000,11452,81,342,3435,9744,3516,10086
221005,202105,1491,3825,1366,3620,16,76,1187,3062,1203,3138
221010,202105,1267,2791,1001,2464,17,52,872,2109,889,2161
221020,202105,1537,4647,1426,4442,20,72,1094,3377,1114,3449
221030,202105,1698,4040,1453,3740,20,50,1262,3309,1282,3359
221035,202105,1525,3882,1345,3644,20,26,1194,3314,1214,3340
221037,202105,719,1905,598,1697,7,22,438,1187,445,1209
221038,202105,537,1486,422,1286,13,48,291,876,304,924
221039,202105,881,2361,759,2163,22,91,620,1709,642,1800
221040,202105,4208,12115,3690,11206,160,465,2970,9076,3130,9541
221050,202105,3952,10195,3498,9623,70,216,3150,8670,3220,8886
221060,202105,8814,24236,7328,21800,322,772,5880,17726,6202,18498
221062,202105,1143,3627,990,3376,37,157,801,2714,838,2871
221063,202105,1083,2900,935,2688,49,146,744,2113,793,2259
221065,202105,2686,6776,2365,6219,15,50,2079,5392,2094,5442
221070,202105,3459,10479,2803,9113,286,913,1738,5771,2024,6684
221080,202105,3527,8541,2904,7626,59,201,2394,6174,2453,6375
221090,202105,1435,3586,1180,3183,9,29,1008,2674,1017,2703
221093,202105,1395,3846,1270,3604,137,355,859,2414,996,2769
221095,202105,878,2274,749,2079,8,21,638,1746,646,1767
221097,202105,875,2192,671,1827,23,54,503,1303,526,1357
221100,202105,119689,313863,99920,280482,10040,30006,64784,176922,74824,206928
221110,202105,9932,29298,9123,28244,129,649,8204,25190,8333,25839
221120,202105,4857,13216,4333,12390,154,436,3768,10822,3922,11258
221130,202105,5556,14053,4218,11513,823,2097,2055,5658,2878,7755
221135,202105,1761,4411,1588,4186,37,96,1427,3773,1464,3869
221140,202105,1354,3110,1144,2851,10,33,1037,2544,1047,2577
221150,202105,1106,2731,873,2335,22,99,674,1686,696,1785
221160,202105,747,1824,662,1717,25,33,534,1403,559,1436
221170,202105,1018,2860,936,2712,9,35,820,2338,829,2373
230010,202105,3076,7941,2543,7054,32,107,2106,5718,2138,5825
230015,202105,3106,9840,2751,9121,151,548,1951,6463,2102,7011
230020,202105,12984,40397,12166,39160,351,1367,10397,33363,10748,34730
230030,202105,13166,32227,11064,29497,222,593,9672,25822,9894,26415
230040,202105,4569,11557,3785,10281,40,183,3182,8506,3222,8689
230050,202105,2753,8420,2108,6934,337,1055,938,3017,1275,4072
230060,202105,2397,6465,1929,5627,26,107,1538,4411,1564,4518
230070,202105,4141,10588,3336,9081,207,590,2367,6355,2574,6945
230075,202105,8851,28607,8127,27354,498,1968,6446,21473,6944,23441
230080,202105,3051,6405,2330,5528,6,18,2129,5071,2135,5089
230090,202105,4452,10715,3788,9689,189,449,3032,7716,3221,8165
230100,202105,18460,46720,16216,43751,1322,3404,11616,31681,12938,35085
230110,202105,12811,37385,10767,33441,1759,5389,5600,17611,7359,23000
230120,202105,7840,20448,6898,18958,541,1277,5078,14158,5619,15435
230125,202105,3197,8355,2594,7398,85,280,2001,5615,2086,5895
230130,202105,5639,17184,4582,14892,394,1335,2959,9515,3353,10850
230140,202105,3434,10197,2941,9183,85,341,2257,6891,2342,7232
230150,202105,1640,4847,1346,4202,206,564,783,2516,989,3080
230160,202105,6564,16716,5679,15371,149,479,4728,12612,4877,13091
230170,202105,6532,18152,5373,15827,328,861,3847,11233,4175,12094
230180,202105,1661,4539,1407,4051,18,79,1154,3218,1172,3297
230185,202105,4508,12493,3825,11364,287,885,2814,8375,3101,9260
230190,202105,13962,39778,11737,35682,1333,4127,6940,20948,8273,25075
230195,202105,5422,15621,4943,14728,392,1132,3685,11002,4077,12134
230200,202105,5077,13813,4272,12326,148,446,3297,9342,3445,9788
230205,202105,4233,12182,3716,11408,209,625,2811,8639,3020,9264
230210,202105,10156,24189,8584,22108,348,1073,6737,17079,7085,18152
230220,202105,13873,34574,12191,32183,556,1462,10085,26395,10641,27857
230230,202105,6920,20244,6184,18765,413,1200,4587,13920,5000,15120
230240,202105,12884,34265,11149,31288,257,1099,9242,25339,9499,26438
230250,202105,9037,24876,8393,23873,242,818,6805,18823,7047,19641
230260,202105,14953,43386,12949,39883,2123,6141,7004,22282,9127,28423
230270,202105,7813,20531,5995,17147,555,1524,3849,11127,4404,12651
230280,202105,20525,54132,16868,48038,438,1711,13293,36512,13731,38223
230290,202105,5061,13671,4184,12039,226,557,3203,9192,3429,9749
230300,202105,4899,12793,4431,12162,92,254,3900,10688,3992,10942
230310,202105,4708,13227,4002,11969,119,484,2904,8507,3023,8991
230320,202105,7951,22560,6683,20258,203,831,5175,15340,5378,16171
230330,202105,4778,12729,3811,10913,117,364,2905,8120,3022,8484
230340,202105,3855,11633,3315,10533,228,753,2337,7344,2565,8097
230350,202105,18220,49015,15913,45660,787,2557,10899,31434,11686,33991
230360,202105,3008,7770,2383,6678,121,329,1665,4601,1786,4930
230365,202105,3101,7561,2563,6769,52,229,2189,5693,2241,5922
230370,202105,60079,162557,51287,149759,7007,20603,31611,93046,38618,113649
230380,202105,6348,17328,5028,14927,111,436,3773,10922,3884,11358
230390,202105,3444,9965,2987,9230,84,327,2336,7148,2420,7475
230393,202105,3441,9846,2747,8430,74,385,2138,6291,2212,6676
230395,202105,5726,15566,4982,14333,338,927,3511,10138,3849,11065
230400,202105,5421,14769,4846,13836,76,374,3928,10929,4004,11303
230410,202105,13861,40521,11482,36199,880,2955,7861,24824,8741,27779
230420,202105,29605,79495,24197,70338,2854,8525,13799,39783,16653,48308
230423,202105,4877,14115,4278,12939,103,389,3481,10383,3584,10772
230425,202105,5729,17246,5225,16224,438,1395,3717,11476,4155,12871
230426,202105,2876,7355,2110,5885,26,94,1602,4364,1628,4458
230427,202105,1878,5166,1370,4123,76,232,883,2559,959,2791
230428,202105,9726,25541,8324,23473,1220,3333,4782,13508,6002,16841
230430,202105,5038,13887,3986,12074,157,508,2976,8903,3133,9411
230435,202105,6181,15743,5153,13954,724,1773,3017,8332,3741,10105
230440,202105,426267,1033461,355855,931737,32519,89730,236163,609294,268682,699024
230445,202105,4322,11305,3489,9857,188,499,2386,6592,2574,7091
230450,202105,3650,10258,3183,9589,227,822,2344,6866,2571,7688
230460,202105,2154,5890,1875,5451,50,204,1584,4568,1634,4772
230465,202105,4199,11518,3562,10314,106,382,2707,7542,2813,7924
230470,202105,11508,37203,10337,35058,882,3280,7270,24357,8152,27637
230480,202105,1486,4243,1249,3818,59,238,931,2740,990,2978
230490,202105,2626,7188,2231,6453,162,535,1434,3908,1596,4443
230495,202105,5734,16771,5068,15590,420,1445,3337,10178,3757,11623
230500,202105,9498,29872,8459,27981,233,936,6927,22926,7160,23862
230510,202105,1658,4794,1311,4066,163,532,696,2122,859,2654
230520,202105,4766,12954,4134,11865,347,893,2876,8307,3223,9200
230523,202105,15566,45097,12457,38595,2725,8417,3172,10484,5897,18901
230526,202105,3792,10582,3252,9681,189,499,2369,7144,2558,7643
230530,202105,5437,16795,4589,15141,299,1080,3327,10817,3626,11897
230533,202105,4695,10801,3845,9484,110,267,3206,7791,3316,8058
230535,202105,5279,14549,4475,13199,308,898,2985,8902,3293,9800
230540,202105,16141,43365,13856,40005,276,998,11494,32967,11770,33965
230550,202105,21689,55861,17499,48864,1473,4164,11391,31634,12864,35798
230560,202105,8113,19641,6617,17303,58,231,5698,14775,5756,15006
230565,202105,3091,8450,2605,7566,104,407,2000,5684,2104,6091
230570,202105,3443,8698,2946,8013,86,216,2418,6576,2504,6792
230580,202105,11370,28612,9779,26363,388,981,8052,21699,8440,22680
230590,202105,9110,25277,7622,22599,422,1391,5693,16384,6115,17775
230600,202105,3830,9550,3038,8197,90,222,2081,5661,2171,5883
230610,202105,6782,18366,6032,17118,436,1176,4774,13483,5210,14659
230620,202105,2151,5674,1683,4786,105,322,1061,2912,1166,3234
230625,202105,8384,22963,7080,20635,1942,5857,2172,6663,4114,12520
230630,202105,11106,31960,9688,29238,1292,3674,5961,18292,7253,21966
230640,202105,27569,82348,24989,78298,1118,4289,20120,62161,21238,66450
230650,202105,5345,14043,4531,12643,123,451,3702,10071,3825,10522
230655,202105,9381,31153,8828,30212,668,2218,7048,24449,7716,26667
230660,202105,6156,17991,5030,16017,135,712,4082,12727,4217,13439
230670,202105,6278,14669,4610,12037,123,389,3705,9441,3828,9830
230680,202105,2738,7309,2305,6547,120,304,1657,4729,1777,5033
230690,202105,7296,21089,6284,19134,393,1365,4035,12062,4428,13427
230700,202105,10525,26274,8560,22706,384,863,6318,16546,6702,17409
230710,202105,6947,21601,6099,19801,661,2007,4016,13061,4677,15068
230720,202105,1885,5491,1551,4840,107,294,1084,3326,1191,3620
230725,202105,4240,12166,3811,11426,386,1254,2336,6897,2722,8151
230730,202105,58417,153348,45997,134868,10230,31886,14735,46353,24965,78239
230740,202105,6194,16893,5261,15399,137,422,4203,12298,4340,12720
230750,202105,8523,22351,7125,20055,155,497,5709,15688,5864,16185
230760,202105,11174,28947,9710,26756,479,1539,7392,19883,7871,21422
230763,202105,5126,13433,4297,11976,106,462,3496,9423,3602,9885
230765,202105,41837,111027,34783,99754,5182,15327,18106,51306,23288,66633
230770,202105,25560,62011,21412,56592,2115,5519,14467,38367,16582,43886
230780,202105,6527,22444,5916,20992,854,2886,3443,12624,4297,15510
230790,202105,3146,8696,2833,8194,95,379,2198,6156,2293,6535
230800,202105,8276,25849,7273,23832,962,3276,4180,13550,5142,16826
230810,202105,11160,33256,10031,31451,361,1314,7840,24212,8201,25526
230820,202105,3521,11173,2908,9843,253,979,1764,5679,2017,6658
230830,202105,7624,20432,6515,18602,115,476,5385,14974,5500,15450
230835,202105,4332,10100,3364,8597,92,257,2703,6800,2795,7057
230837,202105,3125,9336,2794,8780,111,443,2233,6885,2344,7328
230840,202105,9507,27103,8182,24831,991,2715,5616,17310,6607,20025
230850,202105,9874,27945,8285,24847,352,1158,6050,17901,6402,19059
230860,202105,5520,13526,4597,12218,55,177,4063,10722,4118,10899
230870,202105,16488,39572,14216,35836,395,1069,11670,28883,12065,29952
230880,202105,2133,6309,1952,6018,43,218,1559,4686,1602,4904
230890,202105,4524,14280,4130,13509,323,1141,3027,9774,3350,10915
230900,202105,3075,8630,2665,7872,161,531,1847,5315,2008,5846
230910,202105,3217,8438,2606,7505,57,253,2109,6073,2166,6326
230920,202105,4808,13221,4046,12014,102,410,3236,9401,3338,9811
230930,202105,6789,18479,5706,16572,275,749,4015,11655,4290,12404
230940,202105,8353,20632,7255,18987,201,459,6090,15874,6291,16333
230945,202105,6645,18672,5703,16908,284,983,4078,11808,4362,12791
230950,202105,6289,15569,5564,14588,115,259,4783,12624,4898,12883
230960,202105,13650,38561,11978,35442,2068,5951,5800,17322,7868,23273
230970,202105,13768,35817,11513,32377,1638,4422,6764,19252,8402,23674
230980,202105,2727,7755,2415,7208,337,941,1535,4738,1872,5679
230990,202105,1695,4671,1399,4097,61,240,1004,2801,1065,3041
231000,202105,2571,6790,2099,5869,78,186,1559,4256,1637,4442
231010,202105,3728,8526,2937,7186,27,103,2569,6111,2596,6214
231020,202105,8040,24463,7191,22855,1207,3446,4240,14020,5447,17466
231025,202105,7641,20508,6657,18911,716,1933,4695,13494,5411,15427
231030,202105,7468,21750,5890,18454,984,2901,3017,9583,4001,12484
231040,202105,2945,8293,2561,7595,120,362,2006,5858,2126,6220
231050,202105,11808,29704,9689,26011,619,1560,7256,19142,7875,20702
231060,202105,2932,8128,2592,7589,54,163,2173,6362,2227,6525
231070,202105,7985,22698,6875,20773,652,2013,4632,13870,5284,15883
231080,202105,3986,11091,3385,10111,141,529,2564,7500,2705,8029
231085,202105,6999,16454,5587,14816,212,486,4409,11736,4621,12222
231090,202105,4605,11777,3403,9488,102,388,2313,6191,2415,6579
231095,202105,2285,6676,1815,5684,157,473,1207,3785,1364,4258
231100,202105,3257,9209,2673,8105,122,417,2001,6015,2123,6432
231110,202105,3725,10634,3395,10025,134,463,2581,7514,2715,7977
231120,202105,2354,6671,1955,5985,76,265,1418,4301,1494,4566
231123,202105,1952,4941,1647,4421,87,181,1196,3242,1283,3423
231126,202105,5535,14957,4546,13103,294,775,3240,9284,3534,10059
231130,202105,22094,54692,18364,50050,1036,3172,13722,36882,14758,40054
231135,202105,4208,11708,3503,10351,179,561,2484,7259,2663,7820
231140,202105,16653,46118,13450,40625,656,2332,9534,28196,10190,30528
231150,202105,6015,15955,4555,13206,633,1871,1962,5860,2595,7731
231160,202105,6301,19011,5620,17779,775,2365,3189,10402,3964,12767
231170,202105,4305,12287,3617,11020,206,671,2552,7544,2758,8215
231180,202105,14478,40246,11851,34836,2923,8379,4392,13256,7315,21635
231190,202105,4027,11093,3315,9807,62,248,2571,7453,2633,7701
231195,202105,5176,15082,4341,13402,284,923,3134,9662,3418,10585
231200,202105,7815,23974,6865,22073,179,880,5440,16979,5619,17859
231210,202105,4988,14253,4263,13061,145,501,3312,9948,3457,10449
231220,202105,12568,31695,9945,26865,459,1245,7296,19170,7755,20415
231230,202105,9191,29021,8123,27051,546,2028,5929,19834,6475,21862
231240,202105,11607,33266,10233,30717,1617,4633,6142,18755,7759,23388
231250,202105,2184,5494,1442,3888,112,313,856,2234,968,2547
231260,202105,3323,9124,2897,8455,269,720,1968,5905,2237,6625
231270,202105,6419,16522,5157,14450,150,541,3904,10665,4054,11206
231280,202105,1772,5366,1627,5108,90,247,1228,3853,1318,4100
231290,202105,38275,112156,31864,99432,5348,16452,14701,45582,20049,62034
231300,202105,4173,11259,3283,9509,153,512,2270,6403,2423,6915
231310,202105,7619,19131,6094,16374,528,1400,4136,10864,4664,12264
231320,202105,7811,21140,6133,18191,86,381,4826,14112,4912,14493
231325,202105,2522,6347,2079,5699,173,335,1459,4142,1632,4477
231330,202105,9722,28219,8081,24986,1531,4386,4263,13909,5794,18295
231335,202105,5716,14894,4884,13588,62,283,4321,11882,4383,12165
231340,202105,18295,54598,16520,51478,1198,3687,12392,38925,13590,42612
231350,202105,15893,43039,14551,41110,234,828,13117,36742,13351,37570
231355,202105,4409,12894,3986,12100,219,695,3126,9382,3345,10077
231360,202105,7757,22780,6729,21018,285,950,5363,16720,5648,17670
231370,202105,2200,5994,1765,5210,36,110,1343,3949,1379,4059
231375,202105,4295,13265,3925,12667,119,527,3289,10497,3408,11024
231380,202105,6078,16311,5502,15523,194,474,4486,12832,4680,13306
231390,202105,3444,9826,3103,9253,113,420,2319,6727,2432,7147
231395,202105,4176,11877,3479,10780,312,972,2236,6932,2548,7904
231400,202105,9846,27886,8262,25003,248,1049,6289,18622,6537,19671
231410,202105,14927,45329,13659,43252,631,2046,11059,34889,11690,36935
240010,202105,2645,6777,2064,5755,214,594,1208,3325,1422,3919
240020,202105,12883,35232,10781,31545,631,2183,7148,20639,7779,22822
240030,202105,3069,7163,2742,6682,109,283,2377,5750,2486,6033
240040,202105,838,2376,712,2141,30,112,485,1409,515,1521
240050,202105,3388,8905,2747,7760,42,115,2106,5849,2148,5964
240060,202105,1416,3725,1161,3265,21,71,951,2621,972,2692
240070,202105,2191,6165,1981,5725,196,575,1437,4060,1633,4635
240080,202105,2964,7873,2412,6907,62,216,1814,5117,1876,5333
240090,202105,2272,5552,1856,4856,19,57,1554,4010,1573,4067
240100,202105,10433,25062,8326,21356,190,558,6580,16301,6770,16859
240110,202105,4556,12769,3833,11465,175,637,2811,8224,2986,8861
240120,202105,3372,9184,2733,8399,178,574,1974,6195,2152,6769
240130,202105,3787,7679,3138,6846,29,79,2869,6189,2898,6268
240140,202105,1773,5275,1529,4797,161,558,1040,3221,1201,3779
240145,202105,6649,18180,5439,16117,841,2536,3106,9320,3947,11856
240150,202105,973,2762,856,2527,42,132,668,1923,710,2055
240160,202105,1474,4358,1238,3918,36,151,943,2988,979,3139
240165,202105,979,2642,816,2334,21,85,679,1898,700,1983
240170,202105,2697,7042,2271,6298,212,599,1524,4157,1736,4756
240180,202105,3024,8813,2412,7577,562,1683,1053,3518,1615,5201
240185,202105,1257,3841,1161,3671,50,180,984,3080,1034,3260
240190,202105,1087,3128,936,2881,19,80,794,2463,813,2543
240200,202105,10948,27415,8726,23690,903,2595,4982,13274,5885,15869
240210,202105,3366,8133,2728,7113,23,115,2302,5808,2325,5923
240220,202105,7351,21812,6608,20660,316,1337,5280,16270,5596,17607
240230,202105,5891,14757,4720,12846,228,551,3698,10132,3926,10683
240240,202105,1828,5215,1192,3760,114,377,401,1129,515,1506
240250,202105,3067,7814,2676,7276,72,213,2300,6204,2372,6417
240260,202105,13791,40468,11984,37468,1716,4986,7372,24271,9088,29257
240270,202105,2361,6881,2077,6408,115,339,1510,4808,1625,5147
240280,202105,1738,4333,1460,3881,61,147,1155,3043,1216,3190
240290,202105,1184,3411,968,2940,25,108,695,1994,720,2102
240300,202105,2337,5864,1685,4686,71,212,1043,2844,1114,3056
240310,202105,8474,22206,6666,18996,873,2631,3398,9522,4271,12153
240320,202105,2105,5606,1529,4494,33,140,1151,3229,1184,3369
240325,202105,31995,83778,25610,72777,4203,12239,11867,33681,16070,45920
240330,202105,1814,4851,1400,4073,56,180,968,2706,1024,2886
240340,202105,1988,4514,1623,3972,55,126,1337,3220,1392,3346
240350,202105,2251,5613,2015,5344,36,91,1823,4857,1859,4948
240360,202105,9567,25669,8489,24008,854,2395,5932,16988,6786,19383
240370,202105,2023,5113,1578,4232,58,154,1122,2920,1180,3074
240375,202105,936,2314,780,2045,27,89,622,1571,649,1660
240380,202105,2242,6317,1678,5082,144,396,956,2878,1100,3274
240390,202105,1077,2534,775,1979,26,52,494,1177,520,1229
240400,202105,1537,3669,1183,3063,33,108,845,2065,878,2173
240410,202105,594,1708,487,1505,38,135,317,934,355,1069
240420,202105,4621,15813,4090,14655,454,1893,2494,8759,2948,10652
240430,202105,3497,8786,2906,7775,167,497,2176,5651,2343,6148
240440,202105,2530,5476,2149,4955,139,263,1739,4047,1878,4310
240450,202105,4612,12268,3640,10495,352,1026,2129,5920,2481,6946
240460,202105,2978,8291,2642,7749,219,673,2072,6076,2291,6749
240470,202105,3642,10811,2757,8974,626,1927,1203,4164,1829,6091
240480,202105,602,1602,404,1171,32,83,191,528,223,611
240485,202105,2245,6107,1819,5354,121,336,1249,3692,1370,4028
240490,202105,1640,4146,1295,3512,85,182,946,2604,1031,2786
240500,202105,2198,5835,1908,5337,110,286,1522,4288,1632,4574
240510,202105,1702,4453,1476,4109,72,239,1196,3279,1268,3518
240520,202105,1543,3626,1189,3152,77,184,874,2392,951,2576
240530,202105,2280,6180,2054,5829,97,280,1718,4827,1815,5107
240540,202105,2360,5770,2072,5328,65,108,1782,4627,1847,4735
240550,202105,724,1957,656,1826,15,63,562,1513,577,1576
240560,202105,3301,8437,2792,7760,266,639,2028,5787,2294,6426
240570,202105,2866,7370,1938,5374,293,792,691,1830,984,2622
240580,202105,7974,23193,7062,21519,581,1638,5585,17232,6166,18870
240590,202105,788,1936,695,1786,11,33,552,1390,563,1423
240600,202105,1855,4926,1372,3941,45,130,925,2558,970,2688
240610,202105,4232,11099,3629,10033,117,366,2820,7634,2937,8000
240615,202105,1280,3240,1029,2802,112,283,698,1881,810,2164
240620,202105,1858,5075,1605,4653,108,266,1272,3703,1380,3969
240630,202105,2077,5728,1870,5376,136,282,1332,3994,1468,4276
240640,202105,975,2562,776,2234,27,98,571,1611,598,1709
240650,202105,4120,11343,3545,10171,235,644,2669,7575,2904,8219
240660,202105,3063,7750,2721,7318,48,147,2475,6663,2523,6810
240670,202105,2497,6901,2013,5912,142,424,1311,3766,1453,4190
240680,202105,1639,4281,1335,3772,60,171,1003,2769,1063,2940
240690,202105,1066,2576,837,2201,15,63,675,1704,690,1767
240700,202105,2506,7137,2044,6280,71,240,1567,4754,1638,4994
240710,202105,16401,41570,13791,37184,1710,4507,8737,23470,10447,27977
240720,202105,5159,12469,4454,11492,380,991,3325,8506,3705,9497
240725,202105,1164,3234,895,2718,39,117,600,1763,639,1880
240730,202105,2328,6338,1863,5427,50,159,1424,4089,1474,4248
240740,202105,1908,5069,1538,4340,47,171,1128,3024,1175,3195
240750,202105,2163,6961,1838,6283,243,866,1027,3566,1270,4432
240760,202105,1702,3816,1227,3108,65,87,951,2466,1016,2553
240770,202105,3273,8907,2761,8167,124,427,2250,6585,2374,7012
240780,202105,4681,12894,3867,11549,537,1576,2367,7267,2904,8843
240790,202105,896,2488,747,2205,18,83,563,1602,581,1685
240800,202105,49867,116757,38875,100342,5088,13190,20480,52808,25568,65998
240810,202105,92472,233805,78609,211316,8474,23519,51818,136808,60292,160327
240820,202105,6054,17635,5256,16212,714,2153,3228,10148,3942,12301
240830,202105,8841,24715,7848,23255,234,911,6513,19102,6747,20013
240840,202105,1122,2734,895,2375,25,63,647,1657,672,1720
240850,202105,1436,3835,1037,3002,60,172,582,1625,642,1797
240860,202105,1364,3544,1030,2952,12,53,795,2175,807,2228
240870,202105,1101,2741,835,2295,142,404,447,1262,589,1666
240880,202105,1273,3977,1119,3676,75,323,862,2755,937,3078
240890,202105,4474,12067,3443,10148,446,1423,1756,4955,2202,6378
240895,202105,2916,8752,2692,8399,180,519,2246,7151,2426,7670
240910,202105,3552,9319,3009,8361,50,164,2476,6746,2526,6910
240920,202105,1012,2573,816,2267,92,187,454,1353,546,1540
240930,202105,3717,8284,3065,7490,226,328,2248,5871,2474,6199
240933,202105,1696,4125,1428,3746,33,133,1257,3239,1290,3372
240940,202105,6065,14821,4747,12555,557,1439,2777,7236,3334,8675
240950,202105,1082,3149,945,2900,30,122,764,2279,794,2401
240960,202105,686,2095,616,1955,25,82,480,1503,505,1585
240970,202105,1897,4828,1532,4210,62,213,1248,3340,1310,3553
240980,202105,3359,9813,2963,9109,103,454,2418,7296,2521,7750
240990,202105,2667,7310,2357,6720,239,754,1682,4624,1921,5378
241000,202105,955,2474,750,2105,30,70,559,1544,589,1614
241010,202105,2869,8906,2612,8363,169,605,1931,6117,2100,6722
241020,202105,2210,5733,1673,4682,104,280,1140,3093,1244,3373
241025,202105,1817,5104,1456,4453,39,161,1064,3186,1103,3347
241030,202105,2503,7743,2020,6720,235,777,1279,4286,1514,5063
241040,202105,2291,7104,2009,6607,84,382,1578,5150,1662,5532
241050,202105,1403,3866,1156,3418,31,111,846,2430,877,2541
241060,202105,782,2150,686,1957,32,92,480,1330,512,1422
241070,202105,696,1834,597,1671,14,39,463,1254,477,1293
241080,202105,1134,3178,875,2660,24,71,639,1923,663,1994
241090,202105,1989,5737,1627,5119,49,222,1276,3960,1325,4182
241100,202105,1211,3284,928,2717,64,182,605,1727,669,1909
241105,202105,944,2841,775,2529,237,757,255,860,492,1617
241110,202105,1012,2776,760,2249,36,102,517,1481,553,1583
241120,202105,7708,21537,6518,19449,880,2551,3929,12061,4809,14612
241140,202105,3432,8912,2659,7387,139,389,1934,5258,2073,5647
241142,202105,805,2127,595,1736,28,88,354,988,382,1076
241150,202105,6099,15415,5410,14323,162,428,4416,11572,4578,12000
241160,202105,1191,3185,952,2752,139,411,594,1667,733,2078
241170,202105,1390,3463,1179,3096,33,101,970,2460,1003,2561
241180,202105,1072,2698,801,2179,92,255,393,1070,485,1325
241190,202105,1174,3020,982,2636,16,66,726,1871,742,1937
241200,202105,20220,51596,17516,47194,2703,7245,10223,27498,12926,34743
241210,202105,1469,3812,1062,3017,108,322,607,1692,715,2014
241220,202105,9234,26162,8080,24251,1693,5048,3985,12389,5678,17437
241230,202105,2980,7737,2641,7214,115,322,2174,5890,2289,6212
241240,202105,1262,3470,819,2515,75,230,335,1034,410,1264
241250,202105,5719,16022,4588,13915,149,623,3393,9916,3542,10539
241255,202105,2335,7070,2069,6529,114,411,1581,4910,1695,5321
241260,202105,5006,12759,3989,11090,88,332,3180,8667,3268,8999
241270,202105,1671,4788,1398,4271,105,345,1004,3080,1109,3425
241280,202105,2246,5502,1932,4939,66,158,1637,4131,1703,4289
241290,202105,3391,8235,2506,6815,75,229,1968,5224,2043,5453
241300,202105,1554,4042,1256,3530,34,109,860,2352,894,2461
241310,202105,2190,5314,1889,4890,19,51,1638,4293,1657,4344
241320,202105,944,3014,811,2763,82,339,533,1795,615,2134
241330,202105,1812,4555,1426,4044,16,87,1252,3521,1268,3608
241335,202105,3368,9221,2965,8492,117,361,2408,6820,2525,7181
241340,202105,1596,4395,1254,3710,238,766,537,1511,775,2277
241350,202105,2208,5962,1934,5474,112,298,1506,4240,1618,4538
241355,202105,1348,3574,1109,3122,12,31,851,2358,863,2389
241360,202105,2079,5314,1572,4302,41,107,1160,3097,1201,3204
241370,202105,1410,3783,1103,3147,49,143,790,2189,839,2332
241380,202105,705,1875,546,1576,73,186,276,813,349,999
241390,202105,2744,7940,2449,7505,193,518,1885,5908,2078,6426
241400,202105,3624,9897,3234,9304,145,473,2614,7460,2759,7933
241410,202105,2478,7202,2021,6269,319,1010,1071,3343,1390,4353
241415,202105,1711,4908,1424,4362,48,163,1052,3181,1100,3344
241420,202105,2441,7384,2110,6831,425,1498,1147,3718,1572,5216
241430,202105,627,1661,443,1275,15,44,287,789,302,833
241440,202105,7961,23632,7129,22182,357,1189,5676,17663,6033,18852
241445,202105,1202,2935,1061,2750,41,82,913,2462,954,2544
241450,202105,2838,6707,2393,6011,369,777,1595,4174,1964,4951
241460,202105,3949,10472,3214,8951,211,555,2204,6012,2415,6567
241470,202105,1422,3724,1171,3348,24,80,970,2777,994,2857
241475,202105,1256,3422,997,2928,22,104,751,2097,773,2201
241480,202105,3047,9301,2504,8126,753,2412,818,2971,1571,5383
241490,202105,675,1550,530,1347,20,39,410,1031,430,1070
241500,202105,800,2217,719,2116,3,10,671,1994,674,2004
250010,202105,2649,7754,2219,6871,53,190,1625,4929,1678,5119
250020,202105,1691,4396,1234,3523,49,83,880,2534,929,2617
250030,202105,7092,19035,6282,17771,552,1518,4674,13139,5226,14657
250040,202105,4179,12374,3626,11373,277,886,2645,8183,2922,9069
250050,202105,3668,9618,3314,9157,90,326,2794,7699,2884,8025
250053,202105,1231,3349,1131,3196,84,210,830,2368,914,2578
250057,202105,693,2340,645,2268,9,40,588,2090,597,2130
250060,202105,5609,14267,5053,13584,265,682,4228,11455,4493,12137
250070,202105,4115,11193,3465,10080,28,104,2807,7982,2835,8086
250073,202105,786,2038,639,1814,11,21,510,1432,521,1453
250077,202105,2308,5962,1755,5074,54,177,1357,3880,1411,4057
250080,202105,5177,12426,4374,11416,56,217,3874,9975,3930,10192
250090,202105,3492,8182,3042,7589,56,142,2628,6457,2684,6599
250100,202105,3671,10876,3303,10212,158,514,2592,7876,2750,8390
250110,202105,4918,13610,4444,12941,253,889,3467,9936,3720,10825
250115,202105,744,1842,548,1544,13,51,415,1148,428,1199
250120,202105,1899,5409,1592,4906,25,121,1270,3882,1295,4003
250130,202105,5695,15240,4807,13972,63,328,4122,11831,4185,12159
250135,202105,1231,3337,1071,3066,16,50,942,2706,958,2756
250140,202105,2330,6617,2169,6421,100,374,1883,5554,1983,5928
250150,202105,4812,14643,4309,13791,131,525,3470,10941,3601,11466
250153,202105,1397,3645,1162,3301,35,92,919,2596,954,2688
250157,202105,1877,5328,1701,5004,61,214,1374,3981,1435,4195
250160,202105,3906,9613,3102,8542,43,146,2712,7493,2755,7639
250170,202105,1890,4812,1700,4545,25,92,1479,3899,1504,3991
250180,202105,20951,49110,17928,45299,713,2101,14291,35241,15004,37342
250190,202105,4164,10881,3506,9925,305,892,2501,6948,2806,7840
250200,202105,2030,5238,1748,4859,64,169,1464,4096,1528,4265
250205,202105,884,2670,763,2485,7,28,624,2010,631,2038
250210,202105,1565,4635,1419,4413,54,231,1130,3456,1184,3687
250215,202105,1631,4326,1360,3949,77,235,791,2341,868,2576
250220,202105,671,1824,535,1616,26,90,353,1055,379,1145
250230,202105,1717,3791,1205,3036,18,53,967,2385,985,2438
250240,202105,2447,7147,2163,6633,32,149,1867,5631,1899,5780
250250,202105,4667,12720,4075,11869,88,268,3476,10180,3564,10448
250260,202105,1704,4680,1442,4229,52,119,1140,3338,1192,3457
250270,202105,1220,3641,1110,3504,52,183,846,2753,898,2936
250280,202105,3571,9406,3200,8876,144,330,2533,7077,2677,7407
250290,202105,1551,4053,1334,3739,16,48,1070,2979,1086,3027
250300,202105,5561,14569,5003,13915,158,690,4245,11422,4403,12112
250310,202105,1195,3283,997,2958,34,112,756,2224,790,2336
250320,202105,12604,27612,10879,25649,249,659,9807,22843,10056,23502
250330,202105,2400,6513,2019,5985,150,367,1589,4790,1739,5157
250340,202105,1164,2880,1033,2712,13,34,952,2493,965,2527
250350,202105,4260,11763,3754,10896,213,470,2948,8848,3161,9318
250355,202105,2072,6089,1860,5805,28,142,1674,5220,1702,5362
250360,202105,1822,4878,1638,4631,37,123,1389,3887,1426,4010
250370,202105,14013,35009,11668,31495,216,747,9908,26340,10124,27087
250375,202105,1212,3075,979,2796,5,18,925,2660,930,2678
250380,202105,1662,4170,1527,4001,31,112,1349,3436,1380,3548
250390,202105,1887,4725,1594,4270,73,193,1282,3412,1355,3605
250400,202105,70283,170327,52021,142421,14353,42484,13927,40624,28280,83108
250403,202105,1805,4939,1614,4717,65,329,1275,3540,1340,3869
250407,202105,1364,3209,1066,2778,101,204,677,1918,778,2122
250410,202105,670,1759,574,1598,6,14,482,1315,488,1329
250415,202105,1911,5222,1670,4843,29,133,1436,4143,1465,4276
250420,202105,1216,3312,1103,3156,29,96,996,2832,1025,2928
250430,202105,6333,15379,5383,14137,155,433,4430,11411,4585,11844
250435,202105,1583,4372,1286,3876,11,58,987,2927,998,2985
250440,202105,4703,12186,4075,11396,75,181,3617,10117,3692,10298
250450,202105,1835,4779,1518,4349,31,103,1246,3594,1277,3697
250460,202105,7274,19544,6474,18380,379,1113,5146,14594,5525,15707
250470,202105,1552,3967,1284,3554,48,148,1026,2796,1074,2944
250480,202105,4011,10758,3412,10041,38,125,3011,8943,3049,9068
250485,202105,739,1638,553,1377,45,71,388,950,433,1021
250490,202105,5278,12294,4699,11636,165,470,4180,10176,4345,10646
250500,202105,2048,5572,1832,5200,72,209,1487,4223,1559,4432
250510,202105,5503,13650,4745,12644,79,170,4147,11156,4226,11326
250520,202105,1868,4952,1590,4561,109,334,1162,3313,1271,3647
250523,202105,2209,5429,1948,5091,66,250,1631,4126,1697,4376
250527,202105,1699,4265,1526,4073,25,65,1349,3621,1374,3686
250530,202105,646,1629,557,1499,13,31,491,1324,504,1355
250535,202105,1409,4026,1270,3768,24,98,1023,2947,1047,3045
250540,202105,3126,6928,2606,6348,80,143,2290,5696,2370,5839
250550,202105,790,2490,696,2306,20,65,520,1708,540,1773
250560,202105,1785,4857,1575,4561,38,136,1335,3786,1373,3922
250570,202105,2737,7968,2350,7267,78,266,1835,5599,1913,5865
250580,202105,1074,2753,943,2572,44,155,797,2125,841,2280
250590,202105,863,2291,769,2155,20,59,647,1804,667,1863
250600,202105,8220,21071,6847,19272,239,732,5525,15450,5764,16182
250610,202105,3000,8383,2684,7918,109,399,2227,6498,2336,6897
250620,202105,854,2167,736,1974,16,40,531,1411,547,1451
250625,202105,2452,6977,2189,6545,43,210,1869,5444,1912,5654
250630,202105,10534,28327,8622,25075,897,2622,5566,15859,6463,18481
250640,202105,3589,9535,3213,9038,86,322,2797,7768,2883,8090
250650,202105,984,2330,830,2122,14,39,729,1840,743,1879
250660,202105,1678,4069,1343,3611,42,102,1099,2881,1141,2983
250670,202105,2396,7299,2183,6928,38,161,1915,5970,1953,6131
250680,202105,5947,13615,5314,12905,50,190,4952,11853,5002,12043
250690,202105,6842,15264,5759,13924,105,225,5084,12244,5189,12469
250700,202105,4358,12140,3808,11313,508,1468,2507,7536,3015,9004
250710,202105,4425,12550,3868,11760,274,841,2829,8614,3103,9455
250720,202105,2870,7516,2575,7097,28,140,2313,6318,2341,6458
250730,202105,4209,11016,3695,10338,106,421,3111,8469,3217,8890
250740,202105,1999,4840,1653,4391,96,210,1299,3486,1395,3696
250750,202105,108744,261647,92556,239121,7170,19614,67913,172407,75083,192021
250760,202105,2408,6043,2109,5562,68,183,1723,4436,1791,4619
250770,202105,4054,12068,3635,11513,410,1226,2578,8338,2988,9564
250780,202105,1789,4724,1511,4227,65,202,1173,3214,1238,3416
250790,202105,2561,7365,2221,6865,94,380,1620,4891,1714,5271
250800,202105,2484,6460,2178,5967,98,194,1768,4907,1866,5101
250810,202105,1306,3368,1094,3070,34,67,914,2614,948,2681
250820,202105,1996,5463,1836,5289,29,121,1667,4769,1696,4890
250830,202105,6016,17770,4949,15611,272,1009,3340,10256,3612,11265
250840,202105,764,2396,659,2191,17,63,498,1670,515,1733
250850,202105,1805,5251,1616,4912,30,124,1342,3995,1372,4119
250855,202105,1041,2907,898,2680,58,182,689,2057,747,2239
250860,202105,3275,9520,2712,8569,451,1465,1564,5010,2015,6475
250870,202105,1044,2830,890,2583,40,136,719,2059,759,2195
250880,202105,1638,4176,1356,3757,87,248,1037,2869,1124,3117
250890,202105,10532,26404,9313,24799,445,1486,7460,19108,7905,20594
250900,202105,3016,7971,2608,7260,99,229,2192,6060,2291,6289
250905,202105,2563,6955,2368,6688,39,136,2171,6130,2210,6266
250910,202105,6266,15093,5184,13871,65,196,4550,12219,4615,12415
250915,202105,2173,4972,1521,4270,27,57,1334,3834,1361,3891
250920,202105,3644,9045,3208,8386,272,610,2463,6442,2735,7052
250930,202105,2347,6200,2120,5909,44,189,1833,4984,1877,5173
250933,202105,1220,3524,1085,3284,22,91,866,2564,888,2655
250937,202105,724,1941,606,1749,22,72,474,1387,496,1459
250939,202105,1864,4785,1629,4487,57,144,1277,3519,1334,3663
250940,202105,4084,10679,3590,10031,18,64,3218,9001,3236,9065
250950,202105,1778,4498,1435,4052,26,96,1168,3248,1194,3344
250960,202105,1132,3285,998,3071,21,107,827,2467,848,2574
250970,202105,8359,21237,7366,19655,212,638,6092,15982,6304,16620
250980,202105,2417,6345,2185,6014,24,107,1915,5147,1939,5254
250990,202105,2081,6178,1749,5618,57,236,1311,4168,1368,4404
251000,202105,2058,5748,1669,5078,34,145,1368,4136,1402,4281
251010,202105,2742,7473,2490,7085,23,83,2238,6371,2261,6454
251020,202105,1645,4431,1473,4164,29,126,1275,3538,1304,3664
251030,202105,1059,2749,871,2426,51,129,585,1628,636,1757
251040,202105,1874,5124,1581,4630,25,116,1318,3835,1343,3951
251050,202105,1054,2846,887,2529,45,148,637,1742,682,1890
251060,202105,1090,2306,824,1978,10,29,632,1499,642,1528
251065,202105,491,1322,377,1112,8,23,261,747,269,770
251070,202105,751,1903,630,1726,7,26,542,1446,549,1472
251080,202105,19054,47575,15449,42172,2189,6120,9316,25817,11505,31937
251090,202105,2919,8215,2464,7421,58,174,1945,5839,2003,6013
251100,202105,822,2576,727,2390,23,84,576,1826,599,1910
251110,202105,1784,4629,1515,4158,68,149,1152,3176,1220,3325
251120,202105,7642,20705,6465,19288,297,1001,5107,15290,5404,16291
251130,202105,3950,8648,3482,8124,52,142,3179,7375,3231,7517
251140,202105,4347,11941,3869,11271,68,281,3234,9321,3302,9602
251150,202105,2711,7677,2474,7290,69,296,2119,6096,2188,6392
251160,202105,2224,6362,1927,5934,35,168,1666,5035,1701,5203
251170,202105,1648,4353,1446,4094,20,65,1293,3633,1313,3698
251180,202105,2674,7016,2190,6335,144,399,1534,4454,1678,4853
251190,202105,4498,11566,4066,11081,38,204,3704,9901,3742,10105
251200,202105,4470,12779,3937,12108,73,290,3474,10709,3547,10999
251203,202105,982,3101,899,2913,21,94,680,2146,701,2240
251207,202105,1130,3000,860,2572,16,70,607,1777,623,1847
251210,202105,7879,19458,6467,17543,309,653,4897,13616,5206,14269
251220,202105,1293,3004,966,2576,66,134,717,1985,783,2119
251230,202105,4761,13037,4109,11881,112,372,3247,9173,3359,9545
251240,202105,3693,10054,3107,9070,170,439,2318,6728,2488,7167
251250,202105,10774,28381,9452,26158,679,1865,7061,19071,7740,20936
251260,202105,513,1413,465,1336,14,59,374,1042,388,1101
251270,202105,4321,13269,3878,12668,104,410,3173,10586,3277,10996
251272,202105,1326,3591,1207,3433,54,189,1006,2803,1060,2992
251274,202105,916,2517,732,2184,57,186,480,1373,537,1559
251275,202105,1222,3412,1040,3117,28,115,821,2395,849,2510
251276,202105,1342,3620,1169,3391,24,125,953,2671,977,2796
251278,202105,621,1668,561,1579,41,107,429,1223,470,1330
251280,202105,2270,6042,2067,5744,51,137,1742,4815,1793,4952
251290,202105,6189,14088,5614,13400,174,506,4938,11463,5112,11969
251300,202105,894,2588,809,2460,9,46,684,2066,693,2112
251310,202105,2826,7857,2463,7307,31,165,2055,5968,2086,6133
251315,202105,1790,5438,1627,5123,117,314,1215,3818,1332,4132
251320,202105,1652,4340,1212,3575,29,96,910,2639,939,2735
251330,202105,2134,4930,1770,4504,24,72,1581,4059,1605,4131
251335,202105,1123,3126,1005,2944,23,101,886,2546,909,2647
251340,202105,3814,8943,3055,7948,126,332,2356,6142,2482,6474
251350,202105,1077,3030,983,2875,27,86,812,2344,839,2430
251360,202105,1865,5132,1514,4628,10,58,1256,3840,1266,3898
251365,202105,761,2011,597,1693,5,14,477,1338,482,1352
251370,202105,25087,64861,21459,59717,3010,8282,12615,36239,15625,44521
251380,202105,1274,3467,1089,3153,13,79,929,2623,942,2702
251385,202105,770,1951,599,1645,25,63,443,1179,468,1242
251390,202105,6509,18577,5752,17407,523,1563,3835,11730,4358,13293
251392,202105,1006,2691,854,2460,26,100,675,1913,701,2013
251394,202105,638,1802,516,1590,25,77,375,1152,400,1229
251396,202105,665,1796,566,1617,13,35,397,1111,410,1146
251398,202105,1028,2537,727,2016,17,55,549,1491,566,1546
251400,202105,1310,3040,1032,2663,21,77,840,2094,861,2171
251410,202105,1579,3647,1276,3221,21,82,1083,2634,1104,2716
251420,202105,1997,5139,1642,4718,37,120,1315,3738,1352,3858
251430,202105,1586,4701,1427,4425,26,130,1236,3815,1262,3945
251440,202105,1112,3064,901,2671,42,95,699,2113,741,2208
251445,202105,1569,4293,1447,4124,29,89,1244,3497,1273,3586
251450,202105,4417,12909,3952,12197,81,299,3299,10107,3380,10406
251455,202105,874,2606,799,2469,16,67,644,1949,660,2016
251460,202105,964,2702,830,2497,14,46,683,2064,697,2110
251465,202105,460,1318,395,1196,6,26,302,884,308,910
251470,202105,1200,3255,908,2663,74,230,524,1473,598,1703
251480,202105,1036,2660,850,2335,14,54,661,1738,675,1792
251490,202105,1927,4986,1535,4440,70,198,1143,3336,1213,3534
251500,202105,2020,5538,1855,5332,34,123,1684,4831,1718,4954
251510,202105,2701,7932,2260,7075,117,388,1555,4769,1672,5157
251520,202105,1045,2650,812,2227,71,178,523,1406,594,1584
251530,202105,14971,35311,12072,31720,87,467,10725,27705,10812,28172
251540,202105,3110,8610,2789,8037,67,233,2374,6752,2441,6985
251550,202105,3936,9046,3177,8121,133,210,2627,6833,2760,7043
251560,202105,563,1697,502,1603,54,182,351,1090,405,1272
251570,202105,973,2691,800,2351,21,93,640,1833,661,1926
251580,202105,1985,4688,1780,4397,36,133,1532,3647,1568,3780
251590,202105,1629,3942,1374,3642,64,157,1140,2984,1204,3141
251593,202105,932,2706,838,2546,86,266,539,1633,625,1899
251597,202105,2137,5925,1917,5634,19,102,1718,4978,1737,5080
251600,202105,6453,17167,5641,15932,192,539,4636,12957,4828,13496
251610,202105,3145,8948,2731,8185,236,633,1864,5714,2100,6347
251615,202105,1321,3207,1064,2828,20,59,863,2221,883,2280
251620,202105,19565,43938,15026,38394,75,259,13015,33571,13090,33830
251630,202105,4881,11199,3931,9891,204,492,2952,7387,3156,7879
251640,202105,2274,5992,2031,5622,21,95,1817,4925,1838,5020
251650,202105,3999,10622,3478,9942,130,378,2919,8369,3049,8747
251660,202105,3594,10535,3181,9827,61,267,2651,8075,2712,8342
251670,202105,4182,11498,3701,10807,39,186,3329,9665,3368,9851
251675,202105,698,1875,631,1794,93,238,428,1247,521,1485
251680,202105,2607,6664,2182,6116,39,122,1797,5078,1836,5200
251690,202105,3143,8744,2683,7960,78,230,2056,6063,2134,6293
251700,202105,2254,6143,1872,5672,44,178,1590,4730,1634,4908
251710,202105,799,2034,558,1549,35,110,328,863,363,973
251720,202105,1341,3738,1089,3306,18,80,852,2507,870,2587
251740,202105,607,1673,485,1443,40,148,326,926,366,1074
260005,202105,30226,63313,24958,56567,1780,3871,19048,42431,20828,46302
260010,202105,10438,26857,8629,23950,485,1373,5136,14346,5621,15719
260020,202105,6950,15960,5871,14423,67,292,5017,12104,5084,12396
260030,202105,6987,17516,5894,15933,129,382,4807,12919,4936,13301
260040,202105,7743,19273,6535,17554,399,1055,4809,13091,5208,14146
260050,202105,14174,36244,11809,33637,208,676,10859,31072,11067,31748
260060,202105,4277,10200,3681,9267,278,551,2779,7182,3057,7733
260070,202105,10891,26743,9341,24552,295,999,7628,19511,7923,20510
260080,202105,6548,14825,5705,13718,108,333,4801,11358,4909,11691
260090,202105,4789,12085,4283,11394,392,1012,3218,8619,3610,9631
260100,202105,3000,8010,2525,7300,34,170,2117,6032,2151,6202
260105,202105,5048,13652,4534,12964,112,376,3861,10895,3973,11271
260110,202105,22576,61691,20134,58163,854,2836,16769,47828,17623,50664
260120,202105,14713,38254,12441,34927,1446,3895,8000,22849,9446,26744
260130,202105,3234,8019,2863,7483,237,564,2123,5510,2360,6074
260140,202105,12935,28851,11145,26749,503,1368,9447,22324,9950,23692
260150,202105,3592,8287,3110,7694,91,220,2737,6742,2828,6962
260160,202105,6637,16958,5641,15758,93,304,5117,14411,5210,14715
260170,202105,21018,48375,17884,44169,914,2165,14335,35090,15249,37255
260180,202105,3580,9327,3098,8670,73,260,2685,7403,2758,7663
260190,202105,18295,36469,15455,33140,184,435,13768,29030,13952,29465
260200,202105,11231,26554,9696,24603,497,1024,8095,20942,8592,21966
260210,202105,11669,32596,9932,29771,284,1021,7947,23699,8231,24720
260220,202105,10903,25146,10070,24098,171,454,8988,21225,9159,21679
260230,202105,11003,26289,9599,24441,188,505,8149,20460,8337,20965
260240,202105,2804,8230,2456,7572,90,302,1901,5792,1991,6094
260250,202105,2255,5758,1976,5323,127,262,1515,4097,1642,4359
260260,202105,12817,32747,11415,30641,351,1107,9154,24132,9505,25239
260270,202105,4416,10432,3881,9807,101,367,3300,8206,3401,8573
260280,202105,13038,38303,11759,36487,404,1636,10085,30842,10489,32478
260290,202105,41717,103328,35923,95103,3812,10214,24562,64839,28374,75053
260300,202105,9742,25845,8527,24212,167,676,7290,20612,7457,21288
260310,202105,5551,13596,4889,12773,341,745,3779,10073,4120,10818
260320,202105,7950,22421,6762,20417,227,656,5535,16770,5762,17426
260330,202105,2598,7842,2273,7178,60,197,1808,5578,1868,5775
260340,202105,2091,5508,1818,5113,23,97,1597,4399,1620,4496
260345,202105,26245,66038,21943,59885,3345,9590,11596,31096,14941,40686
260350,202105,5774,13172,4993,12287,53,155,4486,10973,4539,11128
260360,202105,2563,6545,2317,6106,45,154,1671,4319,1716,4473
260370,202105,5662,15852,4875,14553,201,612,3804,11283,4005,11895
260380,202105,5150,14732,4422,13546,165,484,3382,10277,3547,10761
260390,202105,4721,13850,3916,12225,225,616,2632,8136,2857,8752
260392,202105,3527,10907,3194,10496,89,530,2656,8705,2745,9235
260400,202105,19194,43149,16572,39764,436,1130,13272,30703,13708,31833
260410,202105,75390,178782,58839,155996,10454,28786,26245,71977,36699,100763
260415,202105,4482,11696,3871,10725,45,169,3234,8813,3279,8982
260420,202105,12649,26173,10763,24088,86,240,10024,22259,10110,22499
260430,202105,2793,8506,2404,7740,116,422,1690,5375,1806,5797
260440,202105,3805,9572,3384,8965,65,209,2899,7568,2964,7777
260450,202105,5867,14424,5249,13630,289,547,4366,11569,4655,12116
260460,202105,5342,15416,4557,14066,471,1609,2778,8437,3249,10046
260470,202105,4978,12933,4207,12047,76,152,3859,11209,3935,11361
260480,202105,4078,10545,3437,9641,243,742,2400,6808,2643,7550
260490,202105,5402,12289,4802,11429,29,130,4388,10276,4417,10406
260500,202105,6171,15107,5277,13868,414,959,3761,10049,4175,11008
260510,202105,10027,24286,8429,22060,95,349,7469,19379,7564,19728
260515,202105,4522,11799,3559,10023,157,388,2435,6675,2592,7063
260520,202105,16832,38417,14654,35674,699,1632,12046,28998,12745,30630
260530,202105,9970,28176,8506,25937,119,565,7361,22162,7480,22727
260540,202105,7354,15817,6506,14755,143,330,5872,13236,6015,13566
260545,202105,70,214,45,153,3,12,20,65,23,77
260550,202105,3202,8549,2613,7598,132,424,1814,5160,1946,5584
260560,202105,6105,15361,5142,13970,113,406,4343,11592,4456,11998
260570,202105,7927,20948,7012,19724,337,995,5667,15985,6004,16980
260580,202105,4561,10658,4107,10060,24,72,3761,9163,3785,9235
260590,202105,7161,15689,6057,14474,224,486,5163,12450,5387,12936
260600,202105,31790,80306,25963,71581,1001,2961,19957,53998,20958,56959
260610,202105,7621,19184,6804,18124,420,1111,5109,13628,5529,14739
260620,202105,17251,43270,15138,40286,1233,3598,11189,29188,12422,32786
260630,202105,2437,6474,1992,5788,43,144,1624,4640,1667,4784
260640,202105,22845,50102,19152,45870,796,1880,15694,37368,16490,39248
260650,202105,6395,16137,5153,14640,460,840,4142,12218,4602,13058
260660,202105,7033,18073,6101,16847,212,722,5228,14196,5440,14918
260670,202105,2310,5921,1913,5295,79,200,1354,3650,1433,3850
260680,202105,29531,69351,24929,62904,1834,4746,17526,43495,19360,48241
260690,202105,3577,9130,2994,8229,66,241,2375,6477,2441,6718
260700,202105,6419,17492,5939,16949,19,68,5762,16525,5781,16593
260710,202105,1389,3580,1191,3286,32,115,946,2609,978,2724
260720,202105,26182,61350,22203,56365,2072,5066,16125,41469,18197,46535
260730,202105,8065,22438,7071,21072,233,771,5970,17576,6203,18347
260740,202105,1333,3754,1128,3423,13,59,896,2783,909,2842
260750,202105,7250,19574,5994,18033,231,460,5231,16247,5462,16707
260760,202105,5981,13618,5159,12663,171,412,4336,10687,4507,11099
260765,202105,8433,23492,7334,21984,339,1276,5293,15545,5632,16821
260770,202105,3976,9897,3305,8789,113,343,2616,6858,2729,7201
260775,202105,5375,14001,4720,13034,179,608,3732,9985,3911,10593
260780,202105,3801,10979,3400,10347,390,1224,2103,6291,2493,7515
260790,202105,123247,270866,102099,243838,15308,35272,63371,151921,78679,187193
260795,202105,3026,7560,2590,7009,77,247,2080,5673,2157,5920
260800,202105,5449,12437,4920,11725,181,476,4269,9879,4450,10355
260805,202105,3746,10249,3182,9289,205,600,2339,6782,2544,7382
260810,202105,6709,17648,5917,16151,433,1046,4384,11805,4817,12851
260820,202105,4628,10503,4121,9919,96,297,3456,8186,3552,8483
260825,202105,3042,8779,2676,8145,107,335,2028,6121,2135,6456
260830,202105,4277,12213,3553,10939,480,1266,2227,7128,2707,8394
260840,202105,4282,10879,3835,10278,216,502,3225,8685,3441,9187
260845,202105,4610,11791,4084,10912,241,654,3092,8115,3333,8769
260850,202105,5295,14036,4440,12460,342,1020,2874,7780,3216,8800
260860,202105,3445,9661,2965,8853,99,322,2393,6990,2492,7312
260870,202105,4580,10838,3927,10046,63,232,3518,8889,3581,9121
260875,202105,7520,17789,6153,15823,530,1315,4288,11144,4818,12459
260880,202105,9832,27121,8567,24984,438,1272,6751,19680,7189,20952
260890,202105,13237,33088,11505,30494,632,1721,8400,21757,9032,23478
260900,202105,5525,14917,4554,13577,293,896,3107,9259,3400,10155
260910,202105,3332,8826,2903,8190,106,289,2295,6447,2401,6736
260915,202105,5106,14920,4498,14221,53,240,4112,13029,4165,13269
260920,202105,3553,8297,3017,7714,120,222,2563,6666,2683,6888
260930,202105,4038,11968,3499,11039,162,581,2685,8248,2847,8829
260940,202105,15274,35497,13309,32804,1085,2600,9974,24274,11059,26874
260950,202105,7336,19024,5952,16688,357,1181,3926,10458,4283,11639
260960,202105,73365,159407,59312,141672,6121,14744,38675,91341,44796,106085
260970,202105,5943,14965,5283,14087,272,556,3915,10731,4187,11287
260980,202105,4708,13345,4132,12632,53,162,3779,11668,3832,11830
260990,202105,18791,49500,15940,45616,824,2328,12562,35634,13386,37962
261000,202105,16820,38522,14175,35224,403,1188,11469,27913,11872,29101
261010,202105,2382,6146,2097,5771,92,199,1811,5040,1903,5239
261020,202105,6391,16568,5555,15211,227,644,4612,12312,4839,12956
261030,202105,4139,11758,3644,10892,110,419,2920,8496,3030,8915
261040,202105,5520,15491,4521,13629,145,526,3470,10175,3615,10701
261050,202105,8157,20332,7403,19202,405,709,5848,15307,6253,16016
261060,202105,14555,35632,12706,33422,250,772,10729,27911,10979,28683
261070,202105,67206,143506,55857,128739,3152,6871,42576,96156,45728,103027
261080,202105,6934,16190,6302,15424,143,315,5838,14282,5981,14597
261090,202105,20035,45994,17840,43161,344,985,15680,37337,16024,38322
261100,202105,8652,23084,7578,21516,500,1425,5664,16121,6164,17546
261110,202105,69738,189586,58695,169799,7792,23541,35026,100005,42818,123546
261120,202105,3657,9080,3186,8435,71,166,2759,7295,2830,7461
261130,202105,7500,17916,6602,16738,123,357,5842,14682,5965,15039
261140,202105,3836,8629,3423,8089,193,469,2700,6290,2893,6759
261150,202105,5307,13717,4703,12818,79,262,4064,10972,4143,11234
261153,202105,1938,5745,1633,5158,57,182,1101,3502,1158,3684
261160,202105,220860,499355,179722,443623,42738,108487,75704,190487,118442,298974
261170,202105,6458,15295,5730,14280,262,535,4727,11744,4989,12279
261180,202105,9755,23747,8517,22143,482,1125,6214,16367,6696,17492
261190,202105,4720,13364,4234,12578,141,613,3415,9839,3556,10452
261200,202105,3417,7742,3029,7224,196,468,2490,5866,2686,6334
261210,202105,1950,4675,1674,4287,71,180,1389,3504,1460,3684
261220,202105,13969,38560,11726,34535,1410,4399,6852,19887,8262,24286
261230,202105,4140,11577,3470,10671,40,146,2919,9071,2959,9217
261240,202105,5555,13488,4901,12474,301,696,3988,10093,4289,10789
261245,202105,3870,10498,3244,9413,69,314,2604,7274,2673,7588
261247,202105,3060,8891,2552,7993,145,460,1801,5596,1946,6056
261250,202105,23468,52068,20411,48548,2564,5482,14451,35664,17015,41146
261255,202105,4187,12017,3452,10599,127,512,2658,7958,2785,8470
261260,202105,12997,34283,11348,32135,308,1121,9882,27693,10190,28814
261270,202105,4644,10975,4059,10250,194,444,3346,8450,3540,8894
261280,202105,2562,7051,2253,6530,59,197,1810,5100,1869,5297
261290,202105,3003,7646,2514,7094,59,212,2045,5834,2104,6046
261300,202105,12931,34942,11061,31846,503,1760,8307,23319,8810,25079
261310,202105,9204,22650,7884,20885,574,1630,5917,15362,6491,16992
261320,202105,6168,16961,5392,15690,75,306,4621,13267,4696,13573
261330,202105,5827,14105,5256,13365,109,391,4597,11460,4706,11851
261340,202105,4373,11869,3808,11152,128,463,3201,9258,3329,9721
261350,202105,8884,25739,7852,23987,114,462,6402,19358,6516,19820
261360,202105,8328,19552,7054,17761,235,607,5686,13961,5921,14568
261370,202105,24506,59806,20566,54463,2242,5595,13286,35657,15528,41252
261380,202105,4215,12350,3723,11521,424,1390,2503,7657,2927,9047
261390,202105,17167,47648,14554,43499,1155,3735,9772,28903,10927,32638
261400,202105,4677,14520,4099,13263,180,716,3083,9717,3263,10433
261410,202105,9881,24079,8143,21455,377,1091,6563,16858,6940,17949
261420,202105,7558,21923,6818,21022,691,2372,4946,15244,5637,17616
261430,202105,3540,9746,3016,8920,54,220,2547,7433,2601,7653
261440,202105,1498,4373,1248,3906,45,200,894,2681,939,2881
261450,202105,14968,39839,13235,37207,160,558,10970,30971,11130,31529
261460,202105,7823,20863,6880,19405,285,824,5528,15577,5813,16401
261470,202105,4240,10326,3671,9549,21,90,3198,8291,3219,8381
261480,202105,5168,15491,4462,14325,207,788,3457,10907,3664,11695
261485,202105,5071,14001,4404,12993,341,1089,3246,9458,3587,10547
261500,202105,6214,15423,5429,14356,388,863,3791,10458,4179,11321
261510,202105,1941,5652,1690,5241,58,209,1294,4034,1352,4243
261520,202105,2382,7164,2146,6687,60,205,1592,4935,1652,5140
261530,202105,12398,35197,10078,31080,852,3033,5310,15723,6162,18756
261540,202105,8659,23850,7835,22687,1215,3313,4401,13601,5616,16914
261550,202105,3765,9821,3255,9040,243,709,2346,6392,2589,7101
261560,202105,8082,23139,7045,21600,287,993,5525,16940,5812,17933
261570,202105,3548,9426,2831,8271,166,550,1974,5688,2140,6238
261580,202105,6996,17978,6051,16698,95,427,5458,14869,5553,15296
261590,202105,2783,6991,2273,6281,77,242,1720,4723,1797,4965
261600,202105,5437,13146,4632,11988,295,614,3309,8747,3604,9361
261610,202105,2165,6132,1736,5340,109,394,1157,3542,1266,3936
261618,202105,2598,6282,2274,5813,78,183,1842,4682,1920,4865
261620,202105,4251,11762,3867,11192,734,1883,2544,7693,3278,9576
261630,202105,6208,17268,5293,15571,368,1226,3535,10034,3903,11260
261640,202105,38296,84003,32654,77118,1938,3436,24732,60415,26670,63851
261650,202105,4299,10387,3666,9574,166,447,2784,7242,2950,7689
270010,202105,4494,14686,3892,13661,123,691,3153,10755,3276,11446
270020,202105,3987,9777,3499,9158,127,418,3008,7684,3135,8102
270030,202105,34577,92278,28842,83113,3341,9514,19677,56546,23018,66060
270040,202105,11211,28877,9651,27025,375,1163,8126,22645,8501,23808
270050,202105,5596,12809,4781,11889,341,675,4062,10313,4403,10988
270060,202105,2306,5713,1932,5285,164,378,1525,4257,1689,4635
270070,202105,4773,13196,4146,12330,111,400,3487,10201,3598,10601
270080,202105,1481,3976,1257,3599,43,126,977,2709,1020,2835
270090,202105,1817,5423,1635,5076,51,211,1371,4163,1422,4374
270100,202105,5764,14494,4995,13385,199,583,4185,11034,4384,11617
270110,202105,3342,7552,2714,6836,147,292,2155,5724,2302,6016
270120,202105,2690,7349,2345,6889,61,263,1981,5712,2042,5975
270130,202105,5201,13056,4522,12239,143,412,3898,10585,4041,10997
270135,202105,2063,4869,1750,4522,30,102,1616,4138,1646,4240
270140,202105,9766,22575,7853,19932,334,984,6184,15035,6518,16019
270150,202105,2701,8075,2459,7722,3,19,2323,7283,2326,7302
270160,202105,6254,16619,5319,15564,103,353,4893,14377,4996,14730
270170,202105,3410,9850,2879,9121,165,754,2203,6700,2368,7454
270180,202105,2274,6987,2088,6752,36,176,1893,6052,1929,6228
270190,202105,1773,5030,1580,4796,22,108,1430,4318,1452,4426
270200,202105,2503,7457,2183,7012,81,269,1644,5276,1725,5545
270210,202105,5888,13529,5029,12552,55,195,4660,11480,4715,11675
270220,202105,1694,4264,1350,3772,180,511,844,2327,1024,2838
270230,202105,9432,25507,7847,23075,720,2218,5587,16414,6307,18632
270235,202105,5967,17992,5164,16726,128,488,4346,13959,4474,14447
270240,202105,11357,30075,9358,27322,927,2741,6663,19655,7590,22396
270250,202105,2918,7092,2571,6602,174,418,2091,5366,2265,5784
270255,202105,4553,12849,3602,11138,110,429,2782,8470,2892,8899
270260,202105,5589,16383,5063,15515,96,449,4435,13328,4531,13777
270270,202105,1080,2744,901,2522,106,286,661,1864,767,2150
270280,202105,3926,9338,3156,8376,503,766,2214,6384,2717,7150
270290,202105,7689,23908,6924,22662,125,629,6117,19780,6242,20409
270300,202105,4339,11041,3389,10009,190,457,2630,7994,2820,8451
270310,202105,7115,19513,6134,17997,72,384,5331,15303,5403,15687
270320,202105,5614,16294,4867,14859,339,1059,3535,10513,3874,11572
270330,202105,4087,12911,3632,12214,232,914,2868,9599,3100,10513
270340,202105,1600,4223,1382,3937,45,133,1183,3324,1228,3457
270350,202105,1916,4399,1566,3994,127,341,1137,2928,1264,3269
270360,202105,2712,6625,2427,6307,89,181,2236,5860,2325,6041
270370,202105,1404,4273,1286,4060,28,134,1108,3443,1136,3577
270375,202105,3168,7317,2641,6739,23,64,2476,6335,2499,6399
270380,202105,5656,15378,4772,14256,531,1464,3350,10351,3881,11815
270390,202105,1248,3093,1011,2821,19,68,850,2380,869,2448
270400,202105,6605,16835,5569,15295,246,584,4478,12261,4724,12845
270410,202105,4724,13377,4098,12435,132,454,3458,10454,3590,10908
270420,202105,5731,16543,5144,15697,107,474,4498,13482,4605,13956
270430,202105,137151,319716,107909,282459,20712,55962,51517,137351,72229,193313
270440,202105,4824,12748,4184,11969,78,303,3707,10503,3785,10806
270450,202105,7256,18968,6366,17900,268,778,5333,15258,5601,16036
270460,202105,3806,8349,3261,7698,162,295,2929,6958,3091,7253
270470,202105,11240,30664,9808,28665,605,1919,7695,22501,8300,24420
270480,202105,3009,7809,2541,7139,91,314,2086,5748,2177,6062
270490,202105,960,2599,840,2452,51,146,677,1973,728,2119
270500,202105,5010,15010,4455,14087,261,935,3546,11081,3807,12016
270510,202105,5679,14724,4789,13606,363,1255,3585,9823,3948,11078
270520,202105,4146,11478,3304,10072,698,2168,1342,4324,2040,6492
270530,202105,1340,3748,1129,3419,57,155,801,2472,858,2627
270540,202105,2303,6360,1983,5944,54,198,1735,5144,1789,5342
270550,202105,6929,17570,5527,16018,689,1569,3995,12146,4684,13715
270560,202105,2989,7603,2569,7041,153,465,2079,5626,2232,6091
270570,202105,4154,11437,3525,10500,192,524,2824,8435,3016,8959
270580,202105,2316,6438,2093,6120,105,306,1798,5228,1903,5534
270590,202105,1610,4817,1484,4646,15,75,1402,4375,1417,4450
270600,202105,2778,8486,2515,8090,44,212,2241,7135,2285,7347
270610,202105,3693,9459,3206,8823,96,256,2859,7850,2955,8106
270620,202105,1286,3768,1187,3586,22,81,1038,3056,1060,3137
270630,202105,17758,42815,15297,39447,651,1919,12793,32362,13444,34281
270640,202105,5516,15476,4834,14393,168,642,4022,11787,4190,12429
270642,202105,2555,8112,2266,7663,148,597,1739,5787,1887,6384
270644,202105,3736,9157,3086,8319,373,861,2227,6257,2600,7118
270650,202105,3232,9287,2836,8751,312,1019,2123,6530,2435,7549
270660,202105,2025,5081,1735,4673,76,241,1332,3535,1408,3776
270670,202105,16850,37919,14071,34525,376,1029,12111,29032,12487,30061
270680,202105,5691,13269,5095,12623,120,179,4772,11973,4892,12152
270690,202105,9521,23021,8003,21121,357,956,6474,16940,6831,17896
270700,202105,525,1551,463,1447,30,103,346,1064,376,1167
270710,202105,5626,16514,5003,15558,245,854,4022,12384,4267,13238
270720,202105,3685,10530,3288,9868,56,290,2928,8621,2984,8911
270730,202105,8366,18009,7350,16926,303,504,5750,14725,6053,15229
270740,202105,2408,6232,2123,5900,85,279,1773,4877,1858,5156
270750,202105,5835,14954,5109,14047,66,280,4574,12474,4640,12754
270760,202105,3294,9161,2844,8560,43,200,2416,7202,2459,7402
270770,202105,21423,51782,17226,46634,2829,6804,10439,29966,13268,36770
270780,202105,1887,4943,1741,4739,56,184,1555,4182,1611,4366
270790,202105,1703,4497,1432,4128,110,327,1077,3076,1187,3403
270800,202105,11278,30005,10183,28455,350,1162,8765,24209,9115,25371
270810,202105,3403,9491,2701,8331,171,604,1905,5782,2076,6386
270820,202105,1640,4794,1394,4409,41,196,1114,3452,1155,3648
270830,202105,5171,12319,4193,11116,157,513,3423,8910,3580,9423
270840,202105,8454,24830,7535,23519,153,793,6600,20145,6753,20938
270850,202105,9100,21287,8040,20039,736,1880,6587,16298,7323,18178
270860,202105,14757,31994,11735,28610,580,1223,9566,23350,10146,24573
270870,202105,2273,6240,1875,5609,257,693,1186,3737,1443,4430
270880,202105,8166,24136,7292,22817,212,862,6112,18836,6324,19698
270890,202105,3049,8079,2563,7385,192,556,1767,5079,1959,5635
270895,202105,3201,9538,2911,9160,68,365,2598,8021,2666,8386
270900,202105,1793,4548,1368,3875,30,87,1087,3048,1117,3135
270910,202105,4033,11424,3493,10584,91,284,2916,8723,3007,9007
270915,202105,9852,27345,7989,24339,631,2156,5511,16424,6142,18580
270920,202105,5576,16326,5080,15518,87,385,4381,13055,4468,13440
270930,202105,17652,39995,13672,35374,1729,3958,9190,25190,10919,29148
270940,202105,6760,17232,5698,15952,184,695,4563,12393,4747,13088
280010,202105,692,1874,554,1592,14,59,397,1043,411,1102
280020,202105,5008,12408,4232,11195,397,995,2952,7847,3349,8842
280030,202105,78659,180629,62812,158514,12506,31465,29364,76762,41870,108227
280040,202105,2994,8066,2619,7506,252,693,1815,5216,2067,5909
280050,202105,4012,11235,3437,10366,614,1871,1930,5844,2544,7715
280060,202105,6136,15574,4893,13679,886,2596,2373,6895,3259,9491
280067,202105,7136,17152,6067,15520,295,759,4493,11350,4788,12109
280070,202105,1882,5533,1751,5330,118,362,1452,4391,1570,4753
280100,202105,4092,10582,3445,9577,345,960,2327,6505,2672,7465
280110,202105,1476,3810,1302,3554,13,54,1166,3110,1179,3164
280120,202105,7669,21689,6842,20375,785,2101,4926,15112,5711,17213
280130,202105,9160,21179,8013,19592,417,1071,6472,15714,6889,16785
280140,202105,5621,13091,4950,12174,254,674,4117,10068,4371,10742
280150,202105,4298,10597,3735,9828,454,1032,2735,7364,3189,8396
280160,202105,1212,3423,1025,3118,93,319,702,2083,795,2402
280170,202105,5286,13618,4748,12948,258,620,3835,10522,4093,11142
280190,202105,1333,2854,1191,2668,49,114,1006,2207,1055,2321
280200,202105,1291,3320,1075,3020,63,204,821,2271,884,2475
280210,202105,17480,42012,15218,38828,1624,4080,9815,25140,11439,29220
280220,202105,1749,4629,1499,4301,47,196,1242,3535,1289,3731
280230,202105,4523,11002,3769,9893,336,692,2603,6980,2939,7672
280240,202105,3360,8828,3003,8286,38,193,2618,7046,2656,7239
280250,202105,955,2223,793,1979,85,215,549,1338,634,1553
280260,202105,2285,5370,2011,5024,39,89,1821,4599,1860,4688
280270,202105,2494,6579,2217,6164,166,421,1774,4957,1940,5378
280280,202105,4217,12233,3751,11535,534,1401,2566,8302,3100,9703
280290,202105,18778,47997,16141,44299,1338,3771,10892,30100,12230,33871
280300,202105,12585,28969,11020,27292,334,758,8074,22118,8408,22876
280310,202105,1418,3585,1188,3209,42,128,898,2372,940,2500
280320,202105,8849,23324,7667,21561,973,2569,5094,14340,6067,16909
280330,202105,4783,11608,4077,10635,249,670,2998,7829,3247,8499
280340,202105,5672,11749,4713,10705,268,415,4035,9403,4303,9818
280350,202105,26570,61094,23401,56937,1061,2631,18667,44676,19728,47307
280360,202105,5703,15505,4995,14342,704,2021,2972,8741,3676,10762
280370,202105,2201,5303,1847,4730,92,184,1449,3690,1541,3874
280380,202105,1030,2654,874,2445,77,204,590,1686,667,1890
280390,202105,3754,8943,3185,8073,175,355,2514,6418,2689,6773
280400,202105,3945,9687,3431,8989,542,1242,2137,5895,2679,7137
280410,202105,2423,6455,1990,5788,155,449,1238,3534,1393,3983
280420,202105,4397,11447,4058,11020,67,242,3738,10095,3805,10337
280430,202105,2120,5046,1870,4721,64,200,1535,3761,1599,3961
280440,202105,4388,11271,3886,10542,138,432,3308,8760,3446,9192
280445,202105,2406,6010,2162,5597,50,124,1666,4161,1716,4285
280450,202105,10348,23894,8981,22057,1085,2264,5807,15018,6892,17282
280460,202105,7051,16245,6381,15340,411,850,5344,12826,5755,13676
280470,202105,1718,4760,1467,4299,82,257,1078,3099,1160,3356
280480,202105,45141,106789,39032,98235,3183,8275,27789,68590,30972,76865
280490,202105,3816,10707,3280,9797,94,373,2560,7427,2654,7800
280500,202105,1020,2372,880,2188,21,63,753,1839,774,1902
280510,202105,2688,6483,2331,5997,65,214,1851,4635,1916,4849
280520,202105,1728,4212,1523,3931,82,188,1212,3105,1294,3293
280530,202105,2499,6139,2183,5702,216,456,1618,4314,1834,4770
280540,202105,8938,23597,8149,22469,253,813,7149,19503,7402,20316
280550,202105,6657,15207,5521,13628,160,548,4607,10971,4767,11519
280560,202105,7453,20053,7011,19395,111,400,6255,17077,6366,17477
280570,202105,6561,15689,5334,14151,233,669,3953,10572,4186,11241
280580,202105,5849,14940,5116,13877,550,1271,3685,10180,4235,11451
280590,202105,2940,6578,2527,6096,116,395,2003,4632,2119,5027
280600,202105,3711,9483,3302,8923,292,697,2307,6327,2599,7024
280610,202105,2507,6040,2258,5673,133,332,1855,4620,1988,4952
280620,202105,5634,13375,4854,12363,426,898,3426,9121,3852,10019
280630,202105,3975,10697,3666,10278,199,592,2991,8367,3190,8959
280640,202105,2375,6263,2101,5955,50,138,1879,5359,1929,5497
280650,202105,1225,3182,1003,2852,83,277,725,1969,808,2246
280660,202105,3834,8158,3293,7534,268,428,2690,6345,2958,6773
280670,202105,20165,45217,17411,41687,1364,3142,13300,31860,14664,35002
280680,202105,2819,6625,2435,6084,237,435,1755,4491,1992,4926
280690,202105,999,2336,850,2150,54,122,677,1682,731,1804
280700,202105,1192,2942,1030,2703,20,54,822,2126,842,2180
280710,202105,15662,34454,13303,31776,606,1034,11172,27495,11778,28529
280720,202105,2707,6114,2259,5576,42,137,1673,4277,1715,4414
280730,202105,1113,2786,988,2593,57,151,742,1893,799,2044
280740,202105,14625,34491,12558,31391,875,2185,9079,22229,9954,24414
280750,202105,3702,10112,3217,9288,189,567,2332,6636,2521,7203
280760,202105,6663,17083,5818,15804,624,1513,3795,10682,4419,12195
290010,202105,3213,6671,2101,4961,5,17,1741,3950,1746,3967
290020,202105,5436,14170,4952,13564,342,625,4172,11839,4514,12464
290030,202105,4772,10599,3852,9596,184,405,3242,8200,3426,8605
290035,202105,5298,11220,4389,10054,350,514,3499,8345,3849,8859
290040,202105,4288,10214,3660,9462,121,302,2858,7839,2979,8141
290050,202105,2077,6568,1745,5858,97,397,1218,3986,1315,4383
290060,202105,1376,3157,1023,2625,135,316,634,1646,769,1962
290070,202105,38123,81769,32858,75295,1843,4316,25694,58219,27537,62535
290080,202105,5325,15370,4615,14318,479,1526,3184,10031,3663,11557
290090,202105,2204,4189,1551,3493,15,40,1416,3178,1431,3218
290100,202105,9926,25427,8048,22684,1394,3645,4244,12658,5638,16303
290110,202105,5211,13555,4619,12648,369,992,3291,8979,3660,9971
290115,202105,4083,11697,3458,10585,265,795,2617,8049,2882,8844
290120,202105,6680,16140,5625,14677,129,417,4843,12428,4972,12845
290130,202105,4857,11596,3779,10180,179,446,2910,7902,3089,8348
290135,202105,4360,10094,3594,8866,143,366,2881,6875,3024,7241
290140,202105,4555,11677,3529,10327,82,301,3007,8773,3089,9074
290150,202105,2591,6421,2221,5974,138,335,1725,4706,1863,5041
290160,202105,3581,7797,3181,7256,239,455,2587,5923,2826,6378
290170,202105,3421,8520,3032,8101,104,236,2710,7351,2814,7587
290180,202105,3041,8166,2523,7319,76,267,2078,5966,2154,6233
290190,202105,4372,11857,3861,11171,106,383,3229,9208,3335,9591
290195,202105,2369,5729,1906,5130,27,110,1632,4372,1659,4482
290200,202105,4230,11513,3429,10165,164,515,2587,7585,2751,8100
290205,202105,3557,8909,3165,8351,150,449,2538,6537,2688,6986
290210,202105,13126,35715,11648,33480,786,2064,9154,26648,9940,28712
290220,202105,2983,7121,2619,6658,115,286,2159,5469,2274,5755
290225,202105,3273,6885,2507,6079,135,225,2146,5305,2281,5530
290230,202105,2548,6578,2333,6320,34,84,2114,5735,2148,5819
290240,202105,3783,9360,3010,8404,63,207,2551,7120,2614,7327
290250,202105,4000,11486,3340,10506,101,301,2749,8805,2850,9106
290260,202105,5532,13249,4670,12009,168,532,3921,9864,4089,10396
290265,202105,3624,10301,2955,9045,225,635,2062,6343,2287,6978
290270,202105,10809,36618,10092,35409,508,2177,8172,28483,8680,30660
290280,202105,6274,18372,5418,16667,290,1005,3914,11886,4204,12891
290290,202105,10162,28883,8320,25580,756,2500,5618,17017,6374,19517
290300,202105,4231,11443,3138,9375,158,500,2239,6681,2397,7181
290310,202105,1688,3947,1355,3551,34,145,1131,2887,1165,3032
290320,202105,24991,63866,19953,56323,4269,11674,9669,28943,13938,40617
290323,202105,3794,10251,3302,9489,111,332,2575,7457,2686,7789
290327,202105,4190,11912,3599,10785,272,752,2581,7706,2853,8458
290330,202105,2327,4721,1824,4184,45,60,1633,3804,1678,3864
290340,202105,5878,14225,4467,12522,410,1107,3265,9300,3675,10407
290350,202105,4868,13290,4068,11937,270,765,2886,8532,3156,9297
290360,202105,5117,13113,4487,12299,135,313,3858,10672,3993,10985
290370,202105,5346,12684,3921,10813,206,466,2755,7744,2961,8210
290380,202105,5720,14938,4742,13599,115,259,4051,11844,4166,12103
290390,202105,14913,41762,12412,37783,1400,4081,7979,24743,9379,28824
290395,202105,3000,8370,2419,7386,57,244,1851,5573,1908,5817
290400,202105,3854,10193,3139,9016,100,359,2442,6884,2542,7243
290405,202105,4775,13535,4065,12325,308,936,2757,8533,3065,9469
290410,202105,5808,15420,4455,13276,105,428,3379,9831,3484,10259
290420,202105,3180,8459,2646,7639,78,225,2106,6045,2184,6270
290430,202105,3315,8759,2723,7838,215,637,1906,5393,2121,6030
290440,202105,2938,7066,2126,5806,80,173,1500,4201,1580,4374
290450,202105,3638,8920,2889,7803,129,283,2174,5908,2303,6191
290460,202105,12108,33679,10212,30135,2094,6239,4410,13084,6504,19323
290470,202105,4700,11156,3474,9480,411,1158,2002,5560,2413,6718
290475,202105,6638,18978,5637,17234,67,365,4681,14047,4748,14412
290480,202105,1835,4538,1501,4064,65,221,1084,2795,1149,3016
290485,202105,4700,13329,4129,12538,95,451,3546,10630,3641,11081
290490,202105,9182,21292,8256,20034,469,979,6523,16072,6992,17051
290500,202105,4100,12043,3214,10182,512,1681,1430,4422,1942,6103
290510,202105,3619,8742,3036,7989,54,175,2686,7021,2740,7196
290515,202105,3718,10198,3228,9516,42,133,2919,8747,2961,8880
290520,202105,11743,32886,9154,27962,617,1962,5586,16914,6203,18876
290530,202105,5089,14323,4289,13032,116,469,3636,10964,3752,11433
290540,202105,3419,8789,3069,8405,42,130,2860,7830,2902,7960
290550,202105,4304,11208,3774,10579,11,61,3486,9877,3497,9938
290560,202105,6372,16248,4854,14050,365,1302,3231,9041,3596,10343
290570,202105,44981,109246,39925,102888,2299,6004,32348,82853,34647,88857
290580,202105,8117,22940,7022,21377,631,1726,5160,16206,5791,17932
290590,202105,7108,21568,5999,19606,147,533,4828,15877,4975,16410
290600,202105,19426,52817,17070,49017,729,2001,13738,39446,14467,41447
290610,202105,2638,7981,2074,6819,82,313,1466,4766,1548,5079
290620,202105,6203,17365,5369,16000,190,540,4524,13484,4714,14024
290630,202105,9576,22426,7669,20000,649,1571,5819,15408,6468,16979
290640,202105,2863,7144,2215,6219,119,306,1564,4568,1683,4874
290650,202105,13066,31820,11530,30099,2418,6057,7329,19978,9747,26035
290660,202105,3716,9436,3094,8500,54,147,2336,6602,2390,6749
290670,202105,6748,18254,5742,16633,370,1010,4400,12973,4770,13983
290680,202105,11104,30175,9305,27521,177,891,7733,22480,7910,23371
290682,202105,4860,12285,4225,11440,138,287,3560,9755,3698,10042
290685,202105,3539,7885,2551,6483,216,481,1527,4189,1743,4670
290687,202105,6637,17507,5421,15538,678,1845,3505,10285,4183,12130
290689,202105,2930,7934,2232,6658,185,572,1514,4529,1699,5101
290690,202105,5319,13745,4320,12364,279,869,3157,8885,3436,9754
290700,202105,2778,7166,2461,6768,45,170,2160,5910,2205,6080
290710,202105,8387,23204,7210,21591,213,655,6046,18222,6259,18877
290720,202105,18709,50506,17014,47911,887,2740,13769,38311,14656,41051
290730,202105,7079,16647,6031,15439,299,586,4725,12347,5024,12933
290740,202105,1043,2743,822,2389,32,99,690,2001,722,2100
290750,202105,11346,27688,9830,25311,624,1692,7333,18355,7957,20047
290755,202105,2029,5664,1653,4984,86,238,1159,3542,1245,3780
290760,202105,3797,10876,3118,9602,161,442,2162,6836,2323,7278
290770,202105,2715,8366,2481,8071,45,204,2094,6914,2139,7118
290780,202105,8273,20276,7148,18807,261,535,5561,15031,5822,15566
290790,202105,4830,13025,4206,12116,185,464,3458,10137,3643,10601
290800,202105,7121,14414,4991,11962,256,531,3762,9129,4018,9660
290810,202105,5354,13833,4336,12360,108,313,3317,9662,3425,9975
290820,202105,4868,12988,4402,12350,178,507,3324,9463,3502,9970
290830,202105,4562,10342,4036,9661,25,80,3529,8304,3554,8384
290840,202105,17752,45720,15167,41739,2011,4550,9674,28387,11685,32937
290850,202105,6910,16100,6160,15297,225,493,5317,13336,5542,13829
290860,202105,6202,17404,5392,16480,209,617,4553,14221,4762,14838
290870,202105,4762,12976,3620,10814,151,446,2535,7543,2686,7989
290880,202105,1424,3464,1148,3105,92,222,754,2160,846,2382
290890,202105,9509,18889,8568,17841,148,310,8027,16618,8175,16928
290900,202105,2488,6355,1929,5381,120,263,1190,3336,1310,3599
290910,202105,5278,12360,4037,10494,40,105,3453,8892,3493,8997
290920,202105,5206,12947,4707,12365,97,140,4401,11768,4498,11908
290930,202105,7631,21006,6195,18520,206,800,4818,14045,5024,14845
290940,202105,3629,10158,3060,9335,161,524,2462,7507,2623,8031
290950,202105,1470,3666,1201,3263,70,184,835,2281,905,2465
290960,202105,5814,14503,5207,13752,225,489,4386,11665,4611,12154
290970,202105,3283,9615,2693,8539,103,377,2088,6637,2191,7014
290980,202105,12684,29614,10684,26620,714,1903,6896,16681,7610,18584
290990,202105,9787,25626,8702,23904,259,984,7336,19542,7595,20526
291000,202105,3432,8675,2667,7710,115,334,2178,6375,2293,6709
291005,202105,15607,37940,13780,35597,1402,3178,10539,27604,11941,30782
291010,202105,3106,9256,2523,8000,140,482,1642,5070,1782,5552
291020,202105,1279,3075,1038,2663,27,85,764,1848,791,1933
291030,202105,2575,6162,1829,4901,116,276,1127,2970,1243,3246
291040,202105,5552,14824,4617,13515,154,519,3656,10686,3810,11205
291050,202105,8018,20042,6863,18488,680,1892,5011,13383,5691,15275
291060,202105,6372,18563,5422,17292,299,1180,4182,13254,4481,14434
291070,202105,16647,43673,13933,39359,388,1247,11373,31885,11761,33132
291072,202105,25577,63247,18652,51744,3223,9155,8324,23173,11547,32328
291075,202105,5565,13438,5027,12639,97,235,4248,10487,4345,10722
291077,202105,1696,4355,1325,3707,68,123,935,2647,1003,2770
291080,202105,117048,279231,92642,245690,25343,67986,28079,80923,53422,148909
291085,202105,5664,14125,4759,12736,171,496,3980,10625,4151,11121
291090,202105,2129,3909,1575,3295,38,64,1322,2739,1360,2803
291100,202105,3285,7053,2282,5867,100,259,1763,4502,1863,4761
291110,202105,6222,18033,5322,16541,288,1040,4145,12490,4433,13530
291120,202105,7824,18663,6614,17160,318,829,5116,13281,5434,14110
291125,202105,2288,3952,1741,3343,84,125,1422,2769,1506,2894
291130,202105,3351,9375,2490,7706,56,271,1879,5604,1935,5875
291140,202105,4951,13058,3584,10603,489,1299,2166,6436,2655,7735
291150,202105,2544,5448,1968,4802,3,9,1874,4573,1877,4582
291160,202105,5117,13839,4261,12617,377,1158,2873,8466,3250,9624
291165,202105,2219,5966,1657,4861,31,121,1202,3403,1233,3524
291170,202105,21194,52875,17676,47023,940,2662,11835,30920,12775,33582
291180,202105,6515,14620,4798,12376,230,563,3781,9757,4011,10320
291185,202105,3094,8054,2729,7484,105,279,2142,5917,2247,6196
291190,202105,7914,18869,6558,17140,272,716,5294,13880,5566,14596
291200,202105,2856,7660,2120,6267,69,215,1355,3842,1424,4057
291210,202105,7200,15153,5356,13047,124,410,3987,9758,4111,10168
291220,202105,4346,11874,3938,11282,230,683,3099,8846,3329,9529
291230,202105,4624,9696,3514,8484,39,94,3199,7776,3238,7870
291240,202105,4172,10615,3544,9562,61,208,3041,8105,3102,8313
291250,202105,3417,9869,2671,8503,148,430,1719,5509,1867,5939
291260,202105,1471,3408,1205,3061,29,90,989,2527,1018,2617
291270,202105,5707,14172,4461,12402,396,1117,3175,8899,3571,10016
291280,202105,2681,6297,1969,5288,176,452,1259,3363,1435,3815
291290,202105,5831,15094,4478,13012,345,1039,3043,8802,3388,9841
291300,202105,3897,10377,3084,9033,113,356,2356,6817,2469,7173
291310,202105,5105,13458,4381,12165,161,465,3666,10098,3827,10563
291320,202105,6221,16951,4858,14437,1065,2971,2390,7519,3455,10490
291330,202105,1885,4688,1574,4186,70,177,1204,3128,1274,3305
291340,202105,4421,11116,3560,9649,97,285,2702,7237,2799,7522
291345,202105,2944,8642,2670,8220,97,331,2251,6949,2348,7280
291350,202105,6983,16808,5436,14971,48,144,4755,13291,4803,13435
291360,202105,37079,83763,29189,74372,2777,6802,19265,50537,22042,57339
291370,202105,8262,22025,7298,20535,548,1561,5430,15041,5978,16602
291380,202105,3541,9392,3099,8802,99,352,2610,7357,2709,7709
291390,202105,13425,28315,10351,24932,442,961,8571,20673,9013,21634
291400,202105,14369,35315,11908,31696,1394,3248,7470,21044,8864,24292
291410,202105,3057,7895,2397,6760,37,150,1770,4902,1807,5052
291420,202105,2024,4821,1577,4267,19,75,1407,3795,1426,3870
291430,202105,2776,7668,2398,7041,69,266,1929,5495,1998,5761
291440,202105,6580,18402,5715,16991,319,963,4457,13321,4776,14284
291450,202105,10037,23046,8295,21066,74,125,7361,19172,7435,19297
291460,202105,15900,41336,13937,38450,669,1981,10576,28932,11245,30913
291465,202105,9348,22563,7339,20270,120,526,6360,17430,6480,17956
291470,202105,17995,39056,15027,35666,858,1749,11105,27125,11963,28874
291480,202105,43300,94009,32333,79345,3644,9182,17643,43181,21287,52363
291490,202105,5573,13727,4800,12854,135,433,4334,11550,4469,11983
291500,202105,5180,12337,4356,11247,55,212,3994,10307,4049,10519
291510,202105,4423,10662,3268,9211,36,211,2759,7689,2795,7900
291520,202105,4634,10293,3494,8792,181,480,2720,6789,2901,7269
291530,202105,2393,5301,1709,4424,304,711,958,2720,1262,3431
291535,202105,3463,10007,3038,9250,161,437,2330,7333,2491,7770
291540,202105,2309,5027,1597,4185,75,197,1310,3431,1385,3628
291550,202105,5724,12885,4452,11290,419,860,3009,7875,3428,8735
291560,202105,18661,43596,13625,36983,1555,3996,7824,22309,9379,26305
291570,202105,2418,5654,1908,5031,53,149,1586,4320,1639,4469
291580,202105,6495,16411,5127,14600,250,711,3759,10676,4009,11387
291590,202105,2264,5325,1987,5014,74,239,1776,4398,1850,4637
291600,202105,5445,12445,4200,10564,361,957,2893,7058,3254,8015
291610,202105,5660,14499,5072,13852,62,232,4670,12725,4732,12957
291620,202105,3169,7055,2390,6200,109,265,1855,4925,1964,5190
291630,202105,3512,7556,2626,6428,238,620,1960,4755,2198,5375
291640,202105,16853,39947,12771,34152,1777,4406,6142,16873,7919,21279
291650,202105,9431,23232,8362,21977,558,1004,7017,19001,7575,20005
291660,202105,2085,5008,1542,4194,128,389,1023,2639,1151,3028
291670,202105,2056,5368,1730,4899,103,257,1304,3748,1407,4005
291680,202105,4092,9841,3320,8750,306,815,2348,6212,2654,7027
291685,202105,4935,11630,3969,10364,213,427,3029,8150,3242,8577
291690,202105,4219,9173,2956,7352,301,598,2185,5537,2486,6135
291700,202105,8897,25085,7843,23281,338,1096,6403,18700,6741,19796
291710,202105,5329,12403,3988,10556,248,681,2871,7549,3119,8230
291720,202105,4512,13366,3794,11946,640,2058,2182,6780,2822,8838
291730,202105,6398,15936,5521,14786,260,758,4609,12265,4869,13023
291733,202105,2810,7139,2398,6607,60,159,1756,5102,1816,5261
291735,202105,2992,7788,2403,6756,77,168,1847,5176,1924,5344
291740,202105,4044,10308,2988,8343,100,231,2079,5796,2179,6027
291750,202105,20450,47412,16704,41960,1760,4184,10984,28162,12744,32346
291760,202105,10601,29735,8317,26113,2479,8794,2261,7068,4740,15862
291770,202105,7357,19262,6178,17253,277,852,4757,12920,5034,13772
291780,202105,5233,13630,4712,12907,86,282,4129,11207,4215,11489
291790,202105,2755,7435,2499,7106,226,518,1889,5561,2115,6079
291800,202105,30280,74188,22742,63175,3868,10157,10712,31347,14580,41504
291810,202105,10662,24970,8997,22959,346,800,7529,19516,7875,20316
291820,202105,4011,10176,3492,9505,92,263,2845,7769,2937,8032
291830,202105,4623,10602,3793,9488,217,402,2995,7577,3212,7979
291835,202105,6628,19560,5240,16934,463,1565,3428,11237,3891,12802
291840,202105,48325,130368,42110,120813,4000,12259,30123,85818,34123,98077
291845,202105,2621,6614,2079,5949,104,284,1728,5023,1832,5307
291850,202105,4171,11297,3475,10163,153,427,2736,8117,2889,8544
291855,202105,2288,4358,1769,3785,31,81,1610,3442,1641,3523
291860,202105,2317,5956,1617,4613,42,100,1090,3015,1132,3115
291870,202105,1302,3233,874,2484,35,98,609,1709,644,1807
291875,202105,2996,8855,2580,7994,54,223,1924,5784,1978,6007
291880,202105,5764,16013,4907,14595,234,637,3641,10969,3875,11606
291890,202105,1638,3309,1061,2641,146,320,687,1741,833,2061
291900,202105,1372,3122,1046,2639,19,61,836,2052,855,2113
291905,202105,2469,6201,2043,5537,71,244,1596,4178,1667,4422
291910,202105,3092,7530,2619,6955,54,184,2246,6133,2300,6317
291915,202105,7369,20703,6013,18442,201,684,4523,14084,4724,14768
291920,202105,26908,68397,22853,62872,1994,6006,16282,43861,18276,49867
291930,202105,2583,6665,2219,6176,219,602,1540,4343,1759,4945
291940,202105,3985,9919,2688,7761,202,565,1581,4545,1783,5110
291950,202105,9168,27475,7773,24824,264,958,5439,17210,5703,18168
291955,202105,15671,38921,13927,36683,1143,3121,10996,29001,12139,32122
291960,202105,3279,8166,2765,7484,134,296,2191,6091,2325,6387
291970,202105,4679,11478,3929,10564,135,420,3007,8117,3142,8537
291980,202105,9850,27526,7930,24201,1028,2841,5010,15675,6038,18516
291990,202105,2377,6034,1945,5516,23,84,1804,5125,1827,5209
291992,202105,3937,9402,3189,8444,268,588,2523,6854,2791,7442
291995,202105,2189,5819,1810,5200,48,195,1413,3971,1461,4166
292000,202105,2695,6151,2201,5565,78,244,1769,4454,1847,4698
292010,202105,5821,13306,4756,11815,150,388,4023,9803,4173,10191
292020,202105,4723,13205,3951,11865,168,592,3020,8801,3188,9393
292030,202105,1918,5641,1741,5325,96,299,1140,3430,1236,3729
292040,202105,4603,11392,3604,9910,222,530,2739,7701,2961,8231
292045,202105,4245,10637,3169,9066,34,95,2831,8235,2865,8330
292050,202105,6653,18223,5412,16101,244,805,3518,10334,3762,11139
292060,202105,11273,25798,10407,24724,407,914,9177,21558,9584,22472
292070,202105,5825,14824,5073,13939,311,791,4313,11835,4624,12626
292080,202105,3240,7904,2660,7158,69,219,2382,6375,2451,6594
292090,202105,4609,9882,3244,8225,191,482,2475,6300,2666,6782
292100,202105,11784,27664,10149,25638,1254,3035,6591,17047,7845,20082
292105,202105,3733,8913,3257,8274,77,168,2752,6996,2829,7164
292110,202105,6156,14488,4392,11777,867,2387,2225,5949,3092,8336
292120,202105,7118,17827,5918,15864,346,938,4453,11755,4799,12693
292130,202105,3532,8269,2930,7525,123,352,2274,5754,2397,6106
292140,202105,5341,12032,4529,10862,192,436,3868,9244,4060,9680
292145,202105,2537,6897,2139,6231,91,218,1682,4942,1773,5160
292150,202105,15134,39437,13144,36259,265,959,10868,29409,11133,30368
292160,202105,3078,7245,2329,6289,34,81,1900,5422,1934,5503
292170,202105,8809,22624,7391,20377,354,1037,5670,15330,6024,16367
292180,202105,2928,7848,2167,6456,140,421,1372,4007,1512,4428
292190,202105,2983,7731,2552,7090,125,372,1954,5407,2079,5779
292200,202105,9022,21676,6731,18476,1203,3392,3193,9181,4396,12573
292205,202105,3819,10469,3320,9738,56,251,2892,8452,2948,8703
292210,202105,6735,15183,5471,13610,68,267,4980,12286,5048,12553
292220,202105,2239,5121,1961,4712,68,152,1547,3606,1615,3758
292225,202105,3293,9330,2916,8764,58,254,2551,7532,2609,7786
292230,202105,8869,20749,7958,19602,165,519,6890,16700,7055,17219
292240,202105,4828,13720,4261,12722,268,792,3072,9157,3340,9949
292250,202105,6067,15128,5454,14239,376,958,4187,10871,4563,11829
292260,202105,3428,8788,3053,8302,89,237,2663,7250,2752,7487
292265,202105,3517,9289,2958,8444,59,247,2406,6731,2465,6978
292270,202105,4358,9884,3475,8833,104,245,2903,7409,3007,7654
292273,202105,2868,6022,2291,5322,58,96,1662,4148,1720,4244
292275,202105,1639,4228,1292,3765,52,147,972,2878,1024,3025
292280,202105,2699,6215,2172,5611,86,142,1833,4892,1919,5034
292285,202105,2646,6224,2109,5498,74,150,1737,4572,1811,4722
292290,202105,7646,19594,6042,17380,157,532,4985,14303,5142,14835
292300,202105,10538,25750,8312,22817,803,2301,5729,15782,6532,18083
292303,202105,2995,8372,2601,7745,86,184,2159,6509,2245,6693
292305,202105,2311,6122,2136,5887,38,156,1934,5259,1972,5415
292310,202105,7045,16962,6118,15838,112,352,5443,13924,5555,14276
292320,202105,6221,16629,4952,14318,240,785,3675,10343,3915,11128
292330,202105,2758,5963,2244,5385,106,179,1733,4378,1839,4557
292335,202105,4910,12515,4360,11711,230,525,3663,9979,3893,10504
292340,202105,5510,15365,4578,13605,217,607,3378,9994,3595,10601
292350,202105,2564,6838,2143,6260,78,274,1749,5134,1827,5408
292360,202105,5065,13214,4225,11802,226,675,2999,8303,3225,8978
292370,202105,10331,24117,8916,22283,111,364,8300,20527,8411,20891
292380,202105,6878,18982,6165,17719,390,1112,4730,13467,5120,14579
292390,202105,4678,8760,3463,7356,124,224,3041,6472,3165,6696
292400,202105,22619,62887,19539,58064,1851,5435,13482,40389,15333,45824
292405,202105,4621,10977,3906,9853,88,212,3267,8113,3355,8325
292410,202105,2256,5287,1876,4807,68,143,1649,4261,1717,4404
292420,202105,3596,10290,3301,9855,111,434,2889,8464,3000,8898
292430,202105,5009,14594,3811,12408,284,921,2506,8203,2790,9124
292440,202105,8689,27013,8049,26047,109,534,7247,23335,7356,23869
292450,202105,4099,11477,3203,9765,89,330,2517,7621,2606,7951
292460,202105,5273,13688,4366,12214,237,612,3391,9451,3628,10063
292465,202105,2765,6883,2372,6387,96,207,1601,4734,1697,4941
292467,202105,1965,5326,1727,5005,272,670,1166,3556,1438,4226
292470,202105,3053,7558,2376,6523,67,105,1835,5072,1902,5177
292480,202105,6369,14798,5186,13365,70,238,4713,12050,4783,12288
292490,202105,2315,5602,1965,5096,104,203,1569,4119,1673,4322
292500,202105,6842,17967,5493,15674,414,1249,3704,10442,4118,11691
292510,202105,13901,36013,10872,31276,524,1551,7707,22160,8231,23711
292520,202105,7272,17782,6421,16541,416,1115,5073,12921,5489,14036
292525,202105,6124,14253,5046,13055,125,266,4420,11631,4545,11897
292530,202105,29590,76169,23058,65471,5094,14658,9931,28680,15025,43338
292540,202105,4560,8210,3598,7189,129,204,3254,6539,3383,6743
292550,202105,8422,21230,6493,18940,497,1316,4545,14267,5042,15583
292560,202105,4517,11105,3862,10204,100,237,2980,7866,3080,8103
292570,202105,3699,9533,3117,8477,52,176,2668,7094,2720,7270
292575,202105,6916,19443,6356,18710,419,1163,5071,15160,5490,16323
292580,202105,7625,18943,6302,17009,126,391,5332,14243,5458,14634
292590,202105,7500,19644,6357,17636,302,853,5109,13977,5411,14830
292593,202105,2919,7148,2423,6328,73,179,2040,5281,2113,5460
292595,202105,5554,14421,4753,13441,136,440,4052,11406,4188,11846
292600,202105,10829,29141,9383,26953,343,929,7538,21748,7881,22677
292610,202105,4356,11015,3719,9920,164,356,2859,7710,3023,8066
292620,202105,6466,17431,5342,16072,131,285,4819,14823,4950,15108
292630,202105,8896,21194,7156,18450,767,1905,4486,11752,5253,13657
292640,202105,8488,24124,7372,22290,201,684,5365,16366,5566,17050
292650,202105,4514,11053,4052,10450,109,282,3692,9432,3801,9714
292660,202105,11569,30663,9810,28098,459,1394,7414,21362,7873,22756
292665,202105,2210,6403,1905,5997,66,185,1588,5088,1654,5273
292670,202105,3610,9642,2807,8156,124,369,1902,5417,2026,5786
292680,202105,4088,10480,3239,9014,160,406,2415,6587,2575,6993
292690,202105,2682,6772,1863,5448,188,498,1138,3476,1326,3974
292700,202105,10210,27151,8925,25183,746,1765,6187,18106,6933,19871
292710,202105,2694,7813,2512,7573,36,103,2312,6989,2348,7092
292720,202105,9211,21410,7780,19758,207,538,6238,16161,6445,16699
292730,202105,4983,11134,4573,10526,339,562,3787,8947,4126,9509
292740,202105,319503,758600,275315,696675,37006,93124,174118,439123,211124,532247
292750,202105,6306,16343,5573,15310,213,565,4432,12379,4645,12944
292760,202105,4005,11154,3507,10291,186,583,2648,7705,2834,8288
292770,202105,6539,16474,5299,14754,733,2071,3490,9975,4223,12046
292780,202105,2164,4145,1612,3488,70,159,1301,2699,1371,2858
292790,202105,4093,8519,3102,7442,165,351,2563,6222,2728,6573
292800,202105,11532,28417,9879,25918,319,817,8276,21499,8595,22316
292805,202105,3774,8777,2976,7751,111,295,2377,6152,2488,6447
292810,202105,11117,27852,8910,24421,542,1320,6543,17704,7085,19024
292820,202105,7406,20275,5437,16956,365,1252,3853,11813,4218,13065
292830,202105,2982,6887,2543,6353,87,201,2166,5467,2253,5668
292840,202105,8762,22667,7446,20906,133,457,6550,18166,6683,18623
292850,202105,2509,6511,2107,5934,138,369,1485,4184,1623,4553
292860,202105,16880,36917,15180,34937,383,969,13214,30037,13597,31006
292870,202105,19109,45758,16547,42262,961,2365,11640,29347,12601,31712
292880,202105,11245,30187,9595,27714,240,923,7636,21383,7876,22306
292890,202105,7319,19643,6472,18449,162,627,5709,16187,5871,16814
292895,202105,3198,6578,2398,5411,105,219,1952,4361,2057,4580
292900,202105,2659,6983,2413,6603,46,176,2010,5354,2056,5530
292905,202105,4382,11024,3497,9717,99,310,2680,7371,2779,7681
292910,202105,4804,12904,4399,12338,188,500,3437,9584,3625,10084
292920,202105,9767,26579,9059,25606,260,931,7814,21778,8074,22709
292925,202105,5415,15175,4535,13601,225,625,3252,9750,3477,10375
292930,202105,6528,18707,5653,17153,480,1585,3659,10856,4139,12441
292935,202105,2525,6110,1968,5490,13,68,1778,4982,1791,5050
292937,202105,2839,7067,2467,6599,70,179,2049,5482,2119,5661
292940,202105,2939,7245,2336,6347,192,432,1686,4763,1878,5195
292950,202105,9599,23999,8406,22287,506,1133,6388,16923,6894,18056
292960,202105,5238,12559,4388,11363,132,321,3508,9028,3640,9349
292970,202105,3915,10900,3478,10250,72,298,2924,8646,2996,8944
292975,202105,4437,9376,3949,8837,115,190,3610,8169,3725,8359
292980,202105,3535,8071,2895,7151,73,211,2445,5932,2518,6143
292990,202105,11273,30935,9468,27756,523,1657,7083,20395,7606,22052
293000,202105,2737,6347,2354,5773,46,160,1911,4674,1957,4834
293010,202105,18604,46614,15069,41198,1826,5114,9318,25525,11144,30639
293015,202105,8616,25668,6848,22301,447,1504,4616,15354,5063,16858
293020,202105,9965,28465,8970,27051,124,457,8098,24469,8222,24926
293030,202105,5272,13635,4029,11720,98,285,2793,8360,2891,8645
293040,202105,4499,11449,3805,10470,59,202,3360,9213,3419,9415
293050,202105,23268,55174,20563,51205,1241,2987,15509,38195,16750,41182
293060,202105,3652,9543,2960,8244,236,689,2046,5584,2282,6273
293070,202105,25341,60123,22269,56261,1892,4931,16719,42090,18611,47021
293075,202105,3677,11184,3209,10394,113,508,2651,8547,2764,9055
293076,202105,3613,8635,3308,8279,63,131,2961,7496,3024,7627
293077,202105,6567,17633,5278,15594,467,1462,3257,10133,3724,11595
293080,202105,4849,13987,4161,12808,81,371,3395,10244,3476,10615
293090,202105,3298,9404,2551,8164,216,641,1658,5401,1874,6042
293100,202105,5846,15277,4855,13527,197,541,3855,10668,4052,11209
293105,202105,3847,11981,3362,10986,232,764,2372,7712,2604,8476
293110,202105,2449,5960,2039,5372,60,176,1678,4350,1738,4526
293120,202105,4644,12146,4173,11428,203,413,3458,9597,3661,10010
293130,202105,3783,10243,3307,9631,59,236,2906,8383,2965,8619
293135,202105,30935,71050,23056,60801,3331,9525,11143,29768,14474,39293
293140,202105,2499,5314,2174,4924,61,108,1867,4238,1928,4346
293150,202105,5501,16139,4530,14318,313,996,3126,9930,3439,10926
293160,202105,3772,9217,3218,8617,238,384,2713,7618,2951,8002
293170,202105,5076,10298,4446,9525,104,208,3932,8380,4036,8588
293180,202105,4449,12264,3709,10935,65,256,2984,8594,3049,8850
293190,202105,14412,38323,12778,36007,119,510,11438,32000,11557,32510
293200,202105,8793,21111,7140,18504,182,530,5845,14976,6027,15506
293210,202105,5247,13569,4517,12448,252,679,3553,9775,3805,10454
293220,202105,5189,12895,3832,10673,728,2009,1836,5215,2564,7224
293230,202105,4048,9993,3008,8557,208,605,2123,6110,2331,6715
293240,202105,4633,11936,3737,10484,72,152,2815,8270,2887,8422
293245,202105,3927,10424,3570,9903,153,433,3026,8325,3179,8758
293250,202105,6076,13836,4946,12395,172,422,4112,10316,4284,10738
293260,202105,4821,12415,3985,11116,137,346,2788,7874,2925,8220
293270,202105,7402,15960,5857,14312,422,578,4581,12116,5003,12694
293280,202105,4511,11674,3950,10881,239,578,3075,8613,3314,9191
293290,202105,15446,42889,13704,40192,1597,4712,9399,27736,10996,32448
293300,202105,5885,13999,5074,12819,294,705,3735,9498,4029,10203
293305,202105,4241,9884,3713,9235,65,136,3357,8379,3422,8515
293310,202105,2127,5350,1804,4861,42,126,1446,3839,1488,3965
293315,202105,4222,9711,3495,8631,196,417,2872,7097,3068,7514
293317,202105,2731,6258,2437,5850,166,291,1909,4616,2075,4907
293320,202105,12332,29008,10917,27446,210,578,9886,24715,10096,25293
293325,202105,1805,4361,1404,3835,197,517,874,2444,1071,2961
293330,202105,62852,170897,51404,151134,8542,26011,25121,73141,33663,99152
293340,202105,2221,6146,1836,5467,90,271,1299,3847,1389,4118
293345,202105,3719,9774,2989,8656,404,920,1884,6019,2288,6939
293350,202105,6553,18660,5658,17589,54,267,5173,16287,5227,16554
293360,202105,15119,37690,12876,34702,282,1174,11377,30114,11659,31288
310010,202105,972,2139,632,1674,41,141,238,581,279,722
310020,202105,2878,7502,2163,6258,436,1346,574,1619,1010,2965
310030,202105,1918,5277,1476,4516,209,708,960,2836,1169,3544
310040,202105,877,2256,693,1936,30,116,468,1208,498,1324
310050,202105,1499,4398,1258,4023,116,464,841,2598,957,3062
310060,202105,3137,8738,2730,8192,74,290,2283,6792,2357,7082
310070,202105,344,774,246,635,11,23,182,466,193,489
310080,202105,694,1821,505,1484,79,248,241,672,320,920
310090,202105,4833,12365,3992,11013,259,766,2990,8125,3249,8891
310100,202105,3611,9653,3053,8751,61,277,2560,7149,2621,7426
310110,202105,4765,12190,3704,10390,697,2132,1772,4761,2469,6893
310120,202105,647,1543,417,1180,47,151,249,656,296,807
310130,202105,367,941,310,856,26,100,236,625,262,725
310140,202105,274,760,191,623,40,152,73,212,113,364
310150,202105,5802,14700,4334,12057,504,1587,2172,5719,2676,7306
310160,202105,8530,20746,6227,16980,1066,3172,2426,6576,3492,9748
310163,202105,1050,3081,854,2708,184,645,280,814,464,1459
310170,202105,9621,23794,7699,20822,641,1725,5450,14755,6091,16480
310180,202105,1875,4497,1374,3699,157,451,814,2145,971,2596
310190,202105,2770,7844,2270,6949,509,1748,382,1093,891,2841
310200,202105,2002,5746,1499,4790,172,636,743,2306,915,2942
310205,202105,1148,3063,918,2696,119,392,542,1594,661,1986
310210,202105,2584,6843,2128,6029,116,330,1524,4210,1640,4540
310220,202105,1294,3450,1003,2889,76,232,670,1854,746,2086
310230,202105,2231,6049,1794,5248,217,688,1133,3094,1350,3782
310240,202105,1021,2987,872,2730,47,167,620,1883,667,2050
310250,202105,1076,2801,871,2469,17,66,632,1765,649,1831
310260,202105,3221,8160,2161,6319,595,2021,680,1632,1275,3653
310270,202105,2802,6664,2249,5921,86,262,1866,4905,1952,5167
310280,202105,2550,5777,2014,5019,227,601,1263,3026,1490,3627
310285,202105,1885,5865,1570,5303,154,559,968,3258,1122,3817
310290,202105,1181,3022,971,2663,180,572,533,1310,713,1882
310300,202105,1587,4442,1349,4042,133,501,806,2239,939,2740
310310,202105,324,771,211,576,38,100,102,272,140,372
310320,202105,539,1338,381,1098,21,82,222,604,243,686
310330,202105,490,1133,302,813,45,142,120,279,165,421
310340,202105,8254,21258,6665,18585,906,2502,3373,9594,4279,12096
310350,202105,13009,30861,9024,24538,1411,4093,4377,11416,5788,15509
310360,202105,530,1191,411,1040,12,35,283,707,295,742
310370,202105,1299,3935,1109,3584,211,752,352,1212,563,1964
310375,202105,890,2170,634,1792,92,268,361,1020,453,1288
310380,202105,398,900,219,619,33,97,100,269,133,366
310390,202105,475,1369,380,1189,76,246,122,340,198,586
310400,202105,11050,26582,8165,22242,703,2208,5168,13681,5871,15889
310410,202105,859,2449,563,1909,81,308,222,701,303,1009
310420,202105,4688,11908,3293,9348,449,1406,1417,3736,1866,5142
310430,202105,1592,4213,1081,3281,208,693,419,1119,627,1812
310440,202105,683,1765,475,1384,40,140,259,694,299,834
310445,202105,1402,3907,1028,3164,60,173,733,2221,793,2394
310450,202105,4566,11324,3466,9614,140,512,2662,7165,2802,7677
310460,202105,1805,4739,1379,3956,225,698,502,1333,727,2031
310470,202105,3726,8146,2917,7081,275,634,2093,5211,2368,5845
310480,202105,1011,2557,790,2198,93,272,486,1310,579,1582
310490,202105,2877,7683,2275,6707,251,877,1281,3531,1532,4408
310500,202105,1385,3780,1059,3238,178,614,567,1669,745,2283
310510,202105,2160,5522,1469,4273,251,793,573,1670,824,2463
310520,202105,1184,3045,869,2483,137,375,463,1338,600,1713
310530,202105,766,1899,518,1473,67,223,180,414,247,637
310540,202105,3039,8444,2514,7522,506,1599,1149,3278,1655,4877
310550,202105,1290,3196,924,2589,74,267,534,1365,608,1632
310560,202105,15398,39401,11054,31803,1406,4555,4990,12946,6396,17501
310570,202105,1055,2732,838,2430,52,190,633,1803,685,1993
310590,202105,4196,10884,3364,9330,216,660,1969,5125,2185,5785
310600,202105,1396,3970,1140,3446,139,471,614,1758,753,2229
310610,202105,484,1292,313,1015,114,374,47,138,161,512
310620,202105,183187,456066,135204,370734,16942,53920,69921,174344,86863,228264
310630,202105,4666,12477,3663,10524,399,1206,2217,6168,2616,7374
310640,202105,1170,3357,960,2954,166,558,443,1295,609,1853
310650,202105,2501,6823,1846,5577,152,503,1138,3304,1290,3807
310660,202105,1334,3545,1093,3216,28,94,931,2724,959,2818
310665,202105,1449,3629,1180,3256,17,62,971,2730,988,2792
310670,202105,59803,150674,50676,135394,4481,13473,35156,89538,39637,103011
310680,202105,787,1815,650,1624,17,59,556,1339,573,1398
310690,202105,2050,5170,1491,4241,108,348,882,2380,990,2728
310700,202105,486,1049,379,916,22,70,300,705,322,775
310710,202105,5862,16236,4327,13946,845,3176,803,2292,1648,5468
310720,202105,1065,2423,832,2128,32,102,637,1572,669,1674
310730,202105,10456,26934,8932,24550,349,1180,6724,18024,7073,19204
310740,202105,6595,17615,4796,14000,656,2153,1925,5069,2581,7222
310750,202105,1279,3023,975,2589,102,315,552,1349,654,1664
310760,202105,679,1695,478,1388,35,113,260,753,295,866
310770,202105,1104,2910,767,2396,80,299,403,1163,483,1462
310780,202105,4312,10117,3596,9190,68,168,2966,7605,3034,7773
310790,202105,1847,5733,1593,5192,344,1185,272,781,616,1966
310800,202105,2420,7025,1783,5744,339,1327,105,267,444,1594
310810,202105,1328,3201,1097,2833,48,131,796,1987,844,2118
310820,202105,1265,3149,773,2329,162,498,177,559,339,1057
310825,202105,2650,7757,2129,6892,57,326,1747,5465,1804,5791
310830,202105,1956,5340,1421,4326,237,851,626,1783,863,2634
310840,202105,2142,5710,1615,4825,337,1160,440,1142,777,2302
310850,202105,1444,3950,1208,3614,34,166,939,2697,973,2863
310855,202105,3138,8154,2426,7002,154,527,1747,4921,1901,5448
310860,202105,6881,19702,5561,17206,538,1708,3424,10725,3962,12433
310870,202105,981,2313,776,2022,57,127,570,1497,627,1624
310880,202105,1005,2955,803,2553,109,355,450,1400,559,1755
310890,202105,2219,6271,1448,4745,253,895,225,633,478,1528
310900,202105,3932,10732,2729,8129,400,1243,1209,3357,1609,4600
310910,202105,2208,5303,1556,4285,135,434,344,881,479,1315
310920,202105,1923,4901,1472,4236,182,564,869,2450,1051,3014
310925,202105,959,2544,786,2260,48,163,563,1543,611,1706
310930,202105,5929,15026,4169,12215,794,2334,1885,5798,2679,8132
310940,202105,6780,15676,5490,13832,179,527,4281,10527,4460,11054
310945,202105,1312,3356,1037,2919,180,521,503,1385,683,1906
310950,202105,1939,5671,1294,4236,214,765,374,1030,588,1795
310960,202105,735,1935,408,1243,70,252,80,217,150,469
310970,202105,1154,3341,819,2651,207,730,131,388,338,1118
310980,202105,260,618,172,486,19,60,103,284,122,344
310990,202105,1333,3568,1053,3093,145,458,576,1657,721,2115
311000,202105,3928,10748,2882,9040,701,2305,1163,3592,1864,5897
311010,202105,931,2563,752,2228,197,645,348,1003,545,1648
311020,202105,1157,2892,735,2119,40,121,403,1130,443,1251
311030,202105,1727,4183,1236,3391,241,748,557,1455,798,2203
311040,202105,269,833,223,734,69,235,75,230,144,465
311050,202105,3066,7339,2297,6227,346,1060,1196,3081,1542,4141
311060,202105,3304,8304,2473,6799,324,1020,1015,2536,1339,3556
311070,202105,2381,5763,1743,4800,145,520,1020,2611,1165,3131
311080,202105,1181,2631,958,2285,56,144,747,1700,803,1844
311090,202105,2099,6518,1671,5722,376,1391,530,1792,906,3183
311100,202105,2484,6898,1485,4885,268,995,285,808,553,1803
311110,202105,3649,7400,2050,5174,377,995,704,1831,1081,2826
311115,202105,1415,3061,1198,2778,69,152,968,2228,1037,2380
311120,202105,7007,18017,5416,15215,799,2495,2066,5101,2865,7596
311130,202105,1923,4932,1458,4290,102,376,868,2478,970,2854
311140,202105,1471,3600,1176,3200,63,202,851,2270,914,2472
311150,202105,1453,4580,1136,3963,176,691,616,2093,792,2784
311160,202105,3944,11103,2810,9008,707,2438,828,2553,1535,4991
311170,202105,890,2221,705,1979,41,117,446,1324,487,1441
311180,202105,1386,3073,881,2336,170,479,370,984,540,1463
311190,202105,889,2425,677,2019,114,393,279,719,393,1112
311200,202105,2103,5607,1515,4460,269,874,564,1502,833,2376
311205,202105,895,2572,736,2271,37,147,470,1370,507,1517
311210,202105,1030,2946,894,2752,115,310,627,2005,742,2315
311220,202105,764,2061,643,1843,39,137,437,1179,476,1316
311230,202105,8154,23795,6222,19921,1165,3874,2274,7397,3439,11271
311240,202105,1099,2789,857,2446,176,503,380,1095,556,1598
311250,202105,1172,3310,908,2795,185,545,354,1039,539,1584
311260,202105,2789,6679,1803,4990,236,745,809,1982,1045,2727
311265,202105,1310,3350,967,2776,39,148,667,1871,706,2019
311270,202105,2989,8809,2617,8210,127,546,1938,5851,2065,6397
311280,202105,1082,2765,533,1649,79,276,71,181,150,457
311290,202105,1891,5559,1721,5213,123,369,1197,3629,1320,3998
311300,202105,4833,13053,3979,11638,176,653,3189,9148,3365,9801
311310,202105,572,1561,487,1412,38,120,315,880,353,1000
311320,202105,3307,9852,2865,8914,321,1193,1479,4180,1800,5373
311330,202105,5416,13744,4321,11991,448,1308,2466,6964,2914,8272
311340,202105,10603,28922,8404,25085,2011,6484,2503,7055,4514,13539
311350,202105,2504,6008,1789,4735,173,466,967,2319,1140,2785
311360,202105,1137,2728,752,2177,196,638,266,755,462,1393
311370,202105,4779,11298,3546,9390,178,586,2378,5937,2556,6523
311380,202105,367,1089,267,882,63,207,123,426,186,633
311390,202105,1789,5327,1430,4831,602,2268,387,1201,989,3469
311400,202105,1593,4282,1168,3458,220,661,355,936,575,1597
311410,202105,1823,5165,1460,4603,212,745,840,2559,1052,3304
311420,202105,1536,4434,1086,3505,189,689,300,824,489,1513
311430,202105,4263,10964,2857,8249,466,1383,1014,2825,1480,4208
311440,202105,3030,8251,2311,7047,605,2140,489,1372,1094,3512
311450,202105,1792,5252,1302,4352,327,1239,326,922,653,2161
311455,202105,1013,2214,680,1724,164,425,269,719,433,1144
311460,202105,518,1546,339,1155,67,275,76,207,143,482
311470,202105,525,1576,354,1187,79,297,54,176,133,473
311480,202105,1109,2729,909,2419,65,152,689,1847,754,1999
311490,202105,252,737,192,623,31,126,92,262,123,388
311500,202105,481,1151,382,1008,18,62,257,646,275,708
311510,202105,3331,8428,2337,6747,300,963,1030,2791,1330,3754
311520,202105,657,1771,577,1625,72,250,331,911,403,1161
311530,202105,8695,19977,5603,15072,1303,3888,1514,3865,2817,7753
311535,202105,813,2213,554,1675,89,277,198,558,287,835
311540,202105,510,1565,453,1459,60,222,327,1021,387,1243
311545,202105,2011,5657,1722,5208,91,309,1335,3997,1426,4306
311547,202105,1534,3754,1339,3460,47,107,989,2561,1036,2668
311550,202105,2877,7792,2313,6794,324,1064,1030,2839,1354,3903
311560,202105,317,671,204,502,74,172,56,132,130,304
311570,202105,1626,3707,1156,3055,36,105,916,2446,952,2551
311580,202105,2173,4058,1471,3226,174,316,969,2143,1143,2459
311590,202105,525,1362,421,1205,76,246,232,657,308,903
311600,202105,1718,3874,1436,3506,96,245,1176,2822,1272,3067
311610,202105,2302,7122,1922,6375,158,614,1181,3815,1339,4429
311615,202105,3336,9139,2714,8119,107,387,2170,6369,2277,6756
311620,202105,426,1062,368,997,9,32,319,859,328,891
311630,202105,1359,3680,1119,3198,97,303,721,2004,818,2307
311640,202105,715,1879,578,1671,58,198,298,785,356,983
311650,202105,1977,4894,1614,4337,190,538,980,2557,1170,3095
311660,202105,2934,8305,2197,6877,353,1208,601,1567,954,2775
311670,202105,1595,4044,1185,3312,162,500,501,1372,663,1872
311680,202105,2216,6125,1680,5137,122,362,1185,3611,1307,3973
311690,202105,604,1283,477,1128,37,71,348,872,385,943
311700,202105,2241,5255,1784,4615,21,104,1523,3829,1544,3933
311710,202105,1527,4337,1121,3622,267,940,384,1243,651,2183
311720,202105,438,1249,347,1089,38,135,179,567,217,702
311730,202105,3579,9145,2390,6823,669,2056,518,1490,1187,3546
311740,202105,928,2348,775,2163,71,184,634,1833,705,2017
311750,202105,3942,11471,3175,10114,359,1242,1949,5989,2308,7231
311760,202105,668,1848,548,1636,67,245,287,753,354,998
311770,202105,2193,6105,1731,5308,287,891,785,2326,1072,3217
311780,202105,1375,3865,1002,3151,149,553,361,974,510,1527
311783,202105,2308,6090,1889,5391,31,148,1539,4222,1570,4370
311787,202105,839,2364,649,1930,92,308,291,750,383,1058
311790,202105,1502,4040,981,3071,224,769,276,817,500,1586
311800,202105,4965,14678,4031,12715,847,2760,583,1560,1430,4320
311810,202105,952,2812,756,2473,45,163,517,1659,562,1822
311820,202105,813,1937,607,1624,62,197,389,977,451,1174
311830,202105,8478,23752,5928,18336,1623,5384,743,2233,2366,7617
311840,202105,3748,9190,3037,8182,205,596,2299,6138,2504,6734
311850,202105,371,964,300,833,13,41,201,529,214,570
311860,202105,62466,154333,48380,130555,6342,18594,28031,71843,34373,90437
311870,202105,1915,4993,1344,3989,223,752,578,1568,801,2320
311880,202105,6536,16483,5487,15046,289,655,4133,11612,4422,12267
311890,202105,1725,4066,1332,3524,89,255,930,2341,1019,2596
311900,202105,758,1901,566,1636,50,161,361,1018,411,1179
311910,202105,4101,10417,3108,9116,540,1546,1566,4791,2106,6337
311920,202105,2146,5536,1731,4940,118,284,1100,3266,1218,3550
311930,202105,3916,8960,2845,7486,808,2327,922,2249,1730,4576
311940,202105,15862,40719,11757,33026,1561,4807,5462,14272,7023,19079
311950,202105,2335,6117,1788,5213,113,365,1098,3251,1211,3616
311960,202105,497,1210,394,1058,27,94,244,596,271,690
311970,202105,421,1314,313,1050,56,232,73,204,129,436
311980,202105,459,1225,248,812,19,61,92,297,111,358
311990,202105,536,1245,339,949,59,202,143,353,202,555
311995,202105,974,2657,516,1615,18,58,78,160,96,218
312000,202105,789,1915,588,1616,52,131,372,1048,424,1179
312010,202105,990,2650,772,2302,42,141,523,1496,565,1637
312015,202105,1392,3955,1237,3709,42,175,1013,2969,1055,3144
312020,202105,1712,5142,1267,4163,216,751,292,857,508,1608
312030,202105,2066,4948,1789,4645,14,49,1690,4385,1704,4434
312040,202105,846,2437,605,1972,73,238,268,848,341,1086
312050,202105,1209,3654,977,3216,211,839,333,973,544,1812
312060,202105,881,2110,579,1733,141,431,263,796,404,1227
312070,202105,930,2590,661,2050,32,114,383,1116,415,1230
312080,202105,2739,6608,2081,5642,114,328,1412,3674,1526,4002
312083,202105,920,2342,706,2013,49,175,509,1401,558,1576
312087,202105,2557,6517,2079,5780,47,145,1665,4650,1712,4795
312090,202105,10477,26824,8241,23356,1084,3378,4408,12042,5492,15420
312100,202105,1590,4497,1271,3910,85,323,793,2333,878,2656
312110,202105,1068,3216,882,2849,177,662,334,984,511,1646
312120,202105,1030,2718,701,2151,187,668,202,504,389,1172
312125,202105,1777,4442,1490,4048,99,293,1142,3002,1241,3295
312130,202105,1061,2562,803,2135,72,213,355,861,427,1074
312140,202105,710,2027,582,1768,113,384,259,719,372,1103
312150,202105,482,1308,416,1183,19,60,289,767,308,827
312160,202105,9282,24563,7164,20882,822,2636,3557,9952,4379,12588
312170,202105,906,2397,705,2014,35,124,467,1294,502,1418
312180,202105,1408,3703,1130,3187,145,421,606,1668,751,2089
312190,202105,689,1875,518,1565,77,265,205,584,282,849
312200,202105,4456,12014,3530,10524,882,2602,1445,4391,2327,6993
312210,202105,1406,3067,1030,2542,46,131,777,1876,823,2007
312220,202105,1596,4873,1382,4474,99,335,892,2903,991,3238
312230,202105,14674,37003,10042,28779,2235,7263,2322,5606,4557,12869
312235,202105,1991,4896,1566,4302,99,310,1126,3000,1225,3310
312240,202105,736,2302,563,1942,106,399,171,574,277,973
312245,202105,2745,6848,2268,6130,52,120,1910,5139,1962,5259
312247,202105,1020,2382,744,1989,117,336,421,1113,538,1449
312250,202105,970,2548,621,1859,75,234,225,649,300,883
312260,202105,969,2547,773,2252,35,134,602,1682,637,1816
312270,202105,744,2019,568,1670,34,128,313,846,347,974
312280,202105,426,1224,332,1056,89,301,56,163,145,464
312290,202105,824,2351,677,2091,121,416,225,656,346,1072
312300,202105,1014,3023,680,2203,162,575,132,352,294,927
312310,202105,972,2843,786,2468,114,389,376,1131,490,1520
312320,202105,2034,5128,1493,4208,324,949,337,927,661,1876
312330,202105,871,2496,714,2169,66,230,448,1317,514,1547
312340,202105,258,652,186,537,35,132,93,226,128,358
312350,202105,253,510,181,432,17,46,127,297,144,343
312352,202105,1585,4684,1403,4349,92,286,840,2791,932,3077
312360,202105,3031,8568,2253,7118,408,1424,806,2353,1214,3777
312370,202105,1920,4852,1571,4265,160,490,986,2555,1146,3045
312380,202105,2185,4867,1822,4403,5,15,1636,3900,1641,3915
312385,202105,1258,3341,986,2867,164,501,418,1239,582,1740
312390,202105,1929,5408,1449,4539,194,713,542,1549,736,2262
312400,202105,2924,8150,2452,7361,685,2245,815,2429,1500,4674
312410,202105,12303,32935,10075,29298,1704,5032,5692,16330,7396,21362
312420,202105,3921,10238,3258,9165,603,1837,1713,4667,2316,6504
312430,202105,8003,20891,6587,18397,340,1097,4772,12988,5112,14085
312440,202105,968,3088,796,2703,372,1343,129,404,501,1747
312450,202105,1201,3478,920,2985,253,861,283,963,536,1824
312460,202105,460,1146,327,944,49,135,176,530,225,665
312470,202105,479,1148,296,818,29,90,107,264,136,354
312480,202105,1036,2520,729,2071,89,288,378,1008,467,1296
312490,202105,2218,5226,1757,4571,182,521,1018,2592,1200,3113
312500,202105,1064,2552,876,2296,42,144,642,1659,684,1803
312510,202105,3935,10345,2817,8247,685,1960,669,1963,1354,3923
312520,202105,260,668,203,580,44,143,88,240,132,383
312530,202105,632,1487,540,1378,23,58,458,1196,481,1254
312540,202105,1632,4409,1121,3424,136,442,640,1894,776,2336
312550,202105,809,2087,627,1737,46,148,413,1060,459,1208
312560,202105,1965,5060,1584,4462,72,202,1177,3335,1249,3537
312570,202105,2362,5539,1776,4818,451,1212,747,2148,1198,3360
312580,202105,619,1661,438,1291,57,193,196,527,253,720
312590,202105,1613,4609,1270,3912,81,346,806,2282,887,2628
312595,202105,2057,5827,1723,5277,259,725,1033,3338,1292,4063
312600,202105,1193,2814,696,1875,111,378,124,379,235,757
312610,202105,7133,17773,4808,13534,685,2114,1738,4422,2423,6536
312620,202105,2575,6509,1917,5581,52,179,1531,4551,1583,4730
312630,202105,305,841,213,672,31,117,80,252,111,369
312640,202105,513,1373,361,1113,37,131,161,492,198,623
312650,202105,2068,5147,1451,4016,65,188,1033,2724,1098,2912
312660,202105,1328,3203,1017,2675,92,245,686,1751,778,1996
312670,202105,5081,13081,4248,11772,176,663,3163,8392,3339,9055
312675,202105,1317,3314,1085,2978,56,162,890,2413,946,2575
312680,202105,1410,3899,1222,3599,42,174,1011,2905,1053,3079
312690,202105,3010,6228,2331,5421,43,107,1962,4569,2005,4676
312695,202105,979,2567,833,2337,47,97,651,1835,698,1932
312700,202105,2101,5427,1541,4416,142,473,910,2465,1052,2938
312705,202105,1457,3378,1258,3090,13,40,1156,2816,1169,2856
312707,202105,1374,3883,1063,3343,68,279,701,2107,769,2386
312710,202105,6527,14818,3947,10838,944,2790,1106,3183,2050,5973
312720,202105,1100,2830,822,2399,94,289,503,1422,597,1711
312730,202105,1658,3850,1175,3191,93,278,698,1837,791,2115
312733,202105,1395,3623,1051,2973,26,86,740,1974,766,2060
312735,202105,737,1918,607,1669,78,217,348,887,426,1104
312737,202105,805,1750,580,1438,61,166,391,949,452,1115
312738,202105,723,1800,521,1461,46,144,311,828,357,972
312740,202105,432,1072,254,775,47,163,58,127,105,290
312750,202105,1583,4492,1187,3750,182,610,553,1664,735,2274
312760,202105,1820,5251,1313,4208,225,739,487,1513,712,2252
312770,202105,44988,106521,28562,78511,5475,16238,9864,26239,15339,42477
312780,202105,2450,7134,2066,6508,235,764,1356,4279,1591,5043
312790,202105,250,579,139,405,6,24,40,82,46,106
312800,202105,5075,13960,3895,11732,837,2651,1520,4388,2357,7039
312810,202105,1545,4094,1040,3267,254,876,382,1104,636,1980
312820,202105,1765,4601,1436,4033,66,217,1075,2957,1141,3174
312825,202105,1383,3161,1212,2944,21,61,1053,2504,1074,2565
312830,202105,2818,7770,1743,5602,313,1130,462,1400,775,2530
312840,202105,1410,3672,1140,3223,66,249,695,1837,761,2086
312850,202105,985,2315,701,1900,19,72,442,1101,461,1173
312860,202105,1103,2812,757,2289,188,584,179,512,367,1096
312870,202105,6224,16400,3925,12035,587,1908,1021,2852,1608,4760
312880,202105,1478,3627,1142,3070,43,138,677,1836,720,1974
312890,202105,2288,5574,1705,4631,134,332,871,2402,1005,2734
312900,202105,1253,3146,1021,2843,149,467,481,1447,630,1914
312910,202105,1574,2865,854,1931,190,365,314,755,504,1120
312920,202105,1006,2623,707,2147,113,405,277,754,390,1159
312930,202105,2431,5874,1866,5043,388,1054,839,2339,1227,3393
312940,202105,998,2689,792,2397,63,243,458,1327,521,1570
312950,202105,3072,7486,2047,5851,476,1504,694,1898,1170,3402
312960,202105,1846,4783,1570,4375,80,201,1198,3423,1278,3624
312965,202105,1640,4421,1367,4005,105,285,963,2814,1068,3099
312970,202105,1453,4000,1174,3556,143,506,729,2096,872,2602
312980,202105,24804,66575,20092,58290,3933,12199,9263,25281,13196,37480
312990,202105,518,1257,347,970,59,195,175,436,234,631
313000,202105,479,1362,362,1148,24,107,218,654,242,761
313005,202105,2592,7293,2198,6630,140,398,1595,4761,1735,5159
313010,202105,5263,14039,4224,12387,700,2232,2513,7249,3213,9481
313020,202105,1105,3246,805,2589,130,435,163,454,293,889
313030,202105,1185,2619,811,2095,71,229,539,1322,610,1551
313040,202105,829,2503,685,2219,39,165,420,1286,459,1451
313050,202105,1791,4844,1258,4047,196,761,410,1155,606,1916
313055,202105,1919,5058,1708,4756,57,177,1482,4103,1539,4280
313060,202105,972,2334,705,1885,140,444,149,370,289,814
313065,202105,1680,4862,1480,4538,45,154,1164,3485,1209,3639
313070,202105,960,2474,737,2104,70,212,429,1186,499,1398
313080,202105,395,1080,294,887,53,180,111,278,164,458
313090,202105,5297,13646,4498,12376,316,987,3101,8419,3417,9406
313100,202105,1340,3433,1036,2997,26,106,793,2238,819,2344
313110,202105,1482,3873,1103,3215,95,335,614,1669,709,2004
313115,202105,2784,7782,2223,6708,272,957,1194,3324,1466,4281
313120,202105,3848,8971,2824,7630,199,588,1897,5134,2096,5722
313130,202105,32166,80972,24580,67276,2418,7563,14164,36501,16582,44064
313140,202105,684,1447,430,1095,25,61,311,793,336,854
313150,202105,1390,3826,1044,3214,316,1048,177,493,493,1541
313160,202105,1243,3050,978,2656,21,71,754,1983,775,2054
313170,202105,11286,31480,8344,26034,1321,4525,3449,10031,4770,14556
313180,202105,2188,5711,1586,4489,248,671,886,2508,1134,3179
313190,202105,4404,12457,3238,10109,563,1902,1131,3276,1694,5178
313200,202105,1120,3049,978,2802,14,48,828,2301,842,2349
313210,202105,3953,11067,3242,9794,369,1173,1972,5799,2341,6972
313220,202105,1770,4577,1182,3415,156,500,500,1281,656,1781
313230,202105,3007,8216,2468,7552,43,149,2063,6444,2106,6593
313240,202105,10194,24532,6637,18941,969,3176,3087,8227,4056,11403
313250,202105,6229,17978,4770,14830,850,2597,2141,6425,2991,9022
313260,202105,689,1760,506,1438,62,227,256,662,318,889
313270,202105,5884,14245,4748,12696,528,1271,3309,9108,3837,10379
313280,202105,470,1308,306,969,37,135,129,387,166,522
313290,202105,1001,3037,753,2590,185,708,273,925,458,1633
313300,202105,1648,4324,1216,3580,291,924,330,857,621,1781
313310,202105,1234,3596,963,3033,150,565,294,802,444,1367
313320,202105,2113,5551,1540,4633,267,899,588,1826,855,2725
313330,202105,4244,10856,3218,9309,147,524,2114,6063,2261,6587
313340,202105,1418,3143,1016,2587,78,212,726,1824,804,2036
313350,202105,2996,8186,1963,5889,220,744,748,1953,968,2697
313360,202105,1549,3735,1064,2956,150,499,562,1440,712,1939
313370,202105,1501,4079,1232,3556,164,523,620,1644,784,2167
313375,202105,1840,4801,1189,3563,227,732,253,686,480,1418
313380,202105,6445,15824,4675,12639,737,2249,2291,5528,3028,7777
313390,202105,813,2561,708,2386,50,217,478,1541,528,1758
313400,202105,3685,8929,2857,7806,117,346,2218,5949,2335,6295
313410,202105,1362,3429,1059,2913,58,188,796,2131,854,2319
313420,202105,15870,34885,8351,22428,1885,5619,1105,2942,2990,8561
313430,202105,981,2795,761,2347,121,458,338,898,459,1356
313440,202105,6108,13172,4090,10549,361,967,2594,6711,2955,7678
313450,202105,743,1943,525,1527,87,280,184,457,271,737
313460,202105,2130,5945,1691,5253,337,1182,786,2312,1123,3494
313470,202105,2901,7240,2296,6355,206,568,1559,4370,1765,4938
313480,202105,1049,2942,616,1990,53,191,206,616,259,807
313490,202105,2987,7218,1557,4618,362,1171,371,1081,733,2252
313500,202105,543,1496,399,1189,33,101,163,450,196,551
313505,202105,10239,26598,8727,24543,319,1074,7027,19768,7346,20842
313507,202105,1495,3791,1224,3369,30,126,992,2648,1022,2774
313510,202105,14425,39041,11254,32784,1339,3830,5286,15164,6625,18994
313520,202105,14900,40729,11921,35649,556,1926,8983,26276,9539,28202
313530,202105,560,1626,424,1343,45,157,148,404,193,561
313535,202105,2420,6569,1998,5772,264,684,1247,3631,1511,4315
313540,202105,805,2341,650,1973,113,355,277,762,390,1117
313545,202105,1141,3735,969,3383,132,500,533,1786,665,2286
313550,202105,1828,5425,1519,4706,287,980,804,2392,1091,3372
313560,202105,2748,5317,2069,4492,56,92,1757,3845,1813,3937
313570,202105,1012,2851,830,2530,202,641,333,995,535,1636
313580,202105,5982,14960,4686,12824,489,1382,2855,7765,3344,9147
313590,202105,1090,2966,884,2666,176,568,447,1423,623,1991
313600,202105,4191,10790,3493,9722,81,292,2990,8175,3071,8467
313610,202105,1088,2661,876,2307,81,244,577,1434,658,1678
313620,202105,5485,14244,4309,12138,483,1569,2563,6923,3046,8492
313630,202105,8930,21092,6395,17324,603,1906,3948,10422,4551,12328
313640,202105,1226,2596,753,2000,118,331,409,1080,527,1411
313650,202105,1720,5052,1360,4450,97,375,884,2922,981,3297
313652,202105,792,2408,714,2257,95,315,472,1450,567,1765
313655,202105,1155,2843,901,2529,52,141,669,1896,721,2037
313657,202105,1180,3063,947,2698,28,98,728,1972,756,2070
313660,202105,976,2713,796,2396,74,272,515,1483,589,1755
313665,202105,5060,13202,4028,11418,381,1202,2580,6969,2961,8171
313670,202105,49962,120518,32611,91523,4388,13572,15135,40077,19523,53649
313680,202105,1065,2765,881,2463,58,176,605,1645,663,1821
313690,202105,819,2468,639,2141,143,534,197,626,340,1160
313695,202105,1881,4914,1416,4150,96,288,921,2773,1017,3061
313700,202105,2999,9235,2620,8729,245,761,2006,6758,2251,7519
313710,202105,1495,3322,1068,2759,73,192,719,1872,792,2064
313720,202105,5821,15766,4163,12311,568,1783,1766,4817,2334,6600
313730,202105,1420,3080,1060,2614,84,180,695,1740,779,1920
313740,202105,1713,6003,1447,5326,295,1243,289,920,584,2163
313750,202105,2087,5420,1630,4638,276,883,820,2178,1096,3061
313753,202105,2247,5308,1505,4107,148,447,822,2167,970,2614
313760,202105,5669,15258,4359,12757,785,2583,2074,5622,2859,8205
313770,202105,4078,11231,3242,9903,155,462,2467,7641,2622,8103
313780,202105,4092,10597,3027,8859,241,795,926,2782,1167,3577
313790,202105,513,1519,459,1425,46,154,278,851,324,1005
313800,202105,1404,3100,1023,2582,99,279,551,1325,650,1604
313810,202105,1644,4087,1321,3629,43,154,1034,2763,1077,2917
313820,202105,18030,45436,11399,31433,1893,5350,2977,7970,4870,13320
313830,202105,404,1149,289,892,51,176,104,300,155,476
313835,202105,914,2624,761,2355,63,230,431,1249,494,1479
313840,202105,7590,19516,5870,16708,1287,3969,1300,3779,2587,7748
313850,202105,998,2395,789,2112,140,436,376,904,516,1340
313860,202105,2660,6924,2020,5742,274,906,934,2417,1208,3323
313862,202105,1321,2758,650,1780,42,117,303,826,345,943
313865,202105,2649,6866,2194,6143,87,245,1657,4557,1744,4802
313867,202105,1406,4181,1173,3757,201,635,628,2077,829,2712
313868,202105,1715,5134,1415,4566,47,209,1091,3401,1138,3610
313870,202105,953,2439,652,1899,93,282,255,679,348,961
313880,202105,1845,4685,1358,3857,168,542,692,1784,860,2326
313890,202105,2156,4511,1628,3827,29,92,1266,2886,1295,2978
313900,202105,4321,12169,3099,9708,764,2616,755,2143,1519,4759
313910,202105,695,1973,535,1676,96,328,126,393,222,721
313920,202105,3001,8910,2512,7912,495,1548,1275,4041,1770,5589
313925,202105,1624,4024,1324,3502,154,384,895,2375,1049,2759
313930,202105,4714,13865,3835,12270,266,941,2507,7904,2773,8845
313940,202105,9069,25670,6764,21687,677,2655,1700,6156,2377,8811
313950,202105,5415,11686,4106,10098,304,939,2682,6647,2986,7586
313960,202105,5820,13728,3931,10570,720,2187,1280,3132,2000,5319
313970,202105,1555,4095,1307,3690,21,68,849,2346,870,2414
313980,202105,1324,3397,882,2723,140,473,367,1074,507,1547
313990,202105,1947,6000,1421,4841,323,1281,514,1552,837,2833
314000,202105,9934,24896,8314,22159,629,2080,5516,14422,6145,16502
314010,202105,1479,3505,1173,3093,33,108,914,2338,947,2446
314015,202105,2003,5390,1546,4606,183,640,882,2536,1065,3176
314020,202105,525,1405,364,1129,83,311,68,232,151,543
314030,202105,785,2219,623,1915,61,186,335,1009,396,1195
314040,202105,603,1621,496,1428,81,264,256,703,337,967
314050,202105,1915,4996,1412,4078,134,448,791,2128,925,2576
314053,202105,1872,5471,1542,4830,323,985,831,2703,1154,3688
314055,202105,2240,5904,1898,5376,41,156,1567,4425,1608,4581
314060,202105,1323,3419,995,2906,33,108,714,2063,747,2171
314070,202105,4853,12959,3836,11185,733,2114,1724,4988,2457,7102
314080,202105,2160,5496,1503,4395,168,538,654,1733,822,2271
314085,202105,2273,6146,1859,5522,187,554,1121,3399,1308,3953
314090,202105,4921,12760,4226,11741,251,791,2810,8066,3061,8857
314100,202105,3045,7272,2360,6320,37,113,1769,4769,1806,4882
314110,202105,5063,13843,4155,12155,460,1492,2306,6291,2766,7783
314120,202105,728,1683,318,938,53,186,83,229,136,415
314130,202105,663,1734,432,1311,27,97,252,739,279,836
314140,202105,4614,12643,3701,10977,486,1488,1893,5531,2379,7019
314150,202105,1525,3743,1121,3052,57,140,771,2070,828,2210
314160,202105,2298,5853,1683,4720,216,651,725,2044,941,2695
314170,202105,929,2556,763,2229,39,149,508,1384,547,1533
314180,202105,5545,15048,4482,13343,339,1056,2751,8217,3090,9273
314190,202105,630,1548,469,1315,73,236,246,637,319,873
314200,202105,3045,8378,2525,7501,163,516,1760,5115,1923,5631
314210,202105,2112,5378,1669,4593,218,615,777,2103,995,2718
314220,202105,1443,3866,1074,3228,224,748,397,1097,621,1845
314225,202105,1079,3034,904,2744,68,168,662,2058,730,2226
314230,202105,824,2097,671,1903,85,253,430,1263,515,1516
314240,202105,1100,2902,850,2518,185,570,337,1006,522,1576
314250,202105,497,1381,315,993,47,131,112,334,159,465
314260,202105,1020,2660,791,2348,161,521,427,1239,588,1760
314270,202105,3280,9126,2702,8235,69,285,2022,6109,2091,6394
314280,202105,3509,7973,2385,6271,245,722,1369,3410,1614,4132
314290,202105,4506,11483,3742,10138,320,875,2561,6796,2881,7671
314300,202105,2053,5702,1335,4186,227,774,472,1341,699,2115
314310,202105,3970,10216,2665,7984,796,2667,415,1057,1211,3724
314315,202105,991,3158,844,2846,45,196,608,1985,653,2181
314320,202105,3135,8352,2080,6381,359,1201,778,2241,1137,3442
314330,202105,50724,139754,38727,118779,9831,31352,8324,26825,18155,58177
314340,202105,2523,6206,1603,4591,291,959,411,1026,702,1985
314345,202105,1457,4202,1171,3685,144,454,711,2225,855,2679
314350,202105,819,2194,535,1682,116,370,123,331,239,701
314360,202105,557,1612,364,1208,48,170,124,372,172,542
314370,202105,768,1994,621,1779,48,144,416,1158,464,1302
314380,202105,1130,3002,739,2311,173,611,157,466,330,1077
314390,202105,14405,35604,9702,27217,1458,4431,3396,8448,4854,12879
314400,202105,3908,11584,2996,9767,761,2593,1103,3753,1864,6346
314410,202105,2766,7634,1948,6110,250,916,606,1974,856,2890
314420,202105,855,2068,626,1697,33,120,429,1102,462,1222
314430,202105,8012,19062,5651,15221,807,2265,2697,6948,3504,9213
314435,202105,1933,5066,1507,4363,152,464,939,2651,1091,3115
314437,202105,912,2301,663,1892,72,217,337,961,409,1178
314440,202105,626,1763,449,1415,139,486,88,217,227,703
314450,202105,1473,3816,1235,3427,138,414,698,1866,836,2280
314460,202105,3194,9557,2353,7849,585,2082,574,1821,1159,3903
314465,202105,2250,6348,1912,5723,49,162,1493,4376,1542,4538
314467,202105,898,2347,760,2129,19,52,614,1681,633,1733
314470,202105,2399,6678,1988,5861,345,1081,934,2577,1279,3658
314480,202105,7261,19865,5454,16167,860,2829,2189,5766,3049,8595
314490,202105,1106,2852,815,2261,65,193,531,1431,596,1624
314500,202105,1686,3988,1221,3371,315,835,414,1207,729,2042
314505,202105,2069,4985,1700,4457,88,253,1273,3236,1361,3489
314510,202105,2042,5215,1455,4310,284,935,667,1925,951,2860
314520,202105,5209,15552,4002,13131,793,2856,627,1844,1420,4700
314530,202105,5477,17215,4929,16173,308,1204,3671,11784,3979,12988
314535,202105,2445,6326,1995,5680,76,285,1543,4362,1619,4647
314537,202105,1121,3128,863,2717,40,149,648,2000,688,2149
314540,202105,413,1022,285,810,23,66,166,452,189,518
314545,202105,1990,4658,1783,4420,30,81,1569,3970,1599,4051
314550,202105,729,1732,543,1454,35,115,318,777,353,892
314560,202105,4622,13503,3419,10896,468,1693,1256,3535,1724,5228
314570,202105,314,868,231,716,26,89,106,333,132,422
314580,202105,458,1351,364,1167,94,299,122,390,216,689
314585,202105,667,2022,511,1684,54,207,235,755,289,962
314587,202105,2120,5665,1620,4867,266,781,919,2783,1185,3564
314590,202105,4201,11105,3112,9117,396,1281,1459,3926,1855,5207
314600,202105,1941,5189,1172,3745,253,843,131,407,384,1250
314610,202105,9181,22358,6626,18643,950,3195,2987,8590,3937,11785
314620,202105,2294,5263,1825,4671,38,124,1538,3923,1576,4047
314625,202105,1560,4179,1346,3883,24,141,1171,3308,1195,3449
314630,202105,5564,13614,4564,12267,102,402,3823,10173,3925,10575
314640,202105,710,1655,525,1372,66,200,306,742,372,942
314650,202105,837,1907,528,1425,48,150,304,728,352,878
314655,202105,1581,4298,1137,3514,167,507,561,1755,728,2262
314660,202105,330,743,220,553,11,23,145,354,156,377
314670,202105,1655,3700,1154,2991,16,47,791,2015,807,2062
314675,202105,1746,4487,1487,4063,67,197,1179,3146,1246,3343
314690,202105,2083,5618,1581,4889,393,1333,556,1687,949,3020
314700,202105,10786,29188,7237,22488,1296,4432,2562,7659,3858,12091
314710,202105,8127,22426,5989,17953,934,3108,2257,5895,3191,9003
314720,202105,2193,6390,1546,5083,288,1027,362,1114,650,2141
314730,202105,2368,6049,1714,4901,284,893,650,1704,934,2597
314740,202105,3044,8417,2386,7239,317,999,1214,3582,1531,4581
314750,202105,280,763,215,631,26,89,131,340,157,429
314760,202105,2005,5823,1310,4260,220,802,337,852,557,1654
314770,202105,1109,3158,621,1970,62,211,192,549,254,760
314780,202105,364,868,250,693,40,131,139,342,179,473
314790,202105,11993,31275,8471,24808,1558,5189,3259,8817,4817,14006
314795,202105,1576,4063,1337,3654,27,115,1083,2843,1110,2958
314800,202105,10970,27632,6974,20356,1200,3782,1889,4919,3089,8701
314810,202105,9124,23831,6693,19674,1705,5292,2149,6198,3854,11490
314820,202105,1283,3042,1016,2633,67,217,648,1596,715,1813
314830,202105,1633,4770,1370,4282,200,684,701,2122,901,2806
314840,202105,853,2623,667,2295,48,212,456,1488,504,1700
314850,202105,2254,4972,1833,4447,52,137,1583,3833,1635,3970
314860,202105,3309,9395,2769,8436,156,614,1987,5879,2143,6493
314870,202105,6535,15752,4946,13714,230,648,3677,10342,3907,10990
314875,202105,1871,5464,1654,5179,157,386,1303,4229,1460,4615
314880,202105,837,2022,655,1738,35,98,407,1096,442,1194
314890,202105,424,1246,327,1050,52,182,136,413,188,595
314900,202105,767,1990,595,1686,80,265,276,755,356,1020
314910,202105,1690,4702,1259,3996,189,701,654,1948,843,2649
314915,202105,2204,6422,1853,5798,117,365,1230,3779,1347,4144
314920,202105,492,1276,329,1031,14,37,216,691,230,728
314930,202105,5623,15538,4283,13039,691,2366,1786,5012,2477,7378
314940,202105,421,1003,349,884,39,98,227,555,266,653
314950,202105,570,1412,397,1140,25,90,214,562,239,652
314960,202105,863,1999,663,1680,27,81,484,1159,511,1240
314970,202105,978,2862,752,2403,133,468,335,966,468,1434
314980,202105,1621,4063,1230,3492,206,659,629,1731,835,2390
314990,202105,2490,7123,1796,5576,350,1130,387,1080,737,2210
314995,202105,1633,4447,1304,3867,29,114,902,2526,931,2640
315000,202105,1127,2825,807,2332,61,179,528,1509,589,1688
315010,202105,380,1025,290,872,48,171,142,406,190,577
315015,202105,2325,6400,2022,5893,187,629,1368,3918,1555,4547
315020,202105,804,2318,571,1802,64,247,251,731,315,978
315030,202105,604,1593,415,1245,93,288,85,218,178,506
315040,202105,885,2366,722,2078,98,313,449,1246,547,1559
315050,202105,1261,3156,936,2647,51,183,514,1379,565,1562
315053,202105,1157,2957,890,2502,57,161,523,1403,580,1564
315057,202105,1779,5199,1448,4649,135,398,975,3231,1110,3629
315060,202105,599,1751,436,1419,90,296,113,353,203,649
315070,202105,524,1345,367,1078,84,273,109,297,193,570
315080,202105,3157,8484,2468,7236,152,495,1699,4727,1851,5222
315090,202105,815,2404,609,2017,87,318,262,824,349,1142
315100,202105,1357,3886,902,2879,126,470,403,1124,529,1594
315110,202105,2037,4757,1487,3940,135,350,756,2066,891,2416
315120,202105,12798,29194,9540,24366,1161,2670,5372,14215,6533,16885
315130,202105,1679,4513,1402,4043,138,457,589,1580,727,2037
315140,202105,2967,8101,2344,7008,432,1414,1172,3293,1604,4707
315150,202105,4425,10560,3155,8553,436,1368,1526,4039,1962,5407
315160,202105,1856,4473,1236,3501,253,775,555,1528,808,2303
315170,202105,1371,4283,977,3334,206,766,270,862,476,1628
315180,202105,17600,42096,10021,28367,1259,4028,3459,8596,4718,12624
315190,202105,2244,4871,1746,4222,217,527,1243,3048,1460,3575
315200,202105,4058,11261,2989,9403,807,2755,785,2382,1592,5137
315210,202105,8843,22528,6154,16990,689,2037,3100,7746,3789,9783
315213,202105,1129,2925,984,2728,21,75,819,2216,840,2291
315217,202105,2881,8102,2202,6974,81,323,1510,4610,1591,4933
315220,202105,8636,23089,6826,19942,1004,3069,3172,9293,4176,12362
315230,202105,3056,7005,2570,6357,207,286,1909,5068,2116,5354
315240,202105,2440,6979,2039,6297,419,1349,995,3111,1414,4460
315250,202105,13826,36620,10162,29827,1537,4869,4355,12124,5892,16993
315260,202105,879,2378,477,1538,75,249,40,108,115,357
315270,202105,885,2505,647,2059,87,295,228,630,315,925
315280,202105,2858,7037,1792,5156,437,1345,311,878,748,2223
315290,202105,1175,2867,710,2129,188,626,202,594,390,1220
315300,202105,654,1583,465,1319,63,200,263,754,326,954
315310,202105,1243,3422,950,2876,69,223,554,1579,623,1802
315320,202105,668,1929,470,1531,68,247,192,571,260,818
315330,202105,761,2531,437,1661,64,278,147,492,211,770
315340,202105,2967,7093,2135,5876,332,923,1079,2946,1411,3869
315350,202105,1618,4303,1305,3814,155,530,781,2233,936,2763
315360,202105,1746,5054,1349,4258,186,612,579,1692,765,2304
315370,202105,544,1474,437,1276,72,201,202,574,274,775
315380,202105,267,743,195,586,32,112,29,72,61,184
315390,202105,1171,3243,949,2841,125,448,490,1356,615,1804
315400,202105,4080,10878,3235,9381,375,1154,1891,5224,2266,6378
315410,202105,2524,5640,1891,4710,406,1132,380,972,786,2104
315415,202105,1436,3854,1166,3433,250,855,419,1239,669,2094
315420,202105,1495,4124,1046,3282,181,599,240,710,421,1309
315430,202105,3677,8840,2608,7243,443,1441,1156,3027,1599,4468
315440,202105,1055,2750,837,2391,62,207,503,1343,565,1550
315445,202105,1962,4633,1420,3863,87,277,1055,2827,1142,3104
315450,202105,2339,6289,1923,5604,244,621,1200,3544,1444,4165
315460,202105,39151,105825,32416,93988,4309,14170,18570,50443,22879,64613
315470,202105,643,1772,459,1327,31,98,262,723,293,821
315480,202105,1134,3221,816,2546,142,452,270,820,412,1272
315490,202105,2950,7366,2080,5978,275,820,814,2206,1089,3026
315500,202105,531,1400,336,980,39,133,177,450,216,583
315510,202105,1268,3217,1080,2960,16,65,962,2595,978,2660
315520,202105,1014,2718,834,2425,44,151,656,1858,700,2009
315530,202105,621,1715,497,1490,117,403,263,738,380,1141
315540,202105,1548,4057,1089,3220,92,324,510,1451,602,1775
315550,202105,1894,4916,1240,3725,249,869,321,952,570,1821
315560,202105,6335,18843,5378,17123,312,945,3590,11628,3902,12573
315570,202105,2132,5607,1695,4876,144,458,901,2519,1045,2977
315580,202105,3113,7177,2403,6075,349,954,991,2414,1340,3368
315590,202105,928,2274,720,1959,52,172,459,1172,511,1344
315600,202105,2548,7723,1813,6280,287,901,888,3298,1175,4199
315610,202105,1006,2490,758,2049,102,342,358,836,460,1178
315620,202105,532,1377,407,1194,44,140,228,674,272,814
315630,202105,1065,2761,818,2315,116,362,407,1047,523,1409
315640,202105,349,848,259,735,28,104,162,436,190,540
315645,202105,1003,2554,699,2054,148,469,191,528,339,997
315650,202105,1708,4062,1382,3612,36,110,1119,2850,1155,2960
315660,202105,2477,6059,1862,5005,91,274,1350,3499,1441,3773
315670,202105,13908,37185,10644,31403,1976,6113,4914,13845,6890,19958
315680,202105,3249,9062,2407,7479,257,935,1354,3990,1611,4925
315690,202105,3631,8695,2237,6352,479,1351,596,1836,1075,3187
315700,202105,8401,22597,6408,18745,968,2967,2859,8028,3827,10995
315710,202105,1868,4532,1348,3754,47,170,953,2573,1000,2743
315720,202105,4432,12143,3687,10799,188,710,2595,7302,2783,8012
315725,202105,2270,5769,1744,4928,210,569,1053,3125,1263,3694
315727,202105,569,1446,435,1231,53,177,186,504,239,681
315730,202105,578,1768,511,1631,92,331,165,469,257,800
315733,202105,1250,3127,927,2596,140,451,351,925,491,1376
315737,202105,1175,3210,927,2732,25,94,677,1913,702,2007
315740,202105,809,2224,653,1913,60,201,439,1206,499,1407
315750,202105,1264,3284,1013,2889,92,275,631,1817,723,2092
315760,202105,1166,2698,1018,2496,48,151,846,2019,894,2170
315765,202105,1994,5147,1647,4693,26,99,1462,4154,1488,4253
315770,202105,1020,2762,787,2437,310,1051,164,444,474,1495
315780,202105,30973,82596,25926,73712,1335,4688,18074,48914,19409,53602
315790,202105,3659,11064,3132,10093,316,1057,1915,6323,2231,7380
315800,202105,1312,4398,990,3595,131,536,355,1131,486,1667
315810,202105,1310,3255,1080,2862,60,191,836,2135,896,2326
315820,202105,2602,6823,2107,6128,195,596,1476,4321,1671,4917
315830,202105,1240,3610,838,2731,86,304,267,740,353,1044
315840,202105,895,2115,632,1661,42,140,334,792,376,932
315850,202105,1204,3439,949,2999,182,606,465,1386,647,1992
315860,202105,497,1399,354,1150,55,197,127,362,182,559
315870,202105,476,1249,381,1096,25,79,269,744,294,823
315880,202105,1135,2838,785,2217,95,294,223,583,318,877
315890,202105,1720,4799,1395,4350,343,1181,695,2141,1038,3322
315895,202105,6345,16894,4792,13880,446,1444,2506,6749,2952,8193
315900,202105,817,2077,707,1922,63,171,530,1404,593,1575
315910,202105,526,1415,443,1286,70,197,295,864,365,1061
315920,202105,1446,3630,826,2473,124,457,274,717,398,1174
315930,202105,1107,2427,756,1928,136,328,342,892,478,1220
315935,202105,878,2604,703,2270,133,462,256,812,389,1274
315940,202105,617,1656,491,1467,62,195,262,753,324,948
315950,202105,1154,3157,955,2832,83,235,747,2213,830,2448
315960,202105,5653,15586,3879,12027,1037,3514,489,1083,1526,4597
315970,202105,590,1550,470,1390,58,175,312,941,370,1116
315980,202105,4345,9194,2434,6125,441,1170,944,2167,1385,3337
315990,202105,3598,9146,2838,7836,313,896,1565,4167,1878,5063
316000,202105,636,1548,492,1338,51,165,260,667,311,832
316010,202105,824,2208,620,1850,53,179,330,892,383,1071
316020,202105,946,2773,757,2402,111,391,414,1226,525,1617
316030,202105,2773,7647,2144,6508,239,730,1370,4246,1609,4976
316040,202105,2513,7031,1882,5859,308,1100,547,1478,855,2578
316045,202105,2078,5293,1912,5095,76,145,1669,4553,1745,4698
316050,202105,403,1089,314,943,46,130,173,488,219,618
316060,202105,684,1659,500,1415,18,78,358,968,376,1046
316070,202105,5454,14827,4461,12978,789,2288,2061,5870,2850,8158
316080,202105,750,2300,582,1962,152,551,92,262,244,813
316090,202105,417,1161,325,980,41,128,169,471,210,599
316095,202105,1327,4038,1042,3322,270,917,375,1128,645,2045
316100,202105,2518,7186,1853,5811,308,1065,710,2018,1018,3083
316105,202105,838,2178,687,1934,42,137,473,1358,515,1495
316110,202105,14085,39395,11806,35586,834,2818,8164,24256,8998,27074
316120,202105,1273,3477,840,2497,126,385,269,627,395,1012
316130,202105,1260,2834,831,2127,66,191,503,1241,569,1432
316140,202105,1238,3247,791,2414,85,279,372,1116,457,1395
316150,202105,2097,4581,1671,3989,210,629,732,1642,942,2271
316160,202105,1040,2740,835,2367,36,118,596,1649,632,1767
316165,202105,874,2121,689,1840,105,319,391,985,496,1304
316170,202105,1222,2989,926,2550,36,119,658,1740,694,1859
316180,202105,1416,3959,988,3103,145,524,202,581,347,1105
316190,202105,2724,7603,1636,5020,239,759,641,1744,880,2503
316200,202105,3294,9302,2525,7970,557,1878,775,2347,1332,4225
316210,202105,4647,13422,3367,10502,1153,3961,188,460,1341,4421
316220,202105,641,1907,437,1463,91,351,46,177,137,528
316225,202105,1583,3549,1186,2928,49,177,902,2069,951,2246
316230,202105,434,1161,336,996,58,188,164,484,222,672
316240,202105,5631,16074,4931,14836,352,1150,3746,11109,4098,12259
316245,202105,3186,9885,2896,9406,107,581,2327,7243,2434,7824
316250,202105,10796,25413,8031,21089,1609,4552,3076,7993,4685,12545
316255,202105,2889,7885,2541,7345,108,317,1935,5666,2043,5983
316257,202105,1428,3385,1044,2722,98,269,658,1629,756,1898
316260,202105,2257,5468,1793,4735,213,547,956,2587,1169,3134
316265,202105,1147,3036,901,2623,17,65,683,1940,700,2005
316270,202105,3764,11303,3246,10205,481,1594,1661,4998,2142,6592
316280,202105,2937,8068,2511,7288,324,1026,1407,3947,1731,4973
316290,202105,3448,9427,2780,8181,328,1073,1156,3270,1484,4343
316292,202105,5196,13549,4218,11986,531,1594,2707,7419,3238,9013
316294,202105,854,2497,654,2156,126,487,172,525,298,1012
316295,202105,3350,9236,2740,8190,140,505,1930,5515,2070,6020
316300,202105,1030,2848,828,2524,34,116,608,1833,642,1949
316310,202105,799,2111,531,1636,117,419,100,256,217,675
316320,202105,695,1900,548,1674,57,205,268,794,325,999
316330,202105,1101,2783,848,2360,52,167,648,1756,700,1923
316340,202105,1003,2657,748,2201,76,277,423,1189,499,1466
316350,202105,1320,3635,1091,3258,127,388,701,2074,828,2462
316360,202105,637,1676,529,1502,57,170,382,1089,439,1259
316370,202105,5366,13729,4081,11491,579,1900,1864,4687,2443,6587
316380,202105,1759,4198,1398,3676,57,117,976,2580,1033,2697
316390,202105,788,2101,563,1707,234,804,81,209,315,1013
316400,202105,1205,3364,799,2557,99,354,274,775,373,1129
316410,202105,1142,3095,956,2815,57,184,772,2230,829,2414
316420,202105,1994,5339,1742,5014,39,135,1450,4096,1489,4231
316430,202105,880,2246,589,1747,94,309,233,634,327,943
316440,202105,826,2497,663,2210,117,448,181,550,298,998
316443,202105,557,1534,407,1246,98,347,103,292,201,639
316447,202105,2061,5375,1801,4956,23,76,1583,4302,1606,4378
316450,202105,2190,6473,1684,5427,234,798,989,3117,1223,3915
316460,202105,1284,3215,1051,2854,118,359,684,1770,802,2129
316470,202105,7113,20037,5176,15989,774,2650,2081,5869,2855,8519
316480,202105,199,528,169,487,50,137,77,221,127,358
316490,202105,331,881,232,698,38,122,81,204,119,326
316500,202105,1240,3762,823,2779,171,639,188,584,359,1223
316510,202105,805,2537,642,2212,102,353,329,1137,431,1490
316520,202105,1400,3323,1102,2843,120,376,599,1404,719,1780
316530,202105,1152,2947,830,2370,83,304,434,1106,517,1410
316540,202105,947,2363,762,2082,104,317,413,1020,517,1337
316550,202105,1349,3868,1166,3538,41,149,913,2749,954,2898
316553,202105,4482,12938,3249,10019,452,1530,1312,3581,1764,5111
316555,202105,2684,8064,2428,7711,97,327,2067,6603,2164,6930
316556,202105,531,1306,409,1085,26,74,249,592,275,666
316557,202105,1050,3177,917,2965,286,1005,342,1061,628,2066
316560,202105,341,940,241,789,41,151,93,289,134,440
316570,202105,1355,3812,1130,3402,286,851,378,1202,664,2053
316580,202105,398,835,247,595,36,96,126,284,162,380
316590,202105,1359,3420,953,2644,210,509,452,1237,662,1746
316600,202105,948,2864,812,2591,125,402,406,1296,531,1698
316610,202105,598,1854,488,1676,59,255,287,953,346,1208
316620,202105,2139,5496,1875,5122,84,247,1510,4109,1594,4356
316630,202105,1597,4674,1323,4160,344,1088,508,1769,852,2857
316640,202105,139,365,112,329,16,57,52,128,68,185
316650,202105,1075,3271,860,2933,83,302,541,1857,624,2159
316660,202105,191,466,79,238,12,40,12,24,24,64
316670,202105,1793,4477,1361,3792,345,1005,453,1238,798,2243
316680,202105,2319,5823,1731,4714,102,301,1298,3446,1400,3747
316690,202105,1440,3978,1090,3354,178,588,485,1441,663,2029
316695,202105,1032,2956,855,2642,29,109,599,1836,628,1945
316700,202105,401,909,329,827,15,42,260,626,275,668
316710,202105,3212,10227,2518,8805,434,1645,1112,3786,1546,5431
316720,202105,21181,56624,15805,46462,2615,8221,6954,19266,9569,27487
316730,202105,479,1243,385,1072,41,141,197,507,238,648
316740,202105,776,2200,670,2033,74,260,422,1296,496,1556
316750,202105,407,1163,314,990,74,234,132,403,206,637
316760,202105,3430,10871,2866,9750,1124,4160,679,2190,1803,6350
316770,202105,1647,3641,1258,3124,28,80,1024,2598,1052,2678
316780,202105,553,1609,438,1387,165,570,88,252,253,822
316790,202105,748,1995,541,1586,98,315,164,442,262,757
316800,202105,6452,17775,5197,15512,633,2076,2515,7303,3148,9379
316805,202105,1062,2305,864,2090,57,161,670,1626,727,1787
316810,202105,626,1716,450,1385,78,266,251,743,329,1009
316820,202105,310,744,174,497,20,73,74,189,94,262
316830,202105,815,2088,656,1836,73,215,406,1125,479,1340
316840,202105,2832,7120,2249,6159,176,593,1597,4163,1773,4756
316850,202105,1939,5039,1421,4111,225,701,644,1769,869,2470
316860,202105,20107,50421,14796,42491,2214,7378,6940,19370,9154,26748
316870,202105,8013,21403,6010,17581,850,2708,2766,7561,3616,10269
316880,202105,973,2557,799,2311,135,424,424,1177,559,1601
316890,202105,1175,2581,709,1968,85,306,460,1199,545,1505
316900,202105,2382,6285,1875,5288,382,1155,577,1529,959,2684
316905,202105,519,1527,416,1327,111,383,166,536,277,919
316910,202105,894,2294,544,1678,127,423,51,148,178,571
316920,202105,1814,4367,1301,3620,206,616,666,1810,872,2426
316930,202105,8073,22670,6079,19109,1387,4718,1680,4931,3067,9649
316935,202105,4163,11058,3051,8996,525,1696,1260,3486,1785,5182
316940,202105,6545,18852,5091,15899,723,2477,2167,6256,2890,8733
316950,202105,1934,4441,1508,3865,36,111,1274,3221,1310,3332
316960,202105,5159,11441,3724,9522,357,995,2541,6355,2898,7350
316970,202105,3868,10676,3345,9712,493,1487,1464,4019,1957,5506
316980,202105,693,2049,529,1740,172,633,68,226,240,859
316990,202105,12467,32792,9274,26412,2213,6875,1569,4049,3782,10924
317000,202105,2504,7279,2202,6840,165,425,1646,5187,1811,5612
317005,202105,2606,7144,2084,6101,321,975,1146,3287,1467,4262
317010,202105,24520,56928,15552,43267,2871,8874,6191,17437,9062,26311
317020,202105,62271,146934,37302,104061,6654,20308,12204,31471,18858,51779
317030,202105,697,1811,547,1605,14,53,422,1225,436,1278
317040,202105,11131,27642,7867,22120,1650,5022,2813,8111,4463,13133
317043,202105,884,1960,635,1610,46,119,473,1183,519,1302
317047,202105,1186,2854,823,2276,64,197,537,1430,601,1627
317050,202105,1212,3684,884,2923,118,418,366,1055,484,1473
317052,202105,2412,6573,1947,5829,271,786,1199,3632,1470,4418
317057,202105,1953,4435,1444,3647,32,110,1006,2493,1038,2603
317060,202105,516,1318,334,964,41,126,137,347,178,473
317065,202105,1154,3367,950,2973,57,174,604,1801,661,1975
317070,202105,7469,20475,5432,16578,902,3074,1787,5117,2689,8191
317075,202105,936,2377,690,1966,89,280,353,918,442,1198
317080,202105,6298,14449,4684,11909,1173,3258,1688,4145,2861,7403
317090,202105,4857,13780,4305,12888,290,793,3197,9649,3487,10442
317100,202105,2688,6325,1757,4804,400,1123,646,1755,1046,2878
317103,202105,2296,5888,1975,5421,68,295,1583,4189,1651,4484
317107,202105,1480,3868,1130,3231,72,243,693,1787,765,2030
317110,202105,673,1557,349,1048,64,223,106,326,170,549
317115,202105,1081,3080,932,2800,65,177,627,1904,692,2081
317120,202105,15971,41986,13035,37323,1037,3553,8382,22840,9419,26393
317130,202105,11727,26829,7725,20338,1156,3357,2769,7193,3925,10550
317140,202105,921,2177,723,1873,49,139,498,1312,547,1451
317150,202105,983,2348,754,2057,29,90,598,1604,627,1694
317160,202105,3642,8559,2449,6692,139,409,1369,3842,1508,4251
317170,202105,1841,4536,1359,3728,174,567,665,1616,839,2183
317180,202105,2017,6178,1490,4920,279,980,417,1268,696,2248
317190,202105,1215,3247,898,2723,213,628,384,1167,597,1795
317200,202105,6068,15952,4583,13037,1011,3091,1084,2819,2095,5910
317210,202105,1219,2909,950,2543,24,93,708,1921,732,2014
317220,202105,254,779,219,714,48,165,90,305,138,470
320010,202105,4604,13225,3696,11408,417,1421,2294,6875,2711,8296
320013,202105,2086,5549,1448,4299,227,699,654,2022,881,2721
320016,202105,3036,7672,2424,6761,192,498,1754,4933,1946,5431
320020,202105,4015,10233,2982,8466,607,1916,1127,3273,1734,5189
320030,202105,1776,4905,1179,3695,216,730,417,1251,633,1981
320035,202105,1968,5252,1613,4655,390,1247,744,2065,1134,3312
320040,202105,4374,12164,3653,10878,491,1524,2058,5885,2549,7409
320050,202105,1764,3987,1526,3655,182,513,910,2105,1092,2618
320060,202105,13559,36239,10139,29437,1533,4790,4766,12898,6299,17688
320070,202105,1621,4446,1173,3558,200,674,447,1246,647,1920
320080,202105,5917,14968,4143,11464,805,2342,1511,3932,2316,6274
320090,202105,8808,23074,5886,17109,1291,4005,2091,5644,3382,9649
320100,202105,3233,8613,2650,7603,425,1305,1410,4040,1835,5345
320110,202105,2174,4996,1509,3944,196,539,800,1985,996,2524
320115,202105,2020,6306,1724,5812,744,2638,470,1662,1214,4300
320120,202105,25119,63168,17729,49919,2425,7309,8350,22154,10775,29463
320130,202105,49682,134599,41031,119082,4919,15624,24504,68699,29423,84323
320140,202105,3695,9986,2493,7604,350,1249,1045,3098,1395,4347
320150,202105,14354,36662,10403,29216,2545,7887,1567,3940,4112,11827
320160,202105,6411,17470,4772,14359,745,2438,2105,6251,2850,8689
320170,202105,1784,5016,1302,4055,354,1076,477,1598,831,2674
320180,202105,707,2210,567,1940,195,719,156,481,351,1200
320190,202105,2968,9285,2294,7805,543,1974,578,1814,1121,3788
320200,202105,1378,3666,941,2877,210,718,332,998,542,1716
320210,202105,4417,11102,3412,9407,542,1604,1768,4648,2310,6252
320220,202105,3251,8258,2513,7056,353,1083,1405,3726,1758,4809
320225,202105,1403,4289,1011,3377,345,1261,201,651,546,1912
320230,202105,5293,14248,4057,12179,841,2741,1570,4568,2411,7309
320240,202105,16811,41920,12555,35137,3049,9321,3926,10814,6975,20135
320245,202105,3174,9194,2485,7818,855,2851,406,1243,1261,4094
320250,202105,2610,7096,1761,5123,401,1296,524,1309,925,2605
320255,202105,1952,5954,1672,5437,415,1396,775,2578,1190,3974
320260,202105,1461,4069,885,2796,169,573,216,582,385,1155
320265,202105,2505,7625,2019,6640,862,3057,302,966,1164,4023
320270,202105,2306,6487,1778,5448,449,1493,608,1863,1057,3356
320280,202105,7506,19688,6144,17376,1165,3575,3062,8380,4227,11955
320290,202105,1393,4083,912,2941,244,851,229,699,473,1550
320300,202105,3822,11262,3032,9661,837,2889,822,2448,1659,5337
320305,202105,5304,14754,4130,12459,737,2437,2023,5905,2760,8342
320310,202105,2314,6213,1630,4807,285,892,724,2005,1009,2897
320313,202105,2501,6124,1683,4634,336,1011,450,1112,786,2123
320316,202105,1544,4311,1264,3838,195,595,734,2235,929,2830
320320,202105,22862,58953,16358,47706,3716,11256,5793,16965,9509,28221
320330,202105,2961,7935,2308,6765,408,1228,1220,3610,1628,4838
320332,202105,8205,21777,6536,18719,1406,4304,2877,8021,4283,12325
320334,202105,1802,4978,1264,3891,266,991,312,722,578,1713
320335,202105,1548,4487,1109,3489,231,835,308,896,539,1731
320340,202105,5068,12369,4205,11111,512,1445,2460,6542,2972,7987
320350,202105,5579,13484,3969,10643,418,1257,2186,5445,2604,6702
320360,202105,1458,3710,1084,3015,138,385,524,1405,662,1790
320370,202105,2613,7897,1933,6432,575,2041,580,1901,1155,3942
320380,202105,2672,7003,2224,6280,250,759,1414,3888,1664,4647
320390,202105,7391,19529,5486,15790,1121,3459,2192,5891,3313,9350
320400,202105,3402,9483,2546,7661,700,2259,792,2240,1492,4499
320405,202105,5257,13476,4016,11318,555,1710,2078,5642,2633,7352
320410,202105,4896,12524,3699,10606,652,1816,1837,5486,2489,7302
320420,202105,3219,8281,2489,7009,525,1657,706,1920,1231,3577
320425,202105,2248,5344,1724,4460,137,353,1072,2710,1209,3063
320430,202105,3292,8158,2620,6987,350,986,1609,4116,1959,5102
320435,202105,2113,6526,1678,5673,591,2133,503,1698,1094,3831
320440,202105,1556,4262,1153,3487,179,589,511,1450,690,2039
320450,202105,1831,5161,1427,4397,264,920,652,1866,916,2786
320455,202105,4499,13401,3068,10009,724,2541,762,2239,1486,4780
320460,202105,2159,6289,1559,5041,370,1301,426,1255,796,2556
320465,202105,1405,3812,1070,3197,153,460,569,1734,722,2194
320470,202105,3724,10100,2721,8028,573,1821,716,1911,1289,3732
320480,202105,1837,4843,1505,4299,167,539,955,2646,1122,3185
320490,202105,22888,58323,17228,48512,2788,8384,7510,20913,10298,29297
320495,202105,1344,3622,970,2892,219,741,325,891,544,1632
320500,202105,53095,139622,42568,121728,5682,17641,24804,67918,30486,85559
320501,202105,4658,13351,3483,11213,947,3426,1068,3356,2015,6782
320503,202105,2343,6690,1535,5013,423,1492,393,1247,816,2739
320506,202105,2749,8158,2032,6563,615,2138,188,628,803,2766
320510,202105,10829,28715,8845,25351,885,2896,5541,15305,6426,18201
320515,202105,1832,4993,1427,4164,363,1167,474,1303,837,2470
320517,202105,2213,6557,1780,5628,521,1783,570,1779,1091,3562
320520,202105,38557,97700,29101,81879,4683,14586,12689,34163,17372,48749
320530,202105,34635,89565,27544,77164,2348,7739,17614,46506,19962,54245
330010,202105,24263,62352,20165,55698,2254,6841,13742,36751,15996,43592
330015,202105,1417,3422,1119,2997,191,576,637,1630,828,2206
330020,202105,20058,49438,16881,44910,2305,6779,11685,30487,13990,37266
330022,202105,1930,5120,1504,4417,238,700,846,2475,1084,3175
330023,202105,5343,12424,3960,10526,581,1734,2342,6079,2923,7813
330025,202105,7105,16186,4248,11500,899,2687,941,2418,1840,5105
330030,202105,10659,27938,8162,23947,793,2718,5109,14268,5902,16986
330040,202105,15328,39052,12285,34027,975,3061,8479,22532,9454,25593
330045,202105,87240,202197,71992,183001,5404,13204,57281,145415,62685,158619
330050,202105,2627,6829,1959,5706,361,1115,1019,2836,1380,3951
330060,202105,5366,13739,4200,11674,788,2457,1805,4609,2593,7066
330070,202105,23563,57933,19049,51550,2697,7844,11682,31303,14379,39147
330080,202105,9042,22287,7704,20437,896,2546,5385,14068,6281,16614
330090,202105,3458,7166,2422,5746,143,357,1729,4091,1872,4448
330093,202105,2792,6558,2110,5624,119,330,1614,4270,1733,4600
330095,202105,1382,3761,1087,3238,103,326,640,1786,743,2112
330100,202105,72900,188734,62306,173337,3376,11055,48271,132287,51647,143342
330110,202105,2112,5781,1694,5097,245,802,998,2904,1243,3706
330115,202105,2597,6132,1830,4952,247,771,1052,2718,1299,3489
330120,202105,3638,7911,2747,6786,203,566,1987,4720,2190,5286
330130,202105,4530,12011,3704,10781,468,1420,2345,6787,2813,8207
330140,202105,3951,9961,3149,8821,378,1187,2102,5726,2480,6913
330150,202105,2281,5923,1753,5097,305,913,875,2489,1180,3402
330160,202105,1382,3695,1021,3054,191,611,537,1528,728,2139
330170,202105,115596,278299,93168,248282,12257,31974,63288,170737,75545,202711
330180,202105,1978,4679,1523,4056,89,264,1059,2752,1148,3016
330185,202105,10110,24896,8450,22620,444,1423,6835,17872,7279,19295
330187,202105,4625,11365,3652,9798,456,1325,2249,5933,2705,7258
330190,202105,35263,82892,29707,75370,1853,5113,23785,59560,25638,64673
330200,202105,16648,41000,13498,37148,2586,6623,8424,24125,11010,30748
330205,202105,2258,5465,1714,4598,108,323,1185,3051,1293,3374
330210,202105,3558,8663,2609,7028,339,977,1345,3406,1684,4383
330220,202105,12677,30606,9030,24596,1710,5230,3542,8944,5252,14174
330225,202105,4004,9867,3056,8455,202,675,2194,5913,2396,6588
330227,202105,17309,41005,14430,37536,555,1510,12362,31871,12917,33381
330230,202105,2158,4598,1419,3684,119,333,836,2182,955,2515
330240,202105,24096,61334,20023,55165,2108,6459,13882,37310,15990,43769
330245,202105,1799,4349,1086,3110,199,571,402,1123,601,1694
330250,202105,39868,99175,32894,89039,5066,14076,20859,56071,25925,70147
330260,202105,5047,11870,3824,10233,311,970,2793,7209,3104,8179
330270,202105,33081,73683,20419,52983,3043,8452,8497,20886,11540,29338
330280,202105,2420,6167,1824,5170,181,566,1104,3011,1285,3577
330285,202105,26150,60746,20666,52975,1219,3693,15784,39125,17003,42818
330290,202105,4074,9643,3287,8614,325,965,2395,6065,2720,7030
330300,202105,5935,13701,4349,11465,325,942,3066,7899,3391,8841
330310,202105,2768,6636,1978,5344,141,321,1336,3609,1477,3930
330320,202105,17778,40636,13696,35583,1579,3772,9807,25922,11386,29694
330330,202105,43640,92887,33989,79912,2791,7210,24603,56445,27394,63655
330340,202105,18549,42664,13333,34737,1840,5537,7136,17266,8976,22803
330350,202105,149935,338141,123975,306763,7417,18949,102775,252559,110192,271508
330360,202105,7518,17985,6419,16668,203,497,5456,14134,5659,14631
330370,202105,5143,14334,3982,12389,904,2880,1673,5379,2577,8259
330380,202105,5696,14717,4334,12360,621,2098,2368,6400,2989,8498
330385,202105,4160,11537,3400,10441,720,2440,1690,5085,2410,7525
330390,202105,27576,72154,21162,61435,2676,8994,12742,34807,15418,43801
330395,202105,3294,7941,2697,7191,136,422,2009,5222,2145,5644
330400,202105,3510,8983,2988,8175,143,523,2273,5852,2416,6375
330410,202105,3476,8930,2497,7267,496,1535,1118,3054,1614,4589
330411,202105,2850,7591,2216,6445,146,513,1545,4294,1691,4807
330412,202105,1629,4488,1330,4002,132,453,863,2470,995,2923
330414,202105,24755,60950,20150,54694,1408,4105,15300,40848,16708,44953
330415,202105,4748,12571,3646,10650,366,1119,2093,6008,2459,7127
330420,202105,12584,30517,9004,24757,976,3085,4941,12595,5917,15680
330430,202105,9842,23224,8268,21102,274,870,6655,16519,6929,17389
330440,202105,2785,7155,2130,6065,270,885,1315,3602,1585,4487
330450,202105,1464,4023,1158,3516,140,456,650,1929,790,2385
330452,202105,18343,45442,14738,39924,1668,5116,9729,25351,11397,30467
330455,202105,569961,1323471,443792,1145500,56911,156789,292031,739218,348942,896007
330460,202105,1187,3148,895,2739,148,482,484,1454,632,1936
330470,202105,5161,12484,3724,10321,1132,3253,1052,2988,2184,6241
330475,202105,10074,25254,8146,22789,1183,3773,5314,14491,6497,18264
330480,202105,6113,15498,5134,14077,408,1211,3583,9517,3991,10728
330490,202105,115772,261146,94008,232094,10132,25763,67350,164734,77482,190497
330500,202105,7591,18320,6260,16529,603,1800,4509,11678,5112,13478
330510,202105,42204,101607,31427,86542,4624,13761,19795,53497,24419,67258
330513,202105,1272,3197,1023,2870,196,579,544,1551,740,2130
330515,202105,2581,6716,2074,6018,353,1132,1189,3342,1542,4474
330520,202105,11925,30528,9781,27272,1047,3280,6379,17249,7426,20529
330530,202105,1748,4155,1287,3477,250,729,601,1607,851,2336
330540,202105,2896,7519,2258,6437,554,1625,889,2491,1443,4116
330550,202105,9715,23948,7497,21075,1893,5904,3408,9345,5301,15249
330555,202105,18974,39026,15721,35230,718,1746,13033,29505,13751,31251
330560,202105,4185,10888,3396,9615,536,1530,2017,5591,2553,7121
330570,202105,2724,7327,2329,6751,342,1075,1556,4466,1898,5541
330575,202105,5615,14171,4829,12864,284,858,3901,10088,4185,10946
330580,202105,18460,47974,14494,40978,2323,7087,7480,20171,9803,27258
330590,202105,1482,3911,1222,3575,224,649,763,2279,987,2928
330600,202105,12963,33004,10487,29051,873,2797,6864,18388,7737,21185
330610,202105,9465,24789,7618,21931,590,1937,5264,14841,5854,16778
330615,202105,2157,5797,1714,5208,311,975,1074,3329,1385,4304
330620,202105,4197,11612,3303,10102,675,2213,1468,4208,2143,6421
330630,202105,25177,62004,19859,53842,1220,3919,14357,37623,15577,41542
350010,202105,2157,5616,1195,3578,229,736,241,541,470,1277
350020,202105,720,1823,416,1243,52,175,138,387,190,562
350030,202105,3545,9738,2682,8260,637,2178,1205,3450,1842,5628
350040,202105,757,2149,440,1465,56,216,141,358,197,574
350050,202105,1405,3389,925,2572,191,610,333,762,524,1372
350055,202105,949,2458,753,2152,82,248,449,1216,531,1464
350060,202105,235,588,137,387,16,50,60,164,76,214
350070,202105,3316,8651,2174,6592,430,1425,720,1936,1150,3361
350075,202105,616,1756,459,1447,172,574,60,192,232,766
350080,202105,659,1705,439,1321,57,193,176,477,233,670
350090,202105,611,1412,372,1015,67,198,157,396,224,594
350100,202105,2370,6170,1673,4965,115,436,1061,2939,1176,3375
350110,202105,493,1217,341,955,17,53,204,560,221,613
350115,202105,1224,3503,1005,3053,168,574,519,1418,687,1992
350120,202105,673,1554,377,1018,34,115,206,490,240,605
350130,202105,3193,8339,2509,7086,429,1219,1233,3317,1662,4536
350140,202105,794,2185,555,1738,48,193,288,834,336,1027
350150,202105,547,1643,441,1437,96,304,129,393,225,697
350160,202105,11494,28827,7839,22109,989,3111,4671,12485,5660,15596
350170,202105,2439,6788,2006,5860,305,974,989,2615,1294,3589
350180,202105,1016,2466,557,1627,94,288,162,437,256,725
350190,202105,2899,8091,1998,6165,341,1203,860,2266,1201,3469
350200,202105,466,1303,356,1096,19,73,233,667,252,740
350210,202105,6085,13902,4173,10947,468,1361,2602,6539,3070,7900
350220,202105,2962,8007,2027,6169,414,1301,669,1833,1083,3134
350230,202105,1000,2489,820,2240,146,426,471,1252,617,1678
350240,202105,660,1877,430,1347,104,326,107,298,211,624
350250,202105,2787,7710,2108,6582,598,2042,580,1772,1178,3814
350260,202105,845,1952,551,1465,53,157,339,855,392,1012
350270,202105,4660,12178,3717,10431,504,1576,2039,5296,2543,6872
350275,202105,2405,6374,1900,5608,301,971,1132,3196,1433,4167
350280,202105,18989,42783,11672,30956,1782,4966,4891,12312,6673,17278
350290,202105,3236,8840,2233,6797,393,1302,902,2555,1295,3857
350300,202105,650,1715,487,1415,59,173,272,733,331,906
350310,202105,953,2672,703,2189,113,405,289,808,402,1213
350315,202105,599,1467,396,1130,21,75,213,553,234,628
350320,202105,15806,39938,11654,32672,2236,6934,4775,12325,7011,19259
350330,202105,14296,34492,10329,27085,1041,3003,6595,16279,7636,19282
350335,202105,384,1073,298,909,39,135,134,381,173,516
350340,202105,1203,3039,746,2208,116,398,315,827,431,1225
350350,202105,763,1882,590,1693,65,213,365,1036,430,1249
350360,202105,1081,3166,822,2642,210,685,254,843,464,1528
350370,202105,685,1689,481,1305,156,401,154,409,310,810
350380,202105,4530,12258,3255,9659,920,2658,864,2625,1784,5283
350390,202105,11065,28459,8730,24565,1547,4596,4445,11941,5992,16537
350395,202105,443,1115,231,716,27,81,84,234,111,315
350400,202105,8185,19782,5701,15747,1403,4154,1571,4240,2974,8394
350410,202105,10213,27959,7502,22790,1459,4925,2979,8348,4438,13273
350420,202105,781,2080,541,1558,83,267,133,323,216,590
350430,202105,691,1829,565,1641,66,219,363,978,429,1197
350440,202105,2103,5173,1711,4593,124,348,1126,2960,1250,3308
350450,202105,6509,17771,5031,15206,1075,3592,2073,5869,3148,9461
350460,202105,1793,4580,1004,3010,141,444,345,941,486,1385
350470,202105,255,639,198,542,12,38,141,369,153,407
350480,202105,1020,2452,673,1870,133,436,186,413,319,849
350490,202105,1996,5128,1428,4205,312,945,470,1264,782,2209
350500,202105,675,1769,504,1468,61,194,242,650,303,844
350510,202105,1233,3121,922,2565,96,301,563,1479,659,1780
350520,202105,2223,6630,1729,5687,260,948,764,2267,1024,3215
350530,202105,2923,7261,2206,5915,233,710,1315,3259,1548,3969
350535,202105,1491,4000,1284,3708,184,583,802,2243,986,2826
350540,202105,2045,4696,1526,3954,179,463,975,2433,1154,2896
350550,202105,8525,20785,5923,16492,606,2036,3418,8760,4024,10796
350560,202105,3917,10822,3138,9490,264,853,2047,5979,2311,6832
350570,202105,25261,69163,20569,60314,3504,11392,10826,30266,14330,41658
350580,202105,2116,5582,1303,3925,335,1099,256,628,591,1727
350590,202105,5195,13788,3822,10780,486,1549,2270,5899,2756,7448
350600,202105,35547,81444,22271,58707,3226,9653,10316,24900,13542,34553
350610,202105,7023,18921,5050,15025,774,2561,2470,6878,3244,9439
350620,202105,432,1078,263,811,23,72,153,443,176,515
350630,202105,1493,3771,1107,3107,69,246,735,1904,804,2150
350635,202105,9653,23303,7246,19565,929,2767,4485,11548,5414,14315
350640,202105,912,2417,486,1490,67,203,141,385,208,588
350650,202105,8727,22925,6064,17746,1097,3492,2376,6427,3473,9919
350660,202105,4562,11728,3524,10023,557,1582,1898,5433,2455,7015
350670,202105,1790,4729,1459,4249,152,450,968,2835,1120,3285
350680,202105,1111,2960,771,2351,132,423,316,919,448,1342
350690,202105,1320,3369,937,2736,159,489,495,1413,654,1902
350700,202105,4922,12295,3575,10213,737,2417,1559,4244,2296,6661
350710,202105,2920,7883,2466,7087,433,1435,1320,3481,1753,4916
350715,202105,772,2195,644,1977,68,266,354,1011,422,1277
350720,202105,159,422,118,351,19,59,41,104,60,163
350730,202105,634,1694,537,1530,24,84,405,1092,429,1176
350740,202105,1733,4532,1205,3478,198,608,423,1116,621,1724
350745,202105,590,1459,339,1006,29,105,143,390,172,495
350750,202105,10237,26222,7873,22191,1346,4425,3698,9336,5044,13761
350760,202105,15223,37244,11095,30200,2168,6555,4881,11946,7049,18501
350770,202105,1058,2597,652,1894,44,135,397,1124,441,1259
350775,202105,717,1645,495,1318,59,152,242,661,301,813
350780,202105,2407,5741,1722,4771,297,968,580,1867,877,2835
350790,202105,2074,5448,1332,4046,253,826,364,925,617,1751
350800,202105,3577,10090,3072,9217,240,821,2150,6256,2390,7077
350810,202105,2901,6929,2231,5951,372,916,1118,3045,1490,3961
350820,202105,963,2235,575,1555,69,208,272,659,341,867
350830,202105,892,2435,515,1615,77,246,159,415,236,661
350840,202105,3381,9735,2558,8207,560,2007,1147,3361,1707,5368
350850,202105,7936,21542,6269,18550,1142,3672,3123,8690,4265,12362
350860,202105,3673,9660,3158,8970,110,394,2439,6873,2549,7267
350870,202105,2601,7242,1938,6184,253,894,1104,3435,1357,4329
350880,202105,1347,3773,1064,3219,275,876,273,772,548,1648
350890,202105,560,1452,358,1029,54,167,131,328,185,495
350900,202105,7542,20016,4931,14626,945,3074,1887,5149,2832,8223
350910,202105,933,2227,805,2035,96,251,582,1444,678,1695
350920,202105,12469,30265,10591,27269,394,1267,8775,21779,9169,23046
350925,202105,4218,11260,3029,9152,549,1794,1477,4128,2026,5922
350930,202105,1513,3888,1065,3026,71,210,674,1866,745,2076
350940,202105,2279,5896,1749,5045,174,578,1106,3031,1280,3609
350945,202105,859,2392,653,1991,101,343,323,902,424,1245
350950,202105,91239,230738,70784,193049,8625,25677,44228,115158,52853,140835
350960,202105,6546,17496,5080,14788,600,1996,3036,8407,3636,10403
350970,202105,3587,9893,2575,8044,732,2525,562,1497,1294,4022
350980,202105,657,1774,526,1528,131,396,239,692,370,1088
350990,202105,1816,4963,1355,4231,313,1097,486,1431,799,2528
350995,202105,793,2452,716,2301,60,229,498,1543,558,1772
351000,202105,2847,7362,1982,5849,353,1087,719,2064,1072,3151
351010,202105,345,859,233,668,29,98,117,321,146,419
351015,202105,847,2507,690,2174,110,372,317,903,427,1275
351020,202105,8819,23638,6744,20114,1479,4388,3090,9078,4569,13466
351030,202105,2888,8410,2329,7350,328,1142,1283,3912,1611,5054
351040,202105,5173,12652,4345,11428,206,645,3574,9138,3780,9783
351050,202105,16813,40606,12226,33583,2294,6680,5577,15145,7871,21825
351060,202105,50046,124099,38614,104786,3718,11130,26287,68791,30005,79921
351070,202105,1379,3358,754,2307,182,609,126,367,308,976
351080,202105,2807,6665,2024,5747,203,693,1374,3710,1577,4403
351090,202105,330,942,243,785,45,148,70,233,115,381
351100,202105,2666,7121,1746,5297,377,1216,517,1606,894,2822
351110,202105,6286,15817,4151,11933,645,2050,1878,5046,2523,7096
351120,202105,760,1945,529,1555,68,220,200,573,268,793
351130,202105,1220,3066,568,1715,95,297,153,414,248,711
351140,202105,2261,6217,1681,5133,323,1119,733,1982,1056,3101
351150,202105,2752,7793,1883,5920,275,964,742,2116,1017,3080
351160,202105,1086,3329,791,2647,149,546,206,568,355,1114
351170,202105,1368,3714,1173,3375,81,261,842,2326,923,2587
351190,202105,1030,2816,699,2164,124,379,264,767,388,1146
351200,202105,1639,3855,1226,3253,89,275,872,2171,961,2446
351210,202105,1586,3852,1005,2777,74,241,586,1483,660,1724
351220,202105,3395,9360,2905,8562,290,863,1950,5665,2240,6528
351230,202105,1819,4830,1363,4032,237,805,657,1775,894,2580
351240,202105,2437,6094,1499,4188,321,983,543,1363,864,2346
351250,202105,1105,2879,650,1977,78,255,242,713,320,968
351260,202105,922,2289,665,1824,133,377,253,654,386,1031
351270,202105,467,1245,373,1071,40,133,203,515,243,648
351280,202105,3880,10021,3006,8411,600,1702,1357,3666,1957,5368
351290,202105,1227,2996,862,2373,115,343,521,1366,636,1709
351300,202105,18934,50492,13231,39709,2225,7282,5880,16796,8105,24078
351310,202105,3512,8418,2678,7156,149,508,2009,5112,2158,5620
351320,202105,965,2739,715,2237,119,406,250,694,369,1100
351330,202105,502,1205,412,1040,21,66,290,654,311,720
351340,202105,6335,17652,5117,15510,1194,3785,2311,6976,3505,10761
351350,202105,11637,28675,9608,25508,906,2560,7090,18318,7996,20878
351360,202105,3851,10080,3159,9050,683,2120,1363,3599,2046,5719
351370,202105,2074,5680,1398,4287,317,1039,433,1202,750,2241
351380,202105,48750,115922,34561,91595,4081,11686,20268,51227,24349,62913
351385,202105,392,982,166,503,30,92,44,110,74,202
351390,202105,1371,3291,850,2527,112,393,495,1379,607,1772
351400,202105,951,2601,789,2282,104,299,504,1419,608,1718
351410,202105,2645,7235,1916,5829,317,960,771,2301,1088,3261
351420,202105,471,1114,268,758,29,75,158,421,187,496
351430,202105,960,2527,770,2221,61,179,539,1501,600,1680
351440,202105,3520,9144,2350,6783,415,1256,665,1655,1080,2911
351450,202105,1741,4534,1163,3482,228,757,217,500,445,1257
351460,202105,895,2298,709,2010,144,405,404,1137,548,1542
351470,202105,1225,3060,968,2639,84,294,641,1636,725,1930
351480,202105,2519,7294,1993,6407,366,1318,867,2592,1233,3910
351490,202105,2093,5770,1795,5244,62,252,1480,4181,1542,4433
351492,202105,354,943,291,809,7,21,224,606,231,627
351495,202105,188,478,145,398,16,37,84,231,100,268
351500,202105,39126,94477,29944,79420,4225,11876,18365,46633,22590,58509
351510,202105,12994,31694,9484,25796,1095,3419,5973,15477,7068,18896
351512,202105,490,1298,355,1008,63,185,122,323,185,508
351515,202105,3282,7291,2079,5436,365,1081,601,1649,966,2730
351518,202105,2429,6000,1591,4543,199,634,902,2328,1101,2962
351519,202105,688,1868,432,1364,81,257,71,201,152,458
351520,202105,1331,3258,580,1721,51,170,262,691,313,861
351530,202105,362,940,213,628,35,112,95,232,130,344
351535,202105,1861,4546,1349,3669,200,593,695,1766,895,2359
351540,202105,2667,6536,1782,4966,230,740,775,1908,1005,2648
351550,202105,7319,17916,4965,13671,465,1462,2826,7185,3291,8647
351560,202105,449,1276,344,1071,81,273,96,271,177,544
351565,202105,246,686,198,599,38,127,54,138,92,265
351570,202105,21844,57189,16741,47185,1628,4970,10615,28663,12243,33633
351580,202105,234,595,134,408,14,44,56,175,70,219
351590,202105,530,1198,287,776,26,100,166,394,192,494
351600,202105,1369,3600,1050,2997,114,359,592,1584,706,1943
351610,202105,785,1848,489,1322,24,68,285,727,309,795
351620,202105,23227,60197,16864,49476,2574,8593,7870,20934,10444,29527
351630,202105,29170,75015,23513,65477,2999,8957,15076,40456,18075,49413
351640,202105,18095,46513,14262,39734,1325,4295,9729,25823,11054,30118
351650,202105,366,964,181,577,22,68,55,163,77,231
351660,202105,744,2048,484,1489,74,230,97,254,171,484
351670,202105,6122,16166,4035,11705,835,2420,1688,4559,2523,6979
351680,202105,428,1199,277,873,39,130,70,173,109,303
351685,202105,391,1112,314,989,84,267,100,298,184,565
351690,202105,1133,2818,627,1810,88,287,278,722,366,1009
351700,202105,1309,3229,956,2639,184,521,484,1255,668,1776
351710,202105,782,2053,572,1671,49,166,317,833,366,999
351720,202105,1439,3662,964,2845,151,492,405,1109,556,1601
351730,202105,964,2521,803,2272,61,209,507,1360,568,1569
351740,202105,3512,8724,2806,7395,481,1380,1437,3444,1918,4824
351750,202105,1388,3551,873,2668,142,464,378,1101,520,1565
351760,202105,3309,9183,2445,7489,483,1687,950,2617,1433,4304
351770,202105,1858,5309,1508,4655,236,766,857,2559,1093,3325
351780,202105,1206,3025,734,2152,99,342,283,756,382,1098
351790,202105,1389,3315,1108,2944,171,470,641,1729,812,2199
351800,202105,534,1212,268,714,35,98,101,224,136,322
351810,202105,1080,2818,903,2562,55,141,626,1695,681,1836
351820,202105,2656,7326,1873,5827,477,1619,444,1261,921,2880
351830,202105,4567,12065,3539,10302,320,1110,2251,6217,2571,7327
351840,202105,8862,23867,6675,19887,876,2942,3667,10151,4543,13093
351850,202105,1550,4225,1039,3214,158,556,371,973,529,1529
351860,202105,2735,7710,2105,6549,330,1166,1159,3573,1489,4739
351870,202105,24157,60752,17983,50680,4227,12351,7497,21324,11724,33675
351880,202105,138581,349386,104670,292045,21095,65357,52585,138838,73680,204195
351885,202105,948,2496,743,2158,54,194,493,1367,547,1561
351890,202105,858,2191,546,1672,107,357,108,281,215,638
351900,202105,1132,2960,880,2580,119,343,529,1535,648,1878
351905,202105,448,1216,317,962,24,82,163,434,187,516
351907,202105,21336,55087,16656,46895,1823,5712,10773,29069,12596,34781
351910,202105,1694,4317,1184,3240,81,252,700,1726,781,1978
351920,202105,903,2398,680,1967,103,333,283,737,386,1070
351925,202105,926,2392,711,2007,87,285,374,970,461,1255
351930,202105,3312,9061,2967,8438,555,1598,2005,5614,2560,7212
351940,202105,1117,2823,808,2287,126,386,400,1116,526,1502
351950,202105,1730,3877,1309,3262,57,174,951,2279,1008,2453
351960,202105,5123,12744,3724,10278,812,2396,1682,4311,2494,6707
351970,202105,7308,21114,5775,18479,860,3125,3217,9910,4077,13035
351980,202105,998,2330,655,1780,91,286,366,899,457,1185
351990,202105,1517,3544,1099,2918,46,170,542,1295,588,1465
352000,202105,2714,7608,2344,6844,243,805,1565,4280,1808,5085
352010,202105,2354,6114,1913,5394,508,1589,423,1212,931,2801
352020,202105,1389,3749,1070,3225,146,498,543,1539,689,2037
352030,202105,5896,15356,4588,13208,820,2567,2305,6404,3125,8971
352040,202105,3348,8646,2366,6717,365,1128,889,2211,1254,3339
352042,202105,3075,7341,2071,5763,358,1161,982,2574,1340,3735
352044,202105,2161,5599,1290,3972,198,689,261,742,459,1431
352050,202105,12990,33999,8623,25487,2028,6859,1731,4321,3759,11180
352060,202105,731,1939,545,1593,87,286,232,604,319,890
352070,202105,938,1886,606,1450,58,156,314,675,372,831
352080,202105,490,1227,282,814,29,99,94,241,123,340
352090,202105,1522,4433,1266,3933,152,547,617,1736,769,2283
352100,202105,3465,9579,2791,8311,563,1830,1234,3526,1797,5356
352110,202105,627,1780,474,1486,96,309,190,549,286,858
352115,202105,559,1476,461,1321,60,198,278,774,338,972
352120,202105,906,2612,741,2296,78,219,443,1292,521,1511
352130,202105,2124,5797,1432,4144,215,637,610,1630,825,2267
352140,202105,1170,3172,838,2521,144,454,379,1100,523,1554
352150,202105,899,2342,700,2013,71,219,501,1407,572,1626
352160,202105,1023,2478,738,2026,69,235,423,1101,492,1336
352170,202105,3022,7938,2402,6754,282,896,1522,4004,1804,4900
352180,202105,2402,6396,1827,5378,407,1363,566,1466,973,2829
352190,202105,1283,3420,1022,3018,180,477,527,1628,707,2105
352200,202105,323,956,227,759,36,142,81,262,117,404
352210,202105,20313,47077,16038,41453,911,2654,12620,31919,13531,34573
352215,202105,682,1713,570,1549,76,231,350,914,426,1145
352220,202105,21639,52583,15200,41408,2610,7836,7318,18323,9928,26159
352230,202105,15078,42436,11710,36169,2740,9418,4198,11891,6938,21309
352240,202105,10254,26068,7856,22151,1668,5269,3464,9091,5132,14360
352250,202105,22971,63175,18427,55513,2805,9058,11258,33310,14063,42368
352260,202105,4934,12116,3355,9117,475,1466,1940,4745,2415,6211
352265,202105,934,2556,826,2408,71,236,605,1705,676,1941
352270,202105,1441,4234,1070,3452,222,765,376,1141,598,1906
352280,202105,2460,6079,1855,5212,186,623,1128,2954,1314,3577
352290,202105,1183,3328,959,2913,125,430,521,1427,646,1857
352300,202105,873,2330,601,1764,79,268,318,865,397,1133
352310,202105,43154,113546,32271,94790,7699,23179,14066,41586,21765,64765
352320,202105,6723,17223,5231,14451,717,2215,2873,7149,3590,9364
352330,202105,2237,5860,1709,5125,279,986,961,2687,1240,3673
352340,202105,6231,16203,4635,13315,689,2269,2381,6281,3070,8550
352350,202105,2253,6307,1749,5205,161,592,1042,2840,1203,3432
352360,202105,1266,3324,1042,2937,80,270,781,2124,861,2394
352370,202105,1112,3076,964,2832,17,69,793,2281,810,2350
352380,202105,846,2256,631,1881,132,399,220,633,352,1032
352390,202105,14858,36208,10168,28026,1585,4777,5599,14599,7184,19376
352400,202105,3564,9741,2917,8547,595,2055,1403,3814,1998,5869
352410,202105,3373,8518,2572,7193,221,741,1601,4281,1822,5022
352420,202105,844,2044,601,1692,117,347,226,589,343,936
352430,202105,8395,20484,6092,16490,1094,3377,3085,7836,4179,11213
352440,202105,18780,50181,14200,41467,3365,10183,5238,14854,8603,25037
352450,202105,781,1868,402,1223,58,192,148,423,206,615
352460,202105,3035,8165,2131,6555,409,1374,888,2553,1297,3927
352470,202105,3379,8489,2568,7196,273,878,1623,4322,1896,5200
352480,202105,4096,9628,2754,7253,394,1217,1345,3114,1739,4331
352490,202105,786,2218,629,1940,101,348,289,831,390,1179
352500,202105,10409,26557,7064,20369,2786,8823,758,1262,3544,10085
352510,202105,3907,10509,2915,8766,554,1804,1385,3978,1939,5782
352520,202105,2959,7558,2308,6486,381,1230,1351,3449,1732,4679
352530,202105,10838,27504,7385,21021,1251,4097,2752,6722,4003,10819
352540,202105,599,1736,442,1399,67,225,156,442,223,667
352550,202105,1038,2834,738,2272,125,452,263,714,388,1166
352560,202105,574,1576,441,1323,72,237,226,625,298,862
352570,202105,2424,6788,1574,4963,376,1308,185,442,561,1750
352580,202105,650,1671,544,1479,44,136,376,973,420,1109
352585,202105,339,900,249,739,19,74,156,419,175,493
352590,202105,13241,34360,9296,26945,2200,6962,4282,11518,6482,18480
352600,202105,1920,5127,1512,4394,141,447,969,2682,1110,3129
352610,202105,2802,7724,2102,6520,407,1437,892,2592,1299,4029
352620,202105,5712,14271,4356,12355,1173,3392,1802,5145,2975,8537
352630,202105,849,2088,632,1781,111,344,298,786,409,1130
352640,202105,3070,7747,2228,6263,218,632,1285,3443,1503,4075
352650,202105,600,1678,417,1288,51,165,158,466,209,631
352660,202105,1102,3185,915,2811,95,309,565,1697,660,2006
352670,202105,9816,26121,6647,19904,1582,5173,2025,5550,3607,10723
352680,202105,3358,9757,2339,7468,362,1371,1103,3140,1465,4511
352690,202105,27802,68813,21821,58822,1284,4111,15718,40607,17002,44718
352700,202105,602,1483,459,1299,139,442,152,419,291,861
352710,202105,5240,13439,3757,10774,875,2757,1572,4160,2447,6917
352720,202105,8033,21380,6298,18226,2271,6784,1775,4767,4046,11551
352725,202105,588,1397,336,948,24,71,173,455,197,526
352730,202105,5516,15905,5018,14799,570,1810,2285,5883,2855,7693
352740,202105,2341,5551,1780,4734,178,550,1085,2713,1263,3263
352750,202105,429,1055,267,763,42,136,111,278,153,414
352760,202105,1733,4736,1361,4016,105,291,793,2334,898,2625
352770,202105,865,2318,599,1812,120,369,226,652,346,1021
352780,202105,648,1808,466,1439,100,278,119,390,219,668
352790,202105,462,1207,328,950,29,91,140,362,169,453
352800,202105,1249,3760,877,2888,235,792,112,327,347,1119
352810,202105,1196,2777,774,2050,131,363,452,1129,583,1492
352820,202105,470,1302,339,1065,68,208,71,216,139,424
352830,202105,600,1510,286,865,23,73,79,196,102,269
352840,202105,4000,11262,3277,9980,1014,3339,1128,3287,2142,6626
352850,202105,11044,26602,7671,21192,1967,5966,2608,6437,4575,12403
352860,202105,1066,2912,813,2465,141,461,307,887,448,1348
352870,202105,888,2186,620,1659,54,163,382,974,436,1137
352880,202105,1720,4048,1208,3168,208,569,609,1527,817,2096
352885,202105,311,838,234,710,24,75,138,404,162,479
352890,202105,700,1688,462,1195,46,137,269,606,315,743
352900,202105,18314,47186,12293,35431,2000,6153,5329,14418,7329,20571
352910,202105,420,1098,244,733,24,78,82,211,106,289
352920,202105,2652,6658,1948,5483,118,365,1362,3722,1480,4087
352930,202105,5844,15549,4401,12765,749,2419,2144,5795,2893,8214
352940,202105,22416,59581,16492,47506,3043,9551,7766,21003,10809,30554
352950,202105,550,1433,343,1054,90,280,71,193,161,473
352960,202105,752,1971,432,1311,67,220,123,295,190,515
352965,202105,221,617,141,460,41,132,35,103,76,235
352970,202105,2996,7119,2318,5998,227,636,1542,3905,1769,4541
352980,202105,1372,3575,1088,3158,252,818,565,1587,817,2405
352990,202105,4357,11758,3301,10003,634,2080,1635,4762,2269,6842
353000,202105,494,1325,287,846,41,136,72,167,113,303
353010,202105,2652,6511,1751,4867,331,1066,766,1911,1097,2977
353020,202105,3571,9136,2162,6269,299,971,751,2043,1050,3014
353030,202105,4575,11344,3155,8915,703,2155,928,2480,1631,4635
353040,202105,658,1469,460,1185,103,258,219,555,322,813
353050,202105,5225,14728,3715,11675,686,2333,1692,5073,2378,7406
353060,202105,48994,123781,40610,110486,2637,8520,30784,80904,33421,89424
353070,202105,9893,27855,7264,22247,1269,4264,3178,8918,4447,13182
353080,202105,4243,11430,2802,8644,491,1732,1121,3010,1612,4742
353090,202105,609,1786,487,1535,33,113,313,950,346,1063
353100,202105,290,773,140,441,23,76,39,98,62,174
353110,202105,7561,19648,6071,17546,1300,3852,3058,9194,4358,13046
353120,202105,406,990,310,838,38,123,158,377,196,500
353130,202105,2603,6028,1638,4383,390,1157,559,1349,949,2506
353140,202105,2760,6762,2008,5508,100,334,1440,3785,1540,4119
353150,202105,1638,3979,1173,3229,240,685,488,1270,728,1955
353160,202105,629,1612,461,1342,60,184,202,532,262,716
353170,202105,531,1398,398,1213,74,243,185,574,259,817
353180,202105,10204,24477,8081,21158,780,2253,5902,14969,6682,17222
353190,202105,3418,9048,2738,7701,358,1079,1610,4252,1968,5331
353200,202105,1821,4773,1011,3140,167,581,281,782,448,1363
353205,202105,407,1214,346,1081,54,175,165,498,219,673
353210,202105,919,2092,598,1580,23,63,417,1078,440,1141
353215,202105,379,1030,298,886,45,149,142,386,187,535
353220,202105,732,1932,477,1414,97,273,83,237,180,510
353230,202105,840,2271,656,1987,174,575,249,688,423,1263
353240,202105,2361,6320,1960,5677,272,909,1178,3258,1450,4167
353250,202105,1309,2929,826,2153,103,301,461,1141,564,1442
353260,202105,1193,2708,664,1853,86,263,319,846,405,1109
353270,202105,699,1799,596,1619,47,141,423,1086,470,1227
353280,202105,685,1820,483,1458,138,423,112,324,250,747
353282,202105,1846,5134,1557,4607,172,547,965,2721,1137,3268
353284,202105,364,817,202,527,18,68,101,227,119,295
353286,202105,177,442,109,332,18,57,39,109,57,166
353290,202105,1489,3913,932,2810,162,483,282,789,444,1272
353300,202105,2113,5573,1571,4519,250,827,716,1823,966,2650
353310,202105,407,989,296,795,21,72,198,505,219,577
353320,202105,660,1595,566,1470,7,26,493,1271,500,1297
353325,202105,699,1998,490,1538,100,308,170,516,270,824
353330,202105,571,1457,403,1153,53,151,211,559,264,710
353340,202105,2937,7917,2158,6394,414,1375,1063,2910,1477,4285
353350,202105,3774,9424,2660,7314,563,1599,850,2114,1413,3713
353360,202105,669,1836,515,1542,48,149,305,886,353,1035
353370,202105,575,1641,481,1494,43,130,340,1031,383,1161
353380,202105,294,856,247,767,22,67,132,381,154,448
353390,202105,6523,15901,4924,13262,438,1344,3051,7758,3489,9102
353400,202105,470,1240,358,1034,65,217,140,335,205,552
353410,202105,532,1419,401,1186,70,204,225,673,295,877
353420,202105,414,1076,258,760,59,175,17,40,76,215
353430,202105,2250,6106,1748,5191,317,1014,848,2398,1165,3412
353440,202105,66112,175523,48407,141948,7378,23663,26643,73696,34021,97359
353450,202105,372,916,249,703,32,104,121,310,153,414
353460,202105,3249,8717,2373,7089,193,617,1043,3006,1236,3623
353470,202105,8142,20987,5946,16978,959,3139,2680,7025,3639,10164
353475,202105,1583,4022,1126,3103,162,489,569,1449,731,1938
353480,202105,1623,4300,1298,3752,52,192,935,2617,987,2809
353490,202105,1112,2899,757,2240,105,346,351,972,456,1318
353500,202105,1086,2557,800,2122,171,467,438,1133,609,1600
353510,202105,815,2396,601,1887,135,445,166,444,301,889
353520,202105,1051,2710,673,2032,73,246,330,914,403,1160
353530,202105,2458,6401,1940,5469,261,831,1065,2780,1326,3611
353540,202105,2135,5655,1762,5063,279,842,1038,2882,1317,3724
353550,202105,5900,14942,4802,13198,733,2109,2798,7369,3531,9478
353560,202105,2355,6217,1797,5377,469,1509,557,1493,1026,3002
353570,202105,593,1536,439,1283,50,159,245,672,295,831
353580,202105,2169,5651,1635,4608,361,1023,720,1978,1081,3001
353590,202105,694,1785,474,1386,82,252,215,634,297,886
353600,202105,1722,4222,1299,3488,154,412,712,1867,866,2279
353610,202105,633,1887,472,1569,90,366,166,498,256,864
353620,202105,2729,7095,1958,5788,380,1254,674,1819,1054,3073
353625,202105,518,1286,353,998,26,87,216,587,242,674
353630,202105,1376,4117,1163,3670,228,803,489,1414,717,2217
353640,202105,1377,3546,1105,3126,155,434,614,1726,769,2160
353650,202105,7702,20272,5884,16913,628,1991,3510,9509,4138,11500
353657,202105,397,1028,291,856,27,88,132,355,159,443
353660,202105,1301,2736,887,2193,342,859,280,669,622,1528
353670,202105,4134,11302,3204,9501,589,1962,1556,4239,2145,6201
353680,202105,703,1802,522,1544,67,230,312,856,379,1086
353690,202105,417,1087,202,616,23,78,43,108,66,186
353700,202105,2103,5385,1747,4809,114,375,1304,3433,1418,3808
353710,202105,5431,12088,3263,8276,375,990,1732,3902,2107,4892
353715,202105,433,1132,258,807,4,19,93,280,97,299
353720,202105,2009,5190,1553,4507,217,670,884,2500,1101,3170
353730,202105,4475,11535,3415,9701,462,1549,1854,4805,2316,6354
353740,202105,2039,5287,1444,4250,334,1081,484,1280,818,2361
353750,202105,892,2658,651,2190,144,528,153,492,297,1020
353760,202105,12796,29195,9795,25216,1975,5185,5231,13267,7206,18452
353770,202105,687,2045,423,1409,75,270,50,151,125,421
353780,202105,5503,14766,4422,12786,948,3052,2195,5838,3143,8890
353790,202105,2760,8163,2016,6604,506,1836,409,1168,915,3004
353800,202105,18875,48502,14877,42112,2188,6483,8281,23349,10469,29832
353810,202105,1181,3134,763,2259,106,358,343,962,449,1320
353820,202105,1770,4707,1239,3662,254,808,416,1154,670,1962
353830,202105,657,1630,478,1336,82,244,210,564,292,808
353850,202105,1632,4437,1266,3763,258,769,478,1364,736,2133
353860,202105,2678,7227,2064,6199,457,1580,947,2550,1404,4130
353870,202105,30259,78091,21828,62059,2705,8579,11606,30171,14311,38750
353880,202105,3206,8713,2544,7487,214,719,1545,4359,1759,5078
353890,202105,2795,5982,2018,4861,143,380,1454,3279,1597,3659
353900,202105,758,2097,557,1706,78,266,227,644,305,910
353910,202105,2425,6622,2023,6007,198,683,1393,4053,1591,4736
353920,202105,1916,5216,1383,4188,312,1077,337,840,649,1917
353930,202105,4507,11776,3092,9123,500,1707,1339,3481,1839,5188
353940,202105,1119,3137,777,2467,137,465,274,781,411,1246
353950,202105,3349,8918,2573,7480,510,1593,1332,3625,1842,5218
353960,202105,783,1974,549,1544,95,256,228,615,323,871
353970,202105,651,1534,488,1286,39,116,340,874,379,990
353980,202105,16527,41060,12957,34964,783,2473,9463,24430,10246,26903
353990,202105,961,2318,589,1646,107,319,267,706,374,1025
354000,202105,2538,6021,1425,3974,317,916,237,636,554,1552
354010,202105,360,929,255,758,51,160,131,377,182,537
354020,202105,3695,9819,2944,8319,630,1925,1304,3357,1934,5282
354025,202105,723,1993,490,1538,70,235,138,411,208,646
354030,202105,514,1116,278,735,59,164,131,319,190,483
354040,202105,816,1863,525,1399,23,73,390,1003,413,1076
354050,202105,939,2640,664,2148,141,501,223,674,364,1175
354060,202105,3351,9347,2368,7303,475,1594,956,2678,1431,4272
354070,202105,3771,9742,2549,7363,421,1410,1158,2878,1579,4288
354075,202105,2730,7669,2167,6654,284,947,1261,3786,1545,4733
354080,202105,1356,3678,901,2799,182,582,263,747,445,1329
354085,202105,447,922,355,803,0,0,268,555,268,555
354090,202105,1672,4616,1441,4146,73,223,1130,3186,1203,3409
354100,202105,19824,52795,13704,42273,2942,9829,5250,16000,8192,25829
354105,202105,1413,3551,983,2780,122,352,460,1227,582,1579
354110,202105,444,1244,316,996,52,167,107,326,159,493
354120,202105,1379,3676,941,2744,189,600,319,808,508,1408
354130,202105,5386,14050,3595,10653,855,2669,199,386,1054,3055
354140,202105,19595,47811,13373,36431,2101,6387,5950,14849,8051,21236
354150,202105,2956,6946,2265,5860,452,1217,924,2349,1376,3566
354160,202105,2826,8115,2129,6742,591,2031,593,1701,1184,3732
354165,202105,685,2006,526,1687,82,304,271,803,353,1107
354170,202105,1894,5195,1587,4623,100,333,981,2727,1081,3060
354180,202105,390,1072,282,845,46,143,125,339,171,482
354190,202105,1521,4197,1089,3337,70,239,545,1581,615,1820
354200,202105,875,2091,670,1783,67,199,443,1110,510,1309
354210,202105,846,2172,687,1915,42,140,502,1325,544,1465
354220,202105,3210,8509,2443,7010,346,1067,1323,3583,1669,4650
354230,202105,788,1925,632,1741,31,110,476,1268,507,1378
354240,202105,1733,4747,1166,3615,197,665,370,1014,567,1679
354250,202105,573,1366,361,1027,94,287,93,271,187,558
354260,202105,8142,21343,6219,18011,1196,3763,2761,7652,3957,11415
354270,202105,1018,3020,832,2660,172,541,336,1043,508,1584
354280,202105,804,1974,682,1798,59,180,455,1118,514,1298
354290,202105,930,2928,784,2630,129,431,399,1382,528,1813
354300,202105,3576,10333,3025,9326,783,2439,1257,3835,2040,6274
354310,202105,725,2124,596,1870,138,464,230,661,368,1125
354320,202105,989,2386,655,1835,94,295,257,643,351,938
354323,202105,484,1141,316,832,49,113,135,338,184,451
354325,202105,1520,4486,1068,3450,171,553,350,1073,521,1626
354330,202105,9604,24003,6576,17954,773,2378,3919,9952,4692,12330
354340,202105,34016,84490,23355,66030,3266,10437,12863,34657,16129,45094
354350,202105,1210,3075,957,2653,122,346,596,1586,718,1932
354360,202105,626,1591,380,1190,83,263,85,263,168,526
354370,202105,1017,2853,818,2541,123,414,494,1485,617,1899
354380,202105,671,1750,483,1448,85,342,132,310,217,652
354390,202105,13987,33358,9263,25130,1564,4561,4308,10989,5872,15550
354400,202105,1559,4928,1205,4104,201,742,452,1507,653,2249
354410,202105,6209,16344,4752,13493,913,2811,2279,6064,3192,8875
354420,202105,1524,3892,1133,3208,149,449,685,1840,834,2289
354425,202105,2753,6612,1954,5240,454,1220,813,2178,1267,3398
354430,202105,1541,4071,1199,3542,107,354,739,2077,846,2431
354440,202105,561,1485,380,1122,61,204,166,445,227,649
354450,202105,437,1131,252,776,35,111,86,228,121,339
354460,202105,850,2118,568,1622,78,233,306,855,384,1088
354470,202105,476,1183,333,915,24,77,169,406,193,483
354480,202105,1287,2871,836,2158,73,183,542,1346,615,1529
354490,202105,818,2388,603,1923,106,353,270,794,376,1147
354500,202105,2149,5907,1745,5297,521,1644,399,1250,920,2894
354510,202105,729,1997,591,1736,44,137,337,897,381,1034
354515,202105,357,1002,262,809,38,134,115,344,153,478
354520,202105,7084,19168,5021,14814,663,2245,2767,7563,3430,9808
354530,202105,4456,12504,3466,10593,880,2676,1184,3751,2064,6427
354540,202105,1346,3512,986,2881,212,639,364,1064,576,1703
354550,202105,599,1537,471,1300,69,207,269,707,338,914
354560,202105,2321,5544,1247,3496,144,412,635,1650,779,2062
354570,202105,1253,3110,502,1414,84,244,58,157,142,401
354580,202105,8477,22057,5555,16499,829,2649,2800,8005,3629,10654
354600,202105,1985,5106,1553,4339,143,460,1040,2761,1183,3221
354610,202105,454,1159,268,794,24,73,138,389,162,462
354620,202105,476,1300,306,978,48,188,119,342,167,530
354625,202105,301,811,177,575,27,89,34,82,61,171
354630,202105,2104,6171,1700,5367,576,1909,313,916,889,2825
354640,202105,3343,9428,2511,7777,368,1262,1037,2969,1405,4231
354650,202105,902,2321,730,2046,58,159,467,1292,525,1451
354660,202105,3625,8433,1919,5604,169,593,901,2398,1070,2991
354670,202105,1072,2925,757,2288,147,477,289,813,436,1290
354680,202105,5459,13969,4114,11807,892,2717,2089,6070,2981,8787
354690,202105,503,1563,366,1253,75,277,110,352,185,629
354700,202105,917,2446,657,1941,77,256,349,946,426,1202
354710,202105,514,1354,361,1039,48,149,156,382,204,531
354720,202105,286,682,131,382,55,165,24,73,79,238
354730,202105,9928,27671,7602,23219,985,3291,4382,12868,5367,16159
354740,202105,308,824,132,432,17,69,26,71,43,140
354750,202105,2702,6870,1796,5209,259,810,806,2096,1065,2906
354760,202105,2199,5750,1565,4580,332,1054,537,1378,869,2432
354765,202105,350,925,146,456,19,65,35,94,54,159
354770,202105,2468,6057,1826,4931,308,877,856,2165,1164,3042
354780,202105,55980,139866,42836,114461,3898,11804,28135,70611,32033,82415
354790,202105,1003,2734,786,2375,74,244,488,1411,562,1655
354800,202105,2603,6624,2058,5792,512,1450,923,2467,1435,3917
354805,202105,1359,3084,942,2479,108,282,546,1340,654,1622
354810,202105,645,1891,384,1339,48,195,105,339,153,534
354820,202105,956,2684,676,2157,112,401,192,487,304,888
354830,202105,468,1135,301,840,52,161,95,249,147,410
354840,202105,928,2291,574,1577,57,168,310,787,367,955
354850,202105,20973,53768,14628,42601,1580,5228,8803,24350,10383,29578
354860,202105,1759,4860,1083,3449,168,593,321,917,489,1510
354870,202105,59455,149230,46002,124529,4575,13572,29352,75187,33927,88759
354880,202105,5901,14398,2934,8246,324,1054,1153,2649,1477,3703
354890,202105,16010,39890,12420,33892,1651,5052,7259,19220,8910,24272
354900,202105,410,1026,263,766,59,184,66,151,125,335
354910,202105,5814,15073,3579,11022,820,2653,684,1972,1504,4625
354920,202105,516,1384,264,871,29,107,66,190,95,297
354925,202105,306,864,184,590,26,90,44,120,70,210
354930,202105,372,899,243,677,21,64,122,310,143,374
354940,202105,2382,6945,1702,5462,569,1961,370,1082,939,3043
354950,202105,1540,3881,1235,3465,54,204,934,2492,988,2696
354960,202105,928,2457,702,2116,65,223,396,1114,461,1337
354970,202105,4208,11506,3294,9967,361,1244,2126,6210,2487,7454
354980,202105,33949,79801,23182,61406,2352,7388,14385,35564,16737,42952
354990,202105,69104,172233,52000,141068,3946,12459,34634,88168,38580,100627
354995,202105,2883,6351,2173,5430,139,411,1623,3909,1762,4320
355000,202105,1597,3916,1200,3339,195,627,588,1490,783,2117
355010,202105,3851,10301,2341,7128,764,2389,307,959,1071,3348
355020,202105,3667,10104,2708,8412,529,1837,1114,3263,1643,5100
355030,202105,1389062,3383267,1014221,2668121,147166,425470,523726,1270160,670892,1695630
355040,202105,3045,7371,2369,6499,264,741,1727,4728,1991,5469
355050,202105,1013,2302,745,1923,178,521,301,690,479,1211
355060,202105,6256,16609,4566,13506,721,2461,2301,6178,3022,8639
355070,202105,9568,24014,7810,21265,895,2800,5030,12863,5925,15663
355080,202105,940,2664,601,2032,119,429,87,236,206,665
355090,202105,1194,3339,934,2906,207,648,358,1072,565,1720
355100,202105,21896,56591,16973,49374,2613,8015,10252,29577,12865,37592
355110,202105,821,2212,590,1855,165,597,99,287,264,884
355120,202105,742,1919,538,1620,47,147,255,749,302,896
355130,202105,846,1876,442,1146,32,101,275,660,307,761
355140,202105,1969,4390,1656,3963,80,212,1383,3230,1463,3442
355150,202105,4272,11148,3414,9639,373,1184,2227,6027,2600,7211
355160,202105,2101,5669,1526,4661,375,1256,401,1137,776,2393
355170,202105,11037,27414,8614,23380,1499,4386,4648,12203,6147,16589
355180,202105,2902,7574,2068,6192,386,1294,831,2258,1217,3552
355190,202105,1868,4860,1466,4221,391,1106,726,2219,1117,3325
355200,202105,804,2485,678,2282,189,698,277,891,466,1589
355210,202105,3034,8182,2352,6796,427,1379,1155,3125,1582,4504
355220,202105,46387,121128,36890,103079,7685,22871,16374,42443,24059,65314
355230,202105,1154,2889,632,1866,106,302,221,606,327,908
355240,202105,25449,66434,17835,51343,2155,6757,9890,26688,12045,33445
355250,202105,37727,99541,28162,81174,7008,21215,10741,29704,17749,50919
355255,202105,676,1678,376,1138,58,189,130,389,188,578
355260,202105,1547,3716,1105,2991,134,425,641,1610,775,2035
355270,202105,1153,3363,884,2825,202,675,325,949,527,1624
355280,202105,31668,79560,22716,62992,2895,8705,11776,30596,14671,39301
355290,202105,885,2383,683,2030,137,388,295,860,432,1248
355300,202105,1314,3829,1044,3305,181,628,373,1095,554,1723
355310,202105,953,2614,708,2208,100,300,394,1250,494,1550
355320,202105,531,1380,398,1140,74,244,160,374,234,618
355330,202105,3033,7578,2331,6387,122,424,1779,4648,1901,5072
355340,202105,4232,9307,3235,7984,390,884,2015,5065,2405,5949
355350,202105,1328,3744,987,3105,198,659,379,1148,577,1807
355360,202105,1226,3109,947,2689,115,366,564,1550,679,1916
355365,202105,356,937,198,654,42,134,29,96,71,230
355370,202105,5467,13902,4225,11922,1004,2604,1811,5666,2815,8270
355380,202105,2893,7675,2199,6414,370,1191,820,2071,1190,3262
355385,202105,1473,3841,1217,3465,102,354,786,2037,888,2391
355390,202105,829,2244,598,1749,130,412,235,619,365,1031
355395,202105,1998,5410,1404,4230,232,741,501,1341,733,2082
355400,202105,9143,25691,7235,21968,1678,5799,2681,7264,4359,13063
355410,202105,22986,62666,14263,44622,2797,9559,3943,12036,6740,21595
355420,202105,628,1974,525,1783,136,495,138,445,274,940
355430,202105,3720,9339,2784,7652,604,1666,1305,3535,1909,5201
355440,202105,773,2078,472,1451,78,247,137,392,215,639
355450,202105,3097,7880,2042,5840,330,1026,897,2325,1227,3351
355460,202105,503,1205,318,903,43,154,160,406,203,560
355465,202105,438,1134,341,978,41,126,191,536,232,662
355470,202105,1107,2828,640,1904,163,533,197,506,360,1039
355475,202105,341,800,275,710,15,34,205,519,220,553
355480,202105,4018,10898,3264,9774,433,1512,2160,6303,2593,7815
355490,202105,942,2483,532,1632,40,133,277,776,317,909
355495,202105,827,2275,599,1887,66,258,223,611,289,869
355500,202105,6868,17410,4173,12254,616,1968,1522,4126,2138,6094
355510,202105,1376,3311,882,2478,115,362,381,954,496,1316
355520,202105,369,827,180,522,31,88,56,161,87,249
355530,202105,397,925,147,434,16,59,54,145,70,204
355535,202105,523,1396,399,1195,77,287,185,509,262,796
355540,202105,11008,27052,9028,24279,1186,3511,6092,15830,7278,19341
355550,202105,618,1798,513,1599,60,210,282,815,342,1025
355560,202105,1139,2892,649,1970,146,518,32,89,178,607
355570,202105,250,690,129,422,25,87,28,76,53,163
355580,202105,1207,2898,770,2163,141,466,293,736,434,1202
355590,202105,177,442,137,379,14,44,87,231,101,275
355600,202105,1556,3777,1033,2908,161,489,386,1093,547,1582
355610,202105,1788,4356,1188,3329,128,399,640,1689,768,2088
355620,202105,4945,12966,3719,10598,374,1284,2144,5637,2518,6921
355630,202105,2411,6532,1715,5238,254,819,882,2626,1136,3445
355635,202105,895,2604,666,2150,116,404,201,579,317,983
355640,202105,3127,8562,2108,6529,418,1363,604,1833,1022,3196
355645,202105,4207,11709,3081,9737,452,1562,1645,5032,2097,6594
355650,202105,6411,17196,4954,14535,1302,3997,1468,3816,2770,7813
355660,202105,1345,3451,943,2736,156,468,287,816,443,1284
355670,202105,3809,10142,2577,7393,314,1051,1300,3285,1614,4336
355680,202105,2804,7638,1288,4104,322,1100,102,321,424,1421
355690,202105,808,2341,516,1767,121,458,11,21,132,479
355695,202105,257,724,155,490,12,56,31,74,43,130
355700,202105,7500,21100,6131,18105,966,3092,3424,9500,4390,12592
355710,202105,9192,21521,6089,15914,827,2442,2988,6924,3815,9366
355715,202105,483,1293,264,808,55,179,47,121,102,300
355720,202105,1457,4040,1150,3502,174,574,636,1811,810,2385
355730,202105,936,2561,772,2259,127,410,389,1064,516,1474
410010,202105,1305,3576,1006,2958,196,627,250,694,446,1321
410020,202105,1044,3098,803,2552,270,805,174,569,444,1374
410030,202105,1583,4236,1353,3881,188,572,753,2191,941,2763
410040,202105,12893,35243,9473,28819,2080,6768,2955,8341,5035,15109
410045,202105,855,2269,605,1782,90,293,224,609,314,902
410050,202105,2321,5765,1612,4544,261,823,593,1551,854,2374
410060,202105,2133,5938,1658,5019,368,1155,507,1469,875,2624
410070,202105,1997,5008,1492,4105,235,728,586,1453,821,2181
410080,202105,1365,3614,973,2895,272,843,203,611,475,1454
410090,202105,1134,2868,963,2598,108,272,548,1566,656,1838
410100,202105,1896,5379,1245,3850,178,635,128,375,306,1010
410105,202105,492,1230,285,829,32,90,104,286,136,376
410110,202105,3344,8307,2350,6448,282,847,1114,2865,1396,3712
410115,202105,579,1478,417,1195,55,169,165,442,220,611
410120,202105,2746,7423,2369,6870,453,1406,1320,3713,1773,5119
410130,202105,1263,3375,1096,3059,206,658,570,1469,776,2127
410140,202105,16451,39523,10960,29790,1968,5866,2966,7329,4934,13195
410150,202105,16814,39100,8629,23305,1444,4328,2103,5084,3547,9412
410160,202105,2940,8015,2351,6992,533,1683,788,2360,1321,4043
410165,202105,745,1960,609,1691,63,201,355,918,418,1119
410170,202105,2932,7492,1940,5388,407,1246,117,342,524,1588
410180,202105,14383,39544,11056,32870,1515,4935,5760,15968,7275,20903
410185,202105,426,1247,306,944,60,196,80,222,140,418
410190,202105,2180,5384,1588,4350,315,896,410,1063,725,1959
410200,202105,5629,12715,3130,8446,494,1512,424,1101,918,2613
410210,202105,3213,7958,2065,5939,330,1050,713,1776,1043,2826
410220,202105,532,1371,344,1023,56,172,83,247,139,419
410230,202105,1790,4698,1377,3898,203,618,616,1596,819,2214
410240,202105,5228,13544,3583,10383,755,2420,446,1143,1201,3563
410250,202105,2686,6312,1986,5203,146,460,972,2466,1118,2926
410260,202105,1835,4563,1157,3287,160,462,544,1484,704,1946
410270,202105,480,1262,342,1021,44,150,137,400,181,550
410275,202105,615,1715,454,1389,71,239,183,511,254,750
410280,202105,2359,6197,1574,4670,204,689,658,1779,862,2468
410290,202105,3446,9478,2385,7261,670,2006,602,1817,1272,3823
410300,202105,682,1697,552,1499,59,177,271,676,330,853
410302,202105,358,911,210,636,22,76,104,308,126,384
410304,202105,1285,3295,1066,2887,118,337,660,1724,778,2061
410305,202105,1737,4143,1215,3393,113,356,785,2114,898,2470
410310,202105,2612,7238,2112,6301,298,982,1102,3219,1400,4201
410315,202105,635,1503,395,1119,137,397,98,283,235,680
410320,202105,1078,2972,736,2278,111,392,132,380,243,772
410322,202105,579,1519,331,969,34,111,146,372,180,483
410330,202105,1549,3715,1069,2820,177,492,303,798,480,1290
410335,202105,869,2289,662,1905,99,303,275,726,374,1029
410337,202105,850,2068,599,1580,82,224,215,523,297,747
410340,202105,523,1464,351,1049,19,56,172,441,191,497
410345,202105,2520,6499,1359,3993,269,819,361,904,630,1723
410347,202105,753,1920,557,1559,57,190,179,502,236,692
410350,202105,1605,3927,1161,3192,137,401,551,1413,688,1814
410360,202105,4354,10662,3336,8889,478,1351,1520,3915,1998,5266
410370,202105,13953,37169,9076,25745,1050,3225,3850,9563,4900,12788
410380,202105,1653,4120,1208,3316,178,508,401,1004,579,1512
410390,202105,2711,6738,1813,5162,382,1219,595,1514,977,2733
410395,202105,932,2625,761,2265,156,469,292,886,448,1355
410400,202105,6782,17430,5163,14378,698,2077,2703,7087,3401,9164
410405,202105,902,2075,644,1702,107,325,311,766,418,1091
410410,202105,1321,3465,1240,3338,151,475,795,2215,946,2690
410420,202105,11073,29845,8444,24664,1273,4165,3589,9405,4862,13570
410425,202105,3362,9293,2311,7158,364,1204,833,2351,1197,3555
410430,202105,13350,33057,9419,25970,1411,4274,3489,8902,4900,13176
410440,202105,2317,6809,1984,6197,287,1012,1059,3222,1346,4234
410442,202105,2251,6759,1852,5902,453,1488,519,1553,972,3041
410445,202105,2277,6481,1662,5300,318,1144,286,1001,604,2145
410450,202105,1486,3618,1107,3029,205,618,430,1106,635,1724
410460,202105,2197,5382,1663,4497,172,490,816,2120,988,2610
410465,202105,2801,8022,2229,6952,399,1300,766,2224,1165,3524
410470,202105,2100,5717,1493,4635,393,1392,208,696,601,2088
410480,202105,37299,88603,20422,58853,3106,10020,4593,11297,7699,21317
410490,202105,11340,30966,8269,24735,1410,4540,3444,9610,4854,14150
410500,202105,1908,4904,1318,3793,278,906,360,883,638,1789
410510,202105,1850,4601,1246,3488,229,619,378,1045,607,1664
410520,202105,3077,9525,2720,8809,965,3199,837,2791,1802,5990
410530,202105,1638,3929,784,2186,99,285,212,485,311,770
410540,202105,2836,7527,1969,5793,299,942,871,2429,1170,3371
410550,202105,7640,20132,5117,14708,839,2616,1426,3550,2265,6166
410560,202105,1498,3883,1127,3134,226,699,392,934,618,1633
410570,202105,2582,6919,1881,5688,529,1908,197,604,726,2512
410580,202105,26253,67263,19177,54498,3367,10237,8587,22807,11954,33044
410590,202105,1571,4433,1079,3293,144,464,310,795,454,1259
410600,202105,1786,4708,1387,3948,318,872,420,1266,738,2138
410610,202105,715,1835,542,1518,54,172,248,641,302,813
410620,202105,2543,7175,1709,5232,364,1222,257,719,621,1941
410630,202105,2518,6503,1656,4794,292,1006,359,824,651,1830
410640,202105,4860,11238,3323,8588,709,2108,408,1069,1117,3177
410645,202105,1107,3088,903,2831,274,882,416,1319,690,2201
410650,202105,2353,6295,1626,4843,312,997,599,1623,911,2620
410655,202105,925,2198,646,1695,25,68,336,840,361,908
410657,202105,628,1696,393,1193,52,176,123,318,175,494
410660,202105,3498,8769,2066,5693,364,1022,616,1582,980,2604
410670,202105,1031,2536,637,1802,128,356,203,525,331,881
410680,202105,2601,7667,1789,5649,413,1320,262,865,675,2185
410685,202105,529,1355,399,1138,94,307,153,389,247,696
410690,202105,133380,320368,89880,241285,13395,41064,36175,85715,49570,126779
410700,202105,2512,6300,2083,5636,360,991,994,2625,1354,3616
410710,202105,911,2283,600,1706,110,326,238,619,348,945
410712,202105,661,1842,548,1634,109,360,246,684,355,1044
410715,202105,834,2388,535,1740,70,231,206,642,276,873
410720,202105,3269,8184,2609,6979,385,1229,675,1763,1060,2992
410725,202105,1140,2777,665,1890,133,402,94,222,227,624
410730,202105,711,1884,560,1605,120,406,124,347,244,753
410740,202105,918,2561,677,2095,81,284,273,833,354,1117
410750,202105,1796,4470,1437,3822,217,638,668,1691,885,2329
410752,202105,374,914,202,581,26,76,96,259,122,335
410753,202105,325,960,227,740,34,129,50,151,84,280
410754,202105,1104,2801,920,2527,63,144,626,1805,689,1949
410755,202105,576,1482,412,1161,54,162,190,477,244,639
410760,202105,3677,9395,2669,7604,667,2184,597,1564,1264,3748
410765,202105,14318,39397,11207,33315,1884,6045,2643,6908,4527,12953
410770,202105,1076,2507,753,1969,60,166,393,1029,453,1195
410773,202105,1304,3430,1144,3190,114,358,736,1987,850,2345
410775,202105,1539,3757,1349,3479,62,186,918,2298,980,2484
410780,202105,650,1594,438,1194,67,187,124,320,191,507
410785,202105,727,1860,557,1569,89,282,179,499,268,781
410790,202105,872,2430,722,2145,179,571,66,137,245,708
410800,202105,3481,7672,2815,6723,50,152,1842,4261,1892,4413
410810,202105,442,1151,335,945,32,91,144,348,176,439
410820,202105,945,2628,514,1541,106,330,85,210,191,540
410830,202105,40833,97117,28234,76308,5320,16216,10962,27730,16282,43946
410832,202105,1044,2705,836,2341,90,289,509,1339,599,1628
410840,202105,8802,21923,5277,15267,963,2994,1395,3763,2358,6757
410845,202105,1171,2898,906,2498,170,481,356,974,526,1455
410850,202105,2269,6405,1993,5904,321,982,968,2822,1289,3804
410855,202105,781,1940,504,1409,53,143,240,622,293,765
410860,202105,4391,10617,3462,9148,282,884,2105,5249,2387,6133
410865,202105,1482,4247,1277,3860,124,413,751,2308,875,2721
410870,202105,1251,3318,1021,2929,95,282,671,1897,766,2179
410880,202105,4715,12336,3305,9784,536,1624,492,1567,1028,3191
410890,202105,1019,2838,772,2355,167,574,226,643,393,1217
410895,202105,1013,3168,860,2837,263,954,205,646,468,1600
410900,202105,868,2297,613,1801,100,307,139,344,239,651
410910,202105,415,965,256,664,13,42,139,325,152,367
410920,202105,878,2090,634,1693,80,234,321,826,401,1060
410930,202105,1721,4369,1188,3434,286,958,216,601,502,1559
410940,202105,23192,62066,16874,50934,3426,11321,5355,15753,8781,27074
410950,202105,1939,5636,1746,5353,51,170,1442,4380,1493,4550
410960,202105,7803,19011,5458,15138,1202,3739,2214,6032,3416,9771
410965,202105,1175,2966,808,2281,81,252,471,1304,552,1556
410970,202105,4116,10885,2930,8647,638,2247,412,999,1050,3246
410975,202105,1374,3329,1043,2811,113,330,513,1347,626,1677
410980,202105,7805,19211,5066,14314,559,1722,2209,5640,2768,7362
410990,202105,1396,3363,959,2671,199,655,366,971,565,1626
411000,202105,670,1750,469,1383,64,217,137,332,201,549
411005,202105,470,1181,283,780,53,157,87,205,140,362
411007,202105,2274,6250,1839,5510,441,1395,617,1825,1058,3220
411010,202105,4217,12529,3323,10722,807,2843,362,1061,1169,3904
411020,202105,2376,6601,1922,5795,523,1640,503,1496,1026,3136
411030,202105,791,1916,559,1461,43,139,302,694,345,833
411040,202105,1008,2537,547,1547,75,238,172,406,247,644
411050,202105,1988,6101,1624,5304,413,1471,229,624,642,2095
411060,202105,2040,5398,1330,3926,275,904,251,685,526,1589
411065,202105,419,1062,279,789,38,111,123,336,161,447
411070,202105,7585,18966,5987,16340,723,2180,3106,8224,3829,10404
411080,202105,2116,5497,1679,4763,405,1340,344,930,749,2270
411090,202105,827,2176,544,1620,45,157,158,449,203,606
411095,202105,2806,6502,1549,4206,188,540,398,1011,586,1551
411100,202105,1243,3168,867,2496,86,283,306,892,392,1175
411110,202105,635,1635,307,943,37,110,19,47,56,157
411120,202105,1339,3622,1101,3186,319,1071,235,621,554,1692
411125,202105,5272,15222,4713,14223,1062,3143,2246,7127,3308,10270
411130,202105,748,1978,536,1586,106,283,185,604,291,887
411140,202105,2304,6949,1941,6202,596,2018,503,1591,1099,3609
411150,202105,3988,9990,2677,7330,508,1621,247,490,755,2111
411155,202105,988,2507,602,1782,87,246,263,736,350,982
411160,202105,376,860,261,689,26,74,70,189,96,263
411170,202105,737,2148,580,1795,134,435,205,602,339,1037
411180,202105,5629,14696,4415,12614,621,1942,2161,5791,2782,7733
411190,202105,1815,4603,1344,3756,200,604,531,1335,731,1939
411200,202105,4922,13218,3560,10703,846,2851,785,2035,1631,4886
411210,202105,3307,7313,2227,5564,389,1053,767,1817,1156,2870
411220,202105,872,2217,624,1745,148,456,169,437,317,893
411230,202105,851,2270,623,1829,123,380,218,616,341,996
411240,202105,1644,3890,1115,2950,130,411,555,1340,685,1751
411250,202105,2282,5993,1673,4903,311,1065,508,1409,819,2474
411260,202105,327,835,228,640,22,65,94,226,116,291
411270,202105,2059,5396,1536,4367,205,606,756,1992,961,2598
411275,202105,1478,3375,1030,2654,138,435,489,1161,627,1596
411280,202105,1331,3586,909,2778,234,730,128,370,362,1100
411290,202105,845,2196,542,1614,71,222,262,760,333,982
411295,202105,1274,3184,904,2460,113,319,406,1042,519,1361
411300,202105,1053,2619,696,1930,69,209,317,760,386,969
411310,202105,893,2038,688,1757,71,182,300,763,371,945
411320,202105,5584,14202,4080,11541,606,1827,1800,4617,2406,6444
411325,202105,1420,3990,1202,3603,217,602,654,2042,871,2644
411330,202105,3368,9006,2456,7347,531,1729,753,2282,1284,4011
411340,202105,844,2271,506,1537,79,242,149,431,228,673
411342,202105,1077,2586,610,1665,108,313,202,511,310,824
411345,202105,1120,2841,849,2396,63,180,616,1751,679,1931
411350,202105,2882,7625,1857,5558,443,1434,320,858,763,2292
411360,202105,725,1722,515,1393,80,233,173,435,253,668
411370,202105,60438,146919,44039,119135,3130,10006,26384,66366,29514,76372
411373,202105,1409,3549,1139,3148,110,347,609,1696,719,2043
411375,202105,1114,2793,812,2232,129,364,313,848,442,1212
411380,202105,1171,2666,794,1969,44,119,490,1122,534,1241
411390,202105,1520,4146,1190,3422,192,600,474,1179,666,1779
411400,202105,2386,5777,1796,4682,150,469,977,2396,1127,2865
411410,202105,2691,7360,1998,5909,417,1335,447,1253,864,2588
411420,202105,4413,10629,2412,6836,307,980,471,1012,778,1992
411430,202105,3554,9508,2720,7945,553,1759,987,2673,1540,4432
411435,202105,408,1118,259,810,55,171,76,203,131,374
411440,202105,2557,7035,2055,6086,438,1392,682,1943,1120,3335
411450,202105,2479,6624,1883,5620,244,711,1015,3102,1259,3813
411460,202105,4304,10928,2738,7992,413,1402,500,1326,913,2728
411470,202105,802,2035,603,1650,104,319,241,577,345,896
411480,202105,5168,13473,3789,10949,679,2364,1456,3736,2135,6100
411490,202105,1663,4271,1279,3634,157,511,547,1398,704,1909
411500,202105,1316,3480,887,2575,150,477,169,389,319,866
411510,202105,2368,5923,1912,5161,349,1097,524,1434,873,2531
411520,202105,32433,78629,19163,53000,2157,6867,7653,18880,9810,25747
411530,202105,969,2514,583,1773,93,310,87,229,180,539
411535,202105,516,1485,330,1048,39,141,93,257,132,398
411540,202105,2659,6459,1835,4980,128,413,991,2629,1119,3042
411545,202105,926,2659,778,2400,73,237,495,1525,568,1762
411550,202105,730,1827,541,1491,83,242,100,293,183,535
411560,202105,1983,5291,1144,3523,150,526,60,153,210,679
411570,202105,7309,16830,4931,13284,1116,3273,890,2426,2006,5699
411573,202105,775,2077,651,1862,101,294,307,856,408,1150
411575,202105,2074,5557,1548,4501,270,851,396,1098,666,1949
411580,202105,4863,11119,2952,8196,421,1429,545,1337,966,2766
411585,202105,621,1843,295,953,63,205,55,165,118,370
411590,202105,408,1095,300,883,44,129,148,403,192,532
411600,202105,333,827,205,620,37,117,65,183,102,300
411605,202105,1583,3651,1033,2801,137,469,521,1393,658,1862
411610,202105,2617,6054,1867,4771,65,222,1300,3100,1365,3322
411620,202105,2763,7302,2355,6666,383,1140,1292,3651,1675,4791
411630,202105,811,2037,513,1495,68,243,190,492,258,735
411640,202105,474,1214,329,910,44,131,105,253,149,384
411650,202105,218,616,144,460,27,94,30,68,57,162
411660,202105,923,2345,670,1886,56,165,273,720,329,885
411670,202105,1439,3410,981,2558,99,271,507,1219,606,1490
411680,202105,1439,3831,1076,3113,158,519,464,1296,622,1815
411690,202105,4028,10053,3051,8388,680,1865,824,2441,1504,4306
411695,202105,650,1919,443,1386,49,167,186,533,235,700
411700,202105,1732,4406,1173,3351,257,754,199,542,456,1296
411705,202105,1946,5875,1649,5368,286,863,992,3437,1278,4300
411710,202105,2013,5031,1392,3885,304,853,305,826,609,1679
411720,202105,1075,2456,769,1940,142,373,296,717,438,1090
411721,202105,1013,2486,767,2039,149,384,219,577,368,961
411722,202105,912,2392,534,1551,96,303,182,443,278,746
411725,202105,1190,3274,808,2544,192,657,169,515,361,1172
411727,202105,1537,4180,996,3030,218,674,140,392,358,1066
411729,202105,689,1653,414,1127,56,191,147,348,203,539
411730,202105,5380,14059,4244,11897,804,2430,1927,5255,2731,7685
411740,202105,528,1336,275,792,63,167,61,161,124,328
411745,202105,808,2282,565,1738,70,242,138,342,208,584
411750,202105,5660,14733,4149,11812,542,1645,1997,5361,2539,7006
411760,202105,6762,17862,5252,15302,1627,4919,1006,3323,2633,8242
411770,202105,3081,8802,2257,7019,496,1653,378,1064,874,2717
411780,202105,2695,7477,2342,6833,672,2050,782,2334,1454,4384
411790,202105,2865,6851,1631,4641,319,1038,390,957,709,1995
411800,202105,1017,2868,764,2296,126,404,151,402,277,806
411810,202105,1625,4151,1210,3327,195,546,532,1360,727,1906
411820,202105,11651,32805,9516,29144,2237,7382,4191,12442,6428,19824
411830,202105,553,1365,402,1090,86,257,61,171,147,428
411840,202105,12468,32750,8616,24869,1421,4424,2430,6299,3851,10723
411845,202105,592,1655,354,1107,50,182,83,225,133,407
411850,202105,7383,18618,5075,14620,1260,4029,909,2401,2169,6430
411860,202105,705,1927,508,1516,82,259,121,311,203,570
411870,202105,595,1703,417,1305,94,322,95,266,189,588
411880,202105,2345,5687,1713,4701,233,705,662,1710,895,2415
411885,202105,1119,2879,804,2311,119,398,248,646,367,1044
411890,202105,1413,3738,1003,2975,170,568,104,302,274,870
411900,202105,785,2152,497,1534,110,364,93,262,203,626
411910,202105,1048,3073,780,2522,175,669,299,882,474,1551
411915,202105,15355,37499,10644,29011,1483,4510,4540,11126,6023,15636
411920,202105,1166,3351,974,2949,206,719,359,996,565,1715
411925,202105,488,1272,351,1028,74,222,139,384,213,606
411930,202105,4942,14794,4162,13350,1863,6499,239,915,2102,7414
411940,202105,3347,9662,2612,8104,620,1953,862,2423,1482,4376
411950,202105,14664,39105,12149,34962,1543,5047,7295,20054,8838,25101
411960,202105,6115,16045,4815,13457,834,2512,1979,5278,2813,7790
411965,202105,481,1321,353,1067,47,155,154,437,201,592
411970,202105,1187,2687,929,2341,181,428,408,1180,589,1608
411980,202105,1491,3615,1074,2940,274,742,389,1062,663,1804
411990,202105,38126,98894,24622,74422,4425,14747,8646,24727,13071,39474
411995,202105,3733,9053,2850,7686,809,2383,749,1973,1558,4356
412000,202105,1882,4331,1309,3370,34,106,905,2171,939,2277
412010,202105,623,1893,471,1560,77,264,127,364,204,628
412015,202105,556,1548,456,1369,68,210,265,788,333,998
412020,202105,450,1253,290,918,46,170,114,322,160,492
412030,202105,620,1723,457,1428,73,225,151,463,224,688
412033,202105,953,2505,679,1950,86,266,255,630,341,896
412035,202105,746,2007,477,1518,50,184,255,774,305,958
412040,202105,619,1640,385,1170,62,189,58,167,120,356
412050,202105,1608,3988,1103,3055,245,749,256,711,501,1460
412060,202105,7377,21194,6154,18764,1596,5499,1714,5019,3310,10518
412065,202105,624,1711,470,1407,100,325,110,324,210,649
412070,202105,1237,3176,970,2664,127,384,375,925,502,1309
412080,202105,2283,6248,1581,4861,234,748,443,1238,677,1986
412085,202105,312,739,112,338,12,38,26,66,38,104
412090,202105,6207,15804,4573,12791,1037,3074,1706,4796,2743,7870
412100,202105,1697,4535,1284,3768,416,1359,275,873,691,2232
412110,202105,832,2223,581,1716,83,266,185,516,268,782
412120,202105,2065,5809,1577,4874,325,1108,399,1035,724,2143
412125,202105,632,1778,443,1381,77,244,108,337,185,581
412130,202105,826,2050,567,1571,92,255,144,410,236,665
412135,202105,630,1656,297,887,50,162,89,228,139,390
412140,202105,1740,4158,1185,3204,184,619,263,668,447,1287
412150,202105,2862,7330,2441,6601,343,1068,1489,3801,1832,4869
412160,202105,889,2735,499,1678,65,242,70,197,135,439
412170,202105,4395,11911,3684,10773,690,2256,1544,4148,2234,6404
412175,202105,1322,3715,1107,3350,228,725,485,1465,713,2190
412180,202105,1681,4583,1231,3750,145,507,560,1575,705,2082
412190,202105,3418,8441,2523,6900,307,903,1086,2947,1393,3850
412200,202105,1741,5061,1234,3929,305,1060,183,538,488,1598
412210,202105,659,1553,414,1135,53,162,163,406,216,568
412215,202105,3452,9218,2670,7695,620,1732,1120,3535,1740,5267
412217,202105,1014,2597,854,2310,46,133,601,1559,647,1692
412220,202105,5629,15620,4610,13775,1314,3820,1419,4575,2733,8395
412230,202105,2705,7830,2138,6738,342,1232,535,1428,877,2660
412240,202105,7636,19488,4866,14023,830,2567,1462,3770,2292,6337
412250,202105,2049,5221,1532,4246,364,1052,322,813,686,1865
412260,202105,1262,3318,938,2646,138,404,291,769,429,1173
412265,202105,932,2500,733,2156,159,475,288,810,447,1285
412270,202105,1045,2825,672,2036,80,270,269,731,349,1001
412280,202105,406,1117,320,971,80,246,92,271,172,517
412290,202105,1053,2657,734,2089,106,324,242,627,348,951
412300,202105,1678,4328,1183,3463,256,788,262,797,518,1585
412310,202105,755,2135,586,1785,106,371,179,500,285,871
412320,202105,821,2089,527,1484,45,150,158,442,203,592
412330,202105,1627,4274,1118,3327,232,733,373,1144,605,1877
412340,202105,1190,3216,774,2314,98,350,117,324,215,674
412350,202105,3017,7841,1961,5762,362,1139,326,871,688,2010
412360,202105,256,700,184,550,7,33,114,318,121,351
412370,202105,857,2414,581,1830,113,394,68,212,181,606
412380,202105,1541,4156,1101,3297,283,884,114,391,397,1275
412382,202105,493,1184,329,923,37,133,150,347,187,480
412385,202105,2217,6005,1821,5247,586,1594,566,1808,1152,3402
412390,202105,2537,6011,2036,5244,339,898,736,1869,1075,2767
412395,202105,703,2001,509,1563,69,196,219,683,288,879
412400,202105,932,2430,670,1936,121,389,198,554,319,943
412402,202105,2251,5498,1584,4414,420,1176,199,597,619,1773
412405,202105,3122,8186,2056,6204,517,1808,111,301,628,2109
412410,202105,6292,16058,4638,13366,749,2510,1567,4209,2316,6719
412420,202105,553,1379,365,999,28,88,172,403,200,491
412430,202105,603,1506,318,916,32,101,133,356,165,457
412440,202105,2790,7395,1861,5641,430,1408,361,1104,791,2512
412450,202105,502,1417,341,1032,43,130,30,69,73,199
412460,202105,1096,2803,858,2403,166,501,384,1045,550,1546
412470,202105,1561,4885,1294,4289,305,1070,277,918,582,1988
412480,202105,1057,2775,718,2057,114,357,241,605,355,962
412490,202105,1348,3265,1079,2785,144,372,528,1287,672,1659
412500,202105,2000,4974,1518,4090,320,890,419,1016,739,1906
412510,202105,1930,5809,1325,4293,312,1060,155,454,467,1514
412520,202105,1152,2967,657,1915,157,422,60,189,217,611
412530,202105,715,1877,515,1467,76,245,113,324,189,569
412535,202105,829,2136,564,1631,104,331,115,283,219,614
412540,202105,1192,2998,865,2413,89,308,294,856,383,1164
412545,202105,693,1778,478,1354,79,236,144,394,223,630
412550,202105,34008,89497,24406,70510,3772,11841,10043,26386,13815,38227
412555,202105,297,756,202,556,22,67,64,136,86,203
412560,202105,4785,13552,3657,10990,653,2177,1084,3221,1737,5398
412570,202105,4526,11245,2620,7593,485,1608,305,938,790,2546
412575,202105,1058,2641,847,2284,113,341,453,1141,566,1482
412580,202105,1454,3729,1040,2959,73,234,576,1568,649,1802
412590,202105,406,1059,228,699,34,111,23,62,57,173
412600,202105,1686,4464,1286,3676,195,613,584,1540,779,2153
412610,202105,844,2198,603,1681,79,239,278,676,357,915
412620,202105,1271,3286,969,2832,187,616,299,819,486,1435
412625,202105,8698,22729,5354,16104,751,2550,339,937,1090,3487
412627,202105,1157,3225,755,2385,140,484,206,650,346,1134
412630,202105,2922,8412,2122,6728,379,1233,629,1806,1008,3039
412635,202105,399,1068,268,791,31,108,87,213,118,321
412640,202105,1058,2767,609,1830,75,234,178,473,253,707
412650,202105,1698,4541,1351,3863,217,693,529,1298,746,1991
412660,202105,2493,6371,1797,5039,261,795,591,1467,852,2262
412665,202105,398,1002,314,853,60,171,144,381,204,552
412667,202105,1827,4754,1368,3872,190,580,593,1604,783,2184
412670,202105,878,2035,565,1521,111,345,149,367,260,712
412680,202105,2088,5465,1461,4278,183,610,517,1332,700,1942
412690,202105,1162,3044,836,2417,142,441,300,824,442,1265
412700,202105,1957,5113,1633,4611,202,629,894,2464,1096,3093
412710,202105,5835,16705,4355,13573,797,2792,1161,3138,1958,5930
412720,202105,1158,3365,893,2797,137,459,200,525,337,984
412730,202105,2521,6564,1760,5057,310,1000,663,1777,973,2777
412740,202105,1935,5342,1322,4107,216,779,184,566,400,1345
412750,202105,4028,10374,3292,9331,254,858,2208,5945,2462,6803
412760,202105,2953,7861,2459,7040,463,1498,1316,3512,1779,5010
412770,202105,10440,26443,5748,17240,759,2453,1283,3227,2042,5680
412780,202105,1196,3147,907,2629,197,626,343,959,540,1585
412785,202105,2132,4990,1521,3975,140,386,1044,2662,1184,3048
412788,202105,1405,3901,1152,3457,322,982,448,1292,770,2274
412790,202105,1357,3559,791,2423,108,376,245,650,353,1026
412795,202105,1256,3200,675,2035,89,293,126,338,215,631
412796,202105,2163,6153,1784,5453,346,1127,595,1673,941,2800
412800,202105,3745,8990,2620,6932,277,863,1267,2952,1544,3815
412810,202105,12157,30760,7930,22299,939,3052,3114,7767,4053,10819
412820,202105,6338,17209,4507,13516,1069,3421,1284,3800,2353,7221
412830,202105,354,990,256,786,36,105,74,208,110,313
412840,202105,1894,4652,1361,3631,147,435,638,1537,785,1972
412850,202105,2799,7268,2029,5944,304,954,871,2505,1175,3459
412853,202105,1521,3779,1275,3359,165,488,680,1586,845,2074
412855,202105,1328,3439,815,2362,113,381,217,552,330,933
412860,202105,754,1843,511,1458,74,227,269,712,343,939
412862,202105,693,1671,469,1296,91,257,182,472,273,729
412863,202105,1268,3774,1127,3521,263,852,524,1628,787,2480
412865,202105,713,1935,528,1562,143,416,129,420,272,836
412870,202105,863,2224,628,1834,180,567,138,451,318,1018
412880,202105,862,2311,575,1727,97,332,101,268,198,600
420005,202105,414,1205,250,828,30,97,115,386,145,483
420010,202105,3281,7960,2214,6168,123,368,1624,4567,1747,4935
420020,202105,432,1335,291,971,45,176,67,163,112,339
420030,202105,86,296,51,203,11,48,19,70,30,118
420040,202105,504,1493,312,1066,64,237,26,67,90,304
420050,202105,707,1601,473,1192,64,187,294,661,358,848
420055,202105,160,481,87,306,19,84,25,76,44,160
420060,202105,97,257,57,164,8,24,15,31,23,55
420070,202105,706,2099,530,1737,110,359,207,659,317,1018
420075,202105,80,197,41,120,7,26,14,22,21,48
420080,202105,364,1018,284,833,68,222,111,316,179,538
420090,202105,412,1263,262,909,57,215,46,132,103,347
420100,202105,1262,3240,1057,2929,58,184,855,2330,913,2514
420110,202105,248,787,222,729,40,142,115,360,155,502
420120,202105,595,1573,407,1171,60,196,205,516,265,712
420125,202105,355,1071,252,844,57,215,96,305,153,520
420127,202105,307,788,120,359,15,48,43,122,58,170
420130,202105,3544,9621,2696,8232,391,1393,1262,3545,1653,4938
420140,202105,3629,9674,2631,7940,718,2446,451,1385,1169,3831
420150,202105,673,1690,464,1332,44,141,277,765,321,906
420160,202105,192,456,68,214,8,28,19,56,27,84
420165,202105,149,421,87,287,21,71,26,75,47,146
420170,202105,279,879,189,641,25,94,63,180,88,274
420180,202105,165,522,102,360,16,57,29,91,45,148
420190,202105,201,612,120,411,31,118,41,130,72,248
420195,202105,1425,3589,1063,3020,271,918,234,572,505,1490
420200,202105,4850,11606,2997,8195,387,1284,1286,3036,1673,4320
420205,202105,1812,4808,1212,3590,174,533,654,1919,828,2452
420207,202105,1800,4641,1135,3378,201,691,474,1315,675,2006
420208,202105,319,905,184,642,55,204,42,125,97,329
420209,202105,155,484,101,316,16,54,49,137,65,191
420210,202105,3114,7846,2136,6266,348,1175,1081,3029,1429,4204
420213,202105,779,2356,659,2123,142,488,330,1047,472,1535
420215,202105,202,603,143,471,41,154,38,119,79,273
420220,202105,275,787,165,553,27,102,72,224,99,326
420230,202105,5194,13850,3973,11599,562,1780,2150,5993,2712,7773
420240,202105,13948,38186,8981,26822,1076,3675,4399,11494,5475,15169
420243,202105,385,1076,314,940,49,171,198,563,247,734
420245,202105,1361,3463,997,2847,73,252,630,1704,703,1956
420250,202105,432,1190,363,1079,53,177,213,592,266,769
420253,202105,471,1139,332,936,32,94,194,544,226,638
420257,202105,157,403,98,298,14,53,51,152,65,205
420260,202105,1123,2881,822,2473,116,408,549,1613,665,2021
420270,202105,539,1392,280,811,37,115,124,339,161,454
420280,202105,1195,3523,955,3025,168,597,380,1134,548,1731
420285,202105,126,268,57,165,9,40,23,52,32,92
420287,202105,434,1001,314,840,86,235,116,316,202,551
420290,202105,4821,13537,3722,11090,515,1728,2169,5999,2684,7727
420300,202105,7368,20642,4328,13448,737,2540,1410,3794,2147,6334
420310,202105,772,1753,396,1081,38,117,216,546,254,663
420315,202105,774,2142,530,1724,90,317,238,762,328,1079
420320,202105,5196,13848,3731,11420,1003,3368,988,2821,1991,6189
420325,202105,322,885,230,703,29,84,102,292,131,376
420330,202105,968,2793,615,2040,99,375,187,571,286,946
420340,202105,918,2536,695,2141,150,472,134,376,284,848
420350,202105,1171,2998,872,2483,63,215,624,1736,687,1951
420360,202105,2874,7793,1571,4984,288,998,115,352,403,1350
420370,202105,1172,3072,965,2740,74,252,698,1915,772,2167
420380,202105,4341,11303,2923,8731,603,1919,1122,3190,1725,5109
420390,202105,1064,2568,738,1914,129,396,304,551,433,947
420395,202105,1131,3156,782,2465,125,447,124,291,249,738
420400,202105,990,2724,690,2105,110,391,302,859,412,1250
420410,202105,571,1504,442,1243,34,104,312,858,346,962
420415,202105,283,821,212,672,51,177,87,286,138,463
420417,202105,601,1745,469,1481,126,417,179,575,305,992
420419,202105,135,479,109,421,38,157,9,36,47,193
420420,202105,11301,28961,7637,22344,2017,6721,2209,5832,4226,12553
420425,202105,626,1662,426,1251,36,118,219,624,255,742
420430,202105,3095,8208,1844,5503,413,1299,602,1648,1015,2947
420435,202105,253,657,133,428,16,55,67,209,83,264
420440,202105,696,1861,426,1302,125,406,124,360,249,766
420445,202105,256,615,169,463,31,84,76,192,107,276
420450,202105,728,2114,533,1689,88,350,191,524,279,874
420455,202105,1983,4782,1448,3986,209,632,700,1843,909,2475
420460,202105,9108,24017,6869,19925,942,3079,3588,9951,4530,13030
420470,202105,577,1489,312,970,59,214,56,145,115,359
420475,202105,65,170,25,82,6,21,2,6,8,27
420480,202105,5213,12738,3235,9482,605,1942,1173,3404,1778,5346
420490,202105,354,977,255,776,54,188,98,287,152,475
420500,202105,1356,3692,881,2811,139,499,405,1267,544,1766
420510,202105,150,422,82,267,11,44,21,58,32,102
420515,202105,65,172,41,116,4,19,16,41,20,60
420517,202105,756,2069,640,1847,60,178,431,1247,491,1425
420519,202105,291,706,205,580,21,65,122,350,143,415
420520,202105,274,728,144,473,20,67,10,31,30,98
420530,202105,795,2319,547,1781,82,323,218,618,300,941
420535,202105,230,671,97,329,15,56,39,127,54,183
420540,202105,37123,88022,24573,67230,3427,10643,9047,21456,12474,32099
420543,202105,205,603,155,486,18,57,83,243,101,300
420545,202105,1224,3646,931,2998,158,573,349,997,507,1570
420550,202105,3471,9121,2262,7081,346,1288,975,3095,1321,4383
420555,202105,290,835,205,655,23,87,122,372,145,459
420560,202105,383,946,256,753,47,152,151,440,198,592
420570,202105,2355,6249,1851,5301,295,976,866,2370,1161,3346
420580,202105,1794,4559,1286,3784,290,920,435,1313,725,2233
420590,202105,2717,7213,1619,4855,274,975,457,1060,731,2035
420600,202105,1021,2900,789,2473,91,347,473,1406,564,1753
420610,202105,338,969,211,684,53,174,69,235,122,409
420620,202105,765,1868,514,1463,111,329,200,563,311,892
420630,202105,903,2713,663,2128,73,253,399,1221,472,1474
420640,202105,482,1290,243,808,77,254,33,104,110,358
420650,202105,3558,9306,2234,6574,299,964,887,2277,1186,3241
420660,202105,424,1083,274,765,58,165,60,149,118,314
420665,202105,640,1644,420,1274,74,251,187,508,261,759
420670,202105,1222,3381,779,2443,125,478,289,788,414,1266
420675,202105,182,496,109,352,19,83,57,166,76,249
420680,202105,306,703,157,495,30,102,74,225,104,327
420690,202105,851,2507,540,1786,75,291,142,409,217,700
420700,202105,2542,6628,1922,5599,211,672,1159,3261,1370,3933
420710,202105,994,2770,775,2302,71,282,498,1337,569,1619
420720,202105,1152,3192,841,2656,138,467,450,1355,588,1822
420730,202105,3097,8008,2319,6728,375,1213,1249,3466,1624,4679
420740,202105,486,1426,268,945,55,218,20,81,75,299
420750,202105,1915,5464,1237,3905,204,750,518,1490,722,2240
420757,202105,85,202,37,108,4,6,17,52,21,58
420760,202105,310,901,169,526,32,112,50,139,82,251
420765,202105,448,1288,214,717,26,95,97,309,123,404
420768,202105,1331,3694,1157,3410,139,405,862,2533,1001,2938
420770,202105,438,1190,214,738,36,145,77,244,113,389
420775,202105,264,772,181,586,30,107,71,190,101,297
420780,202105,892,2481,546,1711,106,367,95,267,201,634
420785,202105,196,509,139,388,14,50,71,164,85,214
420790,202105,1015,3021,758,2507,124,480,428,1336,552,1816
420800,202105,643,1604,333,989,73,250,132,365,205,615
420810,202105,1419,4316,1152,3789,309,1180,439,1232,748,2412
420820,202105,12419,30689,9020,25213,1589,4938,4251,11022,5840,15960
420830,202105,4180,10856,3141,9012,539,1625,1377,3834,1916,5459
420840,202105,475,1393,229,835,62,230,24,92,86,322
420845,202105,2387,6013,1484,4402,269,960,617,1724,886,2684
420850,202105,1061,3347,664,2314,110,411,143,443,253,854
420860,202105,339,865,189,597,36,129,50,130,86,259
420870,202105,759,2100,566,1733,151,518,214,596,365,1114
420880,202105,1032,3095,793,2604,160,626,299,890,459,1516
420890,202105,8100,21845,5077,15655,695,2333,1811,4973,2506,7306
420895,202105,173,500,108,331,27,84,34,105,61,189
420900,202105,1505,3703,919,2684,122,434,426,1093,548,1527
420910,202105,30734,80342,19646,59065,2829,9642,8017,21317,10846,30959
420915,202105,496,1780,367,1409,53,197,202,790,255,987
420917,202105,408,991,188,504,32,87,93,248,125,335
420920,202105,71,196,30,107,1,2,5,20,6,22
420930,202105,16187,41755,11574,33698,1947,6264,5233,14513,7180,20777
420940,202105,3056,7401,1836,5312,418,1359,393,931,811,2290
420945,202105,129,371,101,312,23,80,41,115,64,195
420950,202105,342,987,196,639,30,117,52,149,82,266
420960,202105,1031,2512,740,2019,122,380,331,812,453,1192
420970,202105,2318,6286,1635,5033,463,1466,475,1472,938,2938
420980,202105,273,897,235,815,107,383,61,220,168,603
420985,202105,300,859,156,544,41,164,42,127,83,291
420990,202105,306,956,177,635,28,106,39,137,67,243
421000,202105,543,1619,398,1306,86,303,95,278,181,581
421003,202105,464,1096,157,457,2,4,15,33,17,37
421005,202105,60,168,45,146,9,27,20,68,29,95
421010,202105,3237,8794,2339,7135,448,1538,649,1731,1097,3269
421020,202105,367,1138,290,998,43,175,145,475,188,650
421030,202105,741,2184,563,1828,166,609,190,565,356,1174
421040,202105,625,1493,393,1139,28,99,245,691,273,790
421050,202105,1015,2694,676,1960,130,409,264,670,394,1079
421055,202105,171,469,97,298,15,50,59,163,74,213
421060,202105,648,1857,466,1471,83,304,232,659,315,963
421070,202105,655,1960,415,1350,67,241,161,487,228,728
421080,202105,509,1457,420,1293,39,145,250,761,289,906
421085,202105,375,1044,148,498,16,52,26,70,42,122
421090,202105,268,686,151,424,12,44,47,115,59,159
421100,202105,766,1712,324,975,78,265,85,211,163,476
421105,202105,1547,4151,1075,3236,162,515,522,1499,684,2014
421110,202105,1090,2794,892,2533,22,69,645,1926,667,1995
421120,202105,1007,2995,737,2398,110,390,224,623,334,1013
421125,202105,286,736,203,585,71,230,74,181,145,411
421130,202105,4759,13692,3926,12091,878,3082,2013,5823,2891,8905
421140,202105,339,921,206,630,38,113,74,211,112,324
421145,202105,434,1181,278,842,72,230,94,261,166,491
421150,202105,575,1547,373,1151,60,218,201,575,261,793
421160,202105,511,1384,384,1142,52,173,241,674,293,847
421165,202105,221,651,134,441,28,91,52,167,80,258
421170,202105,998,2745,852,2509,137,386,526,1601,663,1987
421175,202105,958,2374,589,1806,112,391,265,782,377,1173
421180,202105,378,987,213,654,37,147,98,255,135,402
421185,202105,312,815,213,611,21,65,129,359,150,424
421187,202105,274,839,172,582,25,79,62,208,87,287
421189,202105,342,985,270,844,47,159,108,310,155,469
421190,202105,11056,29599,7633,23132,1341,4358,2919,8155,4260,12513
421200,202105,672,1893,558,1693,79,285,332,956,411,1241
421205,202105,188,497,138,416,25,89,64,178,89,267
421210,202105,1059,2628,602,1859,116,373,229,696,345,1069
421220,202105,1351,3984,1051,3360,234,818,336,983,570,1801
421223,202105,314,859,195,635,45,140,95,309,140,449
421225,202105,839,2429,714,2220,112,415,443,1344,555,1759
421227,202105,633,1793,409,1320,75,260,184,607,259,867
421230,202105,566,1456,366,1083,65,226,143,413,208,639
421240,202105,284,821,139,479,12,54,29,90,41,144
421250,202105,2047,5086,1434,4099,141,468,880,2407,1021,2875
421260,202105,203,622,49,177,10,43,5,14,15,57
421265,202105,666,1760,589,1648,19,50,503,1398,522,1448
421270,202105,340,906,144,508,23,75,48,170,71,245
421280,202105,1948,5096,1470,4311,204,719,843,2341,1047,3060
421290,202105,949,2532,495,1493,98,305,111,313,209,618
421300,202105,268,684,131,422,12,50,19,60,31,110
421310,202105,179,499,119,384,26,87,61,191,87,278
421315,202105,221,571,145,416,43,117,35,108,78,225
421320,202105,629,1979,336,1127,34,97,32,58,66,155
421330,202105,589,1732,423,1384,90,333,114,345,204,678
421335,202105,344,1033,278,922,62,228,120,388,182,616
421340,202105,1377,3775,999,3095,162,564,480,1373,642,1937
421350,202105,1471,3777,987,2930,192,634,389,1095,581,1729
421360,202105,2226,5880,1327,4033,240,861,508,1333,748,2194
421370,202105,704,2261,437,1543,74,277,124,373,198,650
421380,202105,825,2135,710,1958,83,255,424,1123,507,1378
421390,202105,164,437,62,211,15,44,22,65,37,109
421400,202105,320,986,233,786,40,154,120,378,160,532
421410,202105,173,486,80,291,21,83,22,70,43,153
421415,202105,177,511,115,350,23,78,29,65,52,143
421420,202105,558,1516,456,1327,49,165,285,811,334,976
421430,202105,96,307,73,247,8,28,18,56,26,84
421440,202105,609,1631,368,1176,66,205,155,479,221,684
421450,202105,445,1274,255,850,29,99,42,141,71,240
421460,202105,352,1043,194,712,17,65,23,64,40,129
421470,202105,278,773,168,541,30,97,62,213,92,310
421480,202105,2703,7189,1815,5420,337,1188,725,1980,1062,3168
421490,202105,115,393,69,258,12,45,13,40,25,85
421500,202105,2031,5894,1408,4612,351,1346,341,976,692,2322
421505,202105,289,799,240,729,31,118,161,463,192,581
421507,202105,420,1163,233,767,50,185,83,245,133,430
421510,202105,341,950,222,657,31,101,114,314,145,415
421520,202105,490,1294,323,924,30,88,182,470,212,558
421530,202105,281,812,154,521,24,103,33,82,57,185
421535,202105,374,987,238,748,40,148,132,397,172,545
421540,202105,303,723,167,504,25,80,57,155,82,235
421545,202105,619,1810,463,1538,100,401,228,699,328,1100
421550,202105,2026,5305,1639,4735,314,917,934,2704,1248,3621
421555,202105,161,490,72,254,6,24,11,24,17,48
421560,202105,83,282,56,213,10,42,18,63,28,105
421565,202105,887,2278,592,1816,147,509,171,514,318,1023
421567,202105,399,1257,260,880,84,303,71,215,155,518
421568,202105,331,983,244,769,42,154,98,298,140,452
421569,202105,150,417,72,227,10,32,39,123,49,155
421570,202105,1248,3382,877,2618,184,614,268,714,452,1328
421575,202105,286,821,215,630,31,100,101,273,132,373
421580,202105,4216,11323,2740,8283,388,1368,1073,2768,1461,4136
421590,202105,140,427,113,365,27,98,41,123,68,221
421600,202105,561,1507,383,1127,72,238,123,313,195,551
421605,202105,732,1893,529,1562,93,237,278,884,371,1121
421610,202105,1018,2745,692,2122,110,374,226,664,336,1038
421620,202105,3725,9782,2278,7154,428,1589,721,2109,1149,3698
421625,202105,126,351,61,188,11,31,17,50,28,81
421630,202105,2520,6544,1650,4893,278,990,628,1553,906,2543
421635,202105,264,699,187,544,13,43,123,328,136,371
421640,202105,662,1782,477,1504,101,364,201,622,302,986
421650,202105,2325,6335,1583,4971,344,1260,511,1388,855,2648
421660,202105,10089,27803,7121,22088,1040,3619,3265,9234,4305,12853
421670,202105,753,2124,530,1603,97,331,246,705,343,1036
421680,202105,1058,2816,818,2402,155,492,477,1296,632,1788
421690,202105,1296,3644,883,2786,154,527,308,966,462,1493
421700,202105,502,1443,350,1115,71,253,125,378,196,631
421710,202105,196,628,99,341,22,79,26,85,48,164
421715,202105,117,310,95,263,21,58,52,141,73,199
421720,202105,1903,5111,1147,3509,292,949,288,755,580,1704
421725,202105,252,606,133,400,23,74,62,162,85,236
421730,202105,383,1057,219,628,30,93,117,310,147,403
421740,202105,738,2076,500,1571,105,364,154,428,259,792
421750,202105,863,2018,418,1208,94,290,156,414,250,704
421755,202105,163,451,95,287,15,56,46,120,61,176
421760,202105,968,2507,666,1960,113,367,243,597,356,964
421770,202105,2304,6036,1667,4931,441,1278,578,1832,1019,3110
421775,202105,215,556,131,395,16,50,56,157,72,207
421780,202105,798,2331,524,1757,106,404,222,676,328,1080
421790,202105,854,2307,501,1639,108,373,219,690,327,1063
421795,202105,168,460,117,338,21,66,39,104,60,170
421800,202105,2540,6773,1862,5531,221,759,1085,3056,1306,3815
421810,202105,630,1705,428,1329,43,156,255,774,298,930
421820,202105,936,2704,568,1810,107,382,188,491,295,873
421825,202105,1318,3620,1171,3399,99,309,861,2448,960,2757
421830,202105,1964,5681,1604,5019,327,1099,642,1971,969,3070
421835,202105,218,524,143,402,30,104,53,134,83,238
421840,202105,206,656,145,517,26,100,31,98,57,198
421850,202105,365,1011,210,705,53,209,54,136,107,345
421860,202105,297,811,168,546,21,72,60,177,81,249
421870,202105,4328,10714,3203,8657,478,1541,1695,4052,2173,5593
421875,202105,279,818,119,369,17,57,30,77,47,134
421880,202105,663,1850,453,1388,91,307,125,366,216,673
421885,202105,218,608,139,427,32,105,40,106,72,211
421890,202105,821,2433,614,2022,102,400,337,1044,439,1444
421895,202105,397,999,342,926,39,110,234,664,273,774
421900,202105,1021,2683,780,2191,93,300,389,988,482,1288
421910,202105,307,889,194,625,29,121,45,114,74,235
421915,202105,362,1017,210,664,46,138,40,121,86,259
421917,202105,570,1321,328,1012,111,352,86,293,197,645
421920,202105,361,1085,260,886,96,341,77,260,173,601
421930,202105,2526,6290,1352,4082,273,946,495,1291,768,2237
421935,202105,393,1199,312,1027,61,203,180,582,241,785
421940,202105,369,1069,182,584,30,104,34,88,64,192
421950,202105,2983,7413,1734,5063,344,1093,441,1130,785,2223
421960,202105,180,440,94,278,15,61,31,67,46,128
421970,202105,1846,4726,1148,3281,220,738,460,1134,680,1872
421985,202105,297,812,186,583,24,85,72,210,96,295
422000,202105,1905,4852,1556,4315,145,479,1084,2965,1229,3444
430003,202105,570,1515,377,1172,63,208,170,530,233,738
430005,202105,263,692,167,521,23,77,84,251,107,328
430010,202105,1708,4068,1365,3543,201,531,908,2321,1109,2852
430020,202105,583,1324,439,1136,43,132,294,729,337,861
430030,202105,926,2180,505,1425,118,379,161,418,279,797
430040,202105,10375,24224,6301,17220,1618,4719,915,2617,2533,7336
430045,202105,461,1153,329,911,25,79,220,596,245,675
430047,202105,232,497,94,250,22,55,26,73,48,128
430050,202105,856,2169,509,1472,106,321,129,356,235,677
430055,202105,273,663,139,387,16,60,79,193,95,253
430057,202105,78,166,29,80,7,20,7,16,14,36
430060,202105,17386,45472,13530,39463,2629,8128,6476,18651,9105,26779
430063,202105,804,2219,656,1921,128,378,355,1038,483,1416
430064,202105,1062,2850,791,2305,197,603,346,981,543,1584
430066,202105,96,195,68,153,6,14,52,111,58,125
430070,202105,725,1855,122,405,19,78,18,39,37,117
430080,202105,871,2137,535,1488,79,264,294,696,373,960
430085,202105,886,1948,531,1385,101,279,229,584,330,863
430087,202105,813,1930,680,1757,61,165,482,1230,543,1395
430090,202105,505,1321,199,628,17,68,58,167,75,235
430100,202105,832,1963,504,1358,90,273,158,366,248,639
430105,202105,1196,3100,801,2426,114,397,394,1155,508,1552
430107,202105,177,515,104,324,22,69,27,75,49,144
430110,202105,2246,5507,1678,4675,303,885,851,2332,1154,3217
430120,202105,1202,3476,813,2510,146,466,361,1088,507,1554
430130,202105,3485,7821,2556,6515,839,2185,463,1447,1302,3632
430140,202105,992,2511,710,2004,164,434,363,1002,527,1436
430150,202105,566,1431,312,923,66,213,101,287,167,500
430155,202105,241,608,114,341,20,57,23,63,43,120
430160,202105,20192,46048,15856,40061,1733,4717,9672,24074,11405,28791
430163,202105,3132,7236,2211,5791,80,273,1652,4216,1732,4489
430165,202105,297,728,92,284,12,27,14,42,26,69
430170,202105,969,2521,341,1137,55,186,42,123,97,309
430175,202105,648,1882,550,1672,135,411,258,787,393,1198
430180,202105,644,1544,500,1307,64,151,324,862,388,1013
430185,202105,656,1635,344,982,94,239,49,138,143,377
430187,202105,742,1575,535,1319,68,176,313,778,381,954
430190,202105,1419,3604,1129,3161,245,727,517,1398,762,2125
430192,202105,124,328,41,121,5,15,8,19,13,34
430195,202105,406,1180,58,204,4,17,5,11,9,28
430200,202105,1036,3036,832,2670,287,956,229,763,516,1719
430205,202105,452,1174,405,1090,13,46,360,942,373,988
430210,202105,5920,15042,4013,11033,656,1937,1262,2762,1918,4699
430215,202105,303,779,193,561,38,114,73,217,111,331
430220,202105,652,1613,207,677,23,84,45,116,68,200
430222,202105,188,517,140,420,18,61,47,132,65,193
430223,202105,250,643,197,555,15,36,118,326,133,362
430225,202105,16,32,10,23,0,0,7,16,7,16
430230,202105,1962,5231,1614,4691,141,458,1172,3336,1313,3794
430235,202105,365,1005,236,739,42,151,60,159,102,310
430237,202105,510,1182,380,975,17,47,289,726,306,773
430240,202105,1319,3036,749,2041,79,259,399,996,478,1255
430245,202105,703,1941,551,1661,132,410,273,844,405,1254
430250,202105,938,2246,676,1837,237,686,36,89,273,775
430258,202105,138,371,100,292,6,15,55,157,61,172
430260,202105,671,1750,469,1366,58,196,264,771,322,967
430265,202105,216,622,147,489,29,91,52,176,81,267
430270,202105,2938,7110,2325,6166,361,1048,1451,3723,1812,4771
430280,202105,5132,11828,3599,9259,676,1770,1603,4034,2279,5804
430290,202105,2236,5044,1830,4577,46,144,1583,3864,1629,4008
430300,202105,10100,24989,7599,20705,1142,3415,4085,10764,5227,14179
430310,202105,12052,29257,8227,22318,1035,3097,4098,10358,5133,13455
430320,202105,1021,2543,572,1672,54,164,333,966,387,1130
430330,202105,703,1679,422,1126,77,214,161,392,238,606
430340,202105,599,1396,397,1072,65,163,237,634,302,797
430350,202105,7987,19616,6085,16334,684,1994,3777,9646,4461,11640
430355,202105,301,793,110,352,16,51,13,33,29,84
430360,202105,835,1979,558,1498,98,298,239,601,337,899
430367,202105,311,692,179,472,30,95,103,252,133,347
430370,202105,508,1332,218,641,30,87,61,147,91,234
430380,202105,716,1734,345,1053,78,275,98,287,176,562
430390,202105,3225,7649,1971,5396,401,1245,306,620,707,1865
430400,202105,1018,2163,783,1851,64,170,463,1061,527,1231
430410,202105,542,1264,378,1002,56,148,239,630,295,778
430420,202105,2600,6874,1997,5615,436,1299,991,2639,1427,3938
430430,202105,564,1408,259,784,59,172,56,179,115,351
430435,202105,1497,3744,1162,3206,197,589,626,1721,823,2310
430440,202105,3836,10209,3030,8854,279,917,1934,5613,2213,6530
430450,202105,6771,16529,5390,14114,1009,2849,2597,6543,3606,9392
430460,202105,34205,84565,25661,70740,4116,12457,13429,35457,17545,47914
430461,202105,232,604,77,232,14,49,31,73,45,122
430462,202105,270,722,158,498,29,98,50,151,79,249
430463,202105,6124,15624,4545,12854,868,2752,2131,5702,2999,8454
430465,202105,449,1129,358,957,59,177,226,582,285,759
430466,202105,4209,10421,3298,8974,733,2080,1564,4027,2297,6107
430467,202105,504,1184,355,960,48,157,195,479,243,636
430468,202105,1283,3110,1018,2728,74,225,716,1871,790,2096
430469,202105,531,1401,79,248,9,29,19,42,28,71
430470,202105,5573,14137,3727,10867,1062,3360,937,2574,1999,5934
430471,202105,541,1494,441,1311,65,208,264,755,329,963
430480,202105,678,1885,440,1360,58,193,106,288,164,481
430485,202105,171,441,66,201,19,53,7,23,26,76
430490,202105,367,938,207,611,23,88,110,289,133,377
430495,202105,393,1047,261,798,36,114,115,327,151,441
430500,202105,987,2501,687,1995,227,710,187,493,414,1203
430510,202105,27097,68655,19502,54335,3087,9672,9328,23951,12415,33623
430511,202105,320,915,140,450,17,56,21,66,38,122
430512,202105,975,2140,756,1817,170,415,282,694,452,1109
430513,202105,801,1959,373,1063,61,190,176,464,237,654
430515,202105,372,1040,271,835,35,104,147,449,182,553
430517,202105,1189,3479,893,2810,158,491,455,1448,613,1939
430520,202105,1290,3211,699,1956,128,384,166,425,294,809
430530,202105,982,2423,406,1212,67,197,118,347,185,544
430535,202105,3524,8927,2566,7185,346,992,1315,3531,1661,4523
430537,202105,353,1135,324,1063,18,51,263,865,281,916
430540,202105,615,1452,338,968,63,177,159,455,222,632
430543,202105,911,1561,542,1151,60,125,220,547,280,672
430544,202105,754,2086,521,1572,124,383,172,507,296,890
430545,202105,2395,5977,1777,5051,312,895,961,2772,1273,3667
430550,202105,344,947,253,755,47,146,99,277,146,423
430558,202105,117,268,55,148,8,17,19,51,27,68
430560,202105,279,647,137,403,21,65,51,135,72,200
430570,202105,852,2058,611,1626,104,325,307,740,411,1065
430580,202105,828,2035,589,1675,149,457,248,706,397,1163
430583,202105,199,488,35,105,4,12,10,22,14,34
430585,202105,226,546,119,327,17,56,52,118,69,174
430587,202105,195,521,148,437,22,70,59,163,81,233
430590,202105,1377,3295,1138,2937,59,178,932,2354,991,2532
430593,202105,20,62,14,41,2,4,5,15,7,19
430595,202105,438,1091,130,416,14,56,19,46,33,102
430597,202105,461,1155,245,718,24,74,79,183,103,257
430600,202105,1988,5052,893,2523,134,400,218,561,352,961
430605,202105,1297,3338,942,2693,109,352,474,1291,583,1643
430607,202105,534,1234,447,1104,27,70,330,804,357,874
430610,202105,5850,13399,3923,10532,1063,3303,896,2283,1959,5586
430613,202105,280,646,79,233,10,27,24,58,34,85
430620,202105,648,1555,486,1261,70,209,293,680,363,889
430630,202105,400,1083,120,384,23,73,29,74,52,147
430632,202105,451,1161,200,594,31,88,84,239,115,327
430635,202105,551,1259,416,1039,45,121,307,757,352,878
430637,202105,458,1076,351,914,38,112,237,588,275,700
430640,202105,1091,2845,727,2105,112,332,286,763,398,1095
430642,202105,357,974,268,775,47,137,136,369,183,506
430645,202105,154,359,60,161,10,28,20,47,30,75
430650,202105,1679,4648,1335,4072,386,1164,562,1860,948,3024
430655,202105,280,697,173,491,28,92,84,207,112,299
430660,202105,5314,13265,4074,11248,845,2434,1842,5013,2687,7447
430670,202105,653,1563,498,1301,34,86,294,790,328,876
430673,202105,539,1205,232,637,35,98,93,237,128,335
430675,202105,240,694,54,193,5,17,21,74,26,91
430676,202105,5166,12536,4123,10951,502,1425,2593,6758,3095,8183
430680,202105,1060,2755,616,1836,163,498,143,401,306,899
430690,202105,2821,7498,2235,6447,761,2324,609,1697,1370,4021
430692,202105,215,659,168,580,14,44,123,439,137,483
430693,202105,932,2413,569,1711,103,370,150,411,253,781
430695,202105,407,1016,251,711,27,71,135,369,162,440
430697,202105,398,996,311,862,73,184,155,465,228,649
430700,202105,7517,18127,4656,12869,894,2680,1191,2952,2085,5632
430705,202105,402,934,198,556,20,57,81,201,101,258
430710,202105,1690,3540,1191,2877,146,397,723,1694,869,2091
430720,202105,682,1622,364,1080,43,121,189,563,232,684
430730,202105,1001,2689,701,2120,87,271,381,1118,468,1389
430740,202105,652,1724,342,1092,61,198,90,288,151,486
430745,202105,344,925,229,685,55,185,71,182,126,367
430750,202105,1456,3597,989,2783,275,789,404,1122,679,1911
430755,202105,452,1091,294,773,23,71,163,399,186,470
430760,202105,2055,4963,1581,4244,308,908,770,1958,1078,2866
430770,202105,6367,15690,4944,13540,591,1843,3194,8432,3785,10275
430780,202105,1868,4556,1140,3319,195,649,484,1347,679,1996
430781,202105,467,1292,274,846,55,155,80,222,135,377
430783,202105,351,795,212,580,26,74,133,344,159,418
430786,202105,34,120,25,93,5,20,3,12,8,32
430790,202105,4495,10744,3179,8497,341,1079,1955,4862,2296,5941
430800,202105,767,1730,579,1456,43,110,380,949,423,1059
430805,202105,335,865,220,627,11,41,146,403,157,444
430807,202105,487,1209,264,785,35,109,101,274,136,383
430810,202105,713,1680,319,922,39,140,130,335,169,475
430820,202105,1162,3102,718,2252,124,397,227,679,351,1076
430825,202105,262,642,86,236,9,22,32,82,41,104
430830,202105,1711,4737,1389,4124,101,295,976,2863,1077,3158
430840,202105,1069,2547,727,1982,108,278,467,1297,575,1575
430843,202105,177,420,82,220,7,22,32,75,39,97
430845,202105,472,1105,313,847,49,141,141,363,190,504
430850,202105,2261,5788,1535,4412,230,717,587,1722,817,2439
430860,202105,856,1987,399,1123,49,167,184,431,233,598
430865,202105,520,1299,377,1049,97,277,120,330,217,607
430870,202105,579,1533,260,822,41,148,75,205,116,353
430880,202105,1495,3325,1017,2600,167,426,551,1377,718,1803
430885,202105,168,441,88,286,5,16,55,176,60,192
430890,202105,1003,2427,677,1883,52,216,146,379,198,595
430900,202105,3136,6769,2195,5444,173,536,1480,3435,1653,3971
430905,202105,863,2107,552,1522,97,293,234,614,331,907
430910,202105,2043,5457,1540,4430,235,775,723,1821,958,2596
430912,202105,505,1407,351,1096,31,92,221,703,252,795
430915,202105,480,1422,366,1211,134,424,92,325,226,749
430920,202105,22635,56704,17305,47991,2179,6633,10532,28524,12711,35157
430925,202105,88,201,36,112,4,12,19,56,23,68
430930,202105,10380,24196,6722,18596,1274,3524,2765,8050,4039,11574
430940,202105,940,2408,575,1654,118,354,205,529,323,883
430950,202105,808,1780,521,1303,34,111,347,792,381,903
430955,202105,388,1000,104,286,22,61,32,65,54,126
430957,202105,166,554,152,526,20,72,102,350,122,422
430960,202105,1316,3093,753,2076,149,443,329,852,478,1295
430965,202105,1599,3757,1237,3192,68,176,940,2477,1008,2653
430970,202105,348,823,184,507,24,76,94,227,118,303
430975,202105,511,1476,392,1203,75,244,210,612,285,856
430980,202105,390,873,227,602,26,81,106,252,132,333
430990,202105,527,1484,346,1069,53,172,151,466,204,638
430995,202105,551,1380,424,1178,55,159,246,663,301,822
431000,202105,1356,3195,585,1690,118,366,42,107,160,473
431010,202105,2227,5835,1484,4523,302,984,403,1112,705,2096
431020,202105,7559,16316,4505,11790,966,2902,1595,3629,2561,6531
431030,202105,359,964,171,569,33,125,21,63,54,188
431033,202105,3828,8760,2509,6718,528,1457,929,2471,1457,3928
431036,202105,336,735,70,209,8,26,23,55,31,81
431040,202105,886,2215,574,1677,64,206,290,784,354,990
431041,202105,444,1020,320,830,28,63,190,496,218,559
431043,202105,316,797,187,562,41,139,91,263,132,402
431046,202105,107,281,44,135,5,12,9,25,14,37
431050,202105,1353,3248,966,2617,181,534,442,1228,623,1762
431053,202105,652,1716,389,1164,73,245,128,330,201,575
431055,202105,583,1389,489,1240,59,133,350,885,409,1018
431057,202105,224,637,124,403,28,92,31,92,59,184
431060,202105,5613,13796,3787,10746,861,2695,1110,3020,1971,5715
431065,202105,403,992,291,807,42,125,151,412,193,537
431070,202105,413,1110,246,739,52,172,75,220,127,392
431075,202105,221,631,133,429,33,113,38,122,71,235
431080,202105,588,1590,411,1214,61,208,155,436,216,644
431085,202105,795,2028,508,1383,55,152,273,724,328,876
431087,202105,395,1097,320,947,22,69,230,690,252,759
431090,202105,402,940,160,491,29,97,42,129,71,226
431100,202105,3356,7228,2316,5888,288,742,1265,3261,1553,4003
431110,202105,1423,3232,976,2461,234,634,415,939,649,1573
431112,202105,617,1655,512,1465,50,168,351,953,401,1121
431113,202105,392,1045,331,928,58,175,184,498,242,673
431115,202105,957,2660,751,2283,80,302,470,1336,550,1638
431120,202105,2659,6836,1852,5334,481,1542,467,1243,948,2785
431123,202105,394,1048,255,750,58,152,132,409,190,561
431125,202105,970,2714,781,2349,284,839,265,855,549,1694
431127,202105,199,525,63,206,8,28,12,34,20,62
431130,202105,2943,7358,2197,6154,319,999,1223,3334,1542,4333
431140,202105,5704,13274,3528,9230,422,1200,1601,3651,2023,4851
431142,202105,507,1319,383,1107,45,136,239,694,284,830
431150,202105,1041,2718,753,2198,136,443,339,948,475,1391
431160,202105,642,1822,423,1328,80,264,123,382,203,646
431162,202105,510,1219,305,856,31,97,164,419,195,516
431164,202105,164,367,40,119,8,25,6,16,14,41
431170,202105,447,1218,318,953,96,296,93,270,189,566
431171,202105,650,1517,531,1359,119,268,303,806,422,1074
431173,202105,381,997,292,869,80,276,123,340,203,616
431175,202105,1308,2991,831,2194,133,351,324,809,457,1160
431177,202105,806,2123,635,1856,114,402,412,1145,526,1547
431179,202105,334,724,103,293,17,46,28,76,45,122
431180,202105,2155,5412,1352,3846,315,921,419,1142,734,2063
431190,202105,591,1499,272,787,31,89,90,223,121,312
431198,202105,383,1071,307,929,89,287,102,322,191,609
431200,202105,364,897,90,241,17,49,11,31,28,80
431205,202105,211,570,114,357,32,104,37,122,69,226
431210,202105,607,1465,492,1308,132,358,212,596,344,954
431213,202105,264,691,200,578,13,42,105,300,118,342
431215,202105,603,1435,290,837,23,73,148,393,171,466
431217,202105,156,401,109,315,13,45,60,156,73,201
431220,202105,524,1337,325,950,29,105,184,494,213,599
431225,202105,1500,3493,1155,2931,114,297,792,2004,906,2301
431230,202105,669,1877,537,1601,73,220,328,946,401,1166
431235,202105,150,383,20,70,2,4,4,19,6,23
431237,202105,327,1014,260,859,44,161,135,425,179,586
431238,202105,33,92,27,79,5,16,13,31,18,47
431240,202105,4483,10813,3560,9380,403,1232,2271,5646,2674,6878
431242,202105,248,632,216,580,40,113,127,323,167,436
431244,202105,314,747,166,460,20,75,62,139,82,214
431245,202105,1317,3012,837,2193,66,187,467,1172,533,1359
431247,202105,277,696,169,478,29,92,78,193,107,285
431250,202105,1702,4181,1260,3593,280,797,645,1975,925,2772
431260,202105,258,707,175,545,25,91,58,175,83,266
431261,202105,255,756,202,665,15,49,115,362,130,411
431262,202105,337,941,174,564,13,39,115,376,128,415
431265,202105,1603,3736,660,1898,76,254,221,551,297,805
431267,202105,251,621,165,443,6,25,122,301,128,326
431270,202105,2815,6220,1526,4079,321,867,512,1411,833,2278
431275,202105,113,323,63,207,22,66,11,41,33,107
431280,202105,236,631,76,237,4,13,10,22,14,35
431290,202105,339,975,217,674,38,119,39,101,77,220
431295,202105,69,167,20,59,3,8,5,13,8,21
431300,202105,289,757,62,192,9,24,20,52,29,76
431301,202105,300,836,68,209,8,23,7,21,15,44
431303,202105,582,1478,358,1017,22,76,165,422,187,498
431306,202105,2315,5407,1429,3948,185,562,627,1544,812,2106
431308,202105,25,76,23,72,10,34,10,31,20,65
431310,202105,548,1466,386,1118,48,137,178,483,226,620
431320,202105,625,1708,343,1101,59,180,75,213,134,393
431330,202105,1720,4007,874,2466,140,451,360,914,500,1365
431333,202105,215,557,116,340,20,55,40,102,60,157
431335,202105,35,100,20,69,5,12,0,0,5,12
431337,202105,2514,6544,1884,5516,303,1024,1078,3024,1381,4048
431339,202105,418,1074,312,885,88,261,116,317,204,578
431340,202105,18665,44802,13191,35742,1961,5851,6319,16019,8280,21870
431342,202105,423,928,311,752,28,53,253,612,281,665
431344,202105,388,980,234,692,9,30,123,355,132,385
431346,202105,234,574,95,300,17,58,23,62,40,120
431349,202105,648,1671,387,1100,84,222,154,439,238,661
431350,202105,4148,10395,3111,8651,390,1264,1739,4614,2129,5878
431360,202105,542,1285,265,746,83,238,67,190,150,428
431365,202105,2067,4745,1641,4170,120,339,1254,3151,1374,3490
431370,202105,4524,10723,3300,8762,616,1723,1700,4575,2316,6298
431380,202105,810,2134,654,1888,49,151,455,1310,504,1461
431390,202105,2630,6382,1674,4710,158,531,866,2141,1024,2672
431395,202105,1313,3168,940,2610,183,526,461,1310,644,1836
431400,202105,316,883,178,569,33,99,39,126,72,225
431402,202105,887,1939,656,1592,78,192,452,1078,530,1270
431403,202105,200,546,156,457,23,63,70,197,93,260
431405,202105,4702,12174,3666,10460,578,1829,1888,5107,2466,6936
431406,202105,534,1491,385,1168,71,206,198,617,269,823
431407,202105,457,1239,324,960,70,234,169,475,239,709
431410,202105,17310,42420,11855,32999,1601,5170,6399,16443,8000,21613
431413,202105,201,525,53,173,5,15,10,36,15,51
431415,202105,674,1615,429,1203,75,254,214,537,289,791
431417,202105,564,1235,379,945,60,177,201,482,261,659
431420,202105,1631,3588,1226,3032,154,387,724,1748,878,2135
431430,202105,562,1427,280,851,44,148,92,248,136,396
431440,202105,29803,68442,20746,54455,3326,9564,8574,20863,11900,30427
431442,202105,131,368,62,211,10,39,8,25,18,64
431445,202105,387,1078,110,351,15,41,12,32,27,73
431446,202105,252,724,190,600,31,115,95,294,126,409
431447,202105,748,1932,429,1253,84,257,140,413,224,670
431449,202105,776,1989,476,1373,90,239,179,534,269,773
431450,202105,2291,4642,1790,3940,65,153,1419,3052,1484,3205
431454,202105,38,121,31,101,8,23,10,29,18,52
431455,202105,588,1371,293,773,36,98,144,343,180,441
431460,202105,2892,6856,2025,5341,524,1446,513,1371,1037,2817
431470,202105,1417,3899,1043,3107,179,537,448,1350,627,1887
431475,202105,238,639,58,195,5,18,9,22,14,40
431477,202105,384,991,237,692,41,111,99,264,140,375
431478,202105,220,578,51,157,10,26,6,13,16,39
431480,202105,3380,8197,2717,7200,635,1682,1387,3701,2022,5383
431490,202105,107255,248534,81554,209868,5452,16662,59738,147637,65190,164299
431500,202105,488,1223,366,999,66,191,189,490,255,681
431505,202105,255,609,173,482,12,40,123,339,135,379
431507,202105,333,777,136,395,46,146,35,91,81,237
431510,202105,1605,4046,1090,3051,265,791,358,1012,623,1803
431513,202105,209,458,117,309,7,13,76,202,83,215
431514,202105,110,283,81,231,3,10,55,148,58,158
431515,202105,462,1146,345,938,81,222,195,494,276,716
431517,202105,56,168,45,141,5,13,21,62,26,75
431520,202105,393,980,163,501,15,54,72,192,87,246
431530,202105,4538,9517,2670,6754,577,1413,830,2157,1407,3570
431531,202105,211,504,134,361,19,44,53,135,72,179
431532,202105,548,1265,339,890,65,191,150,377,215,568
431535,202105,237,619,108,333,23,78,23,59,46,137
431540,202105,1800,5674,1672,5497,53,205,1361,4496,1414,4701
431545,202105,354,896,70,209,7,22,20,57,27,79
431550,202105,2139,5300,1542,4195,241,688,781,2042,1022,2730
431555,202105,673,1508,397,1048,30,87,233,609,263,696
431560,202105,23184,55062,15909,43778,3199,9038,5536,16011,8735,25049
431570,202105,4268,10295,3582,9299,432,1239,2548,6350,2980,7589
431575,202105,280,669,223,581,70,158,88,236,158,394
431580,202105,577,1488,369,1075,37,123,206,576,243,699
431590,202105,592,1624,445,1330,90,280,173,533,263,813
431595,202105,361,972,243,724,41,119,95,262,136,381
431600,202105,1381,3219,973,2624,208,603,401,1069,609,1672
431610,202105,1398,3500,952,2695,145,383,480,1396,625,1779
431620,202105,480,1217,226,647,40,117,86,227,126,344
431630,202105,1319,3204,634,1828,96,281,242,665,338,946
431640,202105,6311,14609,5340,13390,452,1192,4092,10284,4544,11476
431642,202105,571,1361,359,946,39,99,155,378,194,477
431643,202105,380,917,180,508,15,39,53,152,68,191
431645,202105,1856,4066,1463,3550,51,159,1202,2870,1253,3029
431647,202105,300,721,94,273,10,25,24,60,34,85
431650,202105,126,340,88,280,7,24,46,132,53,156
431660,202105,871,2267,424,1332,66,244,115,300,181,544
431670,202105,1162,2733,708,1913,108,300,344,881,452,1181
431673,202105,243,617,90,305,6,22,15,39,21,61
431675,202105,414,1074,117,391,7,30,21,58,28,88
431680,202105,7972,19869,5851,16013,1291,3662,2533,6758,3824,10420
431690,202105,24529,59011,16675,45117,3126,9011,7214,19232,10340,28243
431695,202105,182,436,110,320,22,75,55,140,77,215
431697,202105,468,1087,363,928,52,128,216,564,268,692
431700,202105,1337,3390,1103,2965,179,438,647,1757,826,2195
431710,202105,13492,31333,9513,25687,1417,4117,5084,13750,6501,17867
431720,202105,6612,16018,4014,11130,943,2726,839,2102,1782,4828
431725,202105,27,75,21,65,3,10,9,24,12,34
431730,202105,3979,9267,2501,6984,550,1600,815,2448,1365,4048
431740,202105,5239,12131,3483,9245,883,2721,926,2155,1809,4876
431750,202105,7477,19041,5665,16184,1301,3893,2198,6245,3499,10138
431755,202105,317,842,78,255,14,42,9,26,23,68
431760,202105,5439,12072,3734,9383,404,1138,2331,5563,2735,6701
431770,202105,1942,4425,1504,3846,123,318,1108,2782,1231,3100
431775,202105,201,508,101,313,20,65,14,36,34,101
431780,202105,2168,5200,1415,3841,220,643,597,1572,817,2215
431790,202105,777,2062,548,1622,101,287,252,754,353,1041
431795,202105,233,590,119,358,27,75,30,89,57,164
431800,202105,8249,19275,5160,14466,1243,4161,486,1427,1729,5588
431805,202105,289,673,85,275,11,42,12,28,23,70
431810,202105,3320,7652,2081,5443,389,1056,894,2237,1283,3293
431820,202105,2101,5532,1642,4804,468,1436,574,1767,1042,3203
431830,202105,9023,19296,6610,16091,1679,4869,1611,3838,3290,8707
431840,202105,2626,6652,2108,5836,289,821,1383,3802,1672,4623
431842,202105,518,1282,179,545,25,86,73,200,98,286
431843,202105,333,862,246,691,29,85,121,325,150,410
431844,202105,199,526,69,227,15,55,21,74,36,129
431845,202105,500,1313,354,1024,36,105,207,595,243,700
431846,202105,278,705,238,647,13,38,209,569,222,607
431848,202105,141,352,74,213,10,31,16,34,26,65
431849,202105,405,976,77,221,8,21,13,26,21,47
431850,202105,4159,11008,3202,9150,714,2201,1102,3067,1816,5268
431860,202105,637,1481,347,932,53,153,202,522,255,675
431861,202105,92,254,56,174,9,28,19,59,28,87
431862,202105,453,1408,374,1272,70,261,184,600,254,861
431870,202105,20854,51705,16828,45495,1779,5510,10673,27668,12452,33178
431880,202105,3946,9984,2816,8007,404,1326,1377,3696,1781,5022
431890,202105,4574,11378,2871,8134,791,2421,497,1588,1288,4009
431900,202105,957,2346,620,1753,91,283,322,859,413,1142
431910,202105,752,1775,287,788,36,110,90,203,126,313
431912,202105,483,1281,378,1098,75,232,213,620,288,852
431915,202105,1101,2579,869,2216,30,87,681,1705,711,1792
431920,202105,1243,2825,1028,2546,35,74,873,2161,908,2235
431930,202105,670,1741,462,1353,172,473,157,483,329,956
431935,202105,84,221,61,175,15,42,13,34,28,76
431936,202105,308,862,175,535,35,113,79,218,114,331
431937,202105,142,347,90,246,11,32,42,97,53,129
431940,202105,3079,7132,1787,4811,169,480,944,2443,1113,2923
431950,202105,1865,4797,1485,4168,371,1101,629,1707,1000,2808
431960,202105,2961,7077,2221,5764,587,1627,638,1622,1225,3249
431970,202105,400,1001,175,508,37,118,41,94,78,212
431971,202105,86,211,38,115,4,16,8,17,12,33
431973,202105,474,1509,388,1340,38,128,279,969,317,1097
431975,202105,108,216,21,63,2,7,5,13,7,20
431980,202105,939,2427,724,2080,144,436,347,961,491,1397
431990,202105,5675,13395,3987,10980,430,1434,2198,5813,2628,7247
432000,202105,11634,27218,8544,22480,1922,5106,3852,10204,5774,15310
432010,202105,2424,5673,1710,4504,294,812,884,2189,1178,3001
432020,202105,1762,4544,1090,3112,226,676,380,1045,606,1721
432023,202105,513,1208,264,728,34,99,116,284,150,383
432026,202105,942,2585,694,2107,181,533,205,640,386,1173
432030,202105,362,877,212,578,16,48,122,320,138,368
432032,202105,335,839,230,628,23,69,132,328,155,397
432035,202105,651,1815,565,1669,173,480,248,780,421,1260
432040,202105,1060,2475,410,1246,57,193,160,432,217,625
432045,202105,153,435,100,324,20,62,37,123,57,185
432050,202105,543,1319,402,1080,78,218,178,484,256,702
432055,202105,567,1515,376,1165,128,403,68,198,196,601
432057,202105,184,498,147,399,13,32,71,182,84,214
432060,202105,428,1022,131,406,30,101,37,106,67,207
432065,202105,203,557,146,438,36,115,54,161,90,276
432067,202105,723,2049,613,1803,57,189,465,1320,522,1509
432070,202105,1685,4240,1138,3206,208,662,456,1158,664,1820
432080,202105,4847,11109,3696,9358,578,1716,1785,4299,2363,6015
432085,202105,366,964,261,800,57,185,123,380,180,565
432090,202105,2046,5001,1211,3414,197,601,573,1497,770,2098
432100,202105,974,2406,482,1437,103,325,85,211,188,536
432110,202105,2032,5260,1408,4163,325,1069,165,443,490,1512
432120,202105,2895,7608,2283,6610,399,1293,1041,2842,1440,4135
432130,202105,2611,6468,2177,5832,632,1722,936,2554,1568,4276
432132,202105,178,511,109,358,21,70,53,152,74,222
432135,202105,976,2278,652,1733,40,124,474,1244,514,1368
432140,202105,1617,4733,1231,3959,172,595,761,2416,933,3011
432143,202105,1370,3541,1051,3060,61,199,699,2014,760,2213
432145,202105,1710,4458,1091,3177,159,492,347,867,506,1359
432146,202105,103,291,74,245,25,93,24,69,49,162
432147,202105,463,1265,282,896,96,325,68,194,164,519
432149,202105,444,1067,228,641,25,75,101,249,126,324
432150,202105,3241,7977,2411,6556,471,1375,1064,2807,1535,4182
432160,202105,5077,12987,3717,10845,829,2730,1317,3672,2146,6402
432162,202105,235,507,36,100,6,19,11,24,17,43
432163,202105,104,257,21,53,0,0,4,5,4,5
432166,202105,643,1747,511,1485,98,327,194,493,292,820
432170,202105,1513,4010,1040,3138,185,622,435,1241,620,1863
432180,202105,3105,7237,1697,4641,297,851,665,1594,962,2445
432183,202105,347,1000,242,765,55,196,73,209,128,405
432185,202105,814,2081,472,1414,40,131,232,654,272,785
432190,202105,1961,4642,1354,3694,164,510,806,2062,970,2572
432195,202105,830,2091,560,1598,133,350,217,649,350,999
432200,202105,3418,8426,2484,6967,358,1041,1461,4094,1819,5135
432210,202105,395,1027,249,740,46,161,117,298,163,459
432215,202105,607,1768,554,1688,48,118,419,1305,467,1423
432218,202105,248,602,117,329,13,42,52,126,65,168
432220,202105,3527,8181,2607,6732,503,1299,1281,3317,1784,4616
432225,202105,94,258,71,214,10,27,42,132,52,159
432230,202105,732,1708,394,1085,42,117,177,434,219,551
432232,202105,466,1142,290,842,59,180,104,273,163,453
432234,202105,256,641,116,342,18,50,17,47,35,97
432235,202105,44,125,18,57,5,17,4,13,9,30
432237,202105,308,793,274,738,12,23,227,603,239,626
432240,202105,16138,38873,11813,33134,897,2476,7620,22363,8517,24839
432250,202105,5445,15216,4044,12460,1021,3257,1694,5211,2715,8468
432252,202105,416,985,269,721,32,90,144,364,176,454
432253,202105,867,2584,582,1862,139,472,54,159,193,631
432254,202105,698,1619,205,595,33,84,43,120,76,204
432255,202105,99,248,56,164,4,13,27,72,31,85
432260,202105,4908,12358,3657,10028,1005,2824,1304,3439,2309,6263
432270,202105,1900,5104,1542,4426,464,1436,399,1082,863,2518
432280,202105,1431,3497,761,2198,94,295,279,671,373,966
432285,202105,142,427,22,67,2,6,3,7,5,13
432290,202105,333,911,186,572,62,196,33,73,95,269
432300,202105,26269,65023,19776,54671,2613,8184,11875,31532,14488,39716
432310,202105,836,2198,602,1773,62,189,407,1200,469,1389
432320,202105,200,460,80,241,8,28,29,79,37,107
432330,202105,228,508,71,226,10,24,12,41,22,65
432335,202105,158,447,59,206,6,24,15,47,21,71
432340,202105,305,735,135,424,9,33,46,133,55,166
432345,202105,735,1609,634,1491,14,40,531,1222,545,1262
432350,202105,337,851,181,555,27,89,70,218,97,307
432360,202105,233,689,45,153,3,6,15,51,18,57
432370,202105,295,724,201,566,16,54,138,377,154,431
432375,202105,474,1166,357,940,81,210,163,428,244,638
432377,202105,170,536,35,126,5,20,4,8,9,28
432380,202105,1790,4720,1230,3716,186,603,654,1942,840,2545
500020,202105,2642,6741,1978,5650,200,646,1214,3378,1414,4024
500025,202105,1186,2890,756,2091,78,213,402,1077,480,1290
500060,202105,8087,22549,5556,17292,668,2165,3259,10355,3927,12520
500070,202105,4362,10999,3099,8858,566,1659,1393,4028,1959,5687
500080,202105,1653,3977,1018,2825,189,593,394,955,583,1548
500085,202105,1997,4931,1399,3915,348,1011,624,1672,972,2683
500090,202105,2193,5691,1493,4476,222,702,482,1554,704,2256
500100,202105,3615,9125,2761,7750,421,1325,1411,3731,1832,5056
500110,202105,8179,20448,5348,16079,1059,3512,1633,5793,2692,9305
500124,202105,2092,5975,1664,5266,285,823,876,2931,1161,3754
500150,202105,1352,3006,859,2297,126,361,359,926,485,1287
500190,202105,4980,12836,3195,9356,617,1811,837,2339,1454,4150
500200,202105,2565,5941,1800,4662,176,467,1097,2740,1273,3207
500210,202105,4720,11016,3348,9216,940,2495,1451,4144,2391,6639
500215,202105,1416,3833,1036,3155,102,343,588,1781,690,2124
500220,202105,2855,7776,1922,6040,301,970,624,1907,925,2877
500230,202105,2028,4655,1549,3995,180,438,1050,2682,1230,3120
500240,202105,4061,11741,2901,9335,428,1470,1219,4010,1647,5480
500260,202105,3362,7066,2175,5483,288,730,1197,2891,1485,3621
500270,202105,138891,322580,85530,233834,13204,39754,33502,85184,46706,124938
500280,202105,1414,3484,956,2787,175,524,436,1270,611,1794
500290,202105,3731,8930,2222,6290,329,1057,712,1762,1041,2819
500295,202105,3627,8609,2321,6331,396,1181,918,2175,1314,3356
500310,202105,1007,2054,695,1668,95,208,373,918,468,1126
500315,202105,3871,10431,3112,9312,241,726,2260,6893,2501,7619
500320,202105,19816,52119,13746,42179,3477,10993,4523,15043,8000,26036
500325,202105,4715,10402,3291,8493,298,739,2147,5622,2445,6361
500330,202105,6718,15055,4450,11815,357,1009,2361,6514,2718,7523
500345,202105,2072,5044,1384,3957,305,920,482,1355,787,2275
500348,202105,2386,6109,1790,5085,232,717,1041,2977,1273,3694
500350,202105,1332,3591,749,2332,83,252,300,898,383,1150
500370,202105,27451,69161,19777,56807,2370,7820,10734,30258,13104,38078
500375,202105,2495,6496,1689,4860,261,819,592,1546,853,2365
500380,202105,3389,8410,2362,6660,672,2045,440,1269,1112,3314
500390,202105,640,1339,390,1030,50,156,235,597,285,753
500400,202105,1577,3966,1048,2957,170,520,354,913,524,1433
500410,202105,2424,5847,1706,4790,169,450,974,2862,1143,3312
500430,202105,2652,6462,1839,5266,258,836,784,2388,1042,3224
500440,202105,1221,2929,771,2241,121,379,277,855,398,1234
500450,202105,1536,3737,898,2592,139,439,248,647,387,1086
500460,202105,3543,9397,2157,6681,339,1198,663,1990,1002,3188
500470,202105,2432,6466,1505,4577,408,1381,313,830,721,2211
500480,202105,2091,6351,1779,5878,160,512,1324,4456,1484,4968
500490,202105,1092,2487,652,1822,118,399,177,503,295,902
500500,202105,4267,11132,2763,8705,808,2968,311,1021,1119,3989
500510,202105,715,1775,473,1337,36,103,293,808,329,911
500515,202105,1719,4404,1331,3782,171,532,772,2074,943,2606
500520,202105,3313,9733,2578,8428,656,2107,1048,3782,1704,5889
500525,202105,946,2680,751,2396,61,215,493,1559,554,1774
500540,202105,4521,11660,2702,8419,640,2543,239,676,879,3219
500560,202105,5566,14854,4490,13513,286,844,3651,11199,3937,12043
500568,202105,4366,9450,2693,7010,704,1823,881,2394,1585,4217
500570,202105,7909,18126,5026,13353,818,2388,2066,5105,2884,7493
500580,202105,3088,8042,2266,6601,541,1609,965,2821,1506,4430
500600,202105,3414,8442,2453,6917,542,1591,1011,2913,1553,4504
500620,202105,8105,20829,5495,15924,1033,3141,2229,6170,3262,9311
500625,202105,542,1456,352,1072,69,215,84,233,153,448
500627,202105,776,1982,483,1474,90,295,138,393,228,688
500630,202105,7265,16228,4107,11077,821,2410,1167,3099,1988,5509
500635,202105,2989,9174,2282,8245,153,566,1569,6272,1722,6838
500640,202105,1717,3718,1148,2965,39,118,791,2014,830,2132
500660,202105,18424,46019,12782,37971,3788,12859,3347,10196,7135,23055
500690,202105,2463,6622,1568,5077,516,1982,105,271,621,2253
500710,202105,2821,7424,2172,6334,567,1774,706,1911,1273,3685
500720,202105,4930,12297,3265,9530,741,2297,1015,3059,1756,5356
500730,202105,1109,2710,608,1799,119,334,135,431,254,765
500740,202105,4670,11048,3177,8719,423,1212,1565,4187,1988,5399
500750,202105,1004,2509,700,1992,86,219,276,749,362,968
500755,202105,940,2390,532,1629,99,335,113,312,212,647
500769,202105,5269,12772,2995,8533,547,1679,437,1117,984,2796
500770,202105,1407,3773,936,2960,165,584,304,952,469,1536
500780,202105,1191,2833,772,2156,150,490,210,523,360,1013
500790,202105,6721,17807,5186,15229,1049,3323,2481,7306,3530,10629
500793,202105,2045,5141,1474,4174,350,1065,492,1271,842,2336
500795,202105,2698,6592,2162,5917,123,300,1699,4918,1822,5218
500797,202105,755,1898,487,1420,140,422,137,411,277,833
500800,202105,3345,7441,2065,5561,615,1983,257,755,872,2738
500830,202105,18236,44860,12604,34699,2617,7653,4483,11662,7100,19315
500840,202105,1422,3422,908,2450,128,340,368,936,496,1276
510010,202105,1824,4073,1244,3348,109,228,890,2435,999,2663
510020,202105,3964,9801,2090,6137,375,1202,538,1380,913,2582
510025,202105,6597,15723,4085,11754,573,1787,1821,5076,2394,6863
510030,202105,2852,6206,1906,4835,331,819,880,2174,1211,2993
510035,202105,1243,3221,799,2523,110,362,441,1500,551,1862
510040,202105,2428,5336,1806,4533,195,448,1118,2956,1313,3404
510050,202105,2176,4458,1462,3566,197,497,968,2347,1165,2844
510060,202105,1370,3391,867,2494,169,535,215,568,384,1103
510080,202105,1328,3384,876,2663,205,637,368,1061,573,1698
510100,202105,669,1532,479,1236,57,148,273,682,330,830
510120,202105,278,498,158,357,10,20,117,265,127,285
510125,202105,2008,4961,1577,4331,143,516,883,2280,1026,2796
510130,202105,1540,3814,1070,3070,216,660,355,1042,571,1702
510140,202105,3084,7769,2084,6518,763,2689,719,2243,1482,4932
510160,202105,1712,4393,1268,3822,150,424,924,2861,1074,3285
510170,202105,4707,12211,3502,10261,827,2507,1411,4150,2238,6657
510180,202105,14893,32899,9742,25571,2025,5832,3179,9291,5204,15123
510185,202105,1768,4510,1136,3610,449,1470,247,1047,696,2517
510190,202105,2039,5741,1303,4519,351,1347,234,886,585,2233
510250,202105,17443,43211,12933,36465,2438,7171,6350,18588,8788,25759
510260,202105,1825,7743,1521,7220,245,1264,945,4874,1190,6138
510263,202105,3191,8866,1980,6377,319,1114,387,1086,706,2200
510267,202105,5241,14691,2995,9682,492,1720,433,1217,925,2937
510268,202105,1232,3024,950,2593,108,281,610,1656,718,1937
510269,202105,1011,2704,620,1957,143,498,196,576,339,1074
510270,202105,3037,8460,2081,6775,339,1256,834,2701,1173,3957
510279,202105,1768,4517,1070,3305,176,598,419,1221,595,1819
510285,202105,1123,2920,755,2290,225,776,182,489,407,1265
510300,202105,3705,9224,2747,7946,401,1166,1607,4917,2008,6083
510305,202105,1419,3889,881,2850,173,592,204,754,377,1346
510310,202105,927,2254,635,1773,176,493,186,543,362,1036
510320,202105,3619,8811,2508,6971,527,1642,551,1499,1078,3141
510325,202105,4219,12328,3110,10295,871,3062,861,2942,1732,6004
510330,202105,2600,7772,1748,6279,306,1111,632,2662,938,3773
510335,202105,4903,13905,3717,12015,554,1896,2064,6823,2618,8719
510336,202105,442,1232,320,1046,48,153,167,611,215,764
510337,202105,1437,4102,918,3176,350,1334,188,658,538,1992
510340,202105,93412,205958,61076,159960,14276,43396,18985,47385,33261,90781
510343,202105,1106,2894,725,2211,117,404,323,930,440,1334
510345,202105,1266,3579,951,2947,146,445,426,1309,572,1754
510350,202105,2909,7333,1963,5762,402,1222,879,2567,1281,3789
510360,202105,2004,4015,1247,3135,72,117,865,2377,937,2494
510370,202105,1707,4784,1267,4079,176,620,739,2489,915,3109
510380,202105,557,1351,320,958,48,166,137,405,185,571
510385,202105,1209,4004,905,3445,84,373,599,2358,683,2731
510390,202105,1297,3320,866,2800,271,873,274,1075,545,1948
510395,202105,728,1601,497,1265,25,63,322,865,347,928
510410,202105,4757,12918,3491,10758,661,2096,1751,5682,2412,7778
510420,202105,2533,5180,1707,4092,109,255,1151,2774,1260,3029
510450,202105,412,1030,252,730,67,203,30,102,97,305
510452,202105,816,2269,605,1880,73,241,368,1118,441,1359
510454,202105,962,2618,746,2251,82,237,470,1494,552,1731
510455,202105,944,2543,682,2035,107,339,296,824,403,1163
510460,202105,1806,4478,1323,3758,124,400,825,2265,949,2665
510480,202105,4846,11396,3284,8642,584,1690,1311,3279,1895,4969
510490,202105,1692,4318,1261,3779,237,693,758,2308,995,3001
510500,202105,1548,3790,954,2861,186,606,306,918,492,1524
510510,202105,3559,10067,2597,8395,613,2232,852,2881,1465,5113
510515,202105,5205,13096,3456,10021,752,2474,1035,2643,1787,5117
510517,202105,1053,2968,791,2521,246,883,144,413,390,1296
510520,202105,2231,4460,1258,3247,103,274,599,1678,702,1952
510523,202105,1203,2862,878,2360,156,419,539,1472,695,1891
510525,202105,7475,20132,5541,16365,823,2614,2656,7436,3479,10050
510530,202105,557,1419,412,1206,29,94,271,782,300,876
510550,202105,2276,6672,1667,5629,344,1226,784,2664,1128,3890
510558,202105,2363,6224,1720,5227,226,637,800,2688,1026,3325
510560,202105,1503,4266,921,3128,174,649,222,820,396,1469
510562,202105,5735,14296,4207,11696,967,2901,1433,4261,2400,7162
510590,202105,2997,7423,2204,6382,150,433,1616,4813,1766,5246
510600,202105,1395,3111,940,2461,154,399,466,1200,620,1599
510610,202105,2551,6092,1736,5044,189,609,1084,3150,1273,3759
510615,202105,2676,6549,1880,5296,282,854,1074,3060,1356,3914
510617,202105,1010,3045,792,2700,81,319,549,1924,630,2243
510618,202105,1201,3148,856,2582,192,636,385,1120,577,1756
510619,202105,794,1973,482,1425,69,198,100,268,169,466
510620,202105,1449,3239,678,1985,166,586,33,68,199,654
510621,202105,1565,4141,941,2948,207,722,272,752,479,1474
510622,202105,4757,13041,3262,9941,1027,3423,443,1244,1470,4667
510623,202105,2714,6693,1980,5541,464,1453,659,1831,1123,3284
510624,202105,1614,4104,798,2590,97,360,179,512,276,872
510625,202105,3054,7332,1689,4934,282,932,391,1166,673,2098
510626,202105,1427,3473,904,2649,231,776,204,621,435,1397
510627,202105,629,1603,347,1066,81,279,90,287,171,566
510628,202105,1457,3321,973,2697,216,634,361,991,577,1625
510629,202105,1587,4446,1144,3643,217,746,397,1274,614,2020
510630,202105,3431,9332,2028,6684,456,1609,369,1351,825,2960
510631,202105,576,1364,419,1133,14,32,316,884,330,916
510637,202105,3734,8695,2641,7109,635,1895,795,2165,1430,4060
510642,202105,5383,15107,4108,13206,931,3322,1889,6099,2820,9421
510645,202105,1019,1964,624,1478,188,404,255,645,443,1049
510650,202105,7133,17938,5644,16299,647,1666,3786,12274,4433,13940
510665,202105,1838,3941,1170,2895,256,594,419,1138,675,1732
510670,202105,430,908,246,645,31,84,129,345,160,429
510675,202105,6280,17039,4346,13501,1193,4091,844,2497,2037,6588
510677,202105,2152,5420,1481,4435,202,706,810,2369,1012,3075
510680,202105,693,1743,393,1187,69,235,99,247,168,482
510682,202105,1483,4247,1090,3614,373,1401,271,830,644,2231
510685,202105,477,1363,342,1096,51,169,179,572,230,741
510700,202105,4028,9477,2820,7837,249,754,2118,5881,2367,6635
510704,202105,10884,25358,7295,19329,1701,4809,1804,4667,3505,9476
510706,202105,2102,6169,1463,5110,293,1052,752,2840,1045,3892
510710,202105,2669,6537,1759,4840,381,1106,579,1525,960,2631
510715,202105,593,1259,426,1037,27,69,235,565,262,634
510718,202105,2348,5311,1398,4037,344,984,541,1881,885,2865
510719,202105,455,952,270,708,26,75,159,393,185,468
510720,202105,832,1945,564,1546,106,325,259,679,365,1004
510724,202105,827,2220,569,1733,78,248,298,874,376,1122
510726,202105,1063,1934,576,1343,70,170,284,669,354,839
510729,202105,613,1415,286,816,34,111,73,224,107,335
510730,202105,2949,7016,2015,5607,238,772,1063,2842,1301,3614
510735,202105,1076,2975,822,2627,65,242,623,1977,688,2219
510740,202105,983,2411,637,1779,105,296,310,847,415,1143
510757,202105,479,1527,378,1372,111,454,146,493,257,947
510760,202105,43991,95365,26622,69186,5360,16002,8436,20111,13796,36113
510770,202105,4245,9486,2909,7802,192,475,2034,5693,2226,6168
510774,202105,342,850,240,695,35,105,124,371,159,476
510775,202105,623,1621,392,1246,92,322,76,221,168,543
510776,202105,521,1287,369,1024,73,211,148,404,221,615
510777,202105,1536,4039,1105,3485,133,438,743,2345,876,2783
510779,202105,711,1869,554,1626,56,156,329,1039,385,1195
510780,202105,3767,9561,2794,8167,678,1922,1200,3995,1878,5917
510785,202105,1965,5064,1153,3628,313,1059,185,677,498,1736
510787,202105,2659,7481,1798,5739,518,1719,215,713,733,2432
510788,202105,589,1366,408,1095,63,172,191,590,254,762
510790,202105,18281,46042,11714,34396,2721,8884,1910,5079,4631,13963
510792,202105,9289,25336,5846,18698,1188,4244,977,2852,2165,7096
510794,202105,1171,3131,828,2555,281,940,151,414,432,1354
510795,202105,8604,22086,5740,17021,1244,4076,1563,4532,2807,8608
510800,202105,1633,4119,1071,3197,320,973,136,386,456,1359
510805,202105,1510,4135,1077,3359,222,758,417,1207,639,1965
510810,202105,602,1211,380,915,105,251,143,372,248,623
510820,202105,776,1444,438,1027,29,83,235,557,264,640
510830,202105,878,2060,663,1792,29,61,518,1479,547,1540
510835,202105,559,1334,375,1075,44,145,232,645,276,790
510840,202105,57940,120923,39683,98778,7682,17980,19524,53446,27206,71426
510850,202105,1779,4228,1062,3116,314,1072,175,448,489,1520
510860,202105,2340,6026,1462,4569,450,1685,124,383,574,2068
510880,202105,743,2063,564,1738,135,449,196,597,331,1046
510885,202105,653,1529,426,1201,80,229,135,390,215,619
510890,202105,705,2012,529,1705,129,455,231,734,360,1189
510895,202105,1301,3281,853,2545,151,541,380,1065,531,1606
520005,202105,2885,7226,2229,6410,651,1884,867,2947,1518,4831
520010,202105,2381,6609,1726,5352,398,1371,577,1608,975,2979
520013,202105,3072,7606,2021,5725,467,1338,569,1774,1036,3112
520015,202105,513,1257,374,1058,86,237,152,457,238,694
520017,202105,1218,3007,896,2522,222,649,385,1059,607,1708
520020,202105,429,951,330,835,25,78,265,654,290,732
520025,202105,33477,92057,28646,85378,2883,9063,20504,61083,23387,70146
520030,202105,5703,14144,4596,12627,290,857,3359,9179,3649,10036
520050,202105,402,939,241,651,17,45,153,430,170,475
520055,202105,1852,4383,1214,3185,148,318,661,1747,809,2065
520060,202105,1453,3831,1081,3180,247,851,300,852,547,1703
520080,202105,1793,4645,1369,4065,244,737,668,2173,912,2910
520082,202105,939,2342,724,1993,73,207,386,1094,459,1301
520085,202105,896,2279,699,1974,127,381,344,964,471,1345
520090,202105,871,1708,607,1420,77,129,439,1093,516,1222
520110,202105,37427,99274,26014,80419,7433,26302,2508,7075,9941,33377
520120,202105,201,482,116,341,11,34,48,144,59,178
520130,202105,3858,9189,3024,7908,612,1647,1308,3489,1920,5136
520140,202105,40618,106418,28082,85290,9719,32159,3533,11240,13252,43399
520145,202105,603,1349,414,1097,70,206,239,583,309,789
520150,202105,641,1468,475,1268,72,203,250,672,322,875
520160,202105,766,1751,551,1415,107,265,217,610,324,875
520170,202105,4810,9661,3198,7831,176,505,2462,5990,2638,6495
520180,202105,2376,6301,1942,5675,329,1056,1052,3021,1381,4077
520215,202105,1728,4099,1232,3350,285,814,438,1143,723,1957
520235,202105,683,1523,430,1150,41,125,218,568,259,693
520250,202105,1531,3827,1092,3116,324,996,263,848,587,1844
520260,202105,827,1882,532,1430,98,254,208,572,306,826
520280,202105,773,1817,614,1582,114,290,304,845,418,1135
520310,202105,1004,2145,657,1636,142,397,254,669,396,1066
520320,202105,1703,4500,1289,3823,162,481,738,2195,900,2676
520330,202105,4432,11492,3301,9666,466,1577,1718,4889,2184,6466
520340,202105,2518,5436,1564,4132,177,431,920,2547,1097,2978
520350,202105,2746,6472,1966,5333,551,1589,789,2172,1340,3761
520355,202105,1900,5118,1361,4070,452,1439,212,536,664,1975
520357,202105,742,1747,541,1455,36,80,392,1101,428,1181
520360,202105,692,1792,535,1536,139,422,163,488,302,910
520380,202105,1431,3525,868,2509,110,323,390,1060,500,1383
520390,202105,1046,2286,621,1750,184,567,195,589,379,1156
520393,202105,509,1191,340,930,44,131,149,390,193,521
520396,202105,873,2189,731,1977,37,112,544,1449,581,1561
520400,202105,1604,3869,1238,3379,136,415,866,2344,1002,2759
520410,202105,2071,4477,1351,3404,177,487,692,1633,869,2120
520420,202105,379,862,300,742,21,54,240,568,261,622
520425,202105,1508,3646,827,2349,222,679,147,412,369,1091
520430,202105,2323,5219,1336,3707,234,772,52,142,286,914
520440,202105,2879,6877,1739,4893,407,1258,441,1175,848,2433
520450,202105,11879,27688,8057,22061,2461,7479,1748,4959,4209,12438
520455,202105,702,1919,510,1624,141,461,138,477,279,938
520460,202105,1045,2382,817,2094,77,170,646,1696,723,1866
520465,202105,784,1966,642,1779,65,220,483,1296,548,1516
520470,202105,2080,5223,1585,4570,465,1417,604,1874,1069,3291
520480,202105,888,2410,624,1973,189,624,158,488,347,1112
520485,202105,1532,4358,1276,4009,151,474,905,2848,1056,3322
520490,202105,4016,10843,3017,9264,913,2956,1208,3804,2121,6760
520495,202105,1595,3465,1216,2953,64,157,969,2361,1033,2518
520500,202105,1289,3362,899,2635,185,581,407,1186,592,1767
520505,202105,780,1693,541,1396,62,162,357,923,419,1085
520510,202105,7366,18063,4984,14463,1047,3416,1570,4762,2617,8178
520520,202105,1184,2904,886,2450,198,598,339,929,537,1527
520530,202105,2130,5841,1639,5025,376,1241,768,2417,1144,3658
520540,202105,2948,7589,1936,5652,345,1097,546,1486,891,2583
520545,202105,997,2539,770,2168,168,440,336,985,504,1425
520547,202105,862,2288,702,2033,148,441,356,1015,504,1456
520549,202105,14101,36665,11787,33449,1413,4201,8181,23038,9594,27239
520551,202105,4579,12085,3803,10944,396,1301,2707,7646,3103,8947
520552,202105,826,2099,678,1909,144,381,374,1143,518,1524
520570,202105,519,1164,347,906,81,174,123,371,204,545
520580,202105,2194,4933,1662,4310,136,382,1194,3073,1330,3455
520590,202105,1248,3058,862,2433,252,729,251,713,503,1442
520620,202105,7886,21016,6256,18634,1445,4479,2985,9154,4430,13633
520630,202105,739,1870,533,1515,73,222,218,594,291,816
520640,202105,2394,5778,1823,4804,413,1072,789,2163,1202,3235
520650,202105,996,2180,707,1777,116,297,370,987,486,1284
520660,202105,544,1314,295,871,44,145,85,262,129,407
520670,202105,939,2509,790,2300,61,187,535,1532,596,1719
520680,202105,682,1709,521,1455,81,229,276,790,357,1019
520690,202105,300,692,207,556,63,159,62,185,125,344
520710,202105,398,977,289,797,18,47,194,521,212,568
520725,202105,1465,3429,1010,2686,108,337,645,1663,753,2000
520735,202105,763,1860,501,1424,103,273,200,611,303,884
520740,202105,2278,4943,1739,4326,332,745,961,2665,1293,3410
520750,202105,672,1592,468,1269,78,218,216,571,294,789
520753,202105,1233,3330,936,2767,160,498,373,1032,533,1530
520760,202105,1212,2706,1066,2529,30,54,974,2348,1004,2402
520780,202105,1500,3467,1077,2884,117,297,559,1507,676,1804
520790,202105,3494,8195,2462,6538,357,968,1296,3593,1653,4561
520800,202105,16424,41816,12887,36651,1762,5163,7804,22779,9566,27942
520810,202105,1300,2708,986,2351,145,344,647,1649,792,1993
520815,202105,542,1644,414,1376,78,265,118,401,196,666
520830,202105,1890,3939,1342,3315,71,148,1088,2677,1159,2825
520840,202105,2679,7071,2185,6424,846,2751,593,1846,1439,4597
520850,202105,668,1640,494,1387,145,480,155,438,300,918
520860,202105,6816,18014,5026,15085,1285,4188,1883,5502,3168,9690
520870,202105,110553,253555,75391,201155,15579,44835,27977,73164,43556,117999
520880,202105,6912,19583,5340,16758,1138,3749,1994,6254,3132,10003
520890,202105,4091,9562,2838,7629,485,1452,1323,3459,1808,4911
520910,202105,4647,11500,2989,8680,682,2168,733,2057,1415,4225
520915,202105,717,1977,432,1346,84,273,139,412,223,685
520920,202105,4494,9901,3185,8293,430,1144,1632,4510,2062,5654
520929,202105,683,1601,525,1380,52,114,299,838,351,952
520940,202105,951,2479,746,2192,49,108,567,1669,616,1777
520945,202105,520,1113,381,933,14,34,260,626,274,660
520960,202105,1086,2531,852,2189,250,584,382,1055,632,1639
520970,202105,2536,6786,1992,5927,418,1429,537,1721,955,3150
520980,202105,774,1868,569,1591,100,288,236,645,336,933
520990,202105,3012,7850,2418,7098,335,931,1618,4837,1953,5768
520993,202105,1145,2655,792,2112,136,402,422,1081,558,1483
520995,202105,2341,5857,1756,5031,263,773,706,2111,969,2884
521000,202105,8729,22564,5762,17163,1077,3301,1695,4979,2772,8280
521010,202105,3570,9193,2675,7646,258,739,1566,4454,1824,5193
521015,202105,783,1931,548,1517,40,135,346,910,386,1045
521020,202105,3396,8499,2017,5862,555,1808,170,528,725,2336
521030,202105,510,1115,348,871,62,137,162,437,224,574
521040,202105,7448,18003,5492,14955,1184,3353,2221,6264,3405,9617
521056,202105,927,2397,722,2099,237,669,195,646,432,1315
521060,202105,974,2589,716,2097,137,416,269,780,406,1196
521080,202105,1109,2361,575,1539,85,251,248,584,333,835
521090,202105,3149,8325,2112,6273,524,1700,256,793,780,2493
521100,202105,1759,4024,1308,3387,224,556,799,2111,1023,2667
521120,202105,4605,10879,3415,9398,182,469,1683,5417,1865,5886
521130,202105,1003,2211,573,1491,18,49,295,818,313,867
521140,202105,1357,3441,1010,2829,99,283,546,1527,645,1810
521150,202105,12316,26715,7733,20212,1311,3921,3622,9742,4933,13663
521160,202105,641,1309,457,1053,76,145,280,647,356,792
521170,202105,1040,2414,768,2011,61,172,495,1256,556,1428
521180,202105,7492,20218,6172,17982,1006,3140,3227,9170,4233,12310
521190,202105,10846,26471,6438,19240,1579,5032,1311,4169,2890,9201
521200,202105,704,1664,499,1343,44,124,316,846,360,970
521205,202105,639,1545,488,1305,18,51,380,978,398,1029
521210,202105,666,1698,395,1164,70,217,91,214,161,431
521220,202105,3550,8441,2334,6586,365,1140,990,2800,1355,3940
521225,202105,390,814,282,693,60,140,158,400,218,540
521230,202105,1344,3350,1182,3156,352,941,597,1731,949,2672
521250,202105,31044,80683,24290,70897,8655,26123,7209,22819,15864,48942
521260,202105,535,1232,397,1020,62,162,228,574,290,736
521270,202105,1799,4434,1572,4170,80,184,1225,3272,1305,3456
521280,202105,1769,4701,1322,3953,303,984,562,1697,865,2681
521290,202105,494,1126,348,944,42,129,223,588,265,717
521295,202105,1106,2405,869,2153,65,110,731,1872,796,1982
521300,202105,1907,4617,1501,4046,286,718,904,2549,1190,3267
521305,202105,723,1669,521,1384,83,203,300,815,383,1018
521308,202105,4769,12510,3319,9819,292,857,1972,5724,2264,6581
521310,202105,8400,21234,5992,17221,1165,3696,2680,7359,3845,11055
521340,202105,410,947,298,785,23,62,200,523,223,585
521350,202105,2031,5058,1553,4353,132,426,1113,3023,1245,3449
521370,202105,1220,3061,738,2248,212,742,91,313,303,1055
521375,202105,1262,3045,862,2456,190,547,264,858,454,1405
521377,202105,1530,3191,1135,2713,118,191,889,2264,1007,2455
521380,202105,6234,16231,4054,12271,435,1420,1062,3457,1497,4877
521385,202105,659,1565,519,1389,49,124,299,860,348,984
521390,202105,714,1731,499,1415,145,463,167,503,312,966
521400,202105,2716,6187,2155,5520,232,557,1496,3951,1728,4508
521405,202105,1337,3384,968,2742,151,448,508,1419,659,1867
521410,202105,773,2059,576,1719,94,270,287,908,381,1178
521440,202105,1109,2721,798,2261,264,832,222,637,486,1469
521450,202105,3924,11437,2860,9378,761,2464,647,2353,1408,4817
521460,202105,5557,14246,3921,11387,1181,3584,1050,3108,2231,6692
521470,202105,680,1764,432,1288,62,173,167,500,229,673
521480,202105,378,937,233,673,54,144,74,216,128,360
521483,202105,2355,5514,1643,4461,328,937,702,1907,1030,2844
521486,202105,1794,4270,1366,3674,92,222,968,2631,1060,2853
521487,202105,401,950,283,791,42,112,156,451,198,563
521490,202105,917,2387,690,2016,37,131,481,1362,518,1493
521500,202105,2222,5343,1670,4529,100,327,1206,3184,1306,3511
521520,202105,715,1645,512,1355,78,205,215,581,293,786
521523,202105,12021,35771,9863,32377,2665,9520,2742,9238,5407,18758
521525,202105,1066,2398,815,2060,72,190,583,1467,655,1657
521530,202105,2286,5804,1404,4071,296,860,385,1117,681,1977
521540,202105,824,2043,572,1648,78,247,273,822,351,1069
521550,202105,1613,4047,900,2624,167,550,216,645,383,1195
521560,202105,4442,11378,3035,9489,516,1741,1472,4995,1988,6736
521565,202105,657,1547,496,1317,71,174,300,798,371,972
521570,202105,3332,9089,2292,7071,455,1662,160,526,615,2188
521580,202105,495,1185,295,849,42,130,100,266,142,396
521590,202105,638,1466,471,1237,75,211,287,739,362,950
521600,202105,425,1111,278,829,30,74,127,383,157,457
521630,202105,1675,3606,1045,2710,216,599,348,875,564,1474
521640,202105,1974,4491,1290,3499,245,699,462,1248,707,1947
521645,202105,561,1418,366,1074,78,209,115,338,193,547
521680,202105,1074,3225,827,2755,232,849,144,522,376,1371
521690,202105,549,1303,457,1188,61,172,288,739,349,911
521710,202105,3235,7878,2113,6076,364,1188,608,1609,972,2797
521720,202105,2210,4982,1443,3848,193,544,782,2103,975,2647
521730,202105,3600,9791,2784,8423,738,2632,831,2102,1569,4734
521740,202105,3901,9940,2966,8617,677,2127,1096,3345,1773,5472
521760,202105,15067,40130,11709,35086,2731,8965,4500,14381,7231,23346
521770,202105,3101,7223,2032,5551,569,1699,530,1494,1099,3193
521800,202105,6591,17218,4807,14324,1049,3174,2001,6489,3050,9663
521805,202105,689,1515,493,1257,138,326,211,587,349,913
521810,202105,640,1493,461,1252,69,182,275,766,344,948
521830,202105,5507,15014,4382,13303,263,977,3218,9566,3481,10543
521839,202105,800,1883,578,1514,85,262,341,811,426,1073
521850,202105,5638,12860,3590,9874,751,2242,646,1781,1397,4023
521860,202105,1521,4018,1057,3187,178,580,354,1022,532,1602
521870,202105,686,1892,497,1533,98,347,129,349,227,696
521878,202105,693,1756,492,1363,56,178,280,707,336,885
521880,202105,18581,44912,12717,35828,3318,9795,4400,12556,7718,22351
521890,202105,3104,7962,2075,6168,555,1813,428,1148,983,2961
521900,202105,1476,3411,824,2394,248,704,71,208,319,912
521910,202105,1310,2725,886,2228,93,224,494,1345,587,1569
521920,202105,494,1318,361,1091,57,199,169,488,226,687
521925,202105,765,1940,553,1620,83,266,306,891,389,1157
521930,202105,5466,12899,3617,10142,951,2514,1334,4239,2285,6753
521935,202105,1065,2498,723,1917,68,189,414,1048,482,1237
521940,202105,1322,2815,843,2172,184,534,355,893,539,1427
521945,202105,652,1709,518,1481,98,289,278,821,376,1110
521950,202105,766,1833,533,1472,120,346,229,618,349,964
521960,202105,740,1882,497,1431,48,158,275,741,323,899
521970,202105,2536,6149,2009,5521,170,444,1532,4291,1702,4735
521971,202105,749,1758,529,1421,148,371,133,371,281,742
521973,202105,1482,3749,1219,3395,51,110,994,2780,1045,2890
521975,202105,11986,31110,9838,28153,1682,4869,6059,17479,7741,22348
521980,202105,2546,5889,1964,5127,149,379,1488,3984,1637,4363
521990,202105,1068,2969,862,2608,185,595,337,1006,522,1601
522000,202105,2711,6949,2148,6261,384,1142,1221,3750,1605,4892
522005,202105,317,759,235,635,47,136,111,295,158,431
522010,202105,4107,9862,2938,7995,578,1709,1177,3115,1755,4824
522015,202105,1044,2673,766,2241,242,671,282,876,524,1547
522020,202105,5570,12955,3623,9929,757,2217,1366,3925,2123,6142
522026,202105,771,2035,522,1596,93,310,179,502,272,812
522028,202105,432,1059,315,867,68,190,122,334,190,524
522040,202105,3294,7217,2376,6001,260,732,1656,4096,1916,4828
522045,202105,17424,47476,12970,39719,2992,9846,3636,10881,6628,20727
522050,202105,1170,2980,815,2364,179,570,309,811,488,1381
522060,202105,2982,7678,2092,6225,203,600,1183,3643,1386,4243
522068,202105,1794,4493,1434,4067,109,270,1144,3297,1253,3567
522070,202105,684,1611,560,1433,11,31,487,1224,498,1255
522100,202105,728,1828,498,1478,70,228,256,726,326,954
522108,202105,1084,2586,852,2256,54,141,688,1788,742,1929
522119,202105,1691,3992,1321,3516,187,510,745,2084,932,2594
522130,202105,426,1068,303,900,26,73,213,656,239,729
522140,202105,19808,50813,13942,40506,3399,10555,3974,11023,7373,21578
522145,202105,780,1908,535,1542,143,408,203,593,346,1001
522150,202105,1088,2616,772,2104,204,566,224,636,428,1202
522155,202105,1100,2730,855,2359,165,386,487,1415,652,1801
522157,202105,644,1446,528,1305,25,67,424,1068,449,1135
522160,202105,5876,14971,3828,11254,1026,3245,319,1040,1345,4285
522170,202105,2573,6501,1940,5581,288,838,1108,3250,1396,4088
522180,202105,559,1297,354,918,59,160,88,244,147,404
522185,202105,20172,48743,14328,40762,5407,16919,3051,9342,8458,26261
522190,202105,753,1769,516,1368,104,271,198,521,302,792
522200,202105,1626,4525,1098,3548,224,787,215,661,439,1448
522205,202105,1725,3987,1297,3400,148,400,789,2068,937,2468
522220,202105,1312,3144,969,2638,112,298,592,1653,704,1951
522230,202105,1211,2979,969,2646,189,614,505,1325,694,1939
530010,202105,174139,462156,141622,414959,20206,64634,86033,247828,106239,312462
110001,202104,4003,11029,2694,8599,602,2074,1010,3293,1612,5367
110002,202104,13244,33846,9699,27917,2630,8043,2642,7751,5272,15794
110003,202104,596,1760,447,1451,117,392,124,379,241,771
110004,202104,12038,30686,8124,23910,1649,5244,2432,7228,4081,12472
110005,202104,2519,6430,1755,5201,345,1099,474,1533,819,2632
110006,202104,1743,4822,1091,3448,181,644,227,693,408,1337
110007,202104,1279,3235,818,2463,249,804,201,741,450,1545
110008,202104,3419,9129,2543,7842,288,846,1660,5513,1948,6359
110009,202104,4366,12059,2844,9327,585,2051,1135,3758,1720,5809
110010,202104,7973,24625,5868,20588,1128,3999,2891,11050,4019,15049
110011,202104,7177,18797,4846,14596,1596,5103,650,2054,2246,7157
110012,202104,15691,38924,9425,28013,2036,6667,811,2604,2847,9271
110013,202104,5276,15052,3703,11881,1442,4927,432,1549,1874,6476
110014,202104,3961,10250,2744,7971,531,1647,1218,3432,1749,5079
110015,202104,5796,14685,3522,10372,731,2372,892,2390,1623,4762
110018,202104,3799,9482,2208,6699,389,1374,575,1754,964,3128
110020,202104,74997,177102,54455,149327,12122,34356,22047,67100,34169,101456
110025,202104,5307,12640,3591,9733,651,1895,1663,4482,2314,6377
110026,202104,531,1320,380,1103,87,294,152,466,239,760
110028,202104,7090,17675,4339,12786,1005,3276,607,1795,1612,5071
110029,202104,1555,3758,911,2631,189,557,339,1027,528,1584
110030,202104,12833,29120,7922,21906,1657,5285,1312,4061,2969,9346
110032,202104,3285,9102,1994,6373,640,2036,367,1306,1007,3342
110033,202104,3531,10800,2679,9271,951,3302,688,2687,1639,5989
110034,202104,3333,7728,2217,6201,675,2146,717,2190,1392,4336
110037,202104,1667,4857,1247,4116,293,952,572,1963,865,2915
110040,202104,2941,8043,2134,6578,569,1916,696,2083,1265,3999
110045,202104,4911,13943,3609,11559,913,3142,1200,3997,2113,7139
110050,202104,1836,4927,1295,3986,482,1670,209,643,691,2313
110060,202104,887,2612,608,1956,183,632,99,319,282,951
110070,202104,1513,4684,1111,3805,336,1226,229,720,565,1946
110080,202104,6401,14697,4833,12841,709,1739,3126,8910,3835,10649
110090,202104,595,1575,411,1247,88,291,176,532,264,823
110092,202104,1243,3546,874,2844,152,507,426,1507,578,2014
110094,202104,2818,8311,2101,6916,848,2994,236,814,1084,3808
110100,202104,1677,4906,1343,4261,361,1218,549,1784,910,3002
110110,202104,1760,4732,1261,3933,440,1417,249,886,689,2303
110120,202104,1332,3783,1019,3174,224,765,363,1110,587,1875
110130,202104,2855,7060,1695,4866,128,383,202,510,330,893
110140,202104,2071,6022,1423,4702,321,1112,440,1499,761,2611
110143,202104,1363,3702,967,2925,284,859,168,517,452,1376
110145,202104,891,2302,552,1677,115,352,222,702,337,1054
110146,202104,483,1224,344,1013,72,183,166,534,238,717
110147,202104,759,1965,487,1444,60,202,188,482,248,684
110148,202104,758,2073,451,1466,122,465,61,186,183,651
110149,202104,3116,8329,2150,6784,718,2399,465,1570,1183,3969
110150,202104,2822,6820,1825,5389,519,1707,448,1586,967,3293
110155,202104,741,2155,522,1634,119,400,171,496,290,896
110160,202104,1480,4497,1083,3621,297,1020,263,917,560,1937
110170,202104,2148,5438,1352,3968,232,721,713,2022,945,2743
110175,202104,1851,5193,1278,4055,192,627,508,1698,700,2325
110180,202104,1473,3952,1042,3095,138,451,558,1620,696,2071
120001,202104,3328,9643,2725,8753,446,1509,1701,5590,2147,7099
120005,202104,1964,7383,1789,7139,148,648,1442,5845,1590,6493
120010,202104,5423,15840,4603,14638,414,1237,3413,11209,3827,12446
120013,202104,2120,7265,1863,6956,373,1318,1213,4840,1586,6158
120017,202104,2548,7979,2230,7502,375,1261,1381,4946,1756,6207
120020,202104,15446,57910,14236,55617,984,4281,11478,45140,12462,49421
120025,202104,3194,8800,2567,8054,336,1037,1826,5924,2162,6961
120030,202104,6423,25258,5954,24389,410,2021,4614,19143,5024,21164
120032,202104,1786,7700,1704,7554,93,582,1451,6308,1544,6890
120033,202104,4202,15247,3954,14809,105,622,3484,12871,3589,13493
120034,202104,2742,9782,2353,9113,97,561,1970,7529,2067,8090
120035,202104,3816,14657,3618,14315,271,1282,3004,11867,3275,13149
120038,202104,2714,8555,2299,7883,502,1770,1253,4395,1755,6165
120039,202104,2036,8686,1909,8443,109,683,1550,6813,1659,7496
120040,202104,44715,137512,38130,126985,5019,17624,24211,81692,29230,99316
120042,202104,3423,12381,3184,11947,116,622,2734,10154,2850,10776
120043,202104,1456,5838,1329,5642,33,204,1224,5196,1257,5400
120045,202104,6126,15608,5304,14690,125,499,4812,13176,4937,13675
120050,202104,9404,33609,8628,32430,360,1853,7284,27470,7644,29323
120060,202104,9552,37210,8742,36030,349,2163,7641,31248,7990,33411
120070,202104,3254,10187,2819,9606,256,842,2050,7246,2306,8088
120080,202104,4390,13676,3918,12981,455,1543,2905,9842,3360,11385
130002,202104,3211,12059,2868,11550,176,645,2491,10245,2667,10890
130006,202104,2520,9086,2100,8350,172,654,1610,6476,1782,7130
130008,202104,2745,9489,2439,9049,63,311,2132,7918,2195,8229
130010,202104,4011,11547,3375,10831,78,207,3087,10084,3165,10291
130014,202104,3377,9636,2615,8433,434,1418,1612,5310,2046,6728
130020,202104,2950,11184,2633,10697,105,620,2214,8955,2319,9575
130030,202104,10669,33311,9735,32231,346,909,8724,29505,9070,30414
130040,202104,4253,12155,3509,11170,261,717,2832,9236,3093,9953
130050,202104,7623,27694,6376,26070,171,798,5768,23898,5939,24696
130060,202104,7861,30271,6753,28855,402,2090,5670,24248,6072,26338
130063,202104,6558,21101,5861,20338,192,814,5357,18692,5549,19506
130068,202104,3982,13395,3371,12546,187,1027,2602,9567,2789,10594
130070,202104,7776,21301,6400,19807,302,791,5291,17027,5593,17818
130080,202104,7469,26124,6561,25088,241,1239,5649,21996,5890,23235
130083,202104,2810,9023,2499,8643,134,534,2119,7425,2253,7959
130090,202104,3599,11009,3201,10526,46,194,2872,9641,2918,9835
130100,202104,8183,24297,6940,23012,81,153,6537,22272,6618,22425
130110,202104,8588,24276,7051,22388,1050,2658,5049,17415,6099,20073
130115,202104,5244,16300,4513,15478,100,347,4014,13977,4114,14324
130120,202104,14169,49725,12470,47487,1054,4385,10132,39049,11186,43434
130130,202104,5678,17350,4378,15659,401,1460,3291,11974,3692,13434
130140,202104,7395,25467,6490,24433,186,1031,5697,21568,5883,22599
130150,202104,3687,13689,3466,13444,66,423,3204,12456,3270,12879
130160,202104,5329,18454,4590,17518,288,1047,3893,15301,4181,16348
130165,202104,3303,12243,3101,12001,120,509,2809,10975,2929,11484
130170,202104,11769,33873,9524,31270,698,2466,7693,25800,8391,28266
130180,202104,4531,14555,4303,14300,40,187,4155,13799,4195,13986
130185,202104,18798,45749,15383,42103,1074,1853,12797,37420,13871,39273
130190,202104,19059,62154,15354,56709,1593,5868,11041,42329,12634,48197
130195,202104,2506,8940,2009,8269,74,404,1696,6962,1770,7366
130200,202104,2698,7352,2198,6714,89,349,1872,5692,1961,6041
130210,202104,1371,5108,1242,4957,97,567,1020,3949,1117,4516
130220,202104,2256,7715,1921,7290,44,249,1716,6528,1760,6777
130230,202104,4960,19522,4322,18627,199,1221,3786,16274,3985,17495
130240,202104,12638,37257,10302,34201,150,851,9337,31043,9487,31894
130250,202104,26743,78606,22958,74353,1566,4466,18691,62964,20257,67430
130255,202104,4706,15208,4105,14165,130,544,3376,11681,3506,12225
130260,202104,260593,713873,212151,645728,57417,184488,96600,307342,154017,491830
130270,202104,9907,34387,8230,31790,1383,5228,5270,21401,6653,26629
130280,202104,3596,14270,3310,13955,76,389,3105,13231,3181,13620
130290,202104,13575,44105,11817,41887,633,2280,10052,36446,10685,38726
130300,202104,4931,16579,4473,15966,137,734,3936,14030,4073,14764
130310,202104,6542,21266,5678,20171,262,1135,4890,17393,5152,18528
130320,202104,3455,11191,2872,10424,372,1310,2110,7942,2482,9252
130330,202104,4707,14872,3797,13782,207,900,3245,11816,3452,12716
130340,202104,24367,73309,20999,69507,1450,3895,17689,60658,19139,64553
130350,202104,4066,14450,3667,13949,148,741,3235,12277,3383,13018
130353,202104,7564,20064,6066,18191,772,2181,4364,13634,5136,15815
130356,202104,5379,16759,4459,15345,791,2623,2689,9890,3480,12513
130360,202104,3005,9839,2613,9295,83,358,2327,8260,2410,8618
130370,202104,5772,22785,5019,21731,320,1730,4009,17390,4329,19120
130380,202104,7408,30573,6890,29833,390,2155,5880,25289,6270,27444
130390,202104,5902,24474,5246,23395,555,2715,4021,18090,4576,20805
130395,202104,2419,7558,2094,7050,186,631,1645,5593,1831,6224
130400,202104,2849,8607,2444,8078,94,256,2194,7409,2288,7665
130406,202104,11089,37816,9275,35623,1745,6599,6146,24793,7891,31392
130410,202104,4427,15326,3789,14272,1088,4284,1742,6785,2830,11069
130420,202104,13977,47864,11630,44939,960,4441,9041,35333,10001,39774
130423,202104,4475,13724,3919,13091,175,714,3462,11493,3637,12207
130426,202104,2778,11010,2586,10786,62,339,2397,10071,2459,10410
130430,202104,4396,12134,3797,11346,213,726,3278,9724,3491,10450
130440,202104,5013,15427,4253,14519,76,342,3957,13582,4033,13924
140002,202104,2307,6671,2011,6315,100,359,1680,5376,1780,5735
140005,202104,3311,9171,2882,8674,138,362,2456,7622,2594,7984
140010,202104,55667,146863,44707,130748,10971,33951,18901,56764,29872,90715
140015,202104,3904,11393,3324,10688,224,683,2893,9504,3117,10187
140017,202104,4429,12156,3844,11413,256,672,3166,9721,3422,10393
140020,202104,5335,15250,4613,14316,247,960,3804,11748,4051,12708
140023,202104,2511,7420,2062,6776,202,653,1566,5293,1768,5946
140028,202104,2008,5145,1702,4762,79,249,1378,3861,1457,4110
140030,202104,5461,13670,4858,12979,327,614,4276,11806,4603,12420
140040,202104,2689,10232,2490,9972,82,505,2291,9038,2373,9543
140045,202104,2634,9611,2191,8999,368,1284,1421,6409,1789,7693
140047,202104,6382,17880,5352,16416,563,1749,3886,12113,4449,13862
140050,202104,1461,4233,1238,3919,117,339,938,3087,1055,3426
140060,202104,1749,4485,1524,4168,111,282,1253,3498,1364,3780
140070,202104,1920,9901,1857,9778,110,784,1583,8237,1693,9021
150010,202104,45615,113751,41200,108092,986,2190,36956,97130,37942,99320
150013,202104,2025,5048,1694,4690,147,267,1346,3986,1493,4253
150020,202104,14574,43232,13469,41805,1834,4721,10495,34108,12329,38829
150030,202104,8884,33065,8076,32082,495,1979,6987,28143,7482,30122
150034,202104,4370,10397,3588,9445,240,535,2990,8074,3230,8609
150040,202104,16388,42314,14444,40162,1269,1903,12111,36642,13380,38545
150050,202104,7133,24325,6527,23534,127,542,6020,21932,6147,22474
150060,202104,22361,59833,18014,53418,2703,8150,11700,35494,14403,43644
150070,202104,7055,25664,6204,24642,244,1074,5549,22292,5793,23366
150080,202104,93371,208064,77277,186137,19637,51925,20104,59820,39741,111745
150085,202104,8113,22870,7390,22022,111,342,6938,20847,7049,21189
150090,202104,10159,36261,9588,35167,786,2704,7719,28743,8505,31447
150095,202104,5852,16457,5134,15573,283,555,4419,13978,4702,14533
150100,202104,2881,9934,2541,9376,211,657,2007,7642,2218,8299
150110,202104,4429,17872,4115,17519,170,762,3800,16311,3970,17073
150120,202104,8238,25309,7816,24821,273,680,6967,22777,7240,23457
150125,202104,794,2018,584,1735,99,356,354,1036,453,1392
150130,202104,22774,64668,19657,59975,3761,10268,12111,39876,15872,50144
150140,202104,269644,607181,227728,550239,34136,78543,131333,330448,165469,408991
150145,202104,4322,13354,3645,12277,1019,3192,1722,6619,2741,9811
150150,202104,16557,41561,14440,38924,587,1713,12070,32477,12657,34190
150157,202104,3624,9683,2915,8769,306,870,2049,6486,2355,7356
150160,202104,3125,8850,2908,8536,502,1346,1857,5691,2359,7037
150170,202104,24980,79844,21917,74750,3967,12686,13379,48852,17346,61538
150172,202104,5172,13794,4152,12372,289,709,3123,9698,3412,10407
150175,202104,1687,5197,1412,4684,239,824,832,2799,1071,3623
150178,202104,10437,27862,8687,25841,222,512,7768,23516,7990,24028
150180,202104,22839,79212,20627,76703,1271,3620,18047,69267,19318,72887
150190,202104,6914,22349,6430,21765,185,785,5845,19716,6030,20501
150195,202104,5177,16183,4870,15714,160,618,4380,14051,4540,14669
150200,202104,5891,17128,5384,16570,59,155,5089,15771,5148,15926
150210,202104,26904,91126,25181,88920,1653,5399,20880,76382,22533,81781
150215,202104,8306,23054,7218,21461,1188,3455,4385,13523,5573,16978
150220,202104,12846,35369,11226,33076,1109,2992,7768,23543,8877,26535
150230,202104,12838,35720,11393,33800,1290,3395,7763,24178,9053,27573
150240,202104,33139,90041,27594,80817,6975,20956,10099,29909,17074,50865
150250,202104,4315,16093,4014,15759,587,2236,3141,12650,3728,14886
150260,202104,2785,8804,2512,8398,128,402,2059,6976,2187,7378
150270,202104,9190,25690,6489,20864,2007,6796,1538,5336,3545,12132
150275,202104,7078,21947,6449,21067,229,792,5575,18209,5804,19001
150276,202104,2412,6271,2084,5881,263,651,1392,4421,1655,5072
150277,202104,5207,13475,4170,12268,325,870,3146,9895,3471,10765
150280,202104,7086,27838,6835,27438,421,1655,5935,24065,6356,25720
150285,202104,3288,11419,2889,10797,267,967,2102,8072,2369,9039
150290,202104,10418,28015,9411,26944,304,584,8513,25026,8817,25610
150293,202104,9471,23042,7364,20315,993,2668,4574,13331,5567,15999
150295,202104,7574,20292,5551,17527,1798,6035,1892,6903,3690,12938
150300,202104,2382,7073,2157,6794,31,107,1991,6303,2022,6410
150304,202104,4296,12389,3562,11273,602,1741,2231,7507,2833,9248
150307,202104,6145,19434,5661,18640,294,985,4613,15320,4907,16305
150309,202104,6472,18818,5214,16696,850,2693,3000,10061,3850,12754
150310,202104,7489,29371,7159,28985,191,1011,6427,26273,6618,27284
150320,202104,9354,25302,8547,24132,373,1101,6703,18903,7076,20004
150330,202104,13883,43958,12853,42380,1167,3520,9735,33259,10902,36779
150340,202104,2570,7440,2282,7012,341,984,1564,4989,1905,5973
150345,202104,8426,23846,7575,22722,409,1270,6522,19620,6931,20890
150350,202104,9034,22436,8308,21492,644,1135,6885,18344,7529,19479
150360,202104,24396,65787,19547,59713,2129,4875,13792,45480,15921,50355
150370,202104,11180,33065,9211,30415,1049,2838,6675,23884,7724,26722
150375,202104,3722,14783,3373,14294,210,998,2920,12482,3130,13480
150380,202104,11422,28649,9432,26057,105,404,8399,23185,8504,23589
150390,202104,7836,31086,7029,29851,1069,3908,5038,22782,6107,26690
150400,202104,6725,23689,6452,23183,244,841,5701,20598,5945,21439
150405,202104,9329,24194,8150,22791,504,1014,6611,19168,7115,20182
150410,202104,1986,6069,1690,5571,270,728,1046,3654,1316,4382
150420,202104,40338,109498,31058,96025,8415,27171,10975,39613,19390,66784
150430,202104,8705,24616,7923,23612,931,1932,6164,19406,7095,21338
150440,202104,5837,18054,5288,17304,984,2827,3422,12014,4406,14841
150442,202104,27274,62998,22594,57255,2370,5753,15761,40848,18131,46601
150445,202104,6423,19405,5640,18237,206,649,4856,15790,5062,16439
150450,202104,5347,22066,4942,21531,378,1812,4186,18291,4564,20103
150460,202104,8448,27475,7725,26554,218,814,6683,23798,6901,24612
150470,202104,21419,55466,19110,52850,329,940,18029,49863,18358,50803
150475,202104,5085,15519,4363,14454,383,1121,3422,11663,3805,12784
150480,202104,13932,43670,12500,41585,2295,6579,8309,29801,10604,36380
150490,202104,8509,29208,7789,28320,328,1219,6787,24914,7115,26133
150495,202104,5383,17959,5151,17643,106,502,4718,16084,4824,16586
150497,202104,2821,8875,2272,7939,488,1744,1208,4532,1696,6276
150500,202104,3381,8465,3006,7943,289,695,2275,6029,2564,6724
150503,202104,4794,12129,3286,10177,947,3173,1046,3738,1993,6911
150506,202104,10595,30785,8861,28440,1880,5280,5456,19618,7336,24898
150510,202104,9875,35531,8591,33203,1378,4892,5480,22583,6858,27475
150520,202104,7073,27552,6769,27175,190,1146,6133,24539,6323,25685
150530,202104,12232,41420,10574,39101,1347,4021,7766,30525,9113,34546
150540,202104,5007,13418,4296,12361,266,721,3567,10289,3833,11010
150543,202104,7185,19177,5905,17586,453,1318,4588,14312,5041,15630
150548,202104,10310,31889,9280,30478,225,878,8280,27295,8505,28173
150549,202104,2015,5807,1725,5400,47,154,1448,4572,1495,4726
150550,202104,21088,60722,17522,54931,4481,14160,7205,24236,11686,38396
150553,202104,31666,88127,25013,76627,7187,22203,9251,30036,16438,52239
150555,202104,2040,5305,1598,4609,180,396,1077,3309,1257,3705
150560,202104,1942,5708,1726,5291,297,835,999,3236,1296,4071
150563,202104,2630,7681,2189,6945,415,1359,1239,4002,1654,5361
150565,202104,4506,14104,4015,13348,97,408,3373,11310,3470,11718
150570,202104,6341,19753,5916,19175,303,977,5122,16675,5425,17652
150580,202104,10570,40884,9038,39185,561,2848,7281,32967,7842,35815
150590,202104,8415,28440,7217,27010,146,846,6628,24742,6774,25588
150600,202104,9758,31905,9087,31109,209,802,8450,29102,8659,29904
150610,202104,2922,8409,2616,7937,80,316,2236,6715,2316,7031
150611,202104,3341,9007,2984,8524,91,288,2654,7560,2745,7848
150613,202104,13770,37089,10430,31490,1879,5978,5229,15754,7108,21732
150616,202104,3596,9716,2616,8081,581,1860,1144,3540,1725,5400
150618,202104,7019,19922,5703,17922,521,1573,3660,12173,4181,13746
150619,202104,6804,18443,5635,16841,228,600,4759,14459,4987,15059
150620,202104,6878,22434,5924,20850,657,2165,3991,14540,4648,16705
150630,202104,6435,16863,5880,16187,309,784,5083,14064,5392,14848
150635,202104,4947,13352,4159,12106,581,1539,2696,8111,3277,9650
150640,202104,2290,6683,2094,6439,38,98,1955,6086,1993,6184
150650,202104,11539,31351,10018,28961,2837,7728,4408,14057,7245,21785
150655,202104,5734,16339,5194,15557,193,596,4511,13518,4704,14114
150658,202104,4589,12835,3564,11225,618,2014,1966,6547,2584,8561
150660,202104,5804,16216,5138,15302,524,1450,3569,10928,4093,12378
150670,202104,8928,19926,7102,17864,695,1305,5685,15120,6380,16425
150680,202104,70467,202436,54538,177401,13015,41186,23957,88826,36972,130012
150690,202104,2785,6791,2395,6350,76,162,2140,5799,2216,5961
150700,202104,6105,17865,5450,17026,356,850,4338,13997,4694,14847
150710,202104,3824,12566,3471,12008,302,977,2615,9279,2917,10256
150715,202104,5039,14167,4123,12780,287,807,3251,10290,3538,11097
150720,202104,6960,24144,6485,23440,432,1562,5395,19852,5827,21414
150730,202104,12472,36957,10710,34451,1171,3855,8029,26537,9200,30392
150740,202104,4105,11174,3602,10389,319,759,2714,8043,3033,8802
150745,202104,5117,14253,4122,12802,679,2180,2770,8780,3449,10960
150746,202104,1744,5035,1583,4814,65,164,1347,4143,1412,4307
150747,202104,5049,15425,4472,14523,692,1881,3067,10553,3759,12434
150750,202104,3757,11505,3150,10577,220,780,2410,8355,2630,9135
150760,202104,11811,34616,10710,33082,1493,4148,7508,24078,9001,28226
150770,202104,6625,23089,6244,22665,199,508,5682,21332,5881,21840
150775,202104,1004,2706,793,2434,130,427,461,1427,591,1854
150780,202104,4508,13579,3999,12979,153,409,3585,11978,3738,12387
150790,202104,6028,16404,5191,15502,302,728,3845,13194,4147,13922
150795,202104,14525,43429,12646,40591,2950,8906,7243,24864,10193,33770
150796,202104,3974,9399,3470,8824,235,482,2910,7598,3145,8080
150797,202104,4152,12400,3597,11645,153,365,3072,10192,3225,10557
150800,202104,13534,41847,12194,40079,1524,4643,9029,30851,10553,35494
150803,202104,7407,22712,6929,21986,436,1109,5872,19005,6308,20114
150805,202104,3602,10791,3062,10017,263,807,2324,7820,2587,8627
150808,202104,6137,17256,4538,14633,1694,6001,670,2540,2364,8541
150810,202104,21032,54233,16019,48222,3306,10157,8028,27080,11334,37237
150812,202104,5636,15312,4974,14243,423,1268,3756,10591,4179,11859
150815,202104,9901,28229,8276,26327,658,1987,6836,22209,7494,24196
150820,202104,11811,32128,9987,29872,1093,2753,7535,23767,8628,26520
150830,202104,12270,43347,11350,42229,478,1774,9733,37616,10211,39390
150835,202104,2446,7746,2087,7166,319,1078,1284,4451,1603,5529
150840,202104,7719,21262,6231,18934,984,3239,3583,10792,4567,14031
160005,202104,1236,3316,1093,3139,68,227,920,2654,988,2881
160010,202104,2454,6442,2286,6260,19,103,2219,6005,2238,6108
160015,202104,2889,8194,2564,7802,71,224,2363,7234,2434,7458
160020,202104,2114,6581,1842,6244,157,475,1429,5079,1586,5554
160021,202104,1230,4488,1135,4370,54,278,911,3562,965,3840
160023,202104,1334,4538,1182,4282,143,476,804,3122,947,3598
160025,202104,1840,5531,1741,5419,12,38,1691,5279,1703,5317
160027,202104,8921,24748,7956,23517,644,1779,6372,19262,7016,21041
160030,202104,77477,214051,62833,194323,13186,38194,33122,113680,46308,151874
160040,202104,5916,19533,5395,18880,70,308,5072,17857,5142,18165
160050,202104,4906,14372,3834,12958,1441,4672,1326,5696,2767,10368
160053,202104,3894,11737,3516,11268,289,779,2830,9481,3119,10260
160055,202104,959,2716,925,2678,27,84,852,2483,879,2567
160060,202104,25536,65545,20745,60163,1013,2917,16358,50072,17371,52989
160070,202104,2642,9987,2363,9559,186,736,1865,7816,2051,8552
160080,202104,3378,10547,2997,10120,24,128,2820,9586,2844,9714
170025,202104,647,1653,475,1395,81,223,252,795,333,1018
170030,202104,1275,3756,986,3260,159,485,454,1580,613,2065
170035,202104,1480,3778,1092,3169,80,246,703,2035,783,2281
170040,202104,1948,5324,1546,4756,108,349,980,3100,1088,3449
170070,202104,1922,4436,1374,3745,90,258,811,2333,901,2591
170100,202104,2471,6980,2056,6302,238,638,1274,4066,1512,4704
170105,202104,732,2084,512,1617,148,428,152,507,300,935
170110,202104,993,2930,771,2524,108,372,405,1292,513,1664
170130,202104,1312,3819,953,3141,173,606,475,1586,648,2192
170190,202104,1427,3932,1048,3331,312,1069,260,941,572,2010
170200,202104,2112,4927,1388,3764,213,582,567,1549,780,2131
170210,202104,25387,67753,19344,57752,6028,19693,2899,9500,8927,29193
170215,202104,1326,3497,1062,3134,40,159,843,2482,883,2641
170220,202104,5950,18112,4972,16356,1373,4329,1826,6782,3199,11111
170230,202104,1223,3574,905,2948,255,849,150,537,405,1386
170240,202104,2611,7179,2083,6333,139,463,1510,4510,1649,4973
170255,202104,4015,11374,2914,9421,575,1843,1273,4268,1848,6111
170270,202104,950,2283,640,1838,52,139,379,1080,431,1219
170290,202104,2855,8349,2475,7849,131,395,1924,6315,2055,6710
170300,202104,2068,5469,1674,4882,184,488,1144,3422,1328,3910
170305,202104,660,1779,558,1617,81,241,277,818,358,1059
170307,202104,968,3205,789,2863,99,365,451,1651,550,2016
170310,202104,1594,3937,1135,3218,164,497,551,1583,715,2080
170320,202104,1054,2701,794,2292,76,217,502,1490,578,1707
170330,202104,930,2815,844,2690,43,182,700,2177,743,2359
170360,202104,541,1437,382,1188,20,72,253,745,273,817
170370,202104,1261,3326,910,2743,265,765,252,861,517,1626
170380,202104,1814,5136,1368,4451,86,306,817,2742,903,3048
170382,202104,553,1599,464,1453,29,124,354,1067,383,1191
170384,202104,1624,5597,1334,5053,280,1076,675,2647,955,3723
170386,202104,1013,2711,629,1987,75,269,232,697,307,966
170388,202104,622,1754,441,1442,61,219,204,672,265,891
170389,202104,1056,3201,863,2885,52,189,629,2159,681,2348
170390,202104,1787,3995,1349,3471,34,76,1133,2992,1167,3068
170410,202104,590,1642,434,1364,26,97,281,854,307,951
170460,202104,364,968,302,872,38,112,205,599,243,711
170510,202104,953,2641,704,2201,40,149,461,1361,501,1510
170550,202104,6536,17178,4807,14412,1279,4127,1038,3384,2317,7511
170555,202104,1427,3774,1125,3309,80,237,553,1715,633,1952
170560,202104,1037,2855,790,2515,67,196,503,1721,570,1917
170600,202104,1291,3451,1047,3108,266,664,498,1656,764,2320
170610,202104,1617,4222,1174,3566,84,266,735,2223,819,2489
170625,202104,422,1131,278,844,38,111,103,301,141,412
170650,202104,1256,3669,1000,3249,115,385,611,2032,726,2417
170700,202104,3396,9922,2567,8315,504,1635,1140,3753,1644,5388
170710,202104,1480,3833,1153,3325,162,475,695,2050,857,2525
170720,202104,1754,4376,1333,3693,335,943,586,1668,921,2611
170730,202104,1100,2906,827,2459,131,316,439,1392,570,1708
170740,202104,2136,6867,1843,6340,167,629,1317,4520,1484,5149
170755,202104,899,2424,632,1981,79,255,267,843,346,1098
170765,202104,1166,2990,827,2449,152,440,348,1090,500,1530
170770,202104,1898,5323,1535,4769,149,479,1046,3279,1195,3758
170820,202104,3316,9890,2602,8588,530,1795,1177,4041,1707,5836
170825,202104,1034,2356,847,2109,98,217,611,1544,709,1761
170830,202104,1416,3707,1156,3305,230,604,691,2068,921,2672
170900,202104,2799,8593,2356,7957,215,638,1842,6388,2057,7026
170930,202104,3723,10161,2844,8531,654,2076,899,2728,1553,4804
170950,202104,11276,30834,7885,24729,2139,7691,864,2959,3003,10650
170980,202104,472,1231,370,1070,29,96,243,678,272,774
171050,202104,1659,5108,1447,4752,49,214,1208,3943,1257,4157
171070,202104,1349,3789,1156,3507,308,892,499,1801,807,2693
171090,202104,1080,2652,852,2338,82,234,550,1483,632,1717
171110,202104,577,1537,406,1225,75,212,181,517,256,729
171150,202104,1079,2642,681,1972,67,219,419,1204,486,1423
171180,202104,785,2098,524,1612,100,275,219,685,319,960
171190,202104,1860,6032,1621,5631,247,903,1003,3609,1250,4512
171195,202104,802,2492,644,2199,75,288,397,1341,472,1629
171200,202104,608,1657,456,1405,105,343,161,483,266,826
171215,202104,393,1069,325,957,32,111,218,614,250,725
171240,202104,801,2563,638,2265,30,166,434,1509,464,1675
171245,202104,727,2063,567,1750,48,159,364,1083,412,1242
171250,202104,1016,2696,745,2289,131,425,346,1088,477,1513
171270,202104,480,1667,379,1459,81,316,161,677,242,993
171280,202104,883,2615,708,2303,65,237,428,1440,493,1677
171320,202104,4063,11209,3169,9651,638,1849,1188,3867,1826,5716
171330,202104,2802,7651,2175,6535,497,1490,917,2882,1414,4372
171360,202104,1441,4085,1150,3660,87,275,825,2719,912,2994
171370,202104,704,1760,537,1528,44,123,370,1062,414,1185
171380,202104,1476,3932,1239,3604,155,424,826,2544,981,2968
171395,202104,1010,2685,705,2134,60,202,452,1325,512,1527
171420,202104,2001,5735,1451,4650,254,814,646,2120,900,2934
171430,202104,1057,3054,894,2751,53,161,627,1873,680,2034
171488,202104,2384,6889,1899,6092,303,983,974,3218,1277,4201
171500,202104,988,2424,745,2057,63,157,521,1455,584,1612
171510,202104,841,2661,730,2454,44,179,532,1767,576,1946
171515,202104,489,1218,371,1049,37,108,226,609,263,717
171525,202104,751,2023,569,1737,33,115,349,1028,382,1143
171550,202104,351,987,270,858,38,137,145,440,183,577
171570,202104,1133,3363,961,3063,124,383,572,1887,696,2270
171575,202104,1775,4741,1151,3629,133,435,504,1598,637,2033
171610,202104,5747,15807,4295,13344,871,3044,1123,3813,1994,6857
171620,202104,2606,7312,2217,6750,102,404,1828,5539,1930,5943
171630,202104,1041,2617,808,2304,86,238,563,1663,649,1901
171650,202104,2068,5773,1604,5005,384,1301,480,1672,864,2973
171660,202104,2388,5947,1661,4745,223,560,918,2666,1141,3226
171665,202104,1254,3486,987,3052,175,608,478,1475,653,2083
171670,202104,1933,5097,1486,4359,213,653,766,2296,979,2949
171700,202104,1220,3391,895,2798,106,312,483,1535,589,1847
171720,202104,804,2037,638,1786,56,164,466,1291,522,1455
171750,202104,1331,3685,924,2932,221,728,125,493,346,1221
171780,202104,1220,3073,898,2609,89,278,619,1774,708,2052
171790,202104,1414,4503,1169,4009,185,640,570,1978,755,2618
171800,202104,728,1955,553,1702,63,235,320,966,383,1201
171820,202104,11507,31847,8581,26848,2046,6674,2422,8252,4468,14926
171830,202104,1579,4939,1354,4547,129,500,880,2963,1009,3463
171840,202104,784,2055,608,1781,21,65,395,1165,416,1230
171845,202104,666,1597,506,1365,44,158,334,863,378,1021
171850,202104,905,2939,774,2649,68,288,543,1822,611,2110
171855,202104,1062,3198,903,2901,63,198,585,1853,648,2051
171865,202104,411,1238,351,1147,56,186,184,576,240,762
171870,202104,838,2260,591,1815,76,224,295,922,371,1146
171875,202104,1325,3720,1067,3313,36,145,815,2523,851,2668
171880,202104,1230,3589,1083,3397,42,117,861,2770,903,2887
171884,202104,890,2521,667,2137,143,513,237,769,380,1282
171886,202104,1401,3725,1017,3125,276,963,220,695,496,1658
171888,202104,723,2003,507,1607,27,94,310,965,337,1059
171889,202104,375,1143,298,993,61,219,121,399,182,618
171890,202104,1207,3326,876,2794,158,480,493,1592,651,2072
171900,202104,553,1861,420,1552,78,254,180,708,258,962
172000,202104,592,1713,495,1545,63,185,272,836,335,1021
172010,202104,975,3335,837,3067,64,260,523,1922,587,2182
172015,202104,383,1300,291,1114,56,208,118,468,174,676
172020,202104,2784,7682,2455,7256,163,486,1814,5605,1977,6091
172025,202104,707,1934,529,1649,40,141,382,1194,422,1335
172030,202104,1256,3647,1065,3339,63,192,812,2547,875,2739
172049,202104,1325,3135,895,2544,182,469,435,1373,617,1842
172065,202104,1448,3630,1142,3246,98,205,905,2767,1003,2972
172080,202104,2382,6943,1936,6166,116,377,1294,4124,1410,4501
172085,202104,478,1292,310,937,61,181,107,306,168,487
172090,202104,4060,10013,3163,8830,131,361,2422,6868,2553,7229
172093,202104,470,1392,339,1157,19,100,199,639,218,739
172097,202104,690,1780,488,1438,66,201,211,614,277,815
172100,202104,49364,120356,35613,99072,5976,18207,13300,37826,19276,56033
172110,202104,1614,5783,1394,5444,120,496,1040,4208,1160,4704
172120,202104,5151,14894,4040,13068,520,1726,2217,7416,2737,9142
172125,202104,395,1045,305,902,23,77,186,524,209,601
172130,202104,627,1526,494,1310,22,78,351,856,373,934
172208,202104,2630,6266,2114,5601,231,451,1498,4152,1729,4603
172210,202104,2719,6770,2093,5977,295,900,1232,3692,1527,4592
210005,202104,19092,53680,14422,46026,4035,13317,5557,18617,9592,31934
210010,202104,1938,5925,1753,5702,67,286,1539,5018,1606,5304
210015,202104,3328,9834,2946,9336,154,459,2452,7829,2606,8288
210020,202104,7363,17290,6284,16036,84,250,5789,14828,5873,15078
210030,202104,4639,15288,4278,14742,277,1045,3579,12433,3856,13478
210040,202104,1918,4415,1714,4165,47,107,1468,3489,1515,3596
210043,202104,6065,17286,5167,16019,375,1137,4079,12844,4454,13981
210047,202104,6516,20094,5338,18536,124,645,4640,16107,4764,16752
210050,202104,2210,7317,1763,6498,183,705,1203,4501,1386,5206
210055,202104,1879,5979,1706,5714,61,217,1453,4905,1514,5122
210060,202104,7306,26493,6514,25115,683,2651,4506,17915,5189,20566
210070,202104,7057,19962,6609,19365,42,192,6261,18292,6303,18484
210080,202104,4326,14277,4110,14044,41,238,3799,13061,3840,13299
210083,202104,5669,15911,4723,14900,73,230,4440,14136,4513,14366
210087,202104,2976,8072,2550,7505,87,241,2158,6407,2245,6648
210090,202104,9112,28384,8523,27363,494,1269,7246,23547,7740,24816
210095,202104,6534,20738,5978,20038,265,990,5012,17247,5277,18237
210100,202104,6732,20474,5996,19283,458,1527,4561,14795,5019,16322
210110,202104,2900,9234,2674,8965,55,303,2406,8033,2461,8336
210120,202104,23214,62232,19242,57101,1932,4488,13057,41563,14989,46051
210125,202104,4437,11841,3856,11157,746,1736,2669,8299,3415,10035
210130,202104,4333,11149,3596,10237,164,344,3037,8771,3201,9115
210135,202104,1523,4322,1311,3986,59,127,1082,3376,1141,3503
210140,202104,19631,50553,15154,44798,2970,8176,8299,26328,11269,34504
210150,202104,4354,10426,3887,9789,143,343,3298,8207,3441,8550
210160,202104,16734,47990,14431,45121,1292,4114,10223,33373,11515,37487
210170,202104,15427,46861,14343,45486,829,2122,12509,40326,13338,42448
210173,202104,2285,8675,2141,8423,103,581,1837,7169,1940,7750
210177,202104,3486,9549,3029,8991,187,434,2566,7922,2753,8356
210180,202104,1444,3813,1257,3589,22,60,1149,3287,1171,3347
210190,202104,5399,14264,4573,13170,81,306,3946,11268,4027,11574
210193,202104,1349,3881,1189,3625,36,119,882,2749,918,2868
210197,202104,2100,6456,1940,6240,155,450,1582,5217,1737,5667
210200,202104,7722,24543,6865,23129,387,1450,5476,18442,5863,19892
210203,202104,7086,20776,6031,19358,363,1206,4846,15872,5209,17078
210207,202104,4000,9583,3065,8582,166,327,2554,7380,2720,7707
210210,202104,8002,25744,7308,24766,151,857,6274,21072,6425,21929
210215,202104,2520,7861,2160,7328,115,561,1623,5437,1738,5998
210220,202104,6171,21102,5868,20662,148,995,5196,17937,5344,18932
210230,202104,5165,15456,4708,14776,501,1248,3818,12419,4319,13667
210232,202104,11126,34512,9127,31469,1645,5549,5525,20490,7170,26039
210235,202104,3370,10124,2978,9571,157,601,2501,8051,2658,8652
210237,202104,3002,9433,2587,8938,29,158,2409,8327,2438,8485
210240,202104,2621,8084,2418,7739,67,224,2025,6382,2092,6606
210250,202104,5858,17377,5335,16721,61,349,4901,15313,4962,15662
210255,202104,2514,7616,2140,6974,246,801,1436,4664,1682,5465
210260,202104,5498,16199,4866,15287,238,843,4133,12975,4371,13818
210270,202104,5016,13604,4482,12930,88,367,4024,11526,4112,11893
210275,202104,3460,8765,3026,8230,83,227,2514,6835,2597,7062
210280,202104,5622,15742,4524,14076,239,899,3401,10427,3640,11326
210290,202104,7490,19428,6720,18472,106,321,6291,17309,6397,17630
210300,202104,32508,88430,26578,79921,2268,7078,18171,56974,20439,64052
210310,202104,3124,7847,2767,7330,122,260,2423,6491,2545,6751
210312,202104,2774,6867,2467,6539,23,92,2340,6162,2363,6254
210315,202104,3017,8323,2605,7863,79,216,2305,7122,2384,7338
210317,202104,4100,12806,3712,12349,115,567,3317,10975,3432,11542
210320,202104,19214,56939,17573,54793,367,1579,15639,48624,16006,50203
210325,202104,3688,10286,3168,9612,112,315,2741,8550,2853,8865
210330,202104,24051,67101,19243,61003,5482,15555,9468,34706,14950,50261
210340,202104,10242,29473,9115,27973,757,2161,6966,22089,7723,24250
210350,202104,9073,26031,8009,24745,133,454,7185,22317,7318,22771
210355,202104,4278,14006,3791,13245,94,444,3228,11352,3322,11796
210360,202104,13915,42695,12409,40508,550,2442,9462,30340,10012,32782
210370,202104,10931,24378,8472,21791,243,405,7752,20424,7995,20829
210375,202104,3220,8521,2466,7483,677,2152,985,3309,1662,5461
210380,202104,5451,13848,4716,12987,225,549,4007,11151,4232,11700
210390,202104,2714,9040,2514,8701,107,478,2168,7455,2275,7933
210400,202104,4533,13600,4024,12997,122,365,3592,11817,3714,12182
210405,202104,6889,18306,5584,16478,1067,2844,3131,9965,4198,12809
210407,202104,1985,6491,1696,5988,79,330,1358,4740,1437,5070
210408,202104,2630,9538,2459,9292,143,643,1969,7491,2112,8134
210409,202104,3848,13023,3511,12561,92,463,2953,10688,3045,11151
210410,202104,3495,10318,2993,9498,127,460,2372,7456,2499,7916
210420,202104,3834,12088,3475,11462,203,578,2916,9774,3119,10352
210430,202104,2262,6564,2005,6232,96,272,1698,5366,1794,5638
210440,202104,4332,11631,3764,10918,77,246,3420,9878,3497,10124
210450,202104,2367,6979,2039,6510,88,290,1687,5374,1775,5664
210455,202104,4458,11499,3397,10160,920,2790,1594,5063,2514,7853
210460,202104,3754,10583,3181,9839,54,211,2796,8625,2850,8836
210462,202104,1673,4997,1432,4614,38,148,1163,3778,1201,3926
210465,202104,2749,7886,2396,7395,78,350,1931,5820,2009,6170
210467,202104,5914,18564,5174,17600,275,1027,4307,14874,4582,15901
210470,202104,1982,5257,1475,4535,105,238,1118,3605,1223,3843
210480,202104,16270,47500,13499,44097,1140,3350,9873,34942,11013,38292
210490,202104,3647,9100,2953,8149,69,177,2520,6957,2589,7134
210500,202104,6419,24135,5904,23263,394,1791,4834,18985,5228,20776
210510,202104,5930,19385,5187,18588,112,508,4685,17029,4797,17537
210515,202104,3764,10988,3266,10420,188,654,2671,8730,2859,9384
210520,202104,2526,7262,2267,6922,67,243,1935,5860,2002,6103
210530,202104,51272,125795,39616,108643,6782,22136,11603,39064,18385,61200
210535,202104,3298,10703,3049,10336,143,502,2579,8815,2722,9317
210540,202104,14740,41946,12240,38461,1529,4320,8437,27966,9966,32286
210542,202104,6695,15269,5345,13798,444,803,4251,11781,4695,12584
210545,202104,2233,6859,2105,6654,36,155,1881,5883,1917,6038
210547,202104,3588,12703,3197,11968,275,984,2452,9389,2727,10373
210550,202104,6085,18196,4810,16195,330,1260,3410,11808,3740,13068
210560,202104,3661,10956,3276,10340,129,379,2773,8728,2902,9107
210565,202104,1491,4731,1245,4377,58,290,952,3367,1010,3657
210570,202104,10501,28340,9357,26942,313,824,8135,23966,8448,24790
210580,202104,3002,7944,2413,7176,131,302,1669,5188,1800,5490
210590,202104,4267,12623,3709,11917,59,320,3320,10615,3379,10935
210592,202104,2657,7724,2437,7370,20,93,2109,6309,2129,6402
210594,202104,2508,6697,1926,5796,94,277,1425,4455,1519,4732
210596,202104,2598,9044,2353,8573,132,474,1913,7039,2045,7513
210598,202104,1853,5287,1714,5077,52,168,1512,4450,1564,4618
210600,202104,3030,8042,2498,7297,122,303,1902,5635,2024,5938
210610,202104,2801,7592,2411,7124,61,234,2073,6135,2134,6369
210620,202104,2842,7392,2362,6816,51,139,2134,6200,2185,6339
210630,202104,3039,10009,2782,9580,113,487,2301,7860,2414,8347
210632,202104,4389,13894,3905,13198,214,895,3104,10436,3318,11331
210635,202104,1733,6132,1641,5974,102,344,1348,5024,1450,5368
210637,202104,2500,8156,2179,7701,141,609,1618,5838,1759,6447
210640,202104,4569,16172,4284,15846,60,282,3919,14554,3979,14836
210650,202104,7463,21078,6778,20201,140,432,6068,18145,6208,18577
210660,202104,8102,23840,7253,22475,250,1029,6172,18784,6422,19813
210663,202104,2689,7564,2462,7298,159,329,2055,6321,2214,6650
210667,202104,2000,6379,1797,6079,63,230,1594,5465,1657,5695
210670,202104,4572,14977,4163,14333,97,449,3669,12564,3766,13013
210675,202104,5145,13689,4402,12747,305,714,3535,10640,3840,11354
210680,202104,4674,11132,3961,10296,100,168,3606,9504,3706,9672
210690,202104,7609,23093,6349,21703,230,953,5604,19364,5834,20317
210700,202104,2771,7671,2191,6829,155,428,1573,5126,1728,5554
210710,202104,4837,15005,4261,14201,94,527,3782,12452,3876,12979
210720,202104,3040,9710,2700,9285,57,325,2389,8147,2446,8472
210725,202104,1287,4263,1124,4018,46,175,788,2927,834,3102
210730,202104,1203,3078,1013,2813,51,135,867,2401,918,2536
210735,202104,4727,13539,4036,12640,196,526,3459,11149,3655,11675
210740,202104,5247,13678,4558,12893,80,239,3931,11136,4011,11375
210745,202104,4423,11931,4110,11538,110,311,3731,10446,3841,10757
210750,202104,23389,59629,20283,55715,2149,5188,13781,40325,15930,45513
210760,202104,5931,15475,5010,14504,42,90,4749,13911,4791,14001
210770,202104,6115,15636,5302,14695,57,247,4999,13778,5056,14025
210780,202104,7489,23092,6550,21534,627,1739,5004,16865,5631,18604
210790,202104,4296,13460,3896,12945,198,442,3209,11211,3407,11653
210800,202104,4886,12973,4203,12073,90,344,3739,10637,3829,10981
210805,202104,4006,14269,3824,14008,106,532,3399,12417,3505,12949
210810,202104,4840,14020,4419,13476,322,739,3618,11413,3940,12152
210820,202104,6897,19490,5776,17700,655,2033,3418,10855,4073,12888
210825,202104,6758,20697,6103,19837,280,852,5200,17225,5480,18077
210830,202104,7837,21687,7146,20875,318,730,6266,18706,6584,19436
210840,202104,3146,8305,2839,7909,46,154,2538,6999,2584,7153
210845,202104,6466,17271,5785,16532,35,112,5515,15908,5550,16020
210850,202104,5828,19546,4862,18108,205,1005,3871,14459,4076,15464
210860,202104,21478,53652,17912,49252,1079,2485,14065,40949,15144,43434
210870,202104,7432,18946,5916,17230,238,564,5176,15264,5414,15828
210880,202104,4254,12931,3816,12399,192,736,3047,9893,3239,10629
210890,202104,3830,11109,3465,10687,314,794,2697,8669,3011,9463
210900,202104,4507,12973,3510,11115,1389,4739,505,1856,1894,6595
210905,202104,2016,5459,1685,5038,44,74,1535,4709,1579,4783
210910,202104,7089,21330,5893,19394,715,2399,3883,12897,4598,15296
210920,202104,3171,10386,2743,9821,70,400,2457,8698,2527,9098
210923,202104,1585,4594,1348,4221,77,236,979,3091,1056,3327
210927,202104,5128,16284,4511,15544,402,1336,3445,12301,3847,13637
210930,202104,2386,8225,2098,7669,147,601,1585,5785,1732,6386
210940,202104,4085,11383,3801,11055,104,422,3489,10022,3593,10444
210945,202104,6737,18925,6036,18100,249,675,5068,15631,5317,16306
210950,202104,5207,14331,4024,12695,591,1407,2660,9230,3251,10637
210955,202104,1537,4760,1329,4413,273,837,761,2709,1034,3546
210960,202104,8962,26342,7774,24549,1409,4097,4935,16430,6344,20527
210970,202104,1355,4074,1092,3626,97,289,797,2641,894,2930
210975,202104,1773,5417,1601,5144,82,281,1293,4171,1375,4452
210980,202104,9947,23187,8720,21921,102,241,8220,20782,8322,21023
210990,202104,16410,45370,12903,40774,690,2249,9543,31311,10233,33560
211000,202104,14602,41994,12202,39022,899,2779,9236,31002,10135,33781
211003,202104,5666,16573,4770,15490,129,485,4120,13692,4249,14177
211010,202104,6377,22421,5695,21541,122,556,5057,19437,5179,19993
211020,202104,8169,23312,7070,22061,244,836,5992,19295,6236,20131
211023,202104,1958,6344,1828,6180,88,289,1542,5226,1630,5515
211027,202104,3078,9687,2925,9452,218,556,2463,8144,2681,8700
211030,202104,3831,10491,3431,9995,250,608,2749,8254,2999,8862
211040,202104,4720,16597,4376,16011,110,655,3941,14285,4051,14940
211050,202104,8961,23229,8175,22191,74,267,7510,20376,7584,20643
211060,202104,6926,20787,6313,19964,167,654,5571,17617,5738,18271
211065,202104,2280,6144,1908,5679,88,224,1567,4790,1655,5014
211070,202104,7927,24449,6750,22694,497,1586,5344,18218,5841,19804
211080,202104,1309,3568,1053,3170,31,169,834,2379,865,2548
211085,202104,2081,5741,1772,5325,99,219,1494,4709,1593,4928
211090,202104,3160,8692,2856,8346,30,137,2659,7738,2689,7875
211100,202104,6800,16986,6282,16372,41,130,5838,15309,5879,15439
211102,202104,3136,10485,2873,10100,143,657,2476,8601,2619,9258
211105,202104,2391,7378,1997,6670,162,546,1436,4785,1598,5331
211107,202104,4804,14791,4129,13815,153,603,3240,11326,3393,11929
211110,202104,5989,16024,4673,14025,351,962,3471,10633,3822,11595
211120,202104,44779,108401,36670,98953,5508,13384,23251,67377,28759,80761
211125,202104,2101,6187,1781,5699,48,171,1508,4854,1556,5025
211130,202104,183562,431305,157718,398175,23988,56411,77449,221671,101437,278082
211140,202104,5002,14550,4391,13787,221,595,3681,11720,3902,12315
211150,202104,9391,25254,7935,23375,351,915,6659,19833,7010,20748
211153,202104,2423,7036,1939,6439,262,893,1271,4416,1533,5309
211157,202104,1151,3591,963,3248,27,124,702,2367,729,2491
211160,202104,4089,11399,3217,10152,128,449,2454,7650,2582,8099
211163,202104,1604,5120,1460,4915,41,177,1288,4352,1329,4529
211167,202104,1591,4880,1493,4733,23,89,1380,4359,1403,4448
211170,202104,6444,15751,5987,15232,74,156,5656,14381,5730,14537
211172,202104,2582,6877,2236,6374,107,310,1773,4962,1880,5272
211174,202104,2858,8193,2582,7885,32,165,2427,7379,2459,7544
211176,202104,4248,11934,3314,10559,145,594,2677,8506,2822,9100
211178,202104,5031,11119,4326,10370,21,82,4164,9901,4185,9983
211180,202104,4065,13261,3781,12853,222,785,3126,10694,3348,11479
211190,202104,3097,8984,2633,8304,28,156,2356,7377,2384,7533
211195,202104,1410,3895,1205,3585,110,198,965,3018,1075,3216
211200,202104,2173,6131,1748,5531,205,591,1215,3930,1420,4521
211210,202104,6321,19086,5720,18301,305,1117,4755,15167,5060,16284
211220,202104,37537,93304,30923,85235,3148,7911,22734,64427,25882,72338
211223,202104,5323,13815,4380,12570,382,1061,3171,9165,3553,10226
211227,202104,1754,5642,1576,5389,60,269,1223,4219,1283,4488
211230,202104,7794,21916,6841,20486,382,901,5581,17143,5963,18044
211240,202104,8027,25158,7628,24651,142,693,7085,22706,7227,23399
211245,202104,7001,17379,6219,16565,72,184,6013,16021,6085,16205
211250,202104,13232,41259,11982,39520,798,2794,9612,31743,10410,34537
211260,202104,8103,25928,7212,24756,230,940,6410,22199,6640,23139
211270,202104,10355,32701,8855,30690,362,1645,7185,25120,7547,26765
211280,202104,12341,33848,11098,32288,834,1933,9124,27608,9958,29541
211285,202104,1859,5918,1656,5638,122,453,1280,4452,1402,4905
211290,202104,7482,22165,6767,21231,189,690,5837,18327,6026,19017
211300,202104,7688,22079,6782,20639,235,779,5598,16842,5833,17621
211400,202104,11644,32415,9548,29566,1036,3167,6366,20827,7402,23994
220005,202104,1866,4726,1701,4505,33,100,1453,3787,1486,3887
220010,202104,1491,4216,1226,3745,24,98,956,2892,980,2990
220020,202104,3793,10144,3279,9434,138,442,2719,7780,2857,8222
220025,202104,2225,5034,1911,4576,28,76,1597,3715,1625,3791
220027,202104,1300,3198,1112,2950,20,62,960,2509,980,2571
220030,202104,3404,8424,3196,8155,91,233,2816,7130,2907,7363
220040,202104,7113,21289,6259,19680,1513,4290,3177,10638,4690,14928
220045,202104,1483,4457,1228,4040,25,129,1017,3289,1042,3418
220050,202104,4751,12737,4052,11839,56,264,3731,10780,3787,11044
220060,202104,2408,4999,2062,4602,27,63,1950,4341,1977,4404
220070,202104,2441,6072,2093,5559,73,134,1745,4665,1818,4799
220080,202104,742,2082,643,1940,21,68,551,1658,572,1726
220090,202104,1759,4177,1478,3777,14,40,1229,3269,1243,3309
220095,202104,652,1600,611,1558,33,54,542,1414,575,1468
220100,202104,1415,3802,1144,3376,41,123,927,2668,968,2791
220105,202104,2067,6267,1813,5786,106,366,1384,4405,1490,4771
220110,202104,3392,9331,3114,8853,33,163,2799,7856,2832,8019
220115,202104,2737,7800,2526,7525,68,198,2300,6840,2368,7038
220117,202104,1440,3371,1146,2969,3,15,975,2471,978,2486
220120,202104,13108,34461,12035,33150,80,254,11302,31106,11382,31360
220130,202104,1127,2963,967,2743,9,48,879,2456,888,2504
220140,202104,2158,4385,1826,4000,95,228,1600,3476,1695,3704
220150,202104,6424,18715,5876,17777,105,453,5004,14918,5109,15371
220155,202104,1209,3388,972,2969,35,105,707,2127,742,2232
220157,202104,1078,2588,914,2339,21,68,729,1811,750,1879
220160,202104,2901,7898,2506,7192,31,128,2059,5799,2090,5927
220170,202104,1632,4193,1399,3842,16,74,1249,3380,1265,3454
220173,202104,2217,6028,1805,5304,41,170,1440,4134,1481,4304
220177,202104,2029,5674,1926,5560,8,27,1904,5491,1912,5518
220180,202104,1128,2687,924,2355,4,16,732,1757,736,1773
220190,202104,7046,17314,6011,15900,358,946,4575,12392,4933,13338
220191,202104,1607,4716,1461,4471,76,250,1045,3155,1121,3405
220192,202104,2100,5422,1550,4456,25,73,1253,3558,1278,3631
220194,202104,1731,4878,1549,4591,49,180,1286,3772,1335,3952
220196,202104,2061,5252,1876,4979,29,113,1628,4246,1657,4359
220198,202104,1295,3491,1103,3244,6,16,1021,3035,1027,3051
220200,202104,5132,14668,4487,13838,62,284,3906,12017,3968,12301
220202,202104,2195,6107,1893,5618,24,117,1628,4752,1652,4869
220205,202104,2515,7141,2258,6676,49,190,1925,5604,1974,5794
220207,202104,785,2344,656,2123,54,181,442,1446,496,1627
220208,202104,1685,5089,1402,4553,177,612,833,2679,1010,3291
220209,202104,1597,4490,1395,4132,23,90,1160,3398,1183,3488
220210,202104,1794,4254,1561,3898,11,44,1360,3307,1371,3351
220211,202104,1656,4090,1527,3916,16,62,1341,3445,1357,3507
220213,202104,1828,4746,1584,4332,18,58,1296,3454,1314,3512
220217,202104,2280,6530,2141,6370,40,77,1990,6034,2030,6111
220220,202104,10748,27405,8981,24758,610,1401,6111,17797,6721,19198
220225,202104,1006,2631,826,2397,4,27,779,2237,783,2264
220230,202104,5664,14034,4858,12923,146,334,4197,11246,4343,11580
220240,202104,3068,8722,2791,8267,108,351,2295,6778,2403,7129
220245,202104,1824,4104,1401,3588,12,47,1274,3292,1286,3339
220250,202104,3017,8269,2652,7808,12,68,2484,7276,2496,7344
220253,202104,1617,4326,1457,4063,54,166,1235,3379,1289,3545
220255,202104,1966,4519,1696,4150,27,121,1481,3507,1508,3628
220260,202104,4462,13334,3914,12350,165,560,3086,9731,3251,10291
220265,202104,1295,4105,1163,3936,33,177,967,3221,1000,3398
220270,202104,6047,19309,5731,18742,198,947,4801,15214,4999,16161
220271,202104,1498,3799,1311,3539,25,83,1148,3082,1173,3165
220272,202104,1744,5009,1552,4664,49,145,1172,3445,1221,3590
220273,202104,1260,3536,1057,3168,38,146,814,2395,852,2541
220275,202104,2299,5332,1848,4721,39,75,1624,4180,1663,4255
220277,202104,2193,5400,1882,4960,39,91,1572,4091,1611,4182
220280,202104,1690,3851,1412,3496,18,54,1205,2968,1223,3022
220285,202104,1443,3597,1251,3378,10,38,1159,3107,1169,3145
220290,202104,6718,18287,5353,16372,353,1092,3923,12361,4276,13453
220300,202104,1997,5659,1638,5186,31,153,1382,4346,1413,4499
220310,202104,3061,8028,2417,7286,38,177,2050,6158,2088,6335
220320,202104,3112,8899,2414,7613,62,293,1898,5824,1960,6117
220323,202104,1658,4725,1306,4166,52,179,1074,3372,1126,3551
220325,202104,1256,3682,1084,3397,25,116,902,2769,927,2885
220327,202104,1595,4348,1396,4038,29,114,1167,3288,1196,3402
220330,202104,4578,10726,3896,9906,55,183,3526,8912,3581,9095
220335,202104,1677,5015,1516,4804,31,95,1349,4305,1380,4400
220340,202104,1917,4940,1487,4234,55,161,1017,2818,1072,2979
220342,202104,1196,3402,1068,3208,52,157,842,2534,894,2691
220345,202104,3136,6984,2423,5981,16,43,2195,5406,2211,5449
220350,202104,3362,8422,2704,7461,128,356,1934,5399,2062,5755
220360,202104,1247,3167,989,2736,16,43,795,2190,811,2233
220370,202104,8642,24793,7897,23611,147,581,6870,20324,7017,20905
220375,202104,1633,4554,1456,4337,3,14,1388,4160,1391,4174
220380,202104,1468,3461,1204,3099,14,36,1054,2699,1068,2735
220385,202104,831,1966,682,1701,6,15,596,1471,602,1486
220390,202104,10581,26854,8161,23157,2045,5666,2873,9177,4918,14843
220400,202104,1534,3578,1176,3029,24,74,906,2253,930,2327
220410,202104,1170,3186,965,2837,47,127,782,2283,829,2410
220415,202104,834,2100,704,1898,22,53,570,1521,592,1574
220420,202104,2046,5627,1654,4891,61,168,1255,3670,1316,3838
220430,202104,2561,6656,2380,6396,59,187,2071,5492,2130,5679
220435,202104,1793,4551,1555,4207,40,131,1308,3463,1348,3594
220440,202104,2390,7334,2039,6792,73,331,1748,5717,1821,6048
220450,202104,2529,6492,2060,5913,53,173,1766,5084,1819,5257
220455,202104,1270,3907,1210,3823,6,30,1085,3431,1091,3461
220460,202104,1009,2440,940,2356,36,81,805,2006,841,2087
220465,202104,2344,7172,2073,6747,184,586,1513,5057,1697,5643
220470,202104,3525,9630,3193,9109,96,239,2605,7354,2701,7593
220480,202104,2859,7207,2305,6333,225,481,1485,4181,1710,4662
220490,202104,2504,6148,2171,5732,23,110,1896,4941,1919,5051
220500,202104,3000,7365,2629,6797,87,202,2068,5270,2155,5472
220510,202104,2572,7137,2060,6221,83,216,1605,4918,1688,5134
220515,202104,1683,3987,1558,3812,39,59,1359,3334,1398,3393
220520,202104,5037,12873,4570,12219,94,247,3978,10609,4072,10856
220525,202104,1409,3441,1219,3205,8,43,1126,2925,1134,2968
220527,202104,1310,3576,1132,3319,14,58,971,2890,985,2948
220530,202104,1421,3508,1236,3272,29,82,1133,2984,1162,3066
220535,202104,807,2176,757,2109,30,75,611,1707,641,1782
220540,202104,3254,10233,3050,9840,135,441,2574,8287,2709,8728
220545,202104,1457,4262,1354,4102,56,210,1146,3439,1202,3649
220550,202104,8602,26204,7684,24620,457,1536,5868,18678,6325,20214
220551,202104,1431,3943,1278,3700,26,98,1049,2984,1075,3082
220552,202104,1653,4665,1355,4140,22,112,1101,3254,1123,3366
220553,202104,1778,4498,1476,4101,56,94,1198,3463,1254,3557
220554,202104,921,2342,678,1955,52,121,451,1289,503,1410
220555,202104,2487,6967,2172,6572,37,136,1817,5642,1854,5778
220556,202104,1213,3457,1058,3161,44,180,777,2232,821,2412
220557,202104,1668,5035,1404,4462,62,235,1044,3218,1106,3453
220558,202104,1409,3628,1110,3215,16,65,957,2745,973,2810
220559,202104,1838,4430,1566,4016,14,31,1284,3333,1298,3364
220560,202104,1762,3946,1452,3555,40,75,1317,3258,1357,3333
220570,202104,7364,21458,6731,20564,487,1360,5339,16549,5826,17909
220580,202104,6983,18632,6386,17678,98,282,5769,15922,5867,16204
220585,202104,2099,6461,1728,5787,45,123,1418,4803,1463,4926
220590,202104,1384,3678,1144,3325,79,205,827,2452,906,2657
220595,202104,2603,6999,2377,6694,16,78,2130,5944,2146,6022
220600,202104,1404,3091,1194,2839,80,99,1004,2471,1084,2570
220605,202104,1614,4676,1388,4269,16,93,1137,3393,1153,3486
220610,202104,2830,8089,2658,7828,26,113,2493,7323,2519,7436
220620,202104,7970,24134,7344,23294,152,777,6705,21049,6857,21826
220630,202104,379,1095,294,940,23,77,197,620,220,697
220635,202104,1754,5282,1573,4899,38,188,1244,3764,1282,3952
220640,202104,2452,6753,2092,6243,68,270,1707,5043,1775,5313
220650,202104,2066,5646,1798,5241,33,115,1456,4240,1489,4355
220660,202104,2572,7973,2190,7335,69,335,1839,6048,1908,6383
220665,202104,1255,3732,1062,3413,24,132,899,2821,923,2953
220667,202104,1645,4997,1481,4699,58,209,1206,3810,1264,4019
220669,202104,1640,4883,1573,4780,46,197,1408,4185,1454,4382
220670,202104,2230,5674,1791,5060,18,76,1559,4399,1577,4475
220672,202104,3270,7904,2654,7157,83,278,2367,6295,2450,6573
220675,202104,1301,3502,1163,3248,31,85,960,2668,991,2753
220680,202104,2767,7339,2643,7171,111,219,2403,6624,2514,6843
220690,202104,1599,4160,1413,3884,52,157,1120,3075,1172,3232
220695,202104,917,2496,851,2378,20,60,745,2071,765,2131
220700,202104,10382,24740,8435,22106,335,845,6490,16933,6825,17778
220710,202104,930,2462,686,2010,29,75,522,1498,551,1573
220720,202104,2140,5004,1926,4721,16,59,1691,4096,1707,4155
220730,202104,1318,3633,1128,3320,13,67,954,2746,967,2813
220735,202104,1000,2258,796,1952,23,62,658,1566,681,1628
220740,202104,1374,3507,1111,3170,30,74,933,2705,963,2779
220750,202104,3819,9591,3363,8947,178,416,2941,7871,3119,8287
220755,202104,1374,3278,1146,2941,20,69,952,2389,972,2458
220760,202104,3121,8407,2752,7911,61,175,2505,7257,2566,7432
220770,202104,23926,69412,20306,63307,6006,19733,7072,23127,13078,42860
220775,202104,1169,2896,1039,2731,10,35,998,2610,1008,2645
220777,202104,1626,4069,1247,3496,33,79,958,2705,991,2784
220779,202104,1269,3262,1102,3020,19,63,972,2639,991,2702
220780,202104,5791,14125,5013,12971,218,620,4065,10329,4283,10949
220785,202104,1500,3294,1319,3064,7,21,1262,2912,1269,2933
220790,202104,10265,28736,9265,27294,174,752,7809,22786,7983,23538
220793,202104,939,2435,756,2120,6,9,632,1796,638,1805
220795,202104,1402,3556,1236,3337,22,72,1088,2935,1110,3007
220800,202104,18448,40068,15754,36583,592,1293,12361,28672,12953,29965
220810,202104,3070,8373,2602,7558,42,118,2155,6194,2197,6312
220820,202104,4860,12665,4250,11768,241,583,3248,8994,3489,9577
220830,202104,7293,19048,6556,18033,257,779,5434,14736,5691,15515
220840,202104,12101,36747,10146,32782,2196,6781,4785,16101,6981,22882
220850,202104,3173,9605,2864,9223,48,243,2556,8240,2604,8483
220855,202104,709,1754,619,1634,19,56,559,1465,578,1521
220860,202104,1059,2606,926,2402,16,66,838,2140,854,2206
220865,202104,2465,6406,1917,5433,71,266,1411,3882,1482,4148
220870,202104,3115,8340,2603,7674,27,125,2403,7075,2430,7200
220880,202104,5356,12476,4621,11568,72,259,4237,10495,4309,10754
220885,202104,1419,4159,1179,3762,59,186,926,3008,985,3194
220887,202104,1591,3361,1340,3045,16,33,1236,2798,1252,2831
220890,202104,1416,4232,1243,3982,42,144,1037,3371,1079,3515
220900,202104,2036,4770,1704,4349,32,71,1498,3820,1530,3891
220910,202104,1543,4145,1302,3788,53,141,1069,3144,1122,3285
220915,202104,982,2583,807,2269,14,46,616,1670,630,1716
220920,202104,1432,4387,1243,4142,53,221,1026,3443,1079,3664
220930,202104,1795,4732,1513,4329,18,51,1416,4045,1434,4096
220935,202104,1102,3136,897,2701,22,90,587,1675,609,1765
220937,202104,1519,3923,1310,3597,21,78,1055,2844,1076,2922
220940,202104,1582,4295,1269,3746,28,80,994,2903,1022,2983
220945,202104,441,1518,384,1398,15,91,293,1034,308,1125
220950,202104,1434,3277,958,2544,20,56,759,1948,779,2004
220955,202104,1644,4088,1366,3615,25,64,1176,3076,1201,3140
220960,202104,806,2023,605,1683,23,66,434,1157,457,1223
220965,202104,1807,4859,1573,4519,19,116,1361,3832,1380,3948
220970,202104,2014,4682,1485,3908,24,56,1244,3245,1268,3301
220975,202104,694,1930,598,1810,11,62,534,1570,545,1632
220980,202104,1158,3230,1027,3051,33,121,861,2546,894,2667
220985,202104,1295,3276,1127,3032,50,121,919,2424,969,2545
220987,202104,1462,4285,1288,3979,53,183,1045,3214,1098,3397
220990,202104,1737,4710,1535,4413,14,80,1315,3728,1329,3808
220995,202104,1131,3293,946,2954,34,106,705,2210,739,2316
220997,202104,2353,7084,2178,6806,45,199,1941,6007,1986,6206
221000,202104,4522,12218,3995,11448,82,355,3427,9718,3509,10073
221005,202104,1482,3812,1359,3612,17,82,1181,3053,1198,3135
221010,202104,1261,2781,1005,2469,16,45,883,2134,899,2179
221020,202104,1534,4643,1425,4441,19,70,1093,3373,1112,3443
221030,202104,1683,4018,1448,3732,20,52,1257,3299,1277,3351
221035,202104,1517,3877,1340,3642,19,25,1189,3310,1208,3335
221037,202104,712,1893,593,1692,7,22,432,1175,439,1197
221038,202104,532,1475,420,1281,14,57,289,872,303,929
221039,202104,874,2350,758,2161,23,93,621,1714,644,1807
221040,202104,4118,11934,3611,11042,148,446,2907,8941,3055,9387
221050,202104,3935,10179,3488,9615,70,221,3141,8660,3211,8881
221060,202104,8767,24132,7285,21707,320,778,5850,17650,6170,18428
221062,202104,1141,3634,988,3383,38,169,801,2713,839,2882
221063,202104,1078,2886,931,2676,47,137,741,2106,788,2243
221065,202104,2679,6774,2362,6217,17,54,2076,5391,2093,5445
221070,202104,3440,10469,2792,9128,273,875,1743,5813,2016,6688
221080,202104,3528,8556,2906,7643,61,208,2394,6188,2455,6396
221090,202104,1425,3579,1177,3185,9,29,1007,2678,1016,2707
221093,202104,1387,3833,1263,3592,139,363,849,2394,988,2757
221095,202104,874,2263,745,2068,9,27,634,1733,643,1760
221097,202104,869,2185,669,1831,23,54,500,1302,523,1356
221100,202104,118817,312420,99173,279191,10042,30183,64230,175899,74272,206082
221110,202104,9889,29211,9084,28165,129,653,8167,25109,8296,25762
221120,202104,4851,13200,4326,12370,154,434,3762,10800,3916,11234
221130,202104,5476,13935,4148,11394,828,2116,1982,5516,2810,7632
221135,202104,1741,4400,1571,4178,35,94,1413,3765,1448,3859
221140,202104,1345,3097,1134,2836,10,33,1028,2529,1038,2562
221150,202104,1101,2721,867,2322,22,99,669,1678,691,1777
221160,202104,742,1812,657,1704,24,30,532,1398,556,1428
221170,202104,1017,2856,934,2704,9,35,820,2339,829,2374
230010,202104,3059,7929,2534,7050,30,104,2103,5731,2133,5835
230015,202104,3093,9820,2738,9099,152,552,1942,6453,2094,7005
230020,202104,12919,40186,12103,38947,353,1364,10327,33130,10680,34494
230030,202104,13121,32087,11020,29358,214,577,9656,25744,9870,26321
230040,202104,4556,11550,3773,10273,40,183,3172,8505,3212,8688
230050,202104,2745,8415,2104,6940,333,1054,939,3029,1272,4083
230060,202104,2389,6461,1925,5633,26,107,1534,4413,1560,4520
230070,202104,4101,10544,3297,9035,205,585,2343,6343,2548,6928
230075,202104,8819,28582,8098,27334,492,1971,6422,21444,6914,23415
230080,202104,3036,6380,2319,5510,6,18,2120,5055,2126,5073
230090,202104,4429,10701,3768,9679,187,444,3016,7712,3203,8156
230100,202104,18368,46626,16134,43649,1313,3412,11560,31622,12873,35034
230110,202104,12736,37245,10704,33319,1739,5337,5580,17584,7319,22921
230120,202104,7806,20393,6874,18920,548,1293,5055,14110,5603,15403
230125,202104,3190,8338,2591,7385,86,281,2000,5614,2086,5895
230130,202104,5624,17174,4572,14891,400,1356,2942,9492,3342,10848
230140,202104,3430,10197,2938,9184,86,345,2254,6888,2340,7233
230150,202104,1631,4842,1340,4200,203,559,780,2518,983,3077
230160,202104,6506,16647,5627,15309,154,509,4670,12509,4824,13018
230170,202104,6462,18048,5323,15764,323,870,3811,11168,4134,12038
230180,202104,1657,4533,1405,4050,18,79,1154,3224,1172,3303
230185,202104,4489,12454,3808,11331,282,879,2814,8383,3096,9262
230190,202104,13810,39408,11612,35358,1331,4120,6862,20753,8193,24873
230195,202104,5369,15510,4901,14632,388,1121,3654,10933,4042,12054
230200,202104,5051,13758,4247,12268,151,454,3279,9294,3430,9748
230205,202104,4189,12141,3677,11373,209,652,2789,8614,2998,9266
230210,202104,10148,24189,8577,22108,350,1080,6738,17093,7088,18173
230220,202104,13777,34403,12102,32023,566,1490,10000,26242,10566,27732
230230,202104,6844,20189,6113,18713,412,1221,4512,13829,4924,15050
230240,202104,12883,34274,11148,31298,257,1099,9242,25350,9499,26449
230250,202104,8988,24780,8346,23783,239,808,6775,18782,7014,19590
230260,202104,14958,43421,12956,39916,2124,6146,7009,22310,9133,28456
230270,202104,7778,20523,5962,17137,545,1501,3841,11151,4386,12652
230280,202104,20486,54086,16830,47986,439,1727,13253,36434,13692,38161
230290,202104,5054,13645,4176,12013,226,563,3203,9191,3429,9754
230300,202104,4885,12773,4421,12147,92,254,3890,10671,3982,10925
230310,202104,4680,13168,3970,11901,122,501,2887,8470,3009,8971
230320,202104,7915,22480,6654,20183,206,848,5152,15275,5358,16123
230330,202104,4712,12637,3751,10822,114,362,2856,8039,2970,8401
230340,202104,3776,11458,3240,10365,235,781,2268,7179,2503,7960
230350,202104,18194,49005,15894,45644,790,2580,10877,31400,11667,33980
230360,202104,2977,7713,2354,6623,122,342,1645,4560,1767,4902
230365,202104,3093,7534,2553,6741,53,230,2181,5670,2234,5900
230370,202104,59801,162244,51051,149491,7039,20741,31335,92601,38374,113342
230380,202104,6314,17271,5005,14891,115,457,3752,10886,3867,11343
230390,202104,3427,9928,2971,9202,85,338,2326,7119,2411,7457
230393,202104,3420,9822,2728,8404,78,396,2124,6278,2202,6674
230395,202104,5725,15570,4990,14349,339,929,3518,10149,3857,11078
230400,202104,5387,14727,4816,13797,80,400,3898,10873,3978,11273
230410,202104,13798,40435,11459,36172,875,2969,7859,24816,8734,27785
230420,202104,29424,79200,24037,70056,2864,8616,13657,39488,16521,48104
230423,202104,4866,14101,4267,12923,100,386,3480,10391,3580,10777
230425,202104,5727,17252,5223,16229,437,1394,3718,11484,4155,12878
230426,202104,2856,7330,2094,5857,27,100,1584,4326,1611,4426
230427,202104,1860,5145,1361,4114,69,206,883,2574,952,2780
230428,202104,9644,25378,8258,23332,1194,3265,4748,13445,5942,16710
230430,202104,5034,13873,3984,12066,164,533,2957,8840,3121,9373
230435,202104,6171,15742,5148,13957,726,1780,3009,8322,3735,10102
230440,202104,423409,1029046,353380,927759,32678,90560,233611,604519,266289,695079
230445,202104,4300,11286,3480,9867,183,492,2381,6598,2564,7090
230450,202104,3624,10229,3165,9572,230,829,2325,6842,2555,7671
230460,202104,2146,5869,1870,5435,49,200,1585,4572,1634,4772
230465,202104,4116,11356,3509,10202,100,377,2671,7473,2771,7850
230470,202104,11490,37157,10321,35020,888,3315,7253,24299,8141,27614
230480,202104,1478,4218,1242,3795,59,242,931,2734,990,2976
230490,202104,2608,7153,2215,6420,167,553,1410,3851,1577,4404
230495,202104,5703,16720,5044,15562,418,1460,3336,10193,3754,11653
230500,202104,9476,29843,8442,27953,231,938,6927,22942,7158,23880
230510,202104,1642,4780,1300,4053,161,534,691,2115,852,2649
230520,202104,4741,12945,4110,11854,342,880,2864,8316,3206,9196
230523,202104,15503,44973,12415,38497,2725,8438,3152,10437,5877,18875
230526,202104,3772,10548,3237,9655,192,514,2352,7105,2544,7619
230530,202104,5419,16762,4572,15110,294,1071,3317,10794,3611,11865
230533,202104,4680,10798,3841,9494,106,266,3202,7791,3308,8057
230535,202104,5276,14551,4476,13209,306,897,2992,8923,3298,9820
230540,202104,16085,43312,13818,39987,272,1001,11448,32900,11720,33901
230550,202104,21572,55716,17409,48755,1470,4177,11326,31549,12796,35726
230560,202104,8108,19627,6615,17290,57,226,5695,14760,5752,14986
230565,202104,3085,8437,2599,7552,104,408,1994,5669,2098,6077
230570,202104,3431,8685,2937,8001,87,219,2410,6568,2497,6787
230580,202104,11269,28478,9693,26245,378,985,7998,21615,8376,22600
230590,202104,8983,25024,7502,22347,408,1378,5611,16197,6019,17575
230600,202104,3801,9518,3019,8178,90,223,2068,5647,2158,5870
230610,202104,6775,18351,6024,17098,437,1176,4772,13478,5209,14654
230620,202104,2141,5656,1676,4775,105,322,1051,2885,1156,3207
230625,202104,8280,22773,6984,20464,1968,5974,2049,6381,4017,12355
230630,202104,10967,31863,9553,29129,1338,3864,5767,17910,7105,21774
230640,202104,27512,82215,24942,78180,1133,4364,20068,62019,21201,66383
230650,202104,5335,14034,4522,12632,123,452,3698,10076,3821,10528
230655,202104,9373,31095,8822,30158,665,2210,7043,24405,7708,26615
230660,202104,6126,17934,5012,15987,132,705,4077,12732,4209,13437
230670,202104,6250,14622,4598,12020,126,407,3702,9443,3828,9850
230680,202104,2730,7312,2300,6552,122,314,1655,4737,1777,5051
230690,202104,7268,21057,6260,19107,395,1374,4010,12019,4405,13393
230700,202104,10469,26208,8525,22689,375,856,6291,16524,6666,17380
230710,202104,6933,21583,6087,19788,656,1994,4023,13083,4679,15077
230720,202104,1860,5446,1529,4798,104,294,1062,3275,1166,3569
230725,202104,4172,12000,3740,11255,388,1272,2254,6682,2642,7954
230730,202104,57767,152483,45480,134150,10015,31499,14879,46883,24894,78382
230740,202104,6163,16833,5238,15351,130,405,4189,12281,4319,12686
230750,202104,8502,22294,7113,20017,157,506,5702,15675,5859,16181
230760,202104,11138,28878,9682,26696,476,1545,7386,19881,7862,21426
230763,202104,5106,13406,4288,11967,105,465,3492,9422,3597,9887
230765,202104,41603,110705,34570,99459,5205,15461,17907,50925,23112,66386
230770,202104,25403,61848,21279,56456,2144,5637,14284,38010,16428,43647
230780,202104,6499,22389,5899,20960,843,2870,3449,12653,4292,15523
230790,202104,3127,8679,2821,8189,96,381,2184,6139,2280,6520
230800,202104,8220,25747,7221,23735,945,3250,4154,13505,5099,16755
230810,202104,11118,33180,9993,31385,365,1333,7802,24129,8167,25462
230820,202104,3479,11114,2863,9763,264,1025,1715,5570,1979,6595
230830,202104,7593,20386,6496,18571,111,461,5373,14956,5484,15417
230835,202104,4295,10058,3327,8555,96,265,2661,6740,2757,7005
230837,202104,3117,9333,2789,8780,112,445,2228,6893,2340,7338
230840,202104,9438,27009,8129,24769,965,2678,5610,17356,6575,20034
230850,202104,9808,27852,8231,24782,350,1162,5997,17803,6347,18965
230860,202104,5479,13442,4566,12143,55,180,4046,10691,4101,10871
230870,202104,16492,39585,14218,35841,395,1069,11676,28898,12071,29967
230880,202104,2131,6314,1953,6031,45,230,1556,4682,1601,4912
230890,202104,4505,14222,4114,13455,324,1133,3011,9729,3335,10862
230900,202104,3053,8605,2645,7848,165,549,1832,5302,1997,5851
230910,202104,3205,8414,2600,7488,57,253,2105,6058,2162,6311
230920,202104,4776,13173,4020,11977,104,425,3222,9383,3326,9808
230930,202104,6700,18299,5629,16412,275,739,3962,11588,4237,12327
230940,202104,8330,20570,7234,18926,201,463,6066,15798,6267,16261
230945,202104,6641,18667,5693,16886,284,984,4074,11805,4358,12789
230950,202104,6268,15544,5551,14571,113,254,4775,12615,4888,12869
230960,202104,13575,38470,11915,35370,2021,5803,5815,17491,7836,23294
230970,202104,13658,35628,11416,32196,1650,4468,6661,19057,8311,23525
230980,202104,2713,7725,2406,7188,338,943,1525,4723,1863,5666
230990,202104,1691,4660,1395,4085,59,237,1003,2792,1062,3029
231000,202104,2549,6739,2082,5829,76,185,1547,4234,1623,4419
231010,202104,3714,8509,2926,7176,28,109,2561,6106,2589,6215
231020,202104,7995,24395,7151,22796,1228,3530,4180,13875,5408,17405
231025,202104,7596,20427,6614,18839,710,1942,4665,13427,5375,15369
231030,202104,7420,21671,5859,18418,999,2948,2964,9462,3963,12410
231040,202104,2948,8296,2564,7598,121,364,2004,5845,2125,6209
231050,202104,11696,29548,9593,25887,617,1588,7168,19000,7785,20588
231060,202104,2912,8063,2575,7527,53,157,2166,6334,2219,6491
231070,202104,7915,22597,6814,20680,651,2027,4575,13771,5226,15798
231080,202104,3984,11081,3385,10106,138,519,2574,7523,2712,8042
231085,202104,6972,16424,5561,14778,206,484,4393,11720,4599,12204
231090,202104,4597,11770,3398,9486,99,379,2312,6197,2411,6576
231095,202104,2284,6679,1815,5688,154,467,1211,3799,1365,4266
231100,202104,3245,9184,2664,8088,117,411,1998,6007,2115,6418
231110,202104,3715,10614,3385,10001,137,476,2574,7493,2711,7969
231120,202104,2341,6658,1942,5969,78,275,1409,4293,1487,4568
231123,202104,1947,4922,1645,4408,85,172,1198,3239,1283,3411
231126,202104,5513,14938,4534,13097,298,802,3231,9268,3529,10070
231130,202104,22040,54660,18327,50038,1053,3238,13674,36820,14727,40058
231135,202104,4192,11672,3493,10324,180,571,2476,7233,2656,7804
231140,202104,16593,45998,13397,40509,670,2396,9473,28049,10143,30445
231150,202104,5986,15920,4545,13209,635,1860,1975,5920,2610,7780
231160,202104,6283,18976,5607,17751,784,2392,3173,10374,3957,12766
231170,202104,4190,12099,3517,10861,172,595,2496,7468,2668,8063
231180,202104,14301,39881,11708,34544,2968,8537,4219,12884,7187,21421
231190,202104,3979,11028,3270,9749,61,247,2530,7396,2591,7643
231195,202104,5109,14935,4282,13269,289,936,3073,9523,3362,10459
231200,202104,7810,23964,6862,22070,180,889,5436,16960,5616,17849
231210,202104,4942,14195,4223,13011,143,503,3278,9916,3421,10419
231220,202104,12371,31430,9780,26644,435,1220,7158,18961,7593,20181
231230,202104,9184,29020,8116,27047,544,2026,5923,19828,6467,21854
231240,202104,11590,33254,10220,30711,1612,4634,6119,18702,7731,23336
231250,202104,2179,5490,1439,3890,114,318,855,2240,969,2558
231260,202104,3304,9106,2874,8428,264,710,1965,5917,2229,6627
231270,202104,6397,16501,5147,14448,149,546,3906,10689,4055,11235
231280,202104,1741,5316,1598,5059,84,246,1215,3830,1299,4076
231290,202104,38253,112211,31849,99469,5327,16407,14718,45703,20045,62110
231300,202104,4163,11265,3284,9532,161,529,2259,6392,2420,6921
231310,202104,7566,19068,6052,16316,522,1397,4107,10832,4629,12229
231320,202104,7782,21079,6106,18129,88,390,4796,14041,4884,14431
231325,202104,2512,6341,2069,5692,169,335,1454,4142,1623,4477
231330,202104,9658,28139,8033,24938,1522,4387,4227,13848,5749,18235
231335,202104,5695,14865,4871,13573,59,279,4314,11881,4373,12160
231340,202104,18145,54273,16374,51154,1216,3762,12251,38612,13467,42374
231350,202104,15856,42959,14514,41029,237,841,13080,36647,13317,37488
231355,202104,4399,12880,3977,12087,220,706,3119,9369,3339,10075
231360,202104,7687,22633,6668,20891,280,944,5312,16607,5592,17551
231370,202104,2183,5951,1753,5178,35,109,1336,3929,1371,4038
231375,202104,4281,13254,3913,12655,118,522,3276,10479,3394,11001
231380,202104,6073,16309,5498,15522,193,478,4479,12822,4672,13300
231390,202104,3376,9709,3036,9132,107,406,2266,6629,2373,7035
231395,202104,4133,11800,3436,10696,334,1044,2187,6832,2521,7876
231400,202104,9834,27864,8255,24990,246,1043,6289,18621,6535,19664
231410,202104,14913,45285,13646,43208,632,2056,11047,34839,11679,36895
240010,202104,2644,6787,2067,5766,213,592,1211,3334,1424,3926
240020,202104,12805,35091,10737,31463,628,2189,7139,20613,7767,22802
240030,202104,3055,7145,2732,6672,109,283,2371,5746,2480,6029
240040,202104,833,2359,708,2126,30,112,484,1402,514,1514
240050,202104,3359,8862,2729,7735,43,117,2092,5825,2135,5942
240060,202104,1413,3714,1159,3254,22,74,950,2613,972,2687
240070,202104,2175,6145,1964,5702,198,585,1423,4042,1621,4627
240080,202104,2953,7854,2400,6882,62,221,1809,5106,1871,5327
240090,202104,2261,5529,1849,4839,18,49,1553,4017,1571,4066
240100,202104,10359,24943,8278,21276,187,554,6545,16253,6732,16807
240110,202104,4556,12768,3832,11461,174,635,2813,8226,2987,8861
240120,202104,3328,9101,2700,8325,172,556,1958,6173,2130,6729
240130,202104,3777,7671,3131,6840,26,75,2870,6199,2896,6274
240140,202104,1742,5205,1502,4736,157,546,1024,3193,1181,3739
240145,202104,6598,18090,5404,16066,834,2525,3084,9281,3918,11806
240150,202104,966,2750,851,2516,43,133,666,1923,709,2056
240160,202104,1469,4336,1234,3899,37,157,943,2983,980,3140
240165,202104,981,2647,818,2339,21,85,681,1903,702,1988
240170,202104,2682,7027,2262,6292,207,599,1527,4164,1734,4763
240180,202104,3023,8817,2411,7580,564,1690,1054,3523,1618,5213
240185,202104,1248,3813,1155,3651,48,177,974,3044,1022,3221
240190,202104,1082,3134,932,2888,18,78,795,2478,813,2556
240200,202104,10849,27259,8652,23576,881,2566,4969,13273,5850,15839
240210,202104,3353,8111,2717,7095,23,115,2298,5805,2321,5920
240220,202104,7286,21643,6554,20508,318,1368,5225,16086,5543,17454
240230,202104,5878,14726,4705,12809,230,560,3691,10121,3921,10681
240240,202104,1816,5189,1183,3736,113,375,397,1122,510,1497
240250,202104,3060,7807,2670,7268,72,214,2294,6194,2366,6408
240260,202104,13739,40356,11925,37333,1695,4931,7377,24279,9072,29210
240270,202104,2345,6858,2059,6381,113,337,1492,4777,1605,5114
240280,202104,1729,4321,1456,3881,62,152,1155,3051,1217,3203
240290,202104,1175,3395,961,2926,28,123,694,1997,722,2120
240300,202104,2336,5854,1687,4682,70,208,1045,2843,1115,3051
240310,202104,8432,22111,6631,18919,866,2610,3395,9526,4261,12136
240320,202104,2102,5610,1527,4500,33,140,1146,3221,1179,3361
240325,202104,31817,83477,25481,72554,4193,12255,11788,33531,15981,45786
240330,202104,1802,4839,1392,4069,58,185,962,2700,1020,2885
240340,202104,1967,4471,1611,3943,55,127,1326,3193,1381,3320
240350,202104,2230,5559,1999,5300,37,98,1806,4810,1843,4908
240360,202104,9444,25379,8388,23759,821,2300,5910,16946,6731,19246
240370,202104,2005,5082,1569,4219,56,149,1121,2927,1177,3076
240375,202104,930,2311,775,2043,27,89,620,1573,647,1662
240380,202104,2235,6301,1675,5073,143,393,958,2885,1101,3278
240390,202104,1069,2535,766,1973,26,52,490,1176,516,1228
240400,202104,1528,3661,1180,3063,31,102,847,2075,878,2177
240410,202104,590,1701,482,1493,37,133,315,927,352,1060
240420,202104,4543,15672,4015,14506,441,1880,2434,8608,2875,10488
240430,202104,3466,8725,2884,7733,168,500,2159,5616,2327,6116
240440,202104,2526,5472,2145,4951,139,263,1738,4049,1877,4312
240450,202104,4599,12262,3629,10484,352,1032,2123,5915,2475,6947
240460,202104,2922,8226,2589,7688,212,676,2031,6018,2243,6694
240470,202104,3634,10789,2750,8945,576,1765,1260,4349,1836,6114
240480,202104,595,1597,398,1167,31,81,186,524,217,605
240485,202104,2230,6090,1806,5335,123,345,1242,3676,1365,4021
240490,202104,1631,4128,1290,3499,84,181,947,2603,1031,2784
240500,202104,2192,5822,1902,5326,108,283,1522,4297,1630,4580
240510,202104,1689,4404,1469,4078,70,233,1199,3274,1269,3507
240520,202104,1540,3621,1190,3151,75,179,873,2383,948,2562
240530,202104,2245,6131,2025,5786,97,283,1692,4797,1789,5080
240540,202104,2345,5745,2058,5304,65,108,1767,4600,1832,4708
240550,202104,710,1947,644,1817,15,63,552,1508,567,1571
240560,202104,3287,8418,2784,7754,264,639,2027,5796,2291,6435
240570,202104,2841,7331,1920,5345,291,790,689,1837,980,2627
240580,202104,7967,23187,7060,21523,578,1634,5587,17244,6165,18878
240590,202104,780,1928,688,1779,11,33,545,1382,556,1415
240600,202104,1842,4905,1364,3925,45,132,919,2546,964,2678
240610,202104,4198,11024,3592,9947,118,363,2792,7587,2910,7950
240615,202104,1276,3237,1026,2801,112,283,695,1879,807,2162
240620,202104,1853,5076,1600,4654,108,267,1268,3703,1376,3970
240630,202104,2070,5714,1864,5363,135,286,1333,3996,1468,4282
240640,202104,969,2553,773,2229,26,94,575,1625,601,1719
240650,202104,4099,11281,3528,10119,234,645,2670,7571,2904,8216
240660,202104,3058,7747,2716,7315,47,146,2473,6663,2520,6809
240670,202104,2479,6873,2003,5908,146,438,1299,3746,1445,4184
240680,202104,1637,4285,1334,3776,59,170,1006,2779,1065,2949
240690,202104,1053,2565,829,2195,15,63,667,1697,682,1760
240700,202104,2496,7127,2037,6270,68,233,1568,4759,1636,4992
240710,202104,16294,41398,13697,37030,1703,4509,8672,23368,10375,27877
240720,202104,5099,12357,4405,11397,371,975,3293,8447,3664,9422
240725,202104,1151,3222,887,2712,38,113,595,1764,633,1877
240730,202104,2318,6328,1858,5424,49,160,1420,4087,1469,4247
240740,202104,1907,5065,1536,4333,47,171,1127,3018,1174,3189
240750,202104,2158,6969,1835,6298,242,879,1023,3554,1265,4433
240760,202104,1691,3811,1220,3104,63,85,944,2466,1007,2551
240770,202104,3265,8893,2754,8152,128,443,2241,6565,2369,7008
240780,202104,4676,12889,3864,11545,537,1578,2366,7270,2903,8848
240790,202104,897,2496,748,2213,18,83,565,1614,583,1697
240800,202104,49549,116159,38605,99808,5084,13262,20329,52491,25413,65753
240810,202104,91874,232841,78098,210446,8510,23695,51340,135902,59850,159597
240820,202104,6022,17561,5232,16151,715,2153,3220,10133,3935,12286
240830,202104,8842,24705,7849,23244,236,913,6514,19097,6750,20010
240840,202104,1122,2735,896,2378,25,63,647,1657,672,1720
240850,202104,1419,3789,1025,2971,61,183,580,1619,641,1802
240860,202104,1363,3551,1030,2959,13,59,798,2191,811,2250
240870,202104,1098,2738,834,2296,142,403,446,1260,588,1663
240880,202104,1266,3968,1115,3676,75,319,860,2764,935,3083
240890,202104,4442,11997,3416,10089,436,1398,1751,4967,2187,6365
240895,202104,2877,8684,2658,8341,172,499,2240,7164,2412,7663
240910,202104,3541,9311,3000,8353,48,160,2473,6755,2521,6915
240920,202104,994,2545,800,2244,87,179,448,1346,535,1525
240930,202104,3692,8263,3045,7476,215,315,2249,5883,2464,6198
240933,202104,1695,4130,1427,3751,33,133,1259,3251,1292,3384
240940,202104,5996,14700,4690,12446,536,1403,2771,7243,3307,8646
240950,202104,1071,3122,940,2888,28,117,762,2277,790,2394
240960,202104,685,2096,615,1956,25,83,477,1497,502,1580
240970,202104,1890,4809,1523,4189,59,199,1243,3332,1302,3531
240980,202104,3360,9819,2964,9114,103,454,2419,7301,2522,7755
240990,202104,2632,7256,2328,6671,243,774,1658,4579,1901,5353
241000,202104,945,2463,746,2106,29,69,555,1544,584,1613
241010,202104,2860,8883,2604,8340,168,612,1925,6091,2093,6703
241020,202104,2204,5721,1667,4667,111,298,1130,3071,1241,3369
241025,202104,1820,5118,1458,4460,39,161,1064,3188,1103,3349
241030,202104,2503,7733,2025,6723,234,768,1284,4296,1518,5064
241040,202104,2285,7119,2010,6637,84,377,1587,5207,1671,5584
241050,202104,1394,3848,1148,3403,32,114,842,2426,874,2540
241060,202104,777,2138,682,1947,32,91,479,1329,511,1420
241070,202104,688,1825,592,1668,13,36,456,1244,469,1280
241080,202104,1135,3187,882,2681,25,76,644,1938,669,2014
241090,202104,1979,5721,1617,5103,47,218,1273,3958,1320,4176
241100,202104,1212,3289,929,2723,63,183,608,1737,671,1920
241105,202104,946,2847,777,2535,239,763,255,860,494,1623
241110,202104,999,2753,751,2236,34,96,515,1481,549,1577
241120,202104,7680,21462,6496,19380,889,2589,3909,12003,4798,14592
241140,202104,3402,8856,2642,7350,138,387,1919,5227,2057,5614
241142,202104,800,2118,592,1726,28,88,353,983,381,1071
241150,202104,6030,15301,5352,14215,159,438,4375,11488,4534,11926
241160,202104,1184,3170,948,2741,135,399,600,1690,735,2089
241170,202104,1381,3450,1170,3083,33,103,965,2451,998,2554
241180,202104,1068,2694,801,2183,94,265,391,1063,485,1328
241190,202104,1172,3019,980,2635,17,69,724,1870,741,1939
241200,202104,20057,51318,17373,46947,2706,7277,10127,27353,12833,34630
241210,202104,1455,3796,1060,3024,107,324,607,1696,714,2020
241220,202104,9144,25984,7996,24078,1698,5078,3948,12326,5646,17404
241230,202104,2975,7727,2638,7207,115,322,2172,5889,2287,6211
241240,202104,1253,3444,812,2489,73,231,344,1052,417,1283
241250,202104,5708,16018,4579,13912,148,631,3387,9905,3535,10536
241255,202104,2301,7016,2043,6489,108,407,1567,4892,1675,5299
241260,202104,4957,12661,3942,10993,84,323,3148,8594,3232,8917
241270,202104,1671,4794,1400,4279,103,337,1008,3091,1111,3428
241280,202104,2246,5502,1934,4943,66,158,1639,4135,1705,4293
241290,202104,3389,8233,2505,6815,75,234,1968,5222,2043,5456
241300,202104,1543,4025,1245,3512,36,116,852,2344,888,2460
241310,202104,2175,5289,1877,4869,20,58,1626,4269,1646,4327
241320,202104,935,3001,804,2756,82,339,528,1794,610,2133
241330,202104,1807,4549,1421,4036,16,87,1249,3517,1265,3604
241335,202104,3344,9177,2945,8453,115,358,2391,6786,2506,7144
241340,202104,1591,4388,1251,3701,238,766,537,1509,775,2275
241350,202104,2199,5949,1927,5463,113,310,1502,4230,1615,4540
241355,202104,1339,3562,1106,3116,13,31,851,2364,864,2395
241360,202104,2070,5306,1568,4301,41,107,1157,3097,1198,3204
241370,202104,1392,3754,1087,3120,46,133,777,2167,823,2300
241380,202104,694,1869,535,1561,73,184,268,800,341,984
241390,202104,2738,7928,2443,7493,191,514,1885,5908,2076,6422
241400,202104,3590,9816,3204,9225,139,461,2601,7424,2740,7885
241410,202104,2455,7171,2001,6240,327,1044,1047,3280,1374,4324
241415,202104,1712,4916,1424,4368,49,169,1052,3185,1101,3354
241420,202104,2394,7303,2068,6760,432,1551,1098,3587,1530,5138
241430,202104,629,1664,445,1278,15,44,288,791,303,835
241440,202104,7904,23505,7080,22067,359,1206,5645,17611,6004,18817
241445,202104,1193,2920,1057,2740,46,94,900,2435,946,2529
241450,202104,2816,6674,2375,5983,369,783,1581,4144,1950,4927
241460,202104,3926,10417,3193,8901,214,556,2192,6001,2406,6557
241470,202104,1420,3720,1167,3340,23,75,971,2786,994,2861
241475,202104,1246,3400,990,2911,22,103,738,2066,760,2169
241480,202104,3018,9244,2486,8094,744,2398,812,2952,1556,5350
241490,202104,672,1549,530,1348,20,39,412,1040,432,1079
241500,202104,795,2207,713,2105,3,10,665,1983,668,1993
250010,202104,2628,7715,2209,6860,56,198,1616,4913,1672,5111
250020,202104,1689,4396,1231,3518,50,87,875,2527,925,2614
250030,202104,7076,19003,6272,17745,549,1519,4674,13137,5223,14656
250040,202104,4130,12315,3583,11317,267,871,2610,8130,2877,9001
250050,202104,3657,9598,3309,9145,91,327,2788,7689,2879,8016
250053,202104,1221,3329,1120,3170,85,222,816,2327,901,2549
250057,202104,688,2335,638,2257,7,36,583,2081,590,2117
250060,202104,5533,14174,4982,13500,262,680,4160,11367,4422,12047
250070,202104,4094,11152,3448,10042,29,108,2791,7945,2820,8053
250073,202104,781,2032,637,1811,10,20,512,1434,522,1454
250077,202104,2294,5936,1745,5052,55,183,1349,3863,1404,4046
250080,202104,5093,12336,4303,11344,57,231,3810,9904,3867,10135
250090,202104,3479,8187,3032,7599,55,149,2620,6458,2675,6607
250100,202104,3654,10866,3291,10212,155,513,2579,7866,2734,8379
250110,202104,4912,13629,4446,12971,253,899,3473,9962,3726,10861
250115,202104,741,1839,545,1541,13,51,413,1146,426,1197
250120,202104,1900,5409,1595,4910,25,121,1272,3883,1297,4004
250130,202104,5677,15223,4792,13959,65,345,4105,11808,4170,12153
250135,202104,1228,3325,1068,3054,15,48,938,2689,953,2737
250140,202104,2319,6609,2158,6413,102,387,1871,5537,1973,5924
250150,202104,4801,14625,4300,13777,130,521,3461,10929,3591,11450
250153,202104,1398,3653,1165,3312,35,92,923,2608,958,2700
250157,202104,1861,5293,1685,4969,63,227,1361,3951,1424,4178
250160,202104,3901,9614,3102,8551,43,146,2712,7500,2755,7646
250170,202104,1874,4775,1687,4513,25,92,1472,3884,1497,3976
250180,202104,20767,48831,17759,45036,709,2109,14129,34961,14838,37070
250190,202104,4140,10833,3484,9877,297,859,2497,6950,2794,7809
250200,202104,2009,5204,1736,4837,64,175,1463,4093,1527,4268
250205,202104,881,2657,760,2472,7,28,618,1986,625,2014
250210,202104,1565,4634,1419,4412,57,238,1135,3470,1192,3708
250215,202104,1620,4316,1350,3939,77,236,792,2348,869,2584
250220,202104,668,1821,533,1614,25,93,354,1060,379,1153
250230,202104,1705,3774,1195,3020,17,46,959,2375,976,2421
250240,202104,2406,7080,2123,6568,36,168,1825,5551,1861,5719
250250,202104,4655,12704,4068,11860,88,267,3470,10171,3558,10438
250260,202104,1697,4678,1441,4239,50,117,1139,3340,1189,3457
250270,202104,1216,3634,1107,3498,52,183,844,2745,896,2928
250280,202104,3540,9373,3178,8854,136,318,2526,7081,2662,7399
250290,202104,1547,4043,1333,3735,16,48,1067,2973,1083,3021
250300,202104,5540,14550,4985,13903,162,701,4222,11384,4384,12085
250310,202104,1194,3277,996,2952,36,116,753,2213,789,2329
250320,202104,12516,27488,10807,25543,250,662,9738,22737,9988,23399
250330,202104,2380,6476,2001,5951,138,352,1586,4774,1724,5126
250340,202104,1154,2867,1028,2707,13,34,949,2492,962,2526
250350,202104,4221,11677,3737,10861,208,461,2941,8831,3149,9292
250355,202104,2061,6076,1850,5795,28,142,1663,5204,1691,5346
250360,202104,1813,4859,1629,4611,38,124,1380,3871,1418,3995
250370,202104,13954,34951,11609,31424,224,798,9862,26298,10086,27096
250375,202104,1204,3057,974,2781,5,18,923,2649,928,2667
250380,202104,1654,4153,1520,3986,31,112,1342,3420,1373,3532
250390,202104,1873,4700,1581,4246,76,200,1269,3394,1345,3594
250400,202104,70033,169898,51850,142115,14319,42400,13932,40706,28251,83106
250403,202104,1786,4902,1594,4679,66,331,1255,3501,1321,3832
250407,202104,1354,3190,1061,2764,99,203,678,1917,777,2120
250410,202104,656,1741,564,1588,6,14,470,1299,476,1313
250415,202104,1903,5216,1666,4841,30,139,1433,4141,1463,4280
250420,202104,1208,3301,1099,3149,31,106,991,2823,1022,2929
250430,202104,6301,15308,5360,14081,154,436,4422,11393,4576,11829
250435,202104,1574,4361,1278,3862,12,64,983,2922,995,2986
250440,202104,4682,12172,4058,11385,71,184,3615,10142,3686,10326
250450,202104,1828,4760,1513,4333,30,102,1245,3588,1275,3690
250460,202104,7212,19429,6424,18285,361,1068,5118,14554,5479,15622
250470,202104,1548,3963,1284,3560,47,145,1027,2803,1074,2948
250480,202104,3992,10715,3395,9999,38,125,2995,8902,3033,9027
250485,202104,738,1634,553,1375,47,73,390,955,437,1028
250490,202104,5260,12280,4681,11623,168,478,4160,10158,4328,10636
250500,202104,2033,5548,1820,5179,74,219,1473,4193,1547,4412
250510,202104,5479,13633,4726,12634,77,173,4135,11157,4212,11330
250520,202104,1826,4866,1549,4475,109,332,1124,3232,1233,3564
250523,202104,2208,5429,1951,5097,66,250,1631,4126,1697,4376
250527,202104,1701,4270,1528,4079,25,65,1353,3631,1378,3696
250530,202104,626,1588,540,1464,11,22,474,1290,485,1312
250535,202104,1407,4028,1272,3779,25,103,1026,2957,1051,3060
250540,202104,3123,6923,2605,6345,82,146,2282,5681,2364,5827
250550,202104,786,2474,693,2291,20,65,519,1702,539,1767
250560,202104,1777,4840,1568,4546,37,135,1328,3768,1365,3903
250570,202104,2712,7928,2328,7236,77,271,1821,5581,1898,5852
250580,202104,1070,2747,941,2568,44,155,793,2117,837,2272
250590,202104,849,2274,759,2142,20,61,635,1786,655,1847
250600,202104,8197,21003,6825,19210,239,737,5519,15437,5758,16174
250610,202104,2993,8365,2682,7908,108,395,2225,6497,2333,6892
250620,202104,851,2165,733,1970,15,39,530,1407,545,1446
250625,202104,2451,6980,2190,6552,41,203,1871,5448,1912,5651
250630,202104,10457,28195,8558,24960,875,2563,5523,15791,6398,18354
250640,202104,3572,9520,3199,9026,86,324,2783,7751,2869,8075
250650,202104,975,2320,824,2115,13,36,723,1835,736,1871
250660,202104,1663,4048,1331,3594,36,92,1095,2883,1131,2975
250670,202104,2372,7249,2159,6877,38,164,1893,5921,1931,6085
250680,202104,5923,13588,5293,12885,51,194,4931,11831,4982,12025
250690,202104,6830,15254,5752,13921,106,228,5078,12239,5184,12467
250700,202104,4330,12092,3783,11277,503,1462,2504,7533,3007,8995
250710,202104,4415,12526,3861,11743,273,834,2832,8622,3105,9456
250720,202104,2863,7506,2569,7088,28,140,2306,6304,2334,6444
250730,202104,4183,10976,3672,10301,104,414,3093,8444,3197,8858
250740,202104,1992,4841,1648,4395,94,207,1299,3497,1393,3704
250750,202104,107543,259439,91539,237214,7154,19665,67140,170983,74294,190648
250760,202104,2403,6046,2106,5569,68,186,1718,4432,1786,4618
250770,202104,4016,12019,3597,11461,398,1226,2574,8337,2972,9563
250780,202104,1781,4713,1501,4210,63,195,1162,3192,1225,3387
250790,202104,2541,7316,2202,6815,95,385,1600,4828,1695,5213
250800,202104,2472,6438,2167,5946,98,194,1758,4888,1856,5082
250810,202104,1301,3361,1089,3063,34,68,909,2606,943,2674
250820,202104,1989,5448,1830,5276,28,118,1663,4759,1691,4877
250830,202104,5987,17703,4927,15552,275,1017,3335,10264,3610,11281
250840,202104,758,2375,653,2170,16,60,497,1662,513,1722
250850,202104,1802,5245,1617,4910,30,124,1341,3986,1371,4110
250855,202104,1038,2906,895,2677,59,184,684,2049,743,2233
250860,202104,3235,9414,2694,8515,446,1460,1548,4963,1994,6423
250870,202104,1041,2830,888,2584,39,132,719,2067,758,2199
250880,202104,1635,4158,1352,3742,86,246,1034,2857,1120,3103
250890,202104,10480,26360,9267,24757,455,1531,7403,19024,7858,20555
250900,202104,2965,7916,2569,7228,98,236,2152,6007,2250,6243
250905,202104,2549,6933,2357,6670,40,137,2159,6113,2199,6250
250910,202104,6225,15024,5144,13801,67,204,4514,12161,4581,12365
250915,202104,2159,4942,1504,4238,26,56,1318,3801,1344,3857
250920,202104,3637,9036,3203,8380,275,617,2452,6423,2727,7040
250930,202104,2333,6179,2111,5893,45,191,1825,4975,1870,5166
250933,202104,1213,3510,1079,3272,23,93,861,2553,884,2646
250937,202104,706,1889,587,1695,21,69,460,1349,481,1418
250939,202104,1863,4781,1629,4484,60,151,1276,3512,1336,3663
250940,202104,4079,10663,3590,10020,17,62,3219,8991,3236,9053
250950,202104,1770,4490,1430,4048,25,88,1163,3244,1188,3332
250960,202104,1125,3263,992,3052,21,107,822,2451,843,2558
250970,202104,8313,21150,7330,19586,209,634,6079,15964,6288,16598
250980,202104,2411,6338,2180,6007,24,107,1910,5140,1934,5247
250990,202104,2073,6179,1743,5621,57,242,1303,4161,1360,4403
251000,202104,2051,5728,1665,5064,35,151,1366,4127,1401,4278
251010,202104,2738,7470,2488,7087,23,83,2242,6386,2265,6469
251020,202104,1634,4426,1463,4158,28,125,1267,3534,1295,3659
251030,202104,1055,2741,867,2417,48,125,584,1623,632,1748
251040,202104,1838,5067,1548,4576,27,130,1287,3785,1314,3915
251050,202104,1045,2822,879,2506,46,152,631,1725,677,1877
251060,202104,1088,2300,823,1974,10,29,629,1491,639,1520
251065,202104,488,1315,374,1104,9,26,258,736,267,762
251070,202104,749,1896,631,1721,7,26,544,1446,551,1472
251080,202104,18885,47338,15321,41991,2150,6038,9320,25893,11470,31931
251090,202104,2922,8227,2469,7438,58,174,1950,5856,2008,6030
251100,202104,818,2568,724,2384,23,84,574,1824,597,1908
251110,202104,1774,4615,1509,4153,69,152,1147,3171,1216,3323
251120,202104,7588,20634,6413,19217,291,993,5070,15241,5361,16234
251130,202104,3935,8628,3472,8108,55,146,3164,7351,3219,7497
251140,202104,4318,11891,3845,11228,68,286,3218,9290,3286,9576
251150,202104,2712,7685,2475,7298,69,296,2120,6104,2189,6400
251160,202104,2207,6327,1913,5903,35,168,1655,5011,1690,5179
251170,202104,1646,4338,1443,4078,20,65,1290,3617,1310,3682
251180,202104,2662,7005,2179,6329,147,422,1521,4416,1668,4838
251190,202104,4464,11514,4036,11036,39,215,3671,9843,3710,10058
251200,202104,4435,12717,3916,12068,72,294,3457,10673,3529,10967
251203,202104,977,3092,894,2904,22,100,678,2143,700,2243
251207,202104,1121,2981,851,2552,15,69,605,1774,620,1843
251210,202104,7829,19375,6432,17478,303,646,4890,13599,5193,14245
251220,202104,1275,2978,954,2558,59,126,717,1978,776,2104
251230,202104,4727,12960,4081,11826,109,368,3229,9132,3338,9500
251240,202104,3679,10022,3095,9043,165,428,2317,6721,2482,7149
251250,202104,10702,28276,9393,26071,678,1877,7005,18984,7683,20861
251260,202104,511,1413,464,1339,15,65,374,1044,389,1109
251270,202104,4298,13239,3867,12659,105,416,3162,10573,3267,10989
251272,202104,1321,3579,1202,3420,49,181,1005,2797,1054,2978
251274,202104,907,2510,727,2185,57,194,477,1376,534,1570
251275,202104,1205,3368,1027,3081,28,115,814,2381,842,2496
251276,202104,1338,3609,1166,3381,25,130,952,2669,977,2799
251278,202104,614,1656,556,1575,41,107,423,1214,464,1321
251280,202104,2259,6030,2057,5735,51,142,1736,4809,1787,4951
251290,202104,6049,13914,5493,13246,164,494,4829,11320,4993,11814
251300,202104,888,2577,804,2450,9,46,682,2062,691,2108
251310,202104,2757,7740,2397,7194,34,178,1992,5851,2026,6029
251315,202104,1782,5425,1621,5113,117,315,1209,3811,1326,4126
251320,202104,1641,4312,1205,3553,29,96,905,2624,934,2720
251330,202104,2130,4924,1766,4498,24,72,1578,4054,1602,4126
251335,202104,1121,3128,1005,2949,22,98,886,2547,908,2645
251340,202104,3805,8931,3052,7941,124,329,2359,6145,2483,6474
251350,202104,1074,3029,981,2876,29,92,810,2344,839,2436
251360,202104,1857,5121,1510,4622,10,57,1257,3850,1267,3907
251365,202104,748,1988,585,1670,5,14,466,1314,471,1328
251370,202104,24880,64472,21288,59370,2979,8232,12586,36183,15565,44415
251380,202104,1243,3420,1071,3126,13,80,908,2587,921,2667
251385,202104,763,1946,594,1641,27,71,435,1165,462,1236
251390,202104,6484,18510,5729,17343,520,1553,3821,11691,4341,13244
251392,202104,1003,2684,851,2453,25,99,676,1914,701,2013
251394,202104,630,1780,513,1579,21,73,378,1158,399,1231
251396,202104,662,1788,567,1620,13,35,398,1114,411,1149
251398,202104,1016,2512,716,1992,16,53,542,1478,558,1531
251400,202104,1298,3035,1024,2660,20,75,834,2091,854,2166
251410,202104,1583,3656,1282,3233,22,85,1089,2644,1111,2729
251420,202104,1977,5104,1626,4687,37,120,1307,3729,1344,3849
251430,202104,1583,4696,1426,4422,26,130,1235,3812,1261,3942
251440,202104,1109,3058,901,2669,41,94,702,2117,743,2211
251445,202104,1561,4284,1439,4115,29,89,1236,3485,1265,3574
251450,202104,4411,12906,3946,12193,81,299,3296,10109,3377,10408
251455,202104,869,2589,795,2455,16,67,642,1939,658,2006
251460,202104,952,2683,820,2481,13,42,675,2050,688,2092
251465,202104,457,1316,393,1196,6,26,300,884,306,910
251470,202104,1195,3248,906,2664,74,231,523,1475,597,1706
251480,202104,1030,2662,845,2338,15,60,662,1761,677,1821
251490,202104,1913,4968,1521,4419,66,194,1135,3324,1201,3518
251500,202104,2009,5514,1844,5308,33,123,1680,4832,1713,4955
251510,202104,2671,7874,2230,7016,116,392,1533,4724,1649,5116
251520,202104,1036,2630,802,2199,68,170,522,1403,590,1573
251530,202104,14920,35253,12032,31672,90,490,10690,27663,10780,28153
251540,202104,3084,8580,2770,8013,67,234,2356,6726,2423,6960
251550,202104,3916,9032,3162,8111,127,203,2616,6823,2743,7026
251560,202104,561,1689,501,1598,54,182,350,1083,404,1265
251570,202104,970,2689,797,2349,20,87,637,1824,657,1911
251580,202104,1966,4647,1760,4354,33,120,1521,3631,1554,3751
251590,202104,1619,3934,1366,3639,64,159,1133,2978,1197,3137
251593,202104,921,2679,829,2527,88,273,532,1613,620,1886
251597,202104,2136,5918,1918,5630,19,102,1719,4974,1738,5076
251600,202104,6419,17129,5612,15898,193,542,4611,12926,4804,13468
251610,202104,3142,8959,2731,8198,232,622,1862,5724,2094,6346
251615,202104,1310,3190,1058,2818,19,58,858,2211,877,2269
251620,202104,19483,43847,14979,38353,80,266,12972,33529,13052,33795
251630,202104,4846,11144,3909,9858,200,487,2943,7383,3143,7870
251640,202104,2252,5950,2013,5585,21,95,1802,4897,1823,4992
251650,202104,3981,10589,3472,9922,130,379,2914,8353,3044,8732
251660,202104,3575,10509,3171,9811,61,274,2651,8087,2712,8361
251670,202104,4145,11424,3678,10750,38,180,3302,9602,3340,9782
251675,202104,695,1870,628,1789,90,230,425,1242,515,1472
251680,202104,2591,6634,2168,6092,39,122,1783,5054,1822,5176
251690,202104,3124,8710,2670,7935,81,234,2042,6030,2123,6264
251700,202104,2231,6111,1859,5649,44,176,1580,4718,1624,4894
251710,202104,796,2029,557,1546,35,110,326,855,361,965
251720,202104,1333,3722,1081,3290,16,74,848,2507,864,2581
251740,202104,609,1680,486,1448,40,148,327,931,367,1079
260005,202104,30104,63164,24853,56434,1766,3848,18969,42323,20735,46171
260010,202104,10364,26759,8577,23892,479,1361,5098,14291,5577,15652
260020,202104,6932,15952,5864,14428,67,286,5011,12118,5078,12404
260030,202104,6973,17512,5886,15937,131,386,4802,12926,4933,13312
260040,202104,7680,19163,6478,17450,400,1052,4755,12994,5155,14046
260050,202104,14123,36192,11794,33624,202,672,10847,31052,11049,31724
260060,202104,4254,10173,3661,9239,270,539,2774,7173,3044,7712
260070,202104,10859,26714,9314,24521,295,1023,7621,19521,7916,20544
260080,202104,6538,14808,5696,13701,107,331,4794,11346,4901,11677
260090,202104,4780,12060,4275,11373,397,1022,3211,8603,3608,9625
260100,202104,2976,7968,2504,7263,35,176,2097,5994,2132,6170
260105,202104,5037,13636,4525,12949,112,375,3851,10877,3963,11252
260110,202104,22490,61534,20072,58038,856,2854,16716,47712,17572,50566
260120,202104,14685,38266,12436,34959,1450,3905,7985,22860,9435,26765
260130,202104,3220,8012,2853,7483,235,564,2113,5507,2348,6071
260140,202104,12852,28694,11080,26610,514,1388,9371,22165,9885,23553
260150,202104,3582,8270,3100,7677,87,209,2730,6731,2817,6940
260160,202104,6612,16928,5625,15744,94,312,5097,14383,5191,14695
260170,202104,20927,48275,17810,44096,907,2167,14288,35056,15195,37223
260180,202104,3551,9280,3080,8638,71,258,2672,7380,2743,7638
260190,202104,18249,36420,15409,33092,185,444,13732,28999,13917,29443
260200,202104,11127,26467,9602,24527,484,1024,8014,20866,8498,21890
260210,202104,11673,32617,9940,29794,288,1051,7950,23707,8238,24758
260220,202104,10839,25049,10012,24004,172,465,8931,21126,9103,21591
260230,202104,10982,26265,9587,24426,189,515,8140,20445,8329,20960
260240,202104,2791,8203,2445,7545,91,308,1892,5771,1983,6079
260250,202104,2232,5744,1955,5309,130,268,1484,4055,1614,4323
260260,202104,12784,32757,11388,30653,346,1134,9118,24080,9464,25214
260270,202104,4392,10418,3863,9792,100,367,3289,8197,3389,8564
260280,202104,13033,38301,11757,36491,402,1634,10090,30858,10492,32492
260290,202104,41504,103029,35748,94850,3797,10230,24414,64584,28211,74814
260300,202104,9670,25755,8467,24137,171,700,7234,20543,7405,21243
260310,202104,5520,13546,4866,12735,337,746,3770,10046,4107,10792
260320,202104,7891,22312,6711,20319,230,670,5493,16682,5723,17352
260330,202104,2594,7849,2271,7188,60,196,1804,5584,1864,5780
260340,202104,2079,5496,1808,5099,25,114,1586,4375,1611,4489
260345,202104,26083,65800,21803,59672,3312,9540,11527,31013,14839,40553
260350,202104,5751,13164,4974,12284,54,156,4470,10978,4524,11134
260360,202104,2539,6518,2296,6080,48,171,1648,4274,1696,4445
260370,202104,5644,15846,4865,14558,202,624,3796,11288,3998,11912
260380,202104,5141,14721,4414,13532,165,485,3377,10273,3542,10758
260390,202104,4665,13737,3869,12122,226,640,2606,8075,2832,8715
260392,202104,3491,10849,3159,10439,93,555,2620,8635,2713,9190
260400,202104,19049,42938,16443,39565,434,1126,13150,30499,13584,31625
260410,202104,74708,177655,58247,154967,10309,28623,26053,71626,36362,100249
260415,202104,4454,11657,3849,10699,45,170,3211,8777,3256,8947
260420,202104,12615,26127,10739,24049,87,242,9999,22212,10086,22454
260430,202104,2772,8493,2391,7740,111,411,1694,5419,1805,5830
260440,202104,3794,9568,3374,8959,64,205,2889,7560,2953,7765
260450,202104,5854,14424,5239,13639,290,558,4358,11575,4648,12133
260460,202104,5290,15352,4512,14012,469,1615,2744,8382,3213,9997
260470,202104,4971,12917,4201,12032,75,151,3857,11202,3932,11353
260480,202104,4014,10488,3386,9607,236,764,2363,6751,2599,7515
260490,202104,5395,12290,4799,11433,29,129,4383,10276,4412,10405
260500,202104,6160,15122,5264,13883,423,1002,3749,10061,4172,11063
260510,202104,9944,24144,8357,21934,101,372,7403,19253,7504,19625
260515,202104,4479,11734,3522,9969,156,390,2403,6629,2559,7019
260520,202104,16756,38416,14592,35685,686,1612,11984,28965,12670,30577
260530,202104,9927,28113,8474,25893,120,569,7333,22119,7453,22688
260540,202104,7334,15805,6490,14749,143,342,5860,13232,6003,13574
260545,202104,70,214,45,153,3,12,20,65,23,77
260550,202104,3177,8505,2600,7579,132,428,1807,5160,1939,5588
260560,202104,6082,15329,5119,13939,111,403,4325,11563,4436,11966
260570,202104,7898,20946,6988,19729,333,993,5645,15983,5978,16976
260580,202104,4546,10628,4091,10026,24,72,3747,9132,3771,9204
260590,202104,7109,15641,6011,14434,230,502,5104,12378,5334,12880
260600,202104,31482,79813,25719,71176,1006,2989,19763,53694,20769,56683
260610,202104,7571,19101,6765,18058,408,1083,5093,13613,5501,14696
260620,202104,17170,43171,15062,40188,1241,3638,11118,29073,12359,32711
260630,202104,2419,6449,1984,5781,43,145,1617,4634,1660,4779
260640,202104,22714,49924,19025,45700,795,1886,15586,37212,16381,39098
260650,202104,6367,16097,5127,14602,459,841,4127,12199,4586,13040
260660,202104,6932,17976,6001,16757,193,702,5143,14095,5336,14797
260670,202104,2300,5904,1917,5308,78,193,1368,3702,1446,3895
260680,202104,29372,69078,24791,62650,1794,4661,17480,43448,19274,48109
260690,202104,3558,9102,2984,8214,68,250,2364,6456,2432,6706
260700,202104,6372,17403,5907,16876,18,60,5731,16458,5749,16518
260710,202104,1385,3572,1191,3288,33,126,944,2606,977,2732
260720,202104,24581,59613,21208,55254,1928,4911,15701,40974,17629,45885
260730,202104,8015,22359,7029,21004,234,775,5925,17498,6159,18273
260740,202104,1325,3745,1123,3419,13,63,891,2772,904,2835
260750,202104,7217,19532,5990,18021,229,458,5233,16245,5462,16703
260760,202104,5930,13574,5111,12623,173,420,4283,10626,4456,11046
260765,202104,8337,23328,7247,21836,347,1316,5216,15414,5563,16730
260770,202104,3936,9820,3272,8733,111,336,2592,6819,2703,7155
260775,202104,5341,13954,4698,13003,179,612,3713,9956,3892,10568
260780,202104,3777,10953,3378,10322,381,1216,2091,6268,2472,7484
260790,202104,122553,269689,101527,242803,15222,35142,63029,151274,78251,186416
260795,202104,3013,7553,2582,7006,71,233,2076,5677,2147,5910
260800,202104,5422,12414,4897,11709,172,459,4253,9873,4425,10332
260805,202104,3727,10223,3164,9261,199,582,2330,6778,2529,7360
260810,202104,6604,17539,5813,16026,439,1093,4277,11648,4716,12741
260820,202104,4612,10491,4099,9892,92,299,3449,8174,3541,8473
260825,202104,3025,8750,2660,8116,109,355,2018,6101,2127,6456
260830,202104,4256,12194,3536,10917,477,1266,2220,7117,2697,8383
260840,202104,4267,10871,3824,10274,215,514,3208,8652,3423,9166
260845,202104,4582,11752,4060,10881,240,662,3067,8077,3307,8739
260850,202104,5252,13972,4406,12412,342,1022,2843,7725,3185,8747
260860,202104,3422,9616,2952,8819,97,328,2386,6969,2483,7297
260870,202104,4564,10839,3911,10048,63,238,3509,8894,3572,9132
260875,202104,7468,17722,6119,15779,535,1338,4244,11042,4779,12380
260880,202104,9810,27093,8551,24959,454,1308,6727,19632,7181,20940
260890,202104,13184,33027,11465,30454,612,1686,8400,21798,9012,23484
260900,202104,5482,14824,4517,13494,294,895,3073,9180,3367,10075
260910,202104,3325,8812,2893,8171,104,287,2288,6432,2392,6719
260915,202104,5097,14872,4485,14169,53,244,4099,12976,4152,13220
260920,202104,3537,8266,3008,7695,119,218,2562,6670,2681,6888
260930,202104,3977,11894,3446,10974,171,619,2632,8174,2803,8793
260940,202104,15198,35419,13257,32758,1095,2628,9915,24198,11010,26826
260950,202104,7284,18942,5906,16606,353,1173,3891,10397,4244,11570
260960,202104,72997,158927,59001,141247,6122,14822,38417,90930,44539,105752
260970,202104,5915,14921,5259,14045,267,547,3899,10696,4166,11243
260980,202104,4692,13304,4121,12600,52,161,3770,11642,3822,11803
260990,202104,18688,49403,15861,45549,833,2405,12492,35541,13325,37946
261000,202104,16749,38449,14112,35158,398,1199,11414,27832,11812,29031
261010,202104,2371,6119,2085,5743,87,193,1801,5012,1888,5205
261020,202104,6204,16317,5401,14994,209,623,4461,12041,4670,12664
261030,202104,4123,11728,3630,10866,110,422,2909,8477,3019,8899
261040,202104,5485,15447,4492,13593,149,549,3436,10112,3585,10661
261050,202104,8083,20257,7339,19131,420,761,5776,15201,6196,15962
261060,202104,14487,35530,12645,33328,257,795,10672,27828,10929,28623
261070,202104,66622,142531,55398,127947,3065,6729,42265,95629,45330,102358
261080,202104,6909,16147,6281,15385,140,314,5822,14250,5962,14564
261090,202104,19965,45891,17786,43088,351,1010,15617,37234,15968,38244
261100,202104,8551,22997,7492,21449,510,1479,5555,15960,6065,17439
261110,202104,69259,188658,58327,169093,7784,23603,34754,99389,42538,122992
261120,202104,3635,9056,3171,8420,74,179,2746,7289,2820,7468
261130,202104,7470,17878,6585,16714,124,357,5826,14659,5950,15016
261140,202104,3825,8604,3408,8058,197,482,2695,6280,2892,6762
261150,202104,5245,13605,4641,12705,69,239,4023,10893,4092,11132
261153,202104,1930,5739,1628,5152,56,180,1100,3502,1156,3682
261160,202104,219151,496584,178234,441153,42448,108124,75014,189248,117462,297372
261170,202104,6397,15222,5683,14226,261,538,4683,11679,4944,12217
261180,202104,9743,23738,8506,22136,480,1123,6209,16357,6689,17480
261190,202104,4688,13311,4199,12518,146,631,3377,9758,3523,10389
261200,202104,3396,7731,3013,7220,176,441,2490,5876,2666,6317
261210,202104,1944,4662,1668,4273,70,174,1386,3500,1456,3674
261220,202104,13805,38362,11569,34336,1428,4514,6676,19531,8104,24045
261230,202104,4121,11547,3453,10643,40,147,2902,9034,2942,9181
261240,202104,5539,13482,4890,12472,301,699,3976,10088,4277,10787
261245,202104,3845,10481,3228,9409,73,339,2586,7259,2659,7598
261247,202104,3024,8825,2517,7926,146,457,1759,5505,1905,5962
261250,202104,23164,51633,20131,48128,2462,5327,14345,35516,16807,40843
261255,202104,4148,11950,3419,10547,134,553,2623,7883,2757,8436
261260,202104,12951,34270,11305,32127,315,1179,9822,27588,10137,28767
261270,202104,4642,10981,4059,10257,194,448,3346,8449,3540,8897
261280,202104,2550,7029,2250,6523,54,185,1814,5119,1868,5304
261290,202104,3000,7646,2510,7095,61,222,2043,5837,2104,6059
261300,202104,12822,34788,10962,31702,514,1817,8208,23130,8722,24947
261310,202104,9126,22540,7815,20780,578,1662,5860,15270,6438,16932
261320,202104,6100,16846,5337,15598,72,299,4560,13144,4632,13443
261330,202104,5783,14054,5214,13319,108,396,4557,11410,4665,11806
261340,202104,4359,11848,3794,11130,130,466,3187,9243,3317,9709
261350,202104,8860,25666,7835,23930,115,467,6379,19277,6494,19744
261360,202104,8274,19484,7020,17725,232,605,5663,13946,5895,14551
261370,202104,24396,59658,20470,54328,2234,5610,13210,35526,15444,41136
261380,202104,4172,12297,3684,11469,429,1410,2458,7555,2887,8965
261390,202104,17129,47618,14524,43463,1159,3759,9770,28929,10929,32688
261400,202104,4660,14515,4086,13267,178,717,3071,9710,3249,10427
261410,202104,9851,24039,8121,21420,384,1117,6539,16816,6923,17933
261420,202104,7437,21685,6704,20797,684,2390,4865,15073,5549,17463
261430,202104,3537,9750,3011,8921,57,239,2545,7437,2602,7676
261440,202104,1494,4373,1248,3912,46,206,897,2694,943,2900
261450,202104,14951,39829,13220,37197,161,561,10958,30957,11119,31518
261460,202104,7758,20773,6833,19339,283,831,5488,15510,5771,16341
261470,202104,4213,10274,3656,9518,18,91,3186,8267,3204,8358
261480,202104,5101,15328,4404,14177,210,810,3404,10758,3614,11568
261485,202104,4985,13835,4326,12838,334,1084,3183,9319,3517,10403
261500,202104,6196,15402,5413,14339,385,861,3790,10466,4175,11327
261510,202104,1926,5617,1677,5209,57,206,1284,4010,1341,4216
261520,202104,2371,7155,2135,6677,61,210,1585,4927,1646,5137
261530,202104,12291,35094,9976,30971,863,3108,5224,15592,6087,18700
261540,202104,8577,23709,7758,22549,1188,3252,4387,13586,5575,16838
261550,202104,3745,9778,3236,9000,236,692,2332,6363,2568,7055
261560,202104,7966,22968,6937,21438,282,981,5426,16763,5708,17744
261570,202104,3535,9406,2823,8255,169,562,1971,5674,2140,6236
261580,202104,6975,17956,6032,16679,97,441,5438,14837,5535,15278
261590,202104,2757,6960,2247,6243,79,254,1701,4700,1780,4954
261600,202104,5389,13071,4592,11922,298,629,3273,8696,3571,9325
261610,202104,2155,6111,1729,5330,107,395,1153,3521,1260,3916
261618,202104,2595,6281,2272,5813,78,185,1840,4676,1918,4861
261620,202104,4250,11756,3865,11186,739,1890,2534,7669,3273,9559
261630,202104,6193,17244,5282,15551,361,1228,3548,10064,3909,11292
261640,202104,37996,83628,32381,76767,1895,3389,24538,60120,26433,63509
261650,202104,4255,10336,3631,9528,162,450,2747,7179,2909,7629
270010,202104,4459,14608,3869,13604,126,710,3131,10697,3257,11407
270020,202104,3956,9734,3468,9116,128,428,2977,7634,3105,8062
270030,202104,34330,91689,28614,82550,3368,9572,19437,55946,22805,65518
270040,202104,11140,28802,9594,26971,372,1174,8066,22563,8438,23737
270050,202104,5545,12750,4747,11851,307,621,4059,10317,4366,10938
270060,202104,2289,5685,1922,5264,163,385,1519,4234,1682,4619
270070,202104,4755,13174,4134,12315,118,426,3469,10165,3587,10591
270080,202104,1472,3953,1250,3574,44,130,968,2675,1012,2805
270090,202104,1798,5389,1623,5052,55,226,1353,4119,1408,4345
270100,202104,5722,14458,4957,13353,197,591,4148,10990,4345,11581
270110,202104,3330,7541,2700,6822,142,285,2149,5716,2291,6001
270120,202104,2683,7345,2339,6887,63,272,1978,5724,2041,5996
270130,202104,5185,13014,4509,12203,136,386,3905,10610,4041,10996
270135,202104,2055,4852,1744,4508,30,102,1610,4125,1640,4227
270140,202104,9720,22488,7814,19860,323,966,6159,14980,6482,15946
270150,202104,2702,8079,2461,7727,3,19,2325,7285,2328,7304
270160,202104,6236,16604,5306,15557,101,365,4888,14379,4989,14744
270170,202104,3392,9818,2860,9080,164,756,2190,6677,2354,7433
270180,202104,2262,6935,2081,6706,36,175,1890,6022,1926,6197
270190,202104,1765,5020,1573,4786,22,108,1422,4302,1444,4410
270200,202104,2474,7372,2158,6935,75,260,1632,5237,1707,5497
270210,202104,5876,13500,5017,12529,56,210,4650,11444,4706,11654
270220,202104,1685,4244,1344,3759,180,512,837,2309,1017,2821
270230,202104,9312,25274,7735,22852,678,2124,5516,16262,6194,18386
270235,202104,5908,17877,5112,16624,128,503,4291,13836,4419,14339
270240,202104,11229,29796,9238,27051,933,2770,6563,19430,7496,22200
270250,202104,2895,7091,2549,6597,167,406,2074,5364,2241,5770
270255,202104,4482,12704,3547,11021,111,442,2748,8398,2859,8840
270260,202104,5588,16368,5062,15498,98,462,4439,13328,4537,13790
270270,202104,1066,2720,889,2502,103,287,651,1839,754,2126
270280,202104,3906,9297,3138,8336,494,752,2211,6367,2705,7119
270290,202104,7495,23513,6767,22316,122,620,5993,19515,6115,20135
270300,202104,4320,10998,3374,9973,185,450,2626,7981,2811,8431
270310,202104,7066,19465,6085,17941,73,387,5278,15222,5351,15609
270320,202104,5577,16217,4828,14771,359,1119,3476,10365,3835,11484
270330,202104,4043,12811,3600,12138,231,899,2843,9537,3074,10436
270340,202104,1594,4232,1376,3946,44,126,1178,3337,1222,3463
270350,202104,1913,4403,1564,3999,127,345,1140,2944,1267,3289
270360,202104,2683,6577,2400,6261,88,169,2210,5821,2298,5990
270370,202104,1399,4258,1280,4042,30,149,1101,3419,1131,3568
270375,202104,3142,7271,2613,6690,23,66,2449,6286,2472,6352
270380,202104,5613,15322,4736,14207,540,1491,3307,10261,3847,11752
270390,202104,1241,3071,1004,2803,21,75,841,2351,862,2426
270400,202104,6555,16784,5533,15263,257,619,4431,12178,4688,12797
270410,202104,4680,13267,4063,12345,132,457,3429,10381,3561,10838
270420,202104,5662,16413,5084,15576,115,508,4440,13366,4555,13874
270430,202104,135439,316685,106603,279965,20545,55832,50851,135832,71396,191664
270440,202104,4797,12718,4161,11943,78,313,3687,10477,3765,10790
270450,202104,7207,18886,6329,17831,259,763,5312,15213,5571,15976
270460,202104,3804,8342,3261,7693,163,296,2924,6939,3087,7235
270470,202104,11198,30575,9770,28586,610,1945,7660,22416,8270,24361
270480,202104,3003,7803,2538,7139,89,307,2082,5739,2171,6046
270490,202104,957,2596,838,2450,51,146,677,1976,728,2122
270500,202104,4990,14993,4442,14086,265,948,3530,11064,3795,12012
270510,202104,5593,14613,4715,13514,343,1265,3538,9724,3881,10989
270520,202104,4093,11374,3258,9977,680,2132,1324,4265,2004,6397
270530,202104,1328,3711,1118,3385,59,157,796,2457,855,2614
270540,202104,2290,6338,1972,5924,58,229,1723,5113,1781,5342
270550,202104,6877,17468,5484,15927,685,1579,3967,12083,4652,13662
270560,202104,2981,7586,2566,7035,144,433,2085,5660,2229,6093
270570,202104,4063,11327,3446,10413,131,410,2804,8431,2935,8841
270580,202104,2302,6409,2085,6099,102,304,1793,5212,1895,5516
270590,202104,1607,4802,1481,4631,15,75,1400,4362,1415,4437
270600,202104,2764,8463,2503,8070,45,217,2233,7126,2278,7343
270610,202104,3671,9400,3185,8766,98,266,2840,7796,2938,8062
270620,202104,1280,3755,1182,3574,24,93,1036,3059,1060,3152
270630,202104,17580,42486,15129,39133,631,1878,12658,32120,13289,33998
270640,202104,5458,15378,4779,14291,170,654,3965,11663,4135,12317
270642,202104,2532,8050,2246,7604,142,595,1734,5773,1876,6368
270644,202104,3705,9083,3058,8251,355,822,2223,6244,2578,7066
270650,202104,3209,9254,2819,8724,323,1058,2094,6463,2417,7521
270660,202104,2021,5075,1730,4665,75,244,1331,3532,1406,3776
270670,202104,16681,37606,13922,34240,371,1037,11974,28761,12345,29798
270680,202104,5669,13223,5075,12580,121,181,4749,11921,4870,12102
270690,202104,9436,22775,7921,20875,364,979,6394,16694,6758,17673
270700,202104,520,1546,458,1443,33,122,341,1051,374,1173
270710,202104,5564,16401,4952,15462,237,863,3990,12320,4227,13183
270720,202104,3680,10517,3285,9860,56,291,2928,8621,2984,8912
270730,202104,8340,17959,7340,16896,295,496,5749,14712,6044,15208
270740,202104,2398,6204,2114,5875,86,284,1767,4853,1853,5137
270750,202104,5819,14924,5102,14024,68,290,4573,12471,4641,12761
270760,202104,3271,9124,2829,8534,43,204,2408,7192,2451,7396
270770,202104,21353,51630,17176,46513,2800,6740,10449,29988,13249,36728
270780,202104,1885,4949,1739,4745,57,190,1551,4177,1608,4367
270790,202104,1689,4479,1422,4114,113,333,1070,3069,1183,3402
270800,202104,11204,29855,10116,28315,338,1141,8722,24123,9060,25264
270810,202104,3402,9506,2697,8333,171,607,1907,5793,2078,6400
270820,202104,1602,4727,1360,4348,41,203,1083,3392,1124,3595
270830,202104,5131,12233,4164,11046,161,531,3399,8863,3560,9394
270840,202104,8415,24718,7505,23419,150,784,6579,20070,6729,20854
270850,202104,9074,21245,8015,19999,732,1889,6563,16240,7295,18129
270860,202104,14690,31900,11673,28528,583,1233,9505,23273,10088,24506
270870,202104,2252,6206,1860,5590,255,691,1178,3713,1433,4404
270880,202104,8134,24065,7267,22757,214,887,6081,18742,6295,19629
270890,202104,2981,7917,2501,7236,182,530,1723,4978,1905,5508
270895,202104,3177,9467,2888,9090,66,353,2580,7965,2646,8318
270900,202104,1789,4557,1359,3872,34,97,1078,3047,1112,3144
270910,202104,3960,11251,3424,10421,92,284,2848,8553,2940,8837
270915,202104,9750,27128,7899,24148,630,2167,5445,16297,6075,18464
270920,202104,5473,16197,4983,15396,91,416,4277,12879,4368,13295
270930,202104,17495,39762,13543,35189,1723,4003,9103,25011,10826,29014
270940,202104,6764,17256,5739,16039,192,740,4757,12994,4949,13734
280010,202104,692,1874,554,1592,15,62,394,1036,409,1098
280020,202104,4988,12378,4215,11169,401,1004,2936,7822,3337,8826
280030,202104,77845,179497,62076,157486,12300,31254,28931,76065,41231,107319
280040,202104,2975,8054,2605,7498,251,690,1805,5213,2056,5903
280050,202104,3975,11161,3411,10303,605,1849,1925,5844,2530,7693
280060,202104,5987,15339,4783,13503,880,2618,2295,6726,3175,9344
280067,202104,7102,17112,6043,15499,295,764,4468,11316,4763,12080
280070,202104,1885,5543,1754,5340,119,368,1454,4398,1573,4766
280100,202104,4065,10539,3423,9541,343,958,2317,6489,2660,7447
280110,202104,1470,3808,1298,3551,12,50,1163,3109,1175,3159
280120,202104,7675,21718,6849,20406,785,2108,4932,15134,5717,17242
280130,202104,9129,21132,7986,19550,424,1105,6447,15659,6871,16764
280140,202104,5598,13073,4937,12172,252,675,4119,10086,4371,10761
280150,202104,4288,10573,3724,9804,446,1017,2733,7353,3179,8370
280160,202104,1209,3420,1021,3110,93,319,698,2076,791,2395
280170,202104,5242,13564,4709,12898,251,610,3810,10494,4061,11104
280190,202104,1323,2845,1185,2663,49,116,1001,2202,1050,2318
280200,202104,1283,3301,1068,3003,64,209,813,2248,877,2457
280210,202104,17163,41734,14912,38558,1537,3995,9595,24913,11132,28908
280220,202104,1750,4635,1500,4307,47,202,1242,3534,1289,3736
280230,202104,4500,10975,3762,9898,335,695,2604,6996,2939,7691
280240,202104,3344,8804,2988,8261,40,205,2601,7011,2641,7216
280250,202104,955,2226,793,1982,85,215,549,1341,634,1556
280260,202104,2279,5363,2008,5023,39,95,1818,4590,1857,4685
280270,202104,2486,6549,2214,6139,162,406,1776,4949,1938,5355
280280,202104,4222,12250,3758,11557,530,1388,2580,8343,3110,9731
280290,202104,18606,47743,16009,44114,1322,3776,10837,30041,12159,33817
280300,202104,12553,28932,10993,27260,327,761,8066,22108,8393,22869
280310,202104,1416,3584,1186,3208,43,130,897,2368,940,2498
280320,202104,8778,23191,7608,21448,965,2585,5042,14203,6007,16788
280330,202104,4774,11602,4070,10631,246,673,2992,7818,3238,8491
280340,202104,5652,11716,4700,10682,266,412,4028,9384,4294,9796
280350,202104,26577,61121,23409,56967,1061,2631,18676,44702,19737,47333
280360,202104,5691,15494,4990,14343,713,2049,2960,8718,3673,10767
280370,202104,2150,5233,1811,4689,81,186,1430,3671,1511,3857
280380,202104,1021,2642,867,2437,78,211,589,1690,667,1901
280390,202104,3732,8904,3172,8050,178,362,2498,6390,2676,6752
280400,202104,3914,9649,3402,8954,541,1251,2112,5850,2653,7101
280410,202104,2386,6387,1956,5726,152,445,1215,3491,1367,3936
280420,202104,4382,11418,4046,11000,67,245,3728,10075,3795,10320
280430,202104,2117,5033,1866,4707,65,201,1535,3759,1600,3960
280440,202104,4364,11256,3867,10536,141,440,3288,8743,3429,9183
280445,202104,2384,5968,2140,5553,47,112,1643,4114,1690,4226
280450,202104,10322,23853,8958,22025,1075,2252,5811,15018,6886,17270
280460,202104,7005,16183,6338,15282,405,856,5325,12802,5730,13658
280470,202104,1710,4734,1458,4270,80,250,1074,3092,1154,3342
280480,202104,44772,106084,38695,97603,3170,8291,27563,68218,30733,76509
280490,202104,3805,10703,3274,9798,89,362,2549,7413,2638,7775
280500,202104,1015,2367,877,2186,24,71,746,1827,770,1898
280510,202104,2684,6484,2329,6000,70,224,1844,4629,1914,4853
280520,202104,1705,4185,1501,3906,79,179,1191,3079,1270,3258
280530,202104,2484,6129,2168,5695,217,466,1603,4298,1820,4764
280540,202104,8927,23582,8143,22458,255,826,7148,19494,7403,20320
280550,202104,6644,15205,5512,13633,160,561,4605,10983,4765,11544
280560,202104,7438,20022,7000,19369,114,409,6243,17042,6357,17451
280570,202104,6528,15657,5313,14130,231,674,3948,10559,4179,11233
280580,202104,5824,14898,5094,13842,546,1284,3677,10159,4223,11443
280590,202104,2938,6576,2523,6091,116,402,2004,4641,2120,5043
280600,202104,3662,9432,3259,8879,269,670,2279,6295,2548,6965
280610,202104,2486,6003,2240,5639,137,333,1834,4586,1971,4919
280620,202104,5601,13327,4832,12330,419,886,3409,9097,3828,9983
280630,202104,3947,10666,3642,10251,187,576,2979,8355,3166,8931
280640,202104,2372,6254,2099,5947,49,136,1877,5348,1926,5484
280650,202104,1221,3166,998,2835,82,277,723,1956,805,2233
280660,202104,3801,8132,3274,7522,253,415,2692,6359,2945,6774
280670,202104,20062,45049,17316,41525,1348,3118,13238,31755,14586,34873
280680,202104,2808,6622,2424,6081,233,424,1751,4500,1984,4924
280690,202104,997,2335,848,2149,55,123,674,1680,729,1803
280700,202104,1181,2929,1021,2692,20,57,813,2120,833,2177
280710,202104,15612,34411,13267,31751,598,1027,11146,27483,11744,28510
280720,202104,2706,6106,2257,5569,43,139,1670,4268,1713,4407
280730,202104,1107,2776,984,2586,53,146,744,1898,797,2044
280740,202104,14502,34359,12466,31310,850,2156,9031,22179,9881,24335
280750,202104,3692,10105,3215,9295,188,563,2328,6629,2516,7192
280760,202104,6615,17007,5774,15729,611,1494,3783,10664,4394,12158
290010,202104,3208,6662,2101,4959,5,16,1740,3940,1745,3956
290020,202104,5432,14163,4949,13559,345,627,4163,11824,4508,12451
290030,202104,4743,10547,3826,9548,180,397,3235,8183,3415,8580
290035,202104,5269,11167,4377,10029,348,508,3490,8325,3838,8833
290040,202104,4251,10188,3627,9437,114,295,2841,7836,2955,8131
290050,202104,2061,6551,1732,5847,95,390,1208,3981,1303,4371
290060,202104,1363,3139,1013,2610,129,308,634,1648,763,1956
290070,202104,37970,81545,32743,75122,1825,4290,25625,58141,27450,62431
290080,202104,5302,15342,4597,14289,480,1541,3179,10023,3659,11564
290090,202104,2196,4177,1545,3485,15,40,1411,3171,1426,3211
290100,202104,9882,25335,8020,22616,1382,3631,4249,12688,5631,16319
290110,202104,5132,13433,4562,12569,321,891,3296,9013,3617,9904
290115,202104,4065,11650,3438,10534,260,792,2595,7973,2855,8765
290120,202104,6658,16108,5614,14661,129,419,4838,12427,4967,12846
290130,202104,4847,11575,3772,10164,175,451,2909,7888,3084,8339
290135,202104,4338,10039,3578,8825,144,368,2871,6856,3015,7224
290140,202104,4533,11656,3512,10309,83,307,2991,8754,3074,9061
290150,202104,2569,6381,2205,5938,139,342,1717,4691,1856,5033
290160,202104,3558,7768,3161,7230,247,476,2561,5876,2808,6352
290170,202104,3419,8515,3030,8095,104,236,2707,7345,2811,7581
290180,202104,3015,8139,2501,7298,73,263,2062,5956,2135,6219
290190,202104,4343,11830,3833,11143,110,394,3196,9165,3306,9559
290195,202104,2336,5675,1874,5077,24,98,1602,4331,1626,4429
290200,202104,4187,11438,3403,10123,170,547,2570,7570,2740,8117
290205,202104,3524,8851,3136,8291,132,405,2527,6524,2659,6929
290210,202104,12986,35544,11540,33374,776,2080,9099,26647,9875,28727
290220,202104,2961,7071,2598,6611,116,291,2144,5435,2260,5726
290225,202104,3237,6844,2491,6055,138,240,2128,5268,2266,5508
290230,202104,2524,6537,2313,6283,33,81,2097,5700,2130,5781
290240,202104,3775,9357,3009,8405,64,214,2546,7110,2610,7324
290250,202104,3992,11466,3331,10483,102,308,2749,8803,2851,9111
290260,202104,5512,13200,4657,11979,162,516,3919,9859,4081,10375
290265,202104,3616,10292,2949,9042,229,636,2055,6344,2284,6980
290270,202104,10816,36631,10101,35428,507,2176,8178,28489,8685,30665
290280,202104,6225,18272,5376,16586,289,1004,3900,11883,4189,12887
290290,202104,10078,28699,8247,25409,756,2511,5566,16895,6322,19406
290300,202104,4215,11401,3125,9339,153,489,2238,6675,2391,7164
290310,202104,1674,3945,1342,3550,36,153,1112,2865,1148,3018
290320,202104,24662,63207,19660,55721,4240,11693,9465,28439,13705,40132
290323,202104,3765,10187,3281,9441,108,328,2571,7442,2679,7770
290327,202104,4150,11847,3571,10743,264,736,2569,7703,2833,8439
290330,202104,2305,4688,1808,4157,43,58,1620,3781,1663,3839
290340,202104,5847,14173,4437,12472,408,1113,3238,9248,3646,10361
290350,202104,4837,13243,4044,11899,275,786,2871,8520,3146,9306
290360,202104,5117,13126,4490,12316,136,319,3862,10690,3998,11009
290370,202104,5328,12652,3906,10784,208,473,2744,7723,2952,8196
290380,202104,5686,14888,4722,13577,116,268,4035,11829,4151,12097
290390,202104,14870,41686,12387,37744,1405,4114,7959,24706,9364,28820
290395,202104,2963,8315,2388,7345,56,242,1830,5551,1886,5793
290400,202104,3840,10153,3131,8983,100,361,2434,6849,2534,7210
290405,202104,4746,13522,4044,12322,299,907,2754,8570,3053,9477
290410,202104,5785,15381,4439,13251,106,441,3370,9811,3476,10252
290420,202104,3150,8410,2622,7601,73,215,2085,6010,2158,6225
290430,202104,3257,8676,2681,7791,211,620,1867,5340,2078,5960
290440,202104,2930,7061,2116,5797,74,163,1496,4201,1570,4364
290450,202104,3592,8855,2843,7731,138,325,2121,5815,2259,6140
290460,202104,11979,33360,10117,29889,2049,6122,4421,13112,6470,19234
290470,202104,4650,11127,3434,9461,413,1193,1983,5544,2396,6737
290475,202104,6591,18876,5601,17152,71,387,4653,13973,4724,14360
290480,202104,1818,4505,1488,4038,66,224,1073,2772,1139,2996
290485,202104,4648,13257,4098,12490,95,455,3523,10600,3618,11055
290490,202104,9106,21203,8185,19951,464,967,6457,16002,6921,16969
290500,202104,4028,11889,3159,10066,502,1667,1405,4370,1907,6037
290510,202104,3584,8681,3004,7931,54,176,2656,6969,2710,7145
290515,202104,3710,10183,3222,9506,42,132,2913,8737,2955,8869
290520,202104,11626,32628,9060,27739,594,1913,5566,16868,6160,18781
290530,202104,5065,14275,4272,12997,119,481,3630,10963,3749,11444
290540,202104,3410,8781,3058,8393,45,142,2845,7800,2890,7942
290550,202104,4302,11201,3774,10574,11,61,3484,9868,3495,9929
290560,202104,6356,16244,4848,14056,369,1323,3233,9053,3602,10376
290570,202104,44724,108815,39702,102498,2335,6127,32133,82458,34468,88585
290580,202104,8053,22880,6961,21318,624,1751,5127,16168,5751,17919
290590,202104,7088,21536,5991,19596,145,536,4823,15871,4968,16407
290600,202104,19337,52546,17014,48800,723,2011,13712,39310,14435,41321
290610,202104,2620,7944,2059,6793,82,313,1454,4747,1536,5060
290620,202104,6205,17382,5370,16016,191,546,4526,13497,4717,14043
290630,202104,9479,22306,7585,19905,636,1560,5765,15351,6401,16911
290640,202104,2847,7134,2207,6220,117,302,1560,4552,1677,4854
290650,202104,13009,31730,11480,30021,2440,6110,7256,19839,9696,25949
290660,202104,3692,9404,3084,8505,51,148,2338,6631,2389,6779
290670,202104,6670,18159,5675,16545,365,1008,4340,12872,4705,13880
290680,202104,11060,30111,9269,27472,173,887,7722,22466,7895,23353
290682,202104,4853,12277,4215,11427,136,293,3555,9750,3691,10043
290685,202104,3521,7865,2544,6478,216,484,1528,4195,1744,4679
290687,202104,6581,17443,5376,15499,677,1858,3483,10291,4160,12149
290689,202104,2915,7906,2222,6639,187,586,1507,4513,1694,5099
290690,202104,5310,13744,4320,12371,281,879,3158,8893,3439,9772
290700,202104,2769,7164,2454,6766,47,175,2151,5907,2198,6082
290710,202104,8322,23082,7152,21477,204,643,6005,18148,6209,18791
290720,202104,18635,50399,16961,47843,879,2740,13721,38223,14600,40963
290730,202104,7055,16622,6014,15419,293,577,4721,12351,5014,12928
290740,202104,1027,2736,809,2384,35,110,675,1990,710,2100
290750,202104,11212,27424,9719,25093,631,1730,7239,18168,7870,19898
290755,202104,2016,5640,1641,4963,87,253,1156,3542,1243,3795
290760,202104,3755,10800,3076,9517,157,443,2126,6750,2283,7193
290770,202104,2717,8379,2483,8086,47,216,2093,6910,2140,7126
290780,202104,8244,20237,7133,18785,256,545,5561,15037,5817,15582
290790,202104,4782,12966,4165,12067,180,471,3428,10099,3608,10570
290800,202104,7097,14393,4981,11957,249,531,3757,9125,4006,9656
290810,202104,5341,13815,4324,12343,110,330,3313,9659,3423,9989
290820,202104,4834,12927,4372,12292,176,508,3310,9442,3486,9950
290830,202104,4546,10277,4024,9613,26,84,3526,8297,3552,8381
290840,202104,17599,45403,15038,41461,2001,4549,9610,28263,11611,32812
290850,202104,6709,15854,5984,15083,221,502,5148,13126,5369,13628
290860,202104,6188,17391,5385,16477,205,621,4555,14231,4760,14852
290870,202104,4748,12964,3611,10809,145,442,2536,7551,2681,7993
290880,202104,1407,3442,1134,3086,83,202,750,2161,833,2363
290890,202104,9483,18845,8552,17809,148,311,8028,16633,8176,16944
290900,202104,2469,6319,1913,5350,118,258,1189,3344,1307,3602
290910,202104,5257,12325,4026,10472,42,112,3447,8877,3489,8989
290920,202104,5198,12918,4703,12341,96,139,4398,11747,4494,11886
290930,202104,7629,20999,6198,18522,202,779,4830,14080,5032,14859
290940,202104,3625,10150,3058,9331,161,528,2466,7516,2627,8044
290950,202104,1465,3654,1197,3254,69,180,835,2282,904,2462
290960,202104,5795,14485,5193,13738,221,485,4378,11662,4599,12147
290970,202104,3278,9607,2691,8534,101,374,2090,6639,2191,7013
290980,202104,12518,29285,10535,26330,739,1994,6763,16417,7502,18411
290990,202104,9756,25549,8675,23833,258,987,7312,19467,7570,20454
291000,202104,3416,8640,2660,7689,115,329,2176,6366,2291,6695
291005,202104,15489,37720,13676,35389,1390,3160,10475,27511,11865,30671
291010,202104,3095,9236,2522,8004,133,460,1650,5106,1783,5566
291020,202104,1268,3056,1029,2644,26,82,755,1830,781,1912
291030,202104,2560,6140,1812,4866,118,280,1118,2950,1236,3230
291040,202104,5513,14759,4600,13474,152,512,3648,10663,3800,11175
291050,202104,7859,19806,6717,18277,656,1883,4919,13247,5575,15130
291060,202104,6278,18427,5332,17159,298,1203,4100,13121,4398,14324
291070,202104,16538,43490,13844,39195,390,1279,11322,31832,11712,33111
291072,202104,25189,62624,18351,51244,3221,9207,8126,22860,11347,32067
291075,202104,5530,13386,4993,12587,98,236,4219,10452,4317,10688
291077,202104,1692,4340,1323,3695,66,118,937,2646,1003,2764
291080,202104,115335,275763,91142,242541,25215,68036,27308,78992,52523,147028
291085,202104,5624,14058,4731,12681,165,480,3962,10591,4127,11071
291090,202104,2098,3862,1547,3250,37,61,1294,2688,1331,2749
291100,202104,3274,7035,2280,5860,100,258,1760,4487,1860,4745
291110,202104,6153,17911,5263,16434,282,1052,4105,12413,4387,13465
291120,202104,7762,18577,6561,17081,319,845,5081,13230,5400,14075
291125,202104,2278,3930,1734,3327,82,120,1421,2762,1503,2882
291130,202104,3328,9327,2467,7659,58,279,1858,5561,1916,5840
291140,202104,4927,13019,3572,10584,482,1283,2171,6474,2653,7757
291150,202104,2534,5444,1957,4797,3,9,1862,4566,1865,4575
291160,202104,5087,13771,4236,12557,369,1143,2866,8449,3235,9592
291165,202104,2199,5910,1646,4826,30,118,1198,3401,1228,3519
291170,202104,21061,52651,17569,46843,935,2678,11758,30765,12693,33443
291180,202104,6477,14564,4765,12325,236,579,3747,9704,3983,10283
291185,202104,3066,8038,2707,7477,99,277,2124,5890,2223,6167
291190,202104,7857,18790,6505,17065,276,739,5233,13776,5509,14515
291200,202104,2841,7638,2112,6266,70,220,1349,3841,1419,4061
291210,202104,7141,15080,5320,12994,119,403,3960,9718,4079,10121
291220,202104,4298,11783,3896,11196,223,673,3080,8816,3303,9489
291230,202104,4606,9658,3499,8451,40,95,3184,7745,3224,7840
291240,202104,4161,10600,3544,9564,61,208,3042,8104,3103,8312
291250,202104,3385,9803,2648,8451,146,428,1717,5521,1863,5949
291260,202104,1462,3390,1200,3048,29,89,984,2517,1013,2606
291270,202104,5608,14071,4382,12328,451,1277,3027,8601,3478,9878
291280,202104,2645,6246,1947,5250,162,428,1248,3337,1410,3765
291290,202104,5812,15071,4468,13009,342,1040,3037,8800,3379,9840
291300,202104,3872,10343,3068,9022,114,371,2352,6843,2466,7214
291310,202104,5066,13359,4345,12070,126,376,3668,10093,3794,10469
291320,202104,6155,16833,4805,14350,1063,2983,2370,7503,3433,10486
291330,202104,1870,4652,1564,4158,70,178,1201,3129,1271,3307
291340,202104,4396,11076,3543,9618,95,283,2696,7227,2791,7510
291345,202104,2936,8641,2665,8223,97,332,2252,6967,2349,7299
291350,202104,6966,16781,5423,14946,47,140,4744,13277,4791,13417
291360,202104,36862,83465,29009,74119,2713,6767,19166,50320,21879,57087
291370,202104,8209,21937,7254,20468,537,1540,5405,15015,5942,16555
291380,202104,3508,9338,3075,8762,99,357,2587,7314,2686,7671
291390,202104,13343,28207,10282,24836,437,972,8513,20608,8950,21580
291400,202104,14220,35126,11787,31543,1411,3308,7361,20894,8772,24202
291410,202104,3041,7864,2384,6734,37,150,1760,4883,1797,5033
291420,202104,2011,4810,1567,4262,21,85,1397,3783,1418,3868
291430,202104,2768,7679,2396,7067,62,251,1934,5539,1996,5790
291440,202104,6529,18331,5668,16930,321,976,4420,13266,4741,14242
291450,202104,9992,23004,8254,21022,72,123,7330,19133,7402,19256
291460,202104,15768,41142,13822,38272,667,2006,10479,28787,11146,30793
291465,202104,9348,22574,7341,20286,120,526,6369,17462,6489,17988
291470,202104,17798,38719,14854,35363,848,1728,10985,26936,11833,28664
291480,202104,42698,93174,31816,78584,3663,9288,17130,42296,20793,51584
291490,202104,5500,13558,4734,12694,134,434,4276,11402,4410,11836
291500,202104,5151,12314,4333,11229,52,211,3982,10305,4034,10516
291510,202104,4394,10616,3261,9197,38,217,2753,7684,2791,7901
291520,202104,4623,10271,3487,8776,178,472,2719,6790,2897,7262
291530,202104,2389,5297,1703,4417,310,723,950,2710,1260,3433
291535,202104,3454,10001,3032,9250,160,437,2327,7340,2487,7777
291540,202104,2302,5017,1595,4181,75,208,1309,3424,1384,3632
291550,202104,5684,12835,4424,11257,417,864,3000,7877,3417,8741
291560,202104,18563,43439,13538,36825,1539,3960,7811,22300,9350,26260
291570,202104,2413,5670,1905,5049,54,149,1586,4349,1640,4498
291580,202104,6428,16289,5068,14485,237,692,3742,10655,3979,11347
291590,202104,2244,5308,1963,4991,71,229,1756,4386,1827,4615
291600,202104,5424,12418,4185,10545,358,956,2884,7043,3242,7999
291610,202104,5644,14482,5061,13843,63,235,4660,12717,4723,12952
291620,202104,3160,7029,2385,6179,110,266,1851,4914,1961,5180
291630,202104,3486,7511,2604,6389,248,661,1935,4695,2183,5356
291640,202104,16714,39720,12672,33975,1760,4383,6080,16777,7840,21160
291650,202104,9426,23227,8363,21979,561,1014,7015,18999,7576,20013
291660,202104,2077,4995,1536,4187,131,395,1016,2631,1147,3026
291670,202104,2043,5347,1724,4892,98,243,1306,3764,1404,4007
291680,202104,4088,9838,3320,8753,306,812,2352,6218,2658,7030
291685,202104,4908,11555,3944,10292,211,426,3014,8106,3225,8532
291690,202104,4194,9118,2935,7302,281,548,2191,5559,2472,6107
291700,202104,8851,24991,7806,23196,336,1097,6375,18640,6711,19737
291710,202104,5268,12328,3932,10480,227,666,2853,7518,3080,8184
291720,202104,4493,13349,3776,11930,616,1983,2206,6875,2822,8858
291730,202104,6340,15868,5472,14738,256,758,4561,12211,4817,12969
291733,202104,2796,7100,2391,6579,60,160,1752,5078,1812,5238
291735,202104,2983,7766,2395,6732,77,170,1842,5159,1919,5329
291740,202104,4010,10223,2967,8289,97,226,2060,5745,2157,5971
291750,202104,20261,47024,16596,41723,1704,4049,10998,28224,12702,32273
291760,202104,10500,29507,8239,25931,2463,8736,2256,7091,4719,15827
291770,202104,7273,19122,6109,17146,280,868,4700,12831,4980,13699
291780,202104,5219,13604,4701,12887,86,282,4120,11196,4206,11478
291790,202104,2754,7441,2497,7111,224,514,1888,5566,2112,6080
291800,202104,29822,73365,22362,62466,3723,9892,10668,31302,14391,41194
291810,202104,10617,24888,8951,22877,324,774,7518,19488,7842,20262
291820,202104,3989,10140,3477,9478,93,269,2825,7725,2918,7994
291830,202104,4598,10586,3772,9483,217,410,2975,7558,3192,7968
291835,202104,6610,19533,5227,16914,461,1571,3420,11226,3881,12797
291840,202104,47997,129783,41828,120324,4041,12456,29840,85223,33881,97679
291845,202104,2570,6543,2033,5886,110,310,1667,4905,1777,5215
291850,202104,4063,11125,3379,10012,161,446,2626,7915,2787,8361
291855,202104,2279,4352,1764,3783,30,74,1605,3446,1635,3520
291860,202104,2305,5941,1606,4592,43,110,1090,3019,1133,3129
291870,202104,1297,3225,869,2475,38,104,602,1696,640,1800
291875,202104,2988,8828,2575,7972,57,239,1917,5753,1974,5992
291880,202104,5732,15962,4874,14543,235,656,3619,10921,3854,11577
291890,202104,1634,3297,1059,2634,141,310,690,1747,831,2057
291900,202104,1361,3106,1040,2628,19,69,834,2046,853,2115
291905,202104,2460,6189,2037,5531,71,246,1594,4181,1665,4427
291910,202104,3068,7488,2596,6913,56,190,2226,6091,2282,6281
291915,202104,7330,20641,5979,18383,199,690,4506,14059,4705,14749
291920,202104,26536,67704,22512,62225,2000,6029,15967,43269,17967,49298
291930,202104,2568,6654,2209,6173,221,606,1532,4341,1753,4947
291940,202104,3971,9904,2681,7754,200,563,1583,4555,1783,5118
291950,202104,9137,27394,7755,24763,264,958,5436,17196,5700,18154
291955,202104,15439,38553,13714,36337,1135,3131,10797,28655,11932,31786
291960,202104,3195,8098,2690,7428,139,341,2124,6014,2263,6355
291970,202104,4652,11441,3904,10527,131,424,3003,8123,3134,8547
291980,202104,9728,27334,7818,24019,1016,2866,4889,15385,5905,18251
291990,202104,2369,6023,1940,5508,23,84,1798,5114,1821,5198
291992,202104,3882,9304,3137,8350,248,553,2489,6787,2737,7340
291995,202104,2180,5830,1805,5216,47,190,1404,3981,1451,4171
292000,202104,2679,6140,2188,5558,80,261,1757,4440,1837,4701
292010,202104,5795,13282,4745,11814,151,392,4007,9791,4158,10183
292020,202104,4663,13121,3893,11784,173,612,2953,8672,3126,9284
292030,202104,1881,5588,1707,5278,101,319,1109,3379,1210,3698
292040,202104,4570,11340,3574,9858,215,516,2720,7673,2935,8189
292045,202104,4228,10610,3155,9043,33,88,2816,8209,2849,8297
292050,202104,6601,18119,5370,16011,242,812,3484,10242,3726,11054
292060,202104,11181,25672,10321,24607,405,917,9107,21483,9512,22400
292070,202104,5785,14787,5044,13913,296,771,4313,11862,4609,12633
292080,202104,3131,7760,2617,7099,69,221,2340,6307,2409,6528
292090,202104,4572,9780,3215,8143,197,499,2440,6217,2637,6716
292100,202104,11493,27237,9888,25248,1126,2798,6616,17152,7742,19950
292105,202104,3708,8884,3234,8248,77,168,2729,6969,2806,7137
292110,202104,6120,14444,4367,11742,865,2384,2213,5932,3078,8316
292120,202104,7054,17705,5875,15781,348,944,4436,11742,4784,12686
292130,202104,3514,8241,2917,7511,126,362,2258,5732,2384,6094
292140,202104,5282,12004,4476,10835,202,470,3794,9145,3996,9615
292145,202104,2496,6865,2109,6216,85,207,1653,4918,1738,5125
292150,202104,15037,39320,13057,36155,264,965,10793,29332,11057,30297
292160,202104,3075,7246,2323,6282,34,81,1894,5415,1928,5496
292170,202104,8703,22493,7306,20268,338,1011,5603,15247,5941,16258
292180,202104,2905,7820,2151,6433,143,428,1358,3992,1501,4420
292190,202104,2966,7713,2535,7070,114,352,1958,5426,2072,5778
292200,202104,8980,21615,6709,18454,1205,3407,3193,9189,4398,12596
292205,202104,3815,10466,3317,9736,56,251,2889,8450,2945,8701
292210,202104,6709,15157,5441,13572,68,268,4944,12233,5012,12501
292220,202104,2225,5107,1947,4698,63,145,1536,3593,1599,3738
292225,202104,3232,9232,2861,8671,64,291,2486,7396,2550,7687
292230,202104,8847,20719,7941,19581,164,517,6879,16692,7043,17209
292240,202104,4775,13627,4213,12634,266,788,3033,9085,3299,9873
292250,202104,6034,15077,5426,14198,386,986,4145,10783,4531,11769
292260,202104,3397,8726,3025,8244,88,234,2641,7205,2729,7439
292265,202104,3496,9246,2942,8411,63,265,2387,6690,2450,6955
292270,202104,4348,9902,3465,8853,110,263,2890,7409,3000,7672
292273,202104,2854,5998,2280,5302,58,96,1656,4142,1714,4238
292275,202104,1640,4225,1292,3766,52,148,973,2880,1025,3028
292280,202104,2693,6205,2168,5603,82,137,1832,4884,1914,5021
292285,202104,2630,6209,2098,5492,76,156,1723,4550,1799,4706
292290,202104,7634,19557,6031,17340,161,550,4980,14276,5141,14826
292300,202104,10552,25811,8331,22881,801,2293,5753,15867,6554,18160
292303,202104,2986,8357,2594,7731,86,185,2156,6511,2242,6696
292305,202104,2290,6066,2117,5834,39,162,1919,5218,1958,5380
292310,202104,7014,16923,6093,15809,113,353,5416,13890,5529,14243
292320,202104,6172,16576,4903,14260,252,820,3610,10221,3862,11041
292330,202104,2757,5959,2243,5381,106,179,1733,4375,1839,4554
292335,202104,4876,12465,4330,11665,226,515,3644,9943,3870,10458
292340,202104,5487,15304,4564,13560,214,606,3378,10000,3592,10606
292350,202104,2548,6810,2129,6235,77,273,1737,5110,1814,5383
292360,202104,5006,13100,4179,11716,223,668,2965,8237,3188,8905
292370,202104,10286,24006,8880,22184,103,354,8284,20466,8387,20820
292380,202104,6828,18893,6124,17647,382,1098,4716,13468,5098,14566
292390,202104,4666,8728,3464,7336,123,223,3047,6466,3170,6689
292400,202104,22487,62634,19434,57848,1856,5497,13407,40218,15263,45715
292405,202104,4600,10942,3888,9823,84,196,3254,8094,3338,8290
292410,202104,2247,5272,1867,4792,68,148,1641,4247,1709,4395
292420,202104,3578,10257,3285,9826,111,430,2874,8443,2985,8873
292430,202104,4971,14540,3782,12372,281,916,2486,8182,2767,9098
292440,202104,8645,26875,8012,25920,112,556,7221,23240,7333,23796
292450,202104,4071,11437,3193,9755,87,322,2512,7617,2599,7939
292460,202104,5193,13605,4289,12126,244,656,3310,9326,3554,9982
292465,202104,2754,6865,2364,6375,99,212,1596,4727,1695,4939
292467,202104,1959,5315,1722,4995,265,654,1170,3569,1435,4223
292470,202104,2995,7443,2326,6420,61,99,1812,5028,1873,5127
292480,202104,6355,14771,5175,13344,71,243,4705,12037,4776,12280
292490,202104,2248,5518,1913,5038,101,190,1521,4070,1622,4260
292500,202104,6750,17896,5419,15616,420,1271,3628,10355,4048,11626
292510,202104,13770,35847,10770,31159,514,1560,7636,22076,8150,23636
292520,202104,7218,17674,6385,16479,406,1091,5058,12894,5464,13985
292525,202104,6105,14211,5027,13013,122,259,4400,11582,4522,11841
292530,202104,29201,75436,22713,64789,5046,14569,9673,28125,14719,42694
292540,202104,4511,8158,3560,7145,124,197,3227,6518,3351,6715
292550,202104,8385,21228,6464,18948,501,1340,4524,14283,5025,15623
292560,202104,4497,11056,3867,10202,99,237,3005,7933,3104,8170
292570,202104,3675,9505,3100,8457,54,191,2654,7079,2708,7270
292575,202104,6902,19421,6343,18689,408,1142,5077,15175,5485,16317
292580,202104,7610,18916,6293,16986,127,397,5328,14232,5455,14629
292590,202104,7474,19592,6338,17602,299,879,5129,14050,5428,14929
292593,202104,2899,7114,2413,6311,69,173,2039,5282,2108,5455
292595,202104,5497,14338,4700,13362,132,433,4006,11333,4138,11766
292600,202104,10797,29101,9358,26918,342,934,7513,21698,7855,22632
292610,202104,4321,10959,3684,9853,166,362,2829,7649,2995,8011
292620,202104,6459,17418,5338,16064,131,285,4819,14824,4950,15109
292630,202104,8760,21000,7055,18309,749,1888,4439,11690,5188,13578
292640,202104,8437,24056,7330,22235,194,675,5325,16296,5519,16971
292650,202104,4507,11041,4046,10440,109,282,3689,9432,3798,9714
292660,202104,11514,30553,9777,28040,440,1340,7466,21529,7906,22869
292665,202104,2209,6405,1906,6003,66,185,1589,5092,1655,5277
292670,202104,3593,9609,2797,8138,124,370,1895,5409,2019,5779
292680,202104,4051,10423,3209,8971,165,412,2387,6551,2552,6963
292690,202104,2668,6739,1852,5421,192,508,1124,3437,1316,3945
292700,202104,10123,27010,8847,25056,744,1798,6130,17987,6874,19785
292710,202104,2685,7808,2504,7567,36,102,2305,6985,2341,7087
292720,202104,9189,21373,7759,19725,202,530,6220,16127,6422,16657
292730,202104,4915,11038,4536,10477,334,553,3766,8930,4100,9483
292740,202104,317410,754855,273438,693249,36960,93302,172427,435765,209387,529067
292750,202104,6155,16151,5431,15125,204,560,4295,12165,4499,12725
292760,202104,3975,11145,3484,10292,188,608,2622,7669,2810,8277
292770,202104,6476,16367,5241,14653,739,2097,3445,9879,4184,11976
292780,202104,2150,4123,1601,3469,66,154,1294,2683,1360,2837
292790,202104,4093,8526,3105,7451,170,360,2562,6226,2732,6586
292800,202104,11468,28307,9825,25826,307,808,8246,21448,8553,22256
292805,202104,3757,8736,2964,7718,110,294,2371,6126,2481,6420
292810,202104,11005,27701,8819,24294,494,1256,6511,17656,7005,18912
292820,202104,7394,20266,5433,16956,368,1266,3854,11823,4222,13089
292830,202104,2967,6872,2537,6347,89,221,2159,5453,2248,5674
292840,202104,8738,22611,7424,20851,133,464,6530,18109,6663,18573
292850,202104,2508,6574,2111,6009,145,406,1483,4224,1628,4630
292860,202104,16897,36964,15196,34982,383,969,13229,30076,13612,31045
292870,202104,18849,45282,16315,41822,948,2335,11467,29066,12415,31401
292880,202104,11141,29984,9513,27552,245,968,7574,21244,7819,22212
292890,202104,7269,19548,6434,18375,163,633,5675,16126,5838,16759
292895,202104,3179,6545,2380,5382,104,217,1938,4337,2042,4554
292900,202104,2638,6938,2394,6564,49,191,1994,5321,2043,5512
292905,202104,4351,10977,3476,9694,98,309,2662,7354,2760,7663
292910,202104,4797,12904,4393,12339,190,513,3430,9579,3620,10092
292920,202104,9696,26430,8993,25459,257,927,7736,21582,7993,22509
292925,202104,5413,15187,4536,13624,225,639,3255,9768,3480,10407
292930,202104,6493,18658,5621,17105,471,1574,3637,10832,4108,12406
292935,202104,2535,6131,1960,5493,13,68,1773,4989,1786,5057
292937,202104,2805,6995,2435,6528,64,160,2040,5480,2104,5640
292940,202104,2893,7149,2299,6272,181,400,1668,4742,1849,5142
292950,202104,9520,23853,8342,22162,506,1146,6344,16845,6850,17991
292960,202104,5217,12526,4372,11338,129,315,3498,9009,3627,9324
292970,202104,3877,10846,3445,10202,70,306,2900,8614,2970,8920
292975,202104,4434,9372,3948,8837,112,185,3610,8169,3722,8354
292980,202104,3515,8039,2876,7117,75,220,2432,5910,2507,6130
292990,202104,11256,30895,9450,27714,522,1658,7075,20373,7597,22031
293000,202104,2729,6328,2347,5756,44,148,1908,4674,1952,4822
293010,202104,18430,46343,14934,40988,1811,5090,9248,25451,11059,30541
293015,202104,8509,25449,6766,22134,444,1510,4526,15149,4970,16659
293020,202104,9914,28367,8922,26958,127,483,8056,24387,8183,24870
293030,202104,5258,13606,4022,11705,99,292,2787,8339,2886,8631
293040,202104,4480,11434,3787,10458,65,229,3338,9187,3403,9416
293050,202104,23071,54910,20389,50966,1196,2913,15436,38144,16632,41057
293060,202104,3626,9483,2939,8197,237,696,2031,5550,2268,6246
293070,202104,25206,59920,22153,56090,1887,4939,16644,41995,18531,46934
293075,202104,3655,11151,3190,10364,121,540,2619,8466,2740,9006
293076,202104,3591,8610,3291,8261,62,134,2949,7480,3011,7614
293077,202104,6475,17452,5222,15471,458,1453,3237,10066,3695,11519
293080,202104,4823,13939,4143,12771,81,371,3379,10215,3460,10586
293090,202104,3280,9354,2535,8117,217,640,1645,5372,1862,6012
293100,202104,5811,15208,4820,13457,201,559,3814,10561,4015,11120
293105,202104,3819,11911,3340,10931,236,779,2357,7674,2593,8453
293110,202104,2435,5945,2030,5366,60,184,1674,4352,1734,4536
293120,202104,4588,12081,4120,11365,186,387,3419,9551,3605,9938
293130,202104,3747,10178,3278,9573,62,248,2872,8305,2934,8553
293135,202104,30794,70830,22990,60680,3317,9512,11139,29782,14456,39294
293140,202104,2483,5303,2159,4914,58,103,1852,4227,1910,4330
293150,202104,5488,16132,4521,14323,315,1015,3117,9923,3432,10938
293160,202104,3771,9215,3218,8616,239,384,2712,7620,2951,8004
293170,202104,5072,10297,4443,9524,105,209,3935,8391,4040,8600
293180,202104,4428,12249,3692,10927,68,265,2959,8554,3027,8819
293190,202104,14340,38198,12717,35901,121,524,11384,31907,11505,32431
293200,202104,8708,21010,7072,18427,179,549,5785,14876,5964,15425
293210,202104,5231,13562,4505,12443,253,681,3541,9778,3794,10459
293220,202104,5119,12790,3786,10608,745,2092,1775,5068,2520,7160
293230,202104,4006,9937,2974,8512,205,603,2095,6065,2300,6668
293240,202104,4628,11929,3735,10486,72,152,2815,8272,2887,8424
293245,202104,3871,10340,3521,9835,152,439,2988,8270,3140,8709
293250,202104,6019,13751,4915,12349,172,427,4100,10306,4272,10733
293260,202104,4795,12385,3960,11090,134,350,2765,7835,2899,8185
293270,202104,7359,15927,5825,14289,412,567,4566,12108,4978,12675
293280,202104,4499,11654,3942,10867,238,575,3074,8617,3312,9192
293290,202104,15096,42264,13377,39611,1576,4719,9145,27272,10721,31991
293300,202104,5803,13867,5001,12706,280,677,3697,9465,3977,10142
293305,202104,4218,9831,3699,9196,63,134,3347,8342,3410,8476
293310,202104,2118,5317,1799,4834,45,132,1445,3831,1490,3963
293315,202104,4202,9668,3484,8605,194,411,2869,7093,3063,7504
293317,202104,2702,6218,2413,5821,158,281,1903,4615,2061,4896
293320,202104,12309,28987,10899,27429,211,582,9866,24688,10077,25270
293325,202104,1784,4312,1386,3793,197,518,865,2424,1062,2942
293330,202104,62011,169226,50690,149662,8515,26004,24702,72371,33217,98375
293340,202104,2211,6117,1830,5449,86,263,1301,3852,1387,4115
293345,202104,3690,9733,2962,8616,396,905,1870,6000,2266,6905
293350,202104,6547,18652,5653,17582,54,268,5168,16283,5222,16551
293360,202104,15122,37716,12884,34732,283,1175,11381,30133,11664,31308
310010,202104,968,2130,627,1665,41,148,236,579,277,727
310020,202104,2840,7459,2135,6223,430,1338,565,1602,995,2940
310030,202104,1915,5268,1475,4512,210,715,960,2833,1170,3548
310040,202104,877,2259,695,1944,29,114,470,1213,499,1327
310050,202104,1494,4384,1252,4008,115,462,841,2599,956,3061
310060,202104,3101,8693,2696,8151,75,296,2259,6765,2334,7061
310070,202104,342,770,244,631,11,23,180,462,191,485
310080,202104,686,1800,499,1465,77,244,239,660,316,904
310090,202104,4791,12317,3955,10976,260,764,2953,8078,3213,8842
310100,202104,3595,9633,3042,8738,65,295,2546,7130,2611,7425
310110,202104,4727,12129,3678,10343,703,2153,1742,4692,2445,6845
310120,202104,642,1530,417,1176,43,138,253,666,296,804
310130,202104,367,941,311,858,26,100,236,625,262,725
310140,202104,269,755,189,622,39,149,75,218,114,367
310150,202104,5732,14607,4285,11995,504,1605,2129,5634,2633,7239
310160,202104,8310,20277,6024,16527,1047,3139,2314,6327,3361,9466
310163,202104,1038,3048,845,2686,185,649,279,809,464,1458
310170,202104,9561,23707,7651,20757,639,1741,5423,14719,6062,16460
310180,202104,1860,4476,1363,3684,159,458,801,2120,960,2578
310190,202104,2749,7813,2251,6918,506,1737,375,1081,881,2818
310200,202104,1983,5700,1481,4747,168,630,742,2312,910,2942
310205,202104,1143,3063,912,2698,120,404,541,1595,661,1999
310210,202104,2576,6829,2132,6047,113,322,1534,4248,1647,4570
310220,202104,1286,3436,996,2875,77,232,669,1857,746,2089
310230,202104,2219,6032,1789,5247,215,687,1134,3098,1349,3785
310240,202104,1003,2964,852,2705,47,165,609,1881,656,2046
310250,202104,1069,2788,865,2456,18,72,626,1751,644,1823
310260,202104,3205,8142,2144,6306,591,2017,676,1633,1267,3650
310270,202104,2786,6634,2238,5897,89,271,1858,4888,1947,5159
310280,202104,2529,5751,1991,4985,221,591,1256,3019,1477,3610
310285,202104,1886,5869,1570,5305,157,569,968,3259,1125,3828
310290,202104,1147,2954,940,2597,180,569,513,1280,693,1849
310300,202104,1564,4413,1326,4009,134,506,786,2203,920,2709
310310,202104,318,759,204,561,37,99,100,270,137,369
310320,202104,535,1333,376,1090,21,79,216,590,237,669
310330,202104,486,1126,299,805,44,138,119,278,163,416
310340,202104,8184,21138,6618,18535,886,2453,3378,9632,4264,12085
310350,202104,12910,30636,8957,24365,1406,4098,4332,11300,5738,15398
310360,202104,526,1182,407,1031,13,36,279,702,292,738
310370,202104,1292,3923,1105,3577,205,734,354,1217,559,1951
310375,202104,889,2178,636,1805,94,276,360,1019,454,1295
310380,202104,399,902,220,619,32,96,103,272,135,368
310390,202104,466,1347,373,1170,79,254,114,317,193,571
310400,202104,10857,26157,7998,21861,693,2196,5051,13425,5744,15621
310410,202104,858,2451,568,1927,83,314,225,709,308,1023
310420,202104,4613,11742,3220,9169,420,1310,1397,3699,1817,5009
310430,202104,1563,4144,1061,3232,208,694,409,1093,617,1787
310440,202104,681,1767,471,1380,40,143,257,695,297,838
310445,202104,1397,3893,1024,3152,58,166,732,2221,790,2387
310450,202104,4541,11291,3446,9580,137,506,2647,7142,2784,7648
310460,202104,1794,4712,1365,3923,222,689,499,1325,721,2014
310470,202104,3709,8109,2911,7064,269,624,2093,5204,2362,5828
310480,202104,1005,2548,786,2193,92,270,484,1305,576,1575
310490,202104,2864,7668,2265,6696,249,875,1276,3525,1525,4400
310500,202104,1371,3754,1046,3215,177,613,559,1651,736,2264
310510,202104,2133,5455,1443,4208,249,792,557,1621,806,2413
310520,202104,1182,3043,868,2482,138,379,461,1332,599,1711
310530,202104,759,1894,516,1477,67,227,181,418,248,645
310540,202104,3009,8385,2492,7477,506,1605,1140,3261,1646,4866
310550,202104,1284,3192,918,2587,75,281,529,1362,604,1643
310560,202104,15237,39085,10963,31634,1400,4557,4934,12843,6334,17400
310570,202104,1052,2722,835,2420,52,191,631,1795,683,1986
310590,202104,4169,10836,3341,9293,213,652,1954,5109,2167,5761
310600,202104,1382,3943,1130,3424,140,475,607,1746,747,2221
310610,202104,483,1285,310,1002,115,382,44,126,159,508
310620,202104,180437,449872,132935,365516,16881,53831,68315,170936,85196,224767
310630,202104,4623,12395,3629,10451,385,1166,2204,6148,2589,7314
310640,202104,1158,3339,953,2946,171,581,433,1268,604,1849
310650,202104,2478,6790,1834,5562,157,520,1121,3273,1278,3793
310660,202104,1332,3531,1089,3200,28,94,928,2710,956,2804
310665,202104,1442,3619,1173,3245,17,62,963,2716,980,2778
310670,202104,59253,149628,50230,134507,4440,13429,34866,89022,39306,102451
310680,202104,782,1803,648,1618,18,63,554,1331,572,1394
310690,202104,2030,5149,1472,4219,110,359,860,2340,970,2699
310700,202104,485,1049,378,916,22,70,300,708,322,778
310710,202104,5821,16155,4292,13881,850,3209,803,2308,1653,5517
310720,202104,1063,2418,833,2131,27,83,644,1594,671,1677
310730,202104,10364,26755,8879,24439,349,1181,6688,17979,7037,19160
310740,202104,6552,17535,4760,13937,656,2162,1896,5009,2552,7171
310750,202104,1263,2991,960,2559,103,316,534,1311,637,1627
310760,202104,675,1687,476,1382,37,119,256,743,293,862
310770,202104,1098,2893,760,2381,81,302,397,1146,478,1448
310780,202104,4294,10097,3582,9176,67,167,2950,7580,3017,7747
310790,202104,1829,5692,1574,5148,339,1169,269,773,608,1942
310800,202104,2401,6978,1772,5714,338,1319,105,274,443,1593
310810,202104,1317,3180,1087,2809,47,128,793,1980,840,2108
310820,202104,1261,3142,771,2322,162,500,174,545,336,1045
310825,202104,2639,7742,2122,6878,59,343,1737,5429,1796,5772
310830,202104,1926,5285,1396,4273,234,840,616,1766,850,2606
310840,202104,2115,5658,1586,4767,333,1151,435,1136,768,2287
310850,202104,1441,3939,1205,3602,33,163,942,2699,975,2862
310855,202104,3131,8140,2422,6993,153,524,1749,4924,1902,5448
310860,202104,6859,19685,5543,17189,544,1735,3398,10674,3942,12409
310870,202104,971,2301,773,2017,57,130,569,1498,626,1628
310880,202104,1000,2941,799,2542,110,355,445,1388,555,1743
310890,202104,2194,6199,1428,4680,250,888,226,640,476,1528
310900,202104,3892,10646,2690,8041,395,1234,1179,3280,1574,4514
310910,202104,2200,5276,1552,4267,133,425,345,883,478,1308
310920,202104,1919,4900,1468,4231,183,570,867,2449,1050,3019
310925,202104,942,2517,769,2230,51,173,549,1520,600,1693
310930,202104,5907,15025,4154,12218,788,2322,1885,5815,2673,8137
310940,202104,6723,15618,5435,13772,177,520,4228,10454,4405,10974
310945,202104,1300,3334,1023,2893,177,516,501,1384,678,1900
310950,202104,1932,5643,1289,4216,220,781,374,1037,594,1818
310960,202104,731,1930,409,1250,67,243,79,215,146,458
310970,202104,1148,3332,815,2647,205,725,134,400,339,1125
310980,202104,260,624,173,495,18,57,104,293,122,350
310990,202104,1328,3562,1047,3085,145,458,573,1652,718,2110
311000,202104,3917,10721,2874,9021,699,2322,1166,3586,1865,5908
311010,202104,921,2555,746,2224,198,656,341,986,539,1642
311020,202104,1154,2892,734,2122,40,121,402,1132,442,1253
311030,202104,1694,4112,1208,3330,233,727,548,1439,781,2166
311040,202104,271,839,225,740,70,236,76,235,146,471
311050,202104,3033,7278,2276,6184,348,1064,1179,3047,1527,4111
311060,202104,3271,8219,2445,6718,324,1020,1002,2502,1326,3522
311070,202104,2366,5743,1735,4789,147,527,1012,2603,1159,3130
311080,202104,1183,2634,960,2288,56,144,749,1703,805,1847
311090,202104,2086,6498,1655,5697,379,1413,518,1755,897,3168
311100,202104,2456,6846,1464,4844,260,974,278,798,538,1772
311110,202104,3638,7381,2042,5157,372,983,711,1856,1083,2839
311115,202104,1402,3048,1185,2765,68,151,960,2223,1028,2374
311120,202104,6919,17845,5349,15058,799,2490,2034,5052,2833,7542
311130,202104,1911,4918,1452,4286,100,370,867,2485,967,2855
311140,202104,1462,3575,1169,3182,61,199,850,2267,911,2466
311150,202104,1451,4576,1136,3962,175,688,618,2099,793,2787
311160,202104,3912,11028,2780,8928,701,2432,810,2496,1511,4928
311170,202104,881,2207,696,1965,39,111,440,1316,479,1427
311180,202104,1373,3048,872,2316,165,469,370,982,535,1451
311190,202104,883,2398,673,1998,111,379,281,725,392,1104
311200,202104,2088,5591,1507,4451,266,865,562,1500,828,2365
311205,202104,886,2558,727,2255,37,147,465,1370,502,1517
311210,202104,1014,2910,879,2717,113,309,623,1995,736,2304
311220,202104,764,2061,643,1843,39,137,437,1179,476,1316
311230,202104,8099,23684,6171,19813,1159,3866,2253,7324,3412,11190
311240,202104,1086,2766,844,2423,176,505,370,1075,546,1580
311250,202104,1161,3284,903,2784,189,554,347,1022,536,1576
311260,202104,2764,6636,1787,4966,228,723,801,1978,1029,2701
311265,202104,1304,3338,963,2766,38,146,665,1869,703,2015
311270,202104,2984,8811,2612,8212,129,552,1931,5845,2060,6397
311280,202104,1065,2716,511,1588,75,265,61,148,136,413
311290,202104,1886,5568,1719,5225,122,368,1196,3639,1318,4007
311300,202104,4813,13023,3964,11619,176,662,3179,9135,3355,9797
311310,202104,571,1555,486,1406,41,128,312,869,353,997
311320,202104,3272,9756,2825,8808,321,1195,1459,4131,1780,5326
311330,202104,5372,13683,4277,11916,445,1306,2436,6923,2881,8229
311340,202104,10558,28867,8364,25033,2007,6494,2477,7017,4484,13511
311350,202104,2496,6005,1782,4733,171,458,959,2311,1130,2769
311360,202104,1135,2724,746,2163,195,637,260,739,455,1376
311370,202104,4755,11245,3523,9336,167,565,2375,5920,2542,6485
311380,202104,363,1082,263,875,63,212,120,422,183,634
311390,202104,1773,5282,1416,4786,590,2215,389,1209,979,3424
311400,202104,1575,4237,1155,3422,213,647,352,924,565,1571
311410,202104,1799,5119,1442,4566,211,743,828,2537,1039,3280
311420,202104,1532,4421,1090,3518,190,691,297,814,487,1505
311430,202104,4215,10865,2829,8187,466,1396,1005,2807,1471,4203
311440,202104,2989,8180,2269,6970,589,2103,480,1354,1069,3457
311450,202104,1749,5139,1280,4286,329,1252,326,933,655,2185
311455,202104,1000,2184,670,1699,168,439,259,695,427,1134
311460,202104,512,1534,337,1151,70,289,75,204,145,493
311470,202104,520,1556,348,1165,79,300,50,160,129,460
311480,202104,1101,2721,900,2410,67,162,679,1826,746,1988
311490,202104,252,737,192,623,31,126,92,262,123,388
311500,202104,479,1151,381,1010,19,65,257,651,276,716
311510,202104,3307,8388,2318,6717,299,963,1018,2769,1317,3732
311520,202104,648,1763,568,1616,72,257,324,902,396,1159
311530,202104,8622,19864,5537,14961,1300,3891,1478,3798,2778,7689
311535,202104,807,2200,546,1657,89,282,194,543,283,825
311540,202104,504,1547,449,1443,60,224,322,1002,382,1226
311545,202104,2010,5658,1721,5209,91,309,1334,3997,1425,4306
311547,202104,1519,3740,1327,3451,46,108,978,2545,1024,2653
311550,202104,2848,7736,2289,6748,316,1038,1017,2824,1333,3862
311560,202104,307,654,201,498,74,173,53,128,127,301
311570,202104,1626,3707,1157,3058,36,105,919,2453,955,2558
311580,202104,2157,4035,1457,3205,165,307,964,2130,1129,2437
311590,202104,516,1346,417,1194,75,243,231,656,306,899
311600,202104,1717,3871,1437,3505,78,188,1207,2908,1285,3096
311610,202104,2283,7116,1913,6381,158,621,1166,3785,1324,4406
311615,202104,3307,9077,2691,8066,109,392,2149,6326,2258,6718
311620,202104,420,1057,364,995,9,35,317,857,326,892
311630,202104,1358,3674,1117,3190,90,294,734,2025,824,2319
311640,202104,709,1864,573,1657,59,201,294,774,353,975
311650,202104,1951,4872,1606,4339,183,514,991,2606,1174,3120
311660,202104,2902,8223,2167,6795,355,1209,593,1563,948,2772
311670,202104,1571,4002,1161,3272,157,488,489,1360,646,1848
311680,202104,2198,6087,1667,5107,131,384,1165,3564,1296,3948
311690,202104,602,1284,476,1130,38,72,349,881,387,953
311700,202104,2224,5231,1773,4602,18,95,1517,3827,1535,3922
311710,202104,1516,4318,1109,3599,265,939,381,1239,646,2178
311720,202104,434,1247,344,1090,40,143,176,561,216,704
311730,202104,3561,9130,2376,6808,667,2053,509,1483,1176,3536
311740,202104,918,2326,767,2144,72,188,624,1805,696,1993
311750,202104,3931,11454,3166,10096,362,1254,1936,5952,2298,7206
311760,202104,665,1836,544,1623,67,245,286,749,353,994
311770,202104,2180,6087,1713,5274,285,884,774,2307,1059,3191
311780,202104,1350,3821,980,3110,148,550,348,950,496,1500
311783,202104,2302,6093,1882,5392,33,150,1531,4219,1564,4369
311787,202104,822,2324,632,1889,92,309,282,733,374,1042
311790,202104,1485,3992,973,3048,223,764,276,820,499,1584
311800,202104,4907,14539,3987,12607,842,2768,566,1520,1408,4288
311810,202104,948,2810,754,2472,44,160,515,1656,559,1816
311820,202104,800,1911,595,1601,61,193,379,960,440,1153
311830,202104,8397,23588,5864,18198,1616,5372,722,2187,2338,7559
311840,202104,3723,9158,3011,8151,204,595,2275,6103,2479,6698
311850,202104,371,966,301,837,14,43,202,534,216,577
311860,202104,61612,152561,47698,129076,6312,18546,27505,70746,33817,89292
311870,202104,1894,4945,1324,3942,214,726,568,1544,782,2270
311880,202104,6498,16430,5457,15007,289,661,4114,11581,4403,12242
311890,202104,1725,4066,1333,3526,90,260,931,2339,1021,2599
311900,202104,754,1894,567,1636,48,153,363,1024,411,1177
311910,202104,4083,10403,3096,9116,534,1536,1570,4821,2104,6357
311920,202104,2140,5525,1726,4931,116,279,1096,3256,1212,3535
311930,202104,3881,8906,2817,7445,813,2346,890,2172,1703,4518
311940,202104,15747,40534,11697,32942,1549,4771,5427,14226,6976,18997
311950,202104,2317,6104,1769,5195,119,390,1075,3215,1194,3605
311960,202104,492,1198,391,1050,26,92,245,600,271,692
311970,202104,419,1310,313,1048,55,227,73,204,128,431
311980,202104,456,1220,246,810,21,69,90,293,111,362
311990,202104,534,1241,339,947,59,200,145,358,204,558
311995,202104,969,2651,511,1609,19,61,73,153,92,214
312000,202104,783,1911,586,1618,54,137,366,1041,420,1178
312010,202104,985,2640,767,2292,44,145,512,1470,556,1615
312015,202104,1379,3925,1225,3680,41,173,1007,2961,1048,3134
312020,202104,1678,5049,1248,4110,207,730,292,864,499,1594
312030,202104,2048,4930,1776,4633,14,49,1677,4371,1691,4420
312040,202104,848,2440,608,1978,73,238,270,850,343,1088
312050,202104,1200,3637,972,3208,213,849,328,957,541,1806
312060,202104,877,2107,577,1733,139,427,264,802,403,1229
312070,202104,923,2579,656,2041,34,121,379,1110,413,1231
312080,202104,2705,6549,2050,5586,113,325,1380,3608,1493,3933
312083,202104,888,2262,676,1936,49,173,478,1318,527,1491
312087,202104,2543,6489,2066,5758,45,140,1653,4630,1698,4770
312090,202104,10362,26567,8135,23091,1085,3385,4338,11881,5423,15266
312100,202104,1578,4462,1260,3877,87,328,782,2301,869,2629
312110,202104,1060,3199,875,2834,176,662,334,984,510,1646
312120,202104,1025,2709,699,2146,186,662,202,506,388,1168
312125,202104,1771,4439,1489,4051,102,303,1139,3001,1241,3304
312130,202104,1052,2548,796,2121,71,210,353,863,424,1073
312140,202104,706,2014,577,1753,113,388,258,714,371,1102
312150,202104,474,1291,408,1166,20,67,288,765,308,832
312160,202104,9194,24416,7098,20773,819,2628,3520,9911,4339,12539
312170,202104,901,2393,701,2012,37,129,463,1290,500,1419
312180,202104,1404,3694,1126,3178,147,424,602,1657,749,2081
312190,202104,679,1845,508,1534,77,263,194,550,271,813
312200,202104,4413,11976,3486,10477,942,2828,1338,4100,2280,6928
312210,202104,1402,3060,1025,2534,44,128,773,1870,817,1998
312220,202104,1594,4863,1382,4468,101,340,890,2894,991,3234
312230,202104,14116,35731,9588,27676,2162,7108,2112,5129,4274,12237
312235,202104,1977,4878,1556,4293,93,291,1122,3003,1215,3294
312240,202104,725,2281,555,1931,111,420,165,555,276,975
312245,202104,2730,6848,2261,6140,51,119,1901,5131,1952,5250
312247,202104,1004,2359,731,1970,116,332,410,1099,526,1431
312250,202104,964,2539,619,1859,76,238,224,650,300,888
312260,202104,964,2547,768,2252,37,144,596,1674,633,1818
312270,202104,741,2016,566,1674,34,129,310,840,344,969
312280,202104,422,1220,326,1044,91,310,52,151,143,461
312290,202104,810,2319,662,2059,122,428,218,640,340,1068
312300,202104,1011,3020,678,2202,163,576,131,351,294,927
312310,202104,968,2829,785,2463,116,397,374,1123,490,1520
312320,202104,2017,5110,1486,4201,317,931,339,943,656,1874
312330,202104,864,2487,707,2158,68,239,441,1303,509,1542
312340,202104,255,659,184,540,39,145,89,225,128,370
312350,202104,252,506,181,432,17,46,127,297,144,343
312352,202104,1580,4673,1404,4355,91,283,845,2808,936,3091
312360,202104,2939,8303,2183,6891,409,1425,772,2259,1181,3684
312370,202104,1907,4830,1562,4253,159,486,979,2546,1138,3032
312380,202104,2169,4843,1805,4379,4,13,1623,3882,1627,3895
312385,202104,1244,3318,978,2856,157,479,429,1271,586,1750
312390,202104,1901,5364,1434,4513,189,696,547,1568,736,2264
312400,202104,2913,8125,2444,7341,683,2238,817,2432,1500,4670
312410,202104,12170,32693,9952,29056,1688,5005,5615,16191,7303,21196
312420,202104,3888,10187,3229,9113,597,1826,1705,4659,2302,6485
312430,202104,7954,20817,6556,18344,345,1119,4752,12957,5097,14076
312440,202104,967,3081,793,2694,373,1345,128,402,501,1747
312450,202104,1191,3458,910,2966,252,855,284,976,536,1831
312460,202104,454,1137,321,934,50,139,167,511,217,650
312470,202104,476,1143,295,820,30,92,104,258,134,350
312480,202104,1027,2503,720,2052,91,294,368,989,459,1283
312490,202104,2190,5201,1734,4549,193,544,991,2544,1184,3088
312500,202104,1049,2531,863,2274,43,149,630,1636,673,1785
312510,202104,3828,10073,2735,8017,658,1874,656,1941,1314,3815
312520,202104,257,663,202,576,44,143,87,240,131,383
312530,202104,623,1476,533,1372,23,57,456,1203,479,1260
312540,202104,1624,4392,1115,3411,139,452,639,1891,778,2343
312550,202104,799,2066,621,1726,45,144,411,1059,456,1203
312560,202104,1954,5040,1574,4447,70,200,1168,3313,1238,3513
312570,202104,2338,5514,1760,4799,456,1238,731,2113,1187,3351
312580,202104,617,1661,436,1286,57,193,196,529,253,722
312590,202104,1610,4600,1272,3913,83,353,814,2306,897,2659
312595,202104,2039,5798,1711,5262,254,713,1032,3348,1286,4061
312600,202104,1186,2797,692,1863,110,376,126,383,236,759
312610,202104,7002,17482,4693,13269,667,2079,1688,4305,2355,6384
312620,202104,2558,6491,1904,5565,52,189,1524,4546,1576,4735
312630,202104,305,845,212,671,31,117,80,256,111,373
312640,202104,512,1378,360,1118,39,136,154,478,193,614
312650,202104,2049,5146,1438,4019,62,184,1026,2745,1088,2929
312660,202104,1324,3195,1015,2673,89,239,687,1757,776,1996
312670,202104,5023,12989,4198,11696,179,684,3122,8326,3301,9010
312675,202104,1307,3303,1076,2967,55,158,885,2414,940,2572
312680,202104,1411,3909,1222,3609,42,174,1009,2905,1051,3079
312690,202104,3000,6212,2329,5416,43,104,1957,4561,2000,4665
312695,202104,975,2557,830,2327,47,96,650,1833,697,1929
312700,202104,2098,5428,1540,4412,142,475,907,2462,1049,2937
312705,202104,1441,3350,1243,3063,13,40,1142,2789,1155,2829
312707,202104,1357,3853,1053,3324,66,280,696,2094,762,2374
312710,202104,6438,14623,3861,10652,916,2723,1086,3139,2002,5862
312720,202104,1085,2810,814,2387,97,300,496,1412,593,1712
312730,202104,1655,3850,1177,3198,93,273,695,1834,788,2107
312733,202104,1383,3602,1045,2965,30,111,741,1981,771,2092
312735,202104,728,1903,603,1664,77,218,348,886,425,1104
312737,202104,803,1750,578,1437,64,174,391,953,455,1127
312738,202104,716,1786,515,1446,47,145,305,818,352,963
312740,202104,430,1064,251,764,44,152,61,138,105,290
312750,202104,1571,4464,1175,3721,183,613,541,1636,724,2249
312760,202104,1803,5207,1298,4171,226,746,479,1496,705,2242
312770,202104,44771,106153,28423,78291,5470,16237,9791,26138,15261,42375
312780,202104,2443,7130,2059,6504,235,773,1348,4260,1583,5033
312790,202104,247,573,136,399,5,21,41,88,46,109
312800,202104,5019,13828,3848,11617,839,2665,1488,4315,2327,6980
312810,202104,1537,4077,1036,3256,258,890,379,1101,637,1991
312820,202104,1752,4572,1424,4004,58,203,1073,2949,1131,3152
312825,202104,1369,3142,1199,2926,17,55,1045,2495,1062,2550
312830,202104,2812,7760,1739,5591,319,1163,468,1416,787,2579
312840,202104,1383,3634,1118,3190,67,256,680,1812,747,2068
312850,202104,966,2285,686,1876,19,70,435,1091,454,1161
312860,202104,1097,2808,752,2283,186,578,176,507,362,1085
312870,202104,6156,16257,3867,11908,580,1915,992,2809,1572,4724
312880,202104,1469,3609,1140,3064,42,136,675,1826,717,1962
312890,202104,2281,5563,1698,4624,131,328,870,2403,1001,2731
312900,202104,1245,3133,1016,2835,150,470,475,1437,625,1907
312910,202104,1569,2854,852,1925,193,374,310,740,503,1114
312920,202104,1001,2611,703,2136,112,400,282,770,394,1170
312930,202104,2421,5845,1862,5023,391,1056,833,2321,1224,3377
312940,202104,989,2658,785,2368,63,243,454,1308,517,1551
312950,202104,3035,7401,2015,5776,479,1519,660,1809,1139,3328
312960,202104,1835,4776,1559,4367,80,198,1193,3432,1273,3630
312965,202104,1617,4380,1344,3965,99,275,951,2787,1050,3062
312970,202104,1430,3941,1150,3495,141,504,718,2065,859,2569
312980,202104,24586,66130,19938,57955,3897,12134,9232,25262,13129,37396
312990,202104,516,1260,345,973,58,193,174,438,232,631
313000,202104,478,1360,363,1150,24,107,217,649,241,756
313005,202104,2580,7263,2189,6602,142,397,1585,4745,1727,5142
313010,202104,5195,13907,4175,12295,695,2232,2496,7222,3191,9454
313020,202104,1097,3231,795,2570,131,444,160,447,291,891
313030,202104,1142,2567,785,2060,76,245,516,1286,592,1531
313040,202104,828,2500,685,2217,38,162,421,1285,459,1447
313050,202104,1782,4824,1251,4033,195,764,414,1167,609,1931
313055,202104,1900,5020,1689,4719,56,177,1467,4073,1523,4250
313060,202104,966,2322,699,1872,139,440,146,364,285,804
313065,202104,1669,4852,1471,4533,45,156,1156,3478,1201,3634
313070,202104,959,2479,736,2108,70,216,426,1185,496,1401
313080,202104,394,1080,293,887,54,182,110,277,164,459
313090,202104,5258,13583,4467,12325,319,992,3068,8359,3387,9351
313100,202104,1341,3435,1038,3000,26,106,794,2237,820,2343
313110,202104,1481,3883,1105,3239,99,349,608,1661,707,2010
313115,202104,2752,7729,2206,6681,275,963,1178,3301,1453,4264
313120,202104,3824,8928,2803,7591,199,589,1885,5115,2084,5704
313130,202104,32000,80678,24483,67120,2417,7550,14085,36391,16502,43941
313140,202104,673,1417,420,1066,26,62,297,757,323,819
313150,202104,1376,3795,1029,3179,316,1054,175,485,491,1539
313160,202104,1232,3018,967,2624,21,70,745,1960,766,2030
313170,202104,11198,31308,8275,25919,1312,4505,3426,10027,4738,14532
313180,202104,2162,5661,1568,4447,246,669,882,2498,1128,3167
313190,202104,4357,12368,3211,10070,559,1907,1124,3273,1683,5180
313200,202104,1111,3036,972,2793,14,48,821,2286,835,2334
313210,202104,3922,11014,3228,9772,374,1196,1962,5783,2336,6979
313220,202104,1759,4556,1175,3405,156,499,490,1259,646,1758
313230,202104,2999,8204,2461,7541,42,147,2061,6449,2103,6596
313240,202104,10093,24303,6552,18737,970,3181,3019,8071,3989,11252
313250,202104,6178,17873,4738,14772,841,2610,2141,6438,2982,9048
313260,202104,681,1742,499,1421,63,232,253,654,316,886
313270,202104,5862,14234,4729,12683,533,1283,3285,9078,3818,10361
313280,202104,469,1308,303,964,38,137,129,387,167,524
313290,202104,997,3031,750,2586,185,708,270,922,455,1630
313300,202104,1636,4291,1204,3546,288,918,326,843,614,1761
313310,202104,1222,3556,952,2997,151,566,289,789,440,1355
313320,202104,2110,5554,1541,4643,265,904,594,1834,859,2738
313330,202104,4230,10831,3208,9290,150,538,2104,6044,2254,6582
313340,202104,1407,3134,1006,2578,79,214,715,1815,794,2029
313350,202104,2965,8118,1941,5833,228,767,724,1892,952,2659
313360,202104,1543,3719,1064,2951,154,515,561,1434,715,1949
313370,202104,1488,4066,1223,3546,156,510,641,1715,797,2225
313375,202104,1827,4770,1175,3528,222,717,250,678,472,1395
313380,202104,6402,15739,4635,12553,736,2253,2274,5492,3010,7745
313390,202104,812,2559,707,2384,51,225,475,1529,526,1754
313400,202104,3658,8907,2845,7804,119,365,2209,5940,2328,6305
313410,202104,1351,3407,1052,2901,57,184,793,2129,850,2313
313420,202104,15700,34606,8248,22232,1850,5548,1097,2934,2947,8482
313430,202104,961,2781,743,2335,123,474,318,863,441,1337
313440,202104,6085,13121,4069,10500,362,970,2573,6656,2935,7626
313450,202104,738,1935,522,1523,88,279,180,449,268,728
313460,202104,2118,5917,1681,5234,339,1192,782,2302,1121,3494
313470,202104,2887,7225,2289,6353,209,581,1546,4341,1755,4922
313480,202104,1039,2915,606,1960,57,206,199,595,256,801
313490,202104,2931,7088,1515,4515,358,1156,349,1025,707,2181
313500,202104,538,1485,397,1186,32,98,161,450,193,548
313505,202104,10216,26609,8700,24549,322,1089,7002,19762,7324,20851
313507,202104,1489,3793,1218,3371,30,126,987,2648,1017,2774
313510,202104,14266,38718,11134,32534,1316,3808,5226,15031,6542,18839
313520,202104,14705,40363,11802,35427,555,1953,8925,26181,9480,28134
313530,202104,553,1618,420,1338,48,169,170,476,218,645
313535,202104,2383,6491,1968,5706,254,666,1232,3597,1486,4263
313540,202104,799,2322,645,1956,114,357,274,752,388,1109
313545,202104,1136,3725,964,3376,133,500,531,1789,664,2289
313550,202104,1784,5342,1482,4636,282,975,777,2329,1059,3304
313560,202104,2741,5310,2065,4490,57,93,1752,3840,1809,3933
313570,202104,1003,2833,822,2510,199,636,332,992,531,1628
313580,202104,5924,14874,4634,12750,488,1380,2814,7721,3302,9101
313590,202104,1081,2956,877,2660,176,569,443,1422,619,1991
313600,202104,4170,10758,3472,9688,80,291,2965,8127,3045,8418
313610,202104,1082,2655,870,2300,81,242,573,1430,654,1672
313620,202104,5476,14244,4306,12155,483,1568,2552,6904,3035,8472
313630,202104,8844,20928,6337,17204,600,1901,3924,10394,4524,12295
313640,202104,1221,2597,750,2002,119,336,402,1068,521,1404
313650,202104,1718,5060,1362,4465,98,378,888,2945,986,3323
313652,202104,790,2401,712,2250,96,319,469,1444,565,1763
313655,202104,1157,2853,907,2543,51,144,675,1911,726,2055
313657,202104,1166,3051,937,2693,32,125,719,1959,751,2084
313660,202104,973,2695,792,2376,74,269,511,1465,585,1734
313665,202104,5000,13063,3973,11287,383,1224,2534,6860,2917,8084
313670,202104,49604,119731,32327,90878,4356,13484,14945,39655,19301,53139
313680,202104,1050,2738,869,2443,57,178,595,1624,652,1802
313690,202104,809,2453,631,2130,146,546,187,606,333,1152
313695,202104,1876,4912,1414,4152,97,290,926,2792,1023,3082
313700,202104,2981,9231,2603,8725,241,757,1993,6752,2234,7509
313710,202104,1486,3302,1060,2741,74,201,709,1844,783,2045
313720,202104,5708,15507,4076,12115,543,1709,1730,4742,2273,6451
313730,202104,1396,3057,1057,2609,82,173,699,1754,781,1927
313740,202104,1693,5933,1428,5258,295,1248,284,904,579,2152
313750,202104,2069,5387,1615,4609,278,887,805,2148,1083,3035
313753,202104,2221,5255,1492,4084,150,451,813,2150,963,2601
313760,202104,5628,15180,4328,12702,795,2615,2050,5582,2845,8197
313770,202104,4078,11243,3243,9916,155,467,2469,7649,2624,8116
313780,202104,4056,10544,2995,8802,247,822,915,2753,1162,3575
313790,202104,506,1505,453,1413,44,147,272,840,316,987
313800,202104,1404,3111,1024,2593,101,285,548,1324,649,1609
313810,202104,1635,4075,1315,3619,41,149,1031,2759,1072,2908
313820,202104,17965,45309,11362,31384,1887,5339,2980,7997,4867,13336
313830,202104,400,1137,287,885,51,178,100,286,151,464
313835,202104,907,2619,756,2349,59,221,432,1265,491,1486
313840,202104,7515,19372,5814,16594,1293,3970,1284,3766,2577,7736
313850,202104,999,2395,789,2112,141,438,376,908,517,1346
313860,202104,2637,6875,1998,5688,278,925,916,2360,1194,3285
313862,202104,1319,2762,646,1779,39,109,307,844,346,953
313865,202104,2630,6838,2180,6117,82,227,1652,4567,1734,4794
313867,202104,1382,4120,1154,3706,189,593,642,2126,831,2719
313868,202104,1686,5112,1390,4539,42,202,1072,3381,1114,3583
313870,202104,919,2369,639,1869,93,286,254,685,347,971
313880,202104,1812,4622,1329,3797,160,521,676,1757,836,2278
313890,202104,2151,4506,1624,3824,29,92,1263,2887,1292,2979
313900,202104,4252,12061,3060,9648,754,2607,744,2123,1498,4730
313910,202104,683,1945,526,1656,98,333,124,390,222,723
313920,202104,2997,8920,2511,7929,500,1567,1273,4041,1773,5608
313925,202104,1613,4007,1317,3492,154,387,889,2361,1043,2748
313930,202104,4653,13777,3789,12201,270,973,2455,7811,2725,8784
313940,202104,8974,25461,6686,21499,684,2695,1651,6017,2335,8712
313950,202104,5371,11597,4074,10023,301,943,2666,6600,2967,7543
313960,202104,5791,13710,3907,10561,722,2215,1285,3155,2007,5370
313970,202104,1539,4070,1294,3669,20,62,840,2335,860,2397
313980,202104,1323,3397,880,2722,138,468,367,1077,505,1545
313990,202104,1925,5968,1400,4800,331,1319,486,1474,817,2793
314000,202104,9808,24705,8235,22033,616,2066,5474,14380,6090,16446
314010,202104,1476,3504,1171,3093,35,115,909,2328,944,2443
314015,202104,1982,5359,1535,4598,185,645,873,2531,1058,3176
314020,202104,518,1388,359,1119,83,310,65,225,148,535
314030,202104,786,2225,624,1921,61,186,335,1011,396,1197
314040,202104,602,1621,495,1428,81,266,255,700,336,966
314050,202104,1909,4996,1407,4076,139,471,787,2122,926,2593
314053,202104,1851,5425,1531,4801,320,975,822,2677,1142,3652
314055,202104,2224,5876,1878,5339,43,158,1550,4399,1593,4557
314060,202104,1313,3403,990,2898,34,116,710,2054,744,2170
314070,202104,4799,12872,3782,11095,732,2134,1697,4938,2429,7072
314080,202104,2150,5487,1501,4402,176,567,645,1711,821,2278
314085,202104,2250,6103,1842,5485,195,584,1095,3330,1290,3914
314090,202104,4870,12682,4180,11672,246,773,2775,8006,3021,8779
314100,202104,3043,7261,2359,6309,37,113,1769,4763,1806,4876
314110,202104,5016,13727,4116,12060,457,1493,2288,6256,2745,7749
314120,202104,724,1682,315,934,53,185,83,229,136,414
314130,202104,664,1746,433,1323,27,97,253,749,280,846
314140,202104,4595,12643,3687,10975,491,1502,1887,5525,2378,7027
314150,202104,1525,3742,1123,3053,58,142,774,2074,832,2216
314160,202104,2272,5815,1677,4715,215,653,721,2034,936,2687
314170,202104,922,2542,756,2218,38,144,505,1383,543,1527
314180,202104,5510,15009,4454,13309,331,1045,2742,8218,3073,9263
314190,202104,619,1523,459,1291,75,244,237,610,312,854
314200,202104,3031,8345,2512,7468,160,509,1758,5113,1918,5622
314210,202104,2098,5345,1659,4565,214,597,782,2116,996,2713
314220,202104,1422,3816,1057,3187,221,746,392,1088,613,1834
314225,202104,1052,2958,879,2672,69,172,645,2012,714,2184
314230,202104,820,2093,668,1901,84,251,426,1258,510,1509
314240,202104,1086,2875,839,2498,186,577,331,993,517,1570
314250,202104,497,1379,315,991,46,127,112,332,158,459
314260,202104,1018,2660,795,2357,161,527,442,1281,603,1808
314270,202104,3257,9092,2683,8214,69,288,2005,6086,2074,6374
314280,202104,3491,7937,2371,6246,241,711,1359,3391,1600,4102
314290,202104,4466,11426,3709,10090,308,856,2550,6793,2858,7649
314300,202104,2019,5626,1317,4150,222,754,474,1375,696,2129
314310,202104,3929,10124,2636,7923,791,2647,406,1043,1197,3690
314315,202104,987,3159,843,2853,44,198,609,1992,653,2190
314320,202104,3114,8321,2060,6348,353,1187,767,2219,1120,3406
314330,202104,50151,138517,38260,117712,9723,31112,8213,26588,17936,57700
314340,202104,2507,6176,1592,4561,290,953,407,1014,697,1967
314345,202104,1455,4197,1169,3680,143,452,709,2219,852,2671
314350,202104,808,2164,525,1651,114,364,122,331,236,695
314360,202104,554,1606,365,1212,49,176,124,372,173,548
314370,202104,761,1984,616,1771,48,149,413,1147,461,1296
314380,202104,1103,2956,729,2304,163,583,153,460,316,1043
314390,202104,14243,35328,9572,26998,1463,4468,3301,8279,4764,12747
314400,202104,3861,11475,2954,9664,745,2537,1089,3709,1834,6246
314410,202104,2743,7582,1932,6070,248,907,612,1998,860,2905
314420,202104,854,2062,622,1685,33,120,427,1095,460,1215
314430,202104,7928,18962,5589,15140,800,2264,2675,6923,3475,9187
314435,202104,1928,5058,1504,4360,151,462,944,2670,1095,3132
314437,202104,910,2298,662,1892,72,217,335,957,407,1174
314440,202104,624,1759,446,1410,139,488,87,213,226,701
314450,202104,1464,3813,1232,3435,137,419,698,1871,835,2290
314460,202104,3177,9517,2339,7818,588,2100,570,1821,1158,3921
314465,202104,2237,6335,1906,5720,49,163,1493,4384,1542,4547
314467,202104,901,2351,763,2133,20,55,615,1680,635,1735
314470,202104,2380,6644,1976,5843,341,1071,933,2587,1274,3658
314480,202104,6977,19229,5216,15621,818,2747,2088,5537,2906,8284
314490,202104,1103,2849,809,2250,65,197,529,1426,594,1623
314500,202104,1698,4013,1228,3387,319,849,413,1201,732,2050
314505,202104,2047,4948,1678,4418,89,256,1251,3193,1340,3449
314510,202104,2019,5173,1439,4278,282,940,667,1926,949,2866
314520,202104,5108,15302,3900,12865,777,2811,560,1675,1337,4486
314530,202104,5442,17163,4913,16156,310,1212,3659,11771,3969,12983
314535,202104,2426,6303,1980,5665,75,286,1523,4323,1598,4609
314537,202104,1103,3081,846,2671,39,148,634,1962,673,2110
314540,202104,402,991,277,786,23,66,162,442,185,508
314545,202104,1988,4674,1783,4438,30,82,1567,3983,1597,4065
314550,202104,721,1716,537,1443,33,106,314,772,347,878
314560,202104,4584,13438,3392,10835,468,1694,1236,3485,1704,5179
314570,202104,312,859,229,705,25,87,107,330,132,417
314580,202104,455,1342,362,1159,93,296,120,382,213,678
314585,202104,666,2024,513,1692,53,203,234,755,287,958
314587,202104,2085,5587,1588,4792,215,616,941,2888,1156,3504
314590,202104,4176,11066,3093,9083,392,1270,1451,3926,1843,5196
314600,202104,1925,5163,1155,3716,248,833,134,429,382,1262
314610,202104,9061,22088,6525,18415,952,3219,2912,8404,3864,11623
314620,202104,2279,5242,1810,4651,41,136,1520,3888,1561,4024
314625,202104,1555,4178,1342,3883,25,148,1166,3303,1191,3451
314630,202104,5546,13597,4548,12250,101,398,3815,10172,3916,10570
314640,202104,705,1643,521,1361,66,200,305,740,371,940
314650,202104,835,1900,526,1418,48,150,303,724,351,874
314655,202104,1582,4303,1138,3519,168,510,561,1755,729,2265
314660,202104,322,723,212,535,11,23,140,341,151,364
314670,202104,1634,3669,1145,2978,17,53,778,1988,795,2041
314675,202104,1736,4481,1484,4065,66,198,1177,3146,1243,3344
314690,202104,2072,5600,1576,4878,397,1345,551,1672,948,3017
314700,202104,10594,28784,7061,22091,1285,4426,2427,7321,3712,11747
314710,202104,8039,22242,5921,17801,932,3116,2222,5810,3154,8926
314720,202104,2179,6349,1539,5059,292,1040,366,1126,658,2166
314730,202104,2349,6021,1700,4880,285,902,643,1697,928,2599
314740,202104,3016,8353,2364,7189,313,994,1209,3570,1522,4564
314750,202104,280,766,215,634,26,89,131,343,157,432
314760,202104,2003,5819,1309,4261,218,801,337,856,555,1657
314770,202104,1100,3148,615,1965,60,206,188,547,248,753
314780,202104,362,867,249,693,39,130,137,340,176,470
314790,202104,11839,30964,8352,24549,1553,5211,3174,8606,4727,13817
314795,202104,1560,4026,1327,3625,28,117,1074,2818,1102,2935
314800,202104,10848,27374,6886,20171,1194,3773,1873,4897,3067,8670
314810,202104,9022,23627,6618,19512,1679,5239,2112,6113,3791,11352
314820,202104,1278,3031,1012,2623,70,228,644,1583,714,1811
314830,202104,1621,4748,1364,4272,208,722,692,2100,900,2822
314840,202104,854,2628,668,2300,48,212,457,1493,505,1705
314850,202104,2231,4939,1819,4424,52,136,1573,3818,1625,3954
314860,202104,3291,9351,2754,8397,158,621,1976,5848,2134,6469
314870,202104,6495,15734,4914,13693,230,657,3648,10308,3878,10965
314875,202104,1860,5439,1643,5155,159,385,1298,4223,1457,4608
314880,202104,828,2010,647,1727,37,102,399,1084,436,1186
314890,202104,419,1224,323,1029,52,184,135,401,187,585
314900,202104,734,1938,577,1660,78,257,270,748,348,1005
314910,202104,1685,4683,1255,3982,188,697,653,1945,841,2642
314915,202104,2204,6433,1857,5819,117,369,1231,3789,1348,4158
314920,202104,482,1253,319,1007,9,22,211,681,220,703
314930,202104,5589,15466,4252,12974,690,2365,1774,5005,2464,7370
314940,202104,418,1000,348,884,39,100,228,555,267,655
314950,202104,558,1391,387,1118,26,94,207,546,233,640
314960,202104,854,1982,655,1664,27,81,477,1146,504,1227
314970,202104,970,2842,745,2384,135,476,332,961,467,1437
314980,202104,1609,4042,1218,3471,203,655,623,1719,826,2374
314990,202104,2436,6973,1764,5480,338,1102,386,1079,724,2181
314995,202104,1620,4421,1290,3835,30,120,891,2502,921,2622
315000,202104,1121,2807,802,2315,60,176,527,1505,587,1681
315010,202104,380,1025,290,872,48,171,142,406,190,577
315015,202104,2327,6407,2023,5898,186,626,1371,3930,1557,4556
315020,202104,805,2321,572,1806,63,243,252,740,315,983
315030,202104,603,1590,415,1243,91,280,86,219,177,499
315040,202104,874,2352,709,2059,98,314,432,1217,530,1531
315050,202104,1248,3143,927,2642,51,185,511,1385,562,1570
315053,202104,1144,2934,884,2494,56,158,518,1392,574,1550
315057,202104,1772,5201,1444,4654,138,406,969,3223,1107,3629
315060,202104,594,1745,435,1424,91,301,114,357,205,658
315070,202104,517,1340,359,1070,80,269,101,285,181,554
315080,202104,3102,8375,2424,7130,160,530,1656,4612,1816,5142
315090,202104,807,2382,604,2005,87,317,258,818,345,1135
315100,202104,1341,3841,893,2855,125,467,396,1104,521,1571
315110,202104,2019,4730,1474,3919,134,352,752,2062,886,2414
315120,202104,12685,29001,9466,24237,1152,2657,5333,14153,6485,16810
315130,202104,1666,4487,1389,4012,137,453,581,1564,718,2017
315140,202104,2957,8081,2335,6988,432,1413,1165,3280,1597,4693
315150,202104,4388,10492,3131,8507,433,1369,1518,4026,1951,5395
315160,202104,1827,4408,1214,3437,254,769,546,1495,800,2264
315170,202104,1349,4241,964,3315,201,754,267,862,468,1616
315180,202104,17416,41709,9878,28038,1239,3970,3384,8442,4623,12412
315190,202104,2242,4864,1746,4217,209,504,1253,3074,1462,3578
315200,202104,4023,11200,2966,9368,810,2776,779,2361,1589,5137
315210,202104,8739,22343,6075,16840,684,2036,3026,7581,3710,9617
315213,202104,1125,2918,980,2721,22,76,817,2217,839,2293
315217,202104,2869,8110,2196,6990,91,380,1515,4642,1606,5022
315220,202104,8589,22998,6779,19845,1023,3125,3096,9112,4119,12237
315230,202104,3044,7026,2567,6392,203,273,1945,5176,2148,5449
315240,202104,2419,6953,2024,6276,422,1365,990,3106,1412,4471
315250,202104,13653,36238,10022,29490,1501,4756,4313,12053,5814,16809
315260,202104,874,2362,471,1519,73,244,41,110,114,354
315270,202104,884,2497,648,2062,86,291,230,635,316,926
315280,202104,2826,6965,1767,5097,429,1314,301,847,730,2161
315290,202104,1160,2830,698,2097,185,623,199,583,384,1206
315300,202104,652,1582,463,1316,61,193,263,758,324,951
315310,202104,1236,3415,942,2865,70,229,546,1563,616,1792
315320,202104,667,1934,470,1538,70,254,188,558,258,812
315330,202104,759,2528,432,1649,65,283,144,486,209,769
315340,202104,2952,7063,2130,5866,320,888,1088,2977,1408,3865
315350,202104,1605,4291,1296,3807,157,533,770,2219,927,2752
315360,202104,1732,5028,1330,4215,190,629,566,1667,756,2296
315370,202104,538,1463,435,1269,73,203,200,567,273,770
315380,202104,212,616,156,489,38,127,34,85,72,212
315390,202104,1159,3222,934,2813,129,463,474,1320,603,1783
315400,202104,4033,10776,3200,9300,382,1190,1864,5160,2246,6350
315410,202104,2513,5632,1880,4698,414,1150,370,954,784,2104
315415,202104,1427,3835,1160,3420,250,861,419,1242,669,2103
315420,202104,1483,4110,1036,3269,181,604,231,691,412,1295
315430,202104,3657,8807,2594,7214,444,1445,1153,3020,1597,4465
315440,202104,1052,2740,835,2382,63,211,502,1339,565,1550
315445,202104,1954,4628,1411,3855,88,285,1046,2810,1134,3095
315450,202104,2310,6246,1904,5585,233,603,1194,3552,1427,4155
315460,202104,38748,105036,32075,93276,4286,14134,18304,49912,22590,64046
315470,202104,639,1764,455,1321,30,95,259,718,289,813
315480,202104,1124,3206,807,2529,140,449,270,825,410,1274
315490,202104,2937,7347,2071,5954,270,814,809,2189,1079,3003
315500,202104,524,1388,330,970,39,133,174,448,213,581
315510,202104,1250,3186,1074,2945,16,65,957,2585,973,2650
315520,202104,1015,2726,836,2437,44,151,655,1860,699,2011
315530,202104,614,1701,490,1476,117,405,255,718,372,1123
315540,202104,1534,4042,1082,3219,93,338,511,1462,604,1800
315550,202104,1884,4905,1230,3710,249,869,316,945,565,1814
315560,202104,6218,18686,5266,16971,312,936,3466,11424,3778,12360
315570,202104,2120,5574,1685,4846,138,432,905,2534,1043,2966
315580,202104,3066,7108,2361,6013,351,970,958,2350,1309,3320
315590,202104,917,2264,710,1947,59,202,438,1119,497,1321
315600,202104,2537,7725,1808,6283,288,923,882,3276,1170,4199
315610,202104,997,2471,751,2036,100,336,354,829,454,1165
315620,202104,527,1365,403,1184,43,137,225,668,268,805
315630,202104,1054,2746,807,2296,117,364,399,1037,516,1401
315640,202104,348,846,258,733,28,104,160,430,188,534
315645,202104,991,2532,692,2045,148,478,194,540,342,1018
315650,202104,1699,4055,1372,3603,36,112,1110,2835,1146,2947
315660,202104,2470,6061,1861,5018,93,282,1352,3521,1445,3803
315670,202104,13761,36913,10533,31190,1968,6114,4835,13702,6803,19816
315680,202104,3233,9037,2392,7451,267,973,1334,3939,1601,4912
315690,202104,3543,8505,2172,6191,471,1332,589,1821,1060,3153
315700,202104,8311,22437,6340,18615,967,2977,2827,7975,3794,10952
315710,202104,1863,4524,1341,3740,46,170,950,2561,996,2731
315720,202104,4409,12110,3673,10779,190,717,2576,7261,2766,7978
315725,202104,2261,5759,1742,4926,209,568,1059,3146,1268,3714
315727,202104,567,1445,433,1229,56,190,184,498,240,688
315730,202104,574,1760,510,1628,94,338,165,467,259,805
315733,202104,1224,3077,905,2551,134,435,339,898,473,1333
315737,202104,1160,3190,913,2712,22,86,670,1908,692,1994
315740,202104,794,2183,645,1887,61,206,435,1192,496,1398
315750,202104,1255,3267,1004,2871,91,272,622,1802,713,2074
315760,202104,1149,2672,1007,2483,46,147,841,2014,887,2161
315765,202104,1985,5141,1639,4687,24,95,1458,4155,1482,4250
315770,202104,1021,2771,790,2449,312,1059,164,441,476,1500
315780,202104,30675,81968,25681,73196,1321,4655,17930,48689,19251,53344
315790,202104,3650,11048,3127,10079,315,1053,1917,6332,2232,7385
315800,202104,1308,4391,984,3582,128,529,352,1122,480,1651
315810,202104,1304,3244,1073,2850,59,188,830,2124,889,2312
315820,202104,2584,6802,2101,6128,186,583,1476,4327,1662,4910
315830,202104,1240,3619,842,2748,85,300,273,767,358,1067
315840,202104,882,2088,623,1643,40,134,325,771,365,905
315850,202104,1202,3438,947,2997,183,612,463,1378,646,1990
315860,202104,489,1384,351,1143,54,188,128,378,182,566
315870,202104,469,1230,377,1085,24,77,266,734,290,811
315880,202104,1125,2829,770,2197,94,284,210,562,304,846
315890,202104,1710,4780,1386,4332,335,1158,703,2168,1038,3326
315895,202104,6305,16800,4760,13796,437,1419,2501,6733,2938,8152
315900,202104,816,2076,706,1921,62,168,529,1403,591,1571
315910,202104,520,1401,437,1272,68,191,292,859,360,1050
315920,202104,1444,3634,821,2475,125,463,270,722,395,1185
315930,202104,1096,2392,749,1898,141,334,336,871,477,1205
315935,202104,864,2572,691,2243,133,465,250,795,383,1260
315940,202104,609,1641,485,1454,61,192,261,753,322,945
315950,202104,1144,3137,946,2814,82,233,737,2190,819,2423
315960,202104,5565,15428,3815,11910,1020,3505,466,1040,1486,4545
315970,202104,591,1551,471,1391,58,175,314,943,372,1118
315980,202104,4323,9161,2415,6101,445,1179,927,2144,1372,3323
315990,202104,3582,9112,2832,7824,311,893,1564,4166,1875,5059
316000,202104,624,1527,482,1321,51,170,247,638,298,808
316010,202104,820,2210,617,1857,53,182,331,904,384,1086
316020,202104,940,2764,751,2392,112,396,412,1227,524,1623
316030,202104,2753,7619,2132,6498,239,729,1363,4235,1602,4964
316040,202104,2461,6896,1851,5763,301,1068,538,1457,839,2525
316045,202104,2073,5287,1907,5089,73,142,1664,4547,1737,4689
316050,202104,392,1062,311,931,44,123,172,486,216,609
316060,202104,680,1654,496,1408,18,77,355,965,373,1042
316070,202104,5394,14698,4415,12876,776,2259,2042,5841,2818,8100
316080,202104,748,2295,582,1962,148,530,92,262,240,792
316090,202104,415,1161,323,978,42,130,164,463,206,593
316095,202104,1316,4013,1036,3307,268,915,373,1120,641,2035
316100,202104,2515,7197,1856,5826,311,1078,714,2032,1025,3110
316105,202104,834,2171,685,1932,42,135,473,1360,515,1495
316110,202104,14002,39290,11743,35505,832,2838,8106,24141,8938,26979
316120,202104,1263,3470,832,2487,123,384,267,624,390,1008
316130,202104,1258,2833,828,2125,67,194,498,1236,565,1430
316140,202104,1231,3222,790,2406,88,294,376,1127,464,1421
316150,202104,2075,4538,1651,3947,207,618,717,1618,924,2236
316160,202104,1032,2731,830,2362,35,116,590,1639,625,1755
316165,202104,862,2099,679,1818,104,322,386,968,490,1290
316170,202104,1204,2952,911,2513,37,123,648,1717,685,1840
316180,202104,1400,3930,977,3086,140,524,192,554,332,1078
316190,202104,2704,7567,1618,4985,234,746,626,1717,860,2463
316200,202104,3262,9237,2497,7914,555,1885,757,2300,1312,4185
316210,202104,4604,13346,3345,10457,1149,3956,180,450,1329,4406
316220,202104,633,1883,431,1442,90,348,46,177,136,525
316225,202104,1578,3549,1182,2926,50,181,899,2066,949,2247
316230,202104,424,1147,328,987,56,182,161,483,217,665
316240,202104,5592,16010,4901,14794,351,1158,3723,11073,4074,12231
316245,202104,3145,9842,2859,9372,109,602,2289,7177,2398,7779
316250,202104,10635,25108,7900,20838,1598,4548,3022,7901,4620,12449
316255,202104,2872,7891,2529,7356,111,333,1918,5648,2029,5981
316257,202104,1410,3334,1034,2683,97,257,649,1600,746,1857
316260,202104,2234,5438,1775,4714,217,559,950,2578,1167,3137
316265,202104,1139,3014,896,2612,18,69,677,1926,695,1995
316270,202104,3747,11289,3229,10177,475,1574,1655,5007,2130,6581
316280,202104,2909,8016,2488,7243,315,1006,1407,3961,1722,4967
316290,202104,3388,9279,2727,8057,315,1039,1144,3254,1459,4293
316292,202104,5176,13511,4199,11947,530,1598,2696,7396,3226,8994
316294,202104,843,2472,643,2133,123,474,170,524,293,998
316295,202104,3308,9143,2700,8092,138,500,1903,5453,2041,5953
316300,202104,1032,2869,834,2553,37,130,617,1863,654,1993
316310,202104,796,2110,527,1632,116,417,99,256,215,673
316320,202104,690,1895,543,1669,58,209,265,787,323,996
316330,202104,1097,2777,845,2355,50,162,649,1759,699,1921
316340,202104,1001,2653,747,2199,77,281,423,1187,500,1468
316350,202104,1303,3617,1078,3247,121,365,707,2123,828,2488
316360,202104,635,1678,527,1504,53,157,385,1103,438,1260
316370,202104,5190,13442,3913,11217,576,1928,1735,4444,2311,6372
316380,202104,1747,4174,1390,3661,56,117,972,2577,1028,2694
316390,202104,788,2105,562,1707,235,803,81,212,316,1015
316400,202104,1200,3356,801,2558,103,366,276,786,379,1152
316410,202104,1144,3105,959,2827,58,186,773,2236,831,2422
316420,202104,1996,5352,1744,5026,39,135,1458,4121,1497,4256
316430,202104,876,2240,583,1736,94,311,224,609,318,920
316440,202104,822,2476,653,2178,115,441,178,540,293,981
316443,202104,551,1520,405,1242,99,352,99,279,198,631
316447,202104,2007,5285,1769,4892,23,78,1557,4256,1580,4334
316450,202104,2173,6446,1671,5404,230,798,990,3131,1220,3929
316460,202104,1268,3168,1041,2816,118,359,678,1747,796,2106
316470,202104,7027,19862,5098,15827,763,2623,2043,5799,2806,8422
316480,202104,196,522,166,481,50,137,75,216,125,353
316490,202104,328,878,230,696,36,112,82,214,118,326
316500,202104,1227,3743,814,2767,170,632,187,590,357,1222
316510,202104,792,2503,634,2191,99,344,330,1143,429,1487
316520,202104,1392,3310,1095,2832,117,369,596,1406,713,1775
316530,202104,1144,2945,830,2377,84,308,436,1113,520,1421
316540,202104,940,2351,755,2071,104,319,407,1012,511,1331
316550,202104,1338,3843,1155,3507,43,154,903,2723,946,2877
316553,202104,4452,12882,3230,9980,453,1542,1303,3558,1756,5100
316555,202104,2624,7988,2383,7653,96,333,2027,6535,2123,6868
316556,202104,523,1287,403,1070,26,72,244,582,270,654
316557,202104,1053,3191,920,2977,288,1014,343,1064,631,2078
316560,202104,334,921,234,770,44,162,86,270,130,432
316570,202104,1343,3792,1121,3386,284,848,376,1199,660,2047
316580,202104,395,823,245,584,36,96,124,273,160,369
316590,202104,1359,3426,952,2648,205,501,455,1245,660,1746
316600,202104,945,2852,811,2582,122,397,412,1311,534,1708
316610,202104,599,1859,489,1681,59,255,287,953,346,1208
316620,202104,2132,5473,1872,5109,82,243,1509,4099,1591,4342
316630,202104,1589,4674,1316,4161,342,1088,509,1778,851,2866
316640,202104,139,365,112,329,16,57,52,128,68,185
316650,202104,1074,3274,859,2936,85,306,541,1860,626,2166
316660,202104,189,463,78,237,10,36,12,24,22,60
316670,202104,1789,4482,1354,3793,341,1006,459,1268,800,2274
316680,202104,2311,5816,1725,4707,103,299,1297,3452,1400,3751
316690,202104,1433,3962,1086,3345,176,584,482,1436,658,2020
316695,202104,1018,2925,841,2608,27,108,593,1818,620,1926
316700,202104,403,917,332,837,14,40,261,630,275,670
316710,202104,3189,10187,2494,8761,434,1646,1096,3757,1530,5403
316720,202104,20896,56020,15569,45957,2580,8165,6855,19103,9435,27268
316730,202104,478,1239,384,1068,43,147,198,511,241,658
316740,202104,769,2187,665,2023,75,266,414,1275,489,1541
316750,202104,397,1153,311,990,71,237,131,396,202,633
316760,202104,3353,10701,2787,9565,1091,4051,619,2005,1710,6056
316770,202104,1644,3642,1259,3129,28,80,1024,2601,1052,2681
316780,202104,551,1604,435,1380,163,568,86,241,249,809
316790,202104,738,1973,533,1566,98,315,162,440,260,755
316800,202104,6396,17653,5160,15431,617,2024,2518,7325,3135,9349
316805,202104,1043,2279,852,2071,57,153,660,1616,717,1769
316810,202104,617,1698,443,1370,80,269,242,718,322,987
316820,202104,301,736,167,486,20,73,68,177,88,250
316830,202104,806,2080,649,1831,72,218,400,1113,472,1331
316840,202104,2825,7116,2246,6158,176,593,1595,4165,1771,4758
316850,202104,1920,5003,1405,4078,225,704,629,1737,854,2441
316860,202104,19886,50046,14637,42218,2204,7377,6842,19215,9046,26592
316870,202104,7932,21250,5941,17446,847,2703,2713,7458,3560,10161
316880,202104,952,2499,782,2261,136,422,409,1139,545,1561
316890,202104,1167,2571,704,1960,87,313,453,1175,540,1488
316900,202104,2337,6170,1835,5189,373,1129,558,1489,931,2618
316905,202104,518,1526,417,1331,111,383,164,532,275,915
316910,202104,881,2272,534,1659,127,428,49,143,176,571
316920,202104,1797,4349,1286,3601,203,606,652,1791,855,2397
316930,202104,7965,22429,5982,18886,1367,4664,1649,4864,3016,9528
316935,202104,4110,10968,3017,8957,516,1662,1248,3505,1764,5167
316940,202104,6506,18802,5049,15846,724,2500,2126,6166,2850,8666
316950,202104,1920,4420,1505,3856,37,120,1276,3221,1313,3341
316960,202104,5122,11403,3693,9489,349,983,2522,6329,2871,7312
316970,202104,3796,10554,3285,9616,484,1489,1428,3963,1912,5452
316980,202104,676,2003,516,1698,172,632,63,210,235,842
316990,202104,12348,32535,9165,26172,2187,6827,1555,4019,3742,10846
317000,202104,2500,7269,2199,6830,162,422,1647,5183,1809,5605
317005,202104,2589,7100,2076,6082,318,964,1144,3284,1462,4248
317010,202104,24267,56403,15367,42865,2844,8815,6071,17204,8915,26019
317020,202104,61806,146046,36947,103325,6552,20053,12059,31214,18611,51267
317030,202104,699,1812,549,1606,14,53,425,1228,439,1281
317040,202104,11039,27484,7807,22006,1653,5035,2784,8055,4437,13090
317043,202104,873,1943,628,1598,45,118,466,1170,511,1288
317047,202104,1178,2818,818,2246,65,198,536,1416,601,1614
317050,202104,1188,3620,865,2871,117,417,356,1030,473,1447
317052,202104,2396,6558,1934,5816,276,806,1184,3606,1460,4412
317057,202104,1932,4397,1428,3615,33,114,983,2446,1016,2560
317060,202104,513,1315,333,964,42,130,136,344,178,474
317065,202104,1136,3328,933,2932,57,177,586,1752,643,1929
317070,202104,7391,20309,5363,16422,902,3076,1743,5040,2645,8116
317075,202104,925,2359,680,1951,90,287,343,895,433,1182
317080,202104,6231,14306,4638,11805,1165,3232,1663,4085,2828,7317
317090,202104,4824,13723,4283,12850,287,794,3192,9645,3479,10439
317100,202104,2664,6290,1737,4774,397,1122,639,1740,1036,2862
317103,202104,2284,5879,1963,5410,71,309,1571,4169,1642,4478
317107,202104,1474,3855,1128,3221,71,241,694,1786,765,2027
317110,202104,675,1564,349,1052,60,213,108,332,168,545
317115,202104,1074,3059,930,2792,64,169,629,1913,693,2082
317120,202104,15612,41183,12722,36592,1024,3522,8137,22321,9161,25843
317130,202104,11622,26631,7634,20152,1143,3335,2718,7085,3861,10420
317140,202104,902,2123,707,1828,49,139,482,1276,531,1415
317150,202104,985,2353,757,2065,29,90,600,1608,629,1698
317160,202104,3609,8520,2423,6658,139,408,1364,3845,1503,4253
317170,202104,1811,4485,1335,3682,172,560,645,1583,817,2143
317180,202104,2004,6136,1476,4873,277,976,412,1243,689,2219
317190,202104,1210,3243,894,2719,215,637,381,1161,596,1798
317200,202104,5993,15759,4535,12918,1013,3098,1055,2761,2068,5859
317210,202104,1215,2896,949,2533,24,93,708,1913,732,2006
317220,202104,239,739,205,675,47,160,79,274,126,434
320010,202104,4553,13117,3667,11351,417,1424,2272,6836,2689,8260
320013,202104,2073,5525,1440,4279,223,686,649,2017,872,2703
320016,202104,3017,7654,2409,6749,183,475,1760,4975,1943,5450
320020,202104,3971,10124,2941,8358,603,1906,1103,3221,1706,5127
320030,202104,1757,4847,1161,3639,215,724,409,1227,624,1951
320035,202104,1949,5230,1598,4637,385,1234,731,2045,1116,3279
320040,202104,4280,11921,3577,10667,477,1473,2023,5792,2500,7265
320050,202104,1764,3986,1521,3642,184,525,907,2089,1091,2614
320060,202104,13340,35715,9976,29080,1518,4762,4676,12705,6194,17467
320070,202104,1576,4348,1136,3471,192,653,430,1211,622,1864
320080,202104,5868,14863,4103,11373,803,2350,1490,3886,2293,6236
320090,202104,8762,22972,5852,17036,1272,3949,2086,5643,3358,9592
320100,202104,3172,8457,2599,7476,417,1286,1374,3956,1791,5242
320110,202104,2143,4934,1474,3870,197,542,769,1924,966,2466
320115,202104,1955,6124,1661,5630,713,2571,437,1535,1150,4106
320120,202104,24757,62384,17418,49232,2382,7213,8185,21855,10567,29068
320130,202104,48954,133026,40449,117805,4886,15595,24094,67814,28980,83409
320140,202104,3654,9886,2462,7529,342,1226,1030,3064,1372,4290
320150,202104,14053,35955,10188,28681,2502,7773,1570,3939,4072,11712
320160,202104,6256,17104,4639,14034,732,2424,2046,6105,2778,8529
320170,202104,1762,4961,1283,4003,350,1071,470,1565,820,2636
320180,202104,703,2199,565,1933,201,736,153,476,354,1212
320190,202104,2910,9149,2246,7693,525,1916,574,1829,1099,3745
320200,202104,1362,3618,932,2848,211,723,334,997,545,1720
320210,202104,4365,10990,3376,9316,544,1608,1737,4574,2281,6182
320220,202104,3169,8088,2445,6918,349,1086,1352,3627,1701,4713
320225,202104,1388,4253,997,3344,348,1271,198,647,546,1918
320230,202104,5203,14065,3996,12061,828,2731,1565,4557,2393,7288
320240,202104,16653,41559,12419,34811,3002,9214,3913,10780,6915,19994
320245,202104,3152,9159,2473,7814,842,2821,419,1291,1261,4112
320250,202104,2543,6945,1726,5035,391,1269,505,1257,896,2526
320255,202104,1950,5966,1670,5445,413,1395,776,2587,1189,3982
320260,202104,1450,4034,877,2753,170,581,220,592,390,1173
320265,202104,2488,7580,2007,6611,863,3071,304,977,1167,4048
320270,202104,2279,6428,1757,5403,449,1491,607,1868,1056,3359
320280,202104,7430,19494,6082,17222,1158,3566,3029,8291,4187,11857
320290,202104,1365,4005,892,2881,241,843,220,668,461,1511
320300,202104,3737,11065,2966,9503,817,2848,777,2325,1594,5173
320305,202104,5260,14627,4098,12360,734,2427,2021,5906,2755,8333
320310,202104,2282,6159,1610,4770,282,887,716,1981,998,2868
320313,202104,2477,6081,1660,4593,325,995,444,1101,769,2096
320316,202104,1522,4268,1245,3800,191,589,726,2224,917,2813
320320,202104,22613,58400,16172,47280,3689,11221,5758,16905,9447,28126
320330,202104,2956,7926,2305,6755,400,1199,1219,3617,1619,4816
320332,202104,8005,21299,6369,18311,1418,4361,2746,7718,4164,12079
320334,202104,1784,4937,1254,3867,267,999,311,719,578,1718
320335,202104,1519,4423,1096,3463,233,845,306,891,539,1736
320340,202104,4990,12205,4142,10971,505,1433,2436,6499,2941,7932
320350,202104,5536,13386,3938,10573,420,1258,2176,5463,2596,6721
320360,202104,1446,3683,1078,3000,136,371,520,1397,656,1768
320370,202104,2575,7810,1901,6360,569,2022,583,1926,1152,3948
320380,202104,2652,6970,2204,6245,248,752,1405,3876,1653,4628
320390,202104,7323,19403,5433,15691,1118,3456,2165,5850,3283,9306
320400,202104,3372,9405,2539,7634,703,2276,796,2251,1499,4527
320405,202104,5149,13237,3940,11152,545,1686,2026,5532,2571,7218
320410,202104,4852,12413,3666,10510,655,1832,1819,5449,2474,7281
320420,202104,3056,7900,2360,6692,519,1639,593,1620,1112,3259
320425,202104,2216,5301,1697,4426,130,337,1057,2695,1187,3032
320430,202104,3235,8022,2561,6840,342,980,1571,4020,1913,5000
320435,202104,2091,6474,1656,5625,579,2104,512,1740,1091,3844
320440,202104,1537,4208,1136,3439,178,585,504,1440,682,2025
320450,202104,1799,5072,1401,4317,256,895,644,1848,900,2743
320455,202104,4452,13306,3033,9940,713,2511,745,2220,1458,4731
320460,202104,2134,6206,1540,4977,368,1287,422,1248,790,2535
320465,202104,1383,3799,1059,3194,150,454,571,1753,721,2207
320470,202104,3701,10073,2702,8001,578,1826,697,1866,1275,3692
320480,202104,1781,4734,1464,4212,172,558,921,2571,1093,3129
320490,202104,22304,57248,16777,47692,2728,8349,7243,20373,9971,28722
320495,202104,1303,3535,942,2830,206,703,330,931,536,1634
320500,202104,52694,138776,42247,121040,5650,17607,24579,67410,30229,85017
320501,202104,4575,13157,3423,11057,930,3370,1072,3382,2002,6752
320503,202104,2332,6682,1532,5012,418,1480,400,1261,818,2741
320506,202104,2704,8013,1996,6441,605,2110,186,614,791,2724
320510,202104,10642,28266,8697,24982,867,2841,5429,15054,6296,17895
320515,202104,1811,4930,1409,4110,356,1146,471,1290,827,2436
320517,202104,2196,6524,1769,5612,527,1819,556,1737,1083,3556
320520,202104,38107,96720,28740,81070,4660,14539,12485,33759,17145,48298
320530,202104,34092,88395,27090,76160,2343,7764,17282,45813,19625,53577
330010,202104,23956,61847,19893,55232,2261,6888,13477,36265,15738,43153
330015,202104,1403,3397,1108,2979,188,565,635,1633,823,2198
330020,202104,19932,49242,16770,44735,2307,6822,11613,30346,13920,37168
330022,202104,1915,5094,1490,4392,235,686,847,2491,1082,3177
330023,202104,5288,12323,3905,10424,574,1720,2301,6006,2875,7726
330025,202104,7047,16108,4198,11435,892,2692,909,2355,1801,5047
330030,202104,10591,27807,8100,23825,792,2714,5046,14142,5838,16856
330040,202104,15145,38660,12128,33694,990,3096,8340,22244,9330,25340
330045,202104,86620,201306,71487,182262,5377,13262,56821,144663,62198,157925
330050,202104,2569,6700,1908,5589,351,1095,980,2734,1331,3829
330060,202104,5337,13700,4179,11646,783,2450,1804,4618,2587,7068
330070,202104,23273,57392,18793,51057,2695,7853,11470,30896,14165,38749
330080,202104,8969,22179,7647,20353,892,2544,5338,14007,6230,16551
330090,202104,3442,7144,2413,5734,143,361,1718,4066,1861,4427
330093,202104,2743,6487,2067,5562,109,308,1587,4248,1696,4556
330095,202104,1345,3687,1062,3178,99,313,629,1760,728,2073
330100,202104,72383,187900,61877,172610,3390,11103,47887,131636,51277,142739
330110,202104,2110,5777,1690,5086,246,808,993,2888,1239,3696
330115,202104,2583,6110,1826,4947,247,770,1044,2703,1291,3473
330120,202104,3616,7899,2729,6779,204,571,1966,4698,2170,5269
330130,202104,4501,11973,3683,10756,473,1440,2320,6753,2793,8193
330140,202104,3924,9923,3129,8794,383,1203,2084,5697,2467,6900
330150,202104,2220,5787,1698,4974,301,904,844,2436,1145,3340
330160,202104,1374,3679,1016,3044,185,594,538,1534,723,2128
330170,202104,114507,276400,92222,246569,12122,31795,62599,169481,74721,201276
330180,202104,1964,4663,1511,4042,88,261,1049,2739,1137,3000
330185,202104,10016,24723,8368,22466,446,1448,6769,17747,7215,19195
330187,202104,4577,11273,3610,9721,454,1331,2219,5875,2673,7206
330190,202104,34835,82165,29332,74704,1863,5143,23401,58858,25264,64001
330200,202104,16442,40645,13317,36824,2562,6582,8294,23885,10856,30467
330205,202104,2224,5407,1685,4549,107,328,1168,3031,1275,3359
330210,202104,3566,8696,2608,7047,353,1015,1332,3378,1685,4393
330220,202104,12474,30170,8874,24258,1704,5252,3438,8700,5142,13952
330225,202104,3997,9869,3052,8459,204,678,2186,5909,2390,6587
330227,202104,17162,40755,14289,37296,532,1489,12257,31680,12789,33169
330230,202104,2146,4589,1410,3677,123,348,826,2167,949,2515
330240,202104,23678,60660,19619,54504,2110,6479,13475,36599,15585,43078
330245,202104,1793,4337,1077,3091,200,583,399,1118,599,1701
330250,202104,39307,98185,32407,88168,5117,14311,20362,55050,25479,69361
330260,202104,5018,11843,3796,10206,313,979,2765,7177,3078,8156
330270,202104,32845,73193,20267,52653,3033,8430,8401,20708,11434,29138
330280,202104,2393,6120,1800,5128,179,552,1084,2977,1263,3529
330285,202104,25941,60440,20486,52707,1235,3758,15600,38824,16835,42582
330290,202104,4021,9564,3243,8553,326,974,2353,5994,2679,6968
330300,202104,5908,13670,4324,11430,322,938,3049,7878,3371,8816
330310,202104,2759,6607,1972,5323,135,301,1339,3617,1474,3918
330320,202104,17599,40380,13533,35348,1522,3708,9727,25792,11249,29500
330330,202104,43222,92221,33649,79359,2763,7163,24339,56049,27102,63212
330340,202104,18357,42270,13178,34404,1838,5537,7047,17078,8885,22615
330350,202104,148531,335821,122761,304658,7437,19069,101555,250327,108992,269396
330360,202104,7497,17950,6401,16638,196,489,5441,14092,5637,14581
330370,202104,5081,14201,3929,12270,913,2928,1641,5310,2554,8238
330380,202104,5595,14535,4255,12219,627,2120,2293,6260,2920,8380
330385,202104,4119,11480,3363,10391,712,2428,1670,5061,2382,7489
330390,202104,27254,71612,20890,60956,2665,9011,12519,34385,15184,43396
330395,202104,3269,7918,2683,7181,139,436,1986,5180,2125,5616
330400,202104,3474,8952,2956,8151,142,521,2236,5804,2378,6325
330410,202104,3414,8839,2448,7190,497,1553,1075,2962,1572,4515
330411,202104,2825,7528,2194,6388,137,488,1541,4295,1678,4783
330412,202104,1591,4415,1297,3934,133,458,823,2371,956,2829
330414,202104,24304,60056,19754,53888,1400,4093,14960,40168,16360,44261
330415,202104,4555,12130,3534,10364,360,1108,2061,5955,2421,7063
330420,202104,12408,30157,8850,24422,963,3060,4817,12345,5780,15405
330430,202104,9796,23156,8226,21037,277,885,6612,16437,6889,17322
330440,202104,2746,7087,2098,6010,275,897,1275,3519,1550,4416
330450,202104,1458,4014,1152,3503,140,456,647,1923,787,2379
330452,202104,18181,45161,14608,39692,1647,5076,9624,25167,11271,30243
330455,202104,566788,1318464,441075,1141009,56870,157107,289575,734741,346445,891848
330460,202104,1189,3153,897,2742,150,491,484,1451,634,1942
330470,202104,5023,12237,3639,10143,1113,3222,1035,2961,2148,6183
330475,202104,10002,25163,8078,22699,1175,3768,5273,14451,6448,18219
330480,202104,6084,15443,5108,14027,412,1227,3563,9486,3975,10713
330490,202104,114875,259626,93228,230738,10052,25646,66772,163757,76824,189403
330500,202104,7533,18233,6216,16458,601,1790,4476,11646,5077,13436
330510,202104,41470,100094,30762,85127,4583,13698,19281,52382,23864,66080
330513,202104,1269,3189,1021,2864,197,586,535,1524,732,2110
330515,202104,2550,6652,2050,5961,352,1134,1171,3294,1523,4428
330520,202104,11739,30163,9627,26953,1065,3323,6231,16952,7296,20275
330530,202104,1737,4129,1278,3455,248,724,596,1593,844,2317
330540,202104,2852,7444,2229,6387,542,1589,924,2598,1466,4187
330550,202104,9487,23561,7290,20719,1861,5846,3272,9114,5133,14960
330555,202104,18866,38883,15630,35106,726,1774,12936,29353,13662,31127
330560,202104,4149,10826,3364,9564,522,1499,1992,5540,2514,7039
330570,202104,2711,7316,2315,6737,340,1076,1544,4448,1884,5524
330575,202104,5556,14074,4778,12776,288,871,3853,9999,4141,10870
330580,202104,18246,47523,14307,40561,2327,7103,7342,19874,9669,26977
330590,202104,1475,3895,1216,3560,220,640,764,2280,984,2920
330600,202104,12813,32733,10383,28865,880,2831,6769,18215,7649,21046
330610,202104,9292,24496,7467,21670,556,1865,5188,14729,5744,16594
330615,202104,2138,5763,1706,5190,306,954,1072,3332,1378,4286
330620,202104,4137,11502,3248,9995,677,2225,1434,4148,2111,6373
330630,202104,24917,61490,19646,53393,1231,3974,14197,37306,15428,41280
350010,202104,2122,5510,1162,3473,224,715,229,516,453,1231
350020,202104,713,1807,411,1229,52,172,135,377,187,549
350030,202104,3529,9721,2669,8250,639,2194,1184,3405,1823,5599
350040,202104,751,2130,437,1457,53,204,145,375,198,579
350050,202104,1382,3341,908,2536,189,609,329,758,518,1367
350055,202104,939,2441,746,2141,79,242,440,1200,519,1442
350060,202104,230,576,134,380,16,50,58,160,74,210
350070,202104,3271,8577,2137,6530,423,1421,699,1895,1122,3316
350075,202104,601,1721,445,1419,170,571,59,191,229,762
350080,202104,656,1692,435,1306,56,188,174,472,230,660
350090,202104,603,1405,367,1010,67,199,158,400,225,599
350100,202104,2350,6143,1656,4944,118,449,1045,2909,1163,3358
350110,202104,487,1207,335,944,17,55,198,547,215,602
350115,202104,1224,3509,1006,3067,169,577,517,1417,686,1994
350120,202104,674,1555,378,1019,34,115,207,491,241,606
350130,202104,3174,8303,2495,7059,432,1230,1226,3302,1658,4532
350140,202104,793,2187,554,1744,48,193,288,842,336,1035
350150,202104,544,1637,438,1429,95,301,128,391,223,692
350160,202104,11384,28505,7750,21837,982,3082,4634,12391,5616,15473
350170,202104,2405,6698,1969,5765,308,991,962,2537,1270,3528
350180,202104,1006,2449,548,1611,95,293,153,415,248,708
350190,202104,2873,8036,1972,6121,346,1223,830,2192,1176,3415
350200,202104,465,1302,357,1099,18,71,235,671,253,742
350210,202104,6001,13710,4104,10785,466,1350,2560,6462,3026,7812
350220,202104,2933,7941,2000,6098,412,1296,662,1825,1074,3121
350230,202104,982,2458,805,2215,145,427,462,1233,607,1660
350240,202104,649,1851,414,1302,98,304,103,293,201,597
350250,202104,2723,7546,2058,6444,595,2051,557,1705,1152,3756
350260,202104,843,1948,548,1458,53,162,336,845,389,1007
350270,202104,4632,12150,3697,10421,508,1602,2013,5236,2521,6838
350275,202104,2359,6257,1860,5504,298,964,1095,3100,1393,4064
350280,202104,18880,42566,11568,30774,1788,5015,4799,12131,6587,17146
350290,202104,3227,8833,2226,6797,392,1304,895,2546,1287,3850
350300,202104,638,1690,478,1395,59,173,263,712,322,885
350310,202104,937,2646,695,2173,109,396,283,789,392,1185
350315,202104,595,1463,394,1130,21,76,209,545,230,621
350320,202104,15677,39626,11542,32398,2214,6878,4716,12188,6930,19066
350330,202104,14169,34260,10226,26895,1045,2998,6522,16156,7567,19154
350335,202104,379,1065,294,903,38,133,132,377,170,510
350340,202104,1199,3033,743,2210,119,407,313,820,432,1227
350350,202104,760,1880,587,1691,65,214,363,1033,428,1247
350360,202104,1070,3142,814,2622,206,669,249,832,455,1501
350370,202104,624,1544,443,1225,152,394,136,379,288,773
350380,202104,4506,12201,3235,9603,918,2659,858,2612,1776,5271
350390,202104,11033,28414,8705,24533,1562,4646,4398,11822,5960,16468
350395,202104,431,1095,224,698,25,75,83,234,108,309
350400,202104,8084,19580,5623,15582,1366,4078,1559,4234,2925,8312
350410,202104,10132,27802,7434,22650,1462,4932,2922,8221,4384,13153
350420,202104,748,1987,517,1489,78,250,122,294,200,544
350430,202104,685,1814,561,1629,65,220,360,967,425,1187
350440,202104,2105,5177,1710,4592,122,340,1133,2983,1255,3323
350450,202104,6483,17718,5024,15190,1082,3619,2069,5855,3151,9474
350460,202104,1763,4514,983,2961,141,448,325,889,466,1337
350470,202104,256,644,199,547,12,38,142,374,154,412
350480,202104,1017,2445,671,1865,134,445,187,407,321,852
350490,202104,1992,5110,1423,4198,314,944,469,1270,783,2214
350500,202104,675,1772,507,1479,63,199,242,652,305,851
350510,202104,1226,3114,920,2570,98,310,559,1479,657,1789
350520,202104,2184,6537,1700,5605,257,945,752,2228,1009,3173
350530,202104,2890,7196,2177,5859,233,711,1294,3223,1527,3934
350535,202104,1479,3975,1275,3689,180,569,798,2243,978,2812
350540,202104,2034,4690,1522,3953,177,462,979,2441,1156,2903
350550,202104,8445,20614,5866,16361,601,2024,3394,8733,3995,10757
350560,202104,3904,10815,3126,9481,268,861,2035,5974,2303,6835
350570,202104,25194,69069,20510,60219,3506,11417,10788,30208,14294,41625
350580,202104,2097,5541,1285,3889,334,1102,244,600,578,1702
350590,202104,5164,13729,3804,10750,491,1571,2252,5852,2743,7423
350600,202104,35312,80951,22125,58362,3218,9640,10257,24785,13475,34425
350610,202104,6945,18729,4987,14858,788,2613,2403,6692,3191,9305
350620,202104,428,1071,262,812,23,72,152,444,175,516
350630,202104,1481,3766,1096,3101,70,247,723,1895,793,2142
350635,202104,9553,23136,7174,19450,928,2772,4423,11463,5351,14235
350640,202104,907,2400,486,1489,69,211,140,376,209,587
350650,202104,8632,22734,5986,17590,1086,3456,2321,6325,3407,9781
350660,202104,4543,11699,3508,9998,554,1580,1878,5384,2432,6964
350670,202104,1770,4666,1440,4189,141,420,972,2841,1113,3261
350680,202104,1113,2962,768,2345,131,422,316,921,447,1343
350690,202104,1304,3319,927,2703,157,482,494,1406,651,1888
350700,202104,4875,12198,3533,10122,718,2357,1529,4189,2247,6546
350710,202104,2886,7806,2446,7035,432,1435,1318,3493,1750,4928
350715,202104,774,2201,645,1982,68,266,354,1012,422,1278
350720,202104,159,423,117,350,19,59,40,103,59,162
350730,202104,628,1681,530,1516,23,81,403,1095,426,1176
350740,202104,1722,4505,1205,3474,199,611,420,1105,619,1716
350745,202104,587,1458,337,1006,31,113,143,393,174,506
350750,202104,10119,25954,7764,21935,1330,4386,3638,9207,4968,13593
350760,202104,15035,36876,10936,29858,2154,6523,4771,11729,6925,18252
350770,202104,1015,2515,643,1867,39,123,407,1148,446,1271
350775,202104,707,1622,489,1302,59,151,237,646,296,797
350780,202104,2368,5666,1690,4710,288,943,576,1857,864,2800
350790,202104,2044,5368,1312,3995,250,822,357,902,607,1724
350800,202104,3534,10009,3033,9147,238,815,2120,6203,2358,7018
350810,202104,2868,6865,2206,5894,361,895,1122,3062,1483,3957
350820,202104,964,2237,573,1551,71,214,266,648,337,862
350830,202104,881,2415,508,1604,76,249,158,404,234,653
350840,202104,3342,9620,2522,8098,563,2020,1124,3295,1687,5315
350850,202104,7823,21295,6164,18327,1138,3671,3035,8512,4173,12183
350860,202104,3643,9607,3135,8926,113,411,2415,6822,2528,7233
350870,202104,2596,7243,1940,6201,255,904,1099,3418,1354,4322
350880,202104,1328,3731,1049,3186,267,850,273,779,540,1629
350890,202104,553,1428,352,1008,55,166,127,316,182,482
350900,202104,7409,19698,4812,14352,930,3045,1803,4960,2733,8005
350910,202104,928,2213,799,2021,96,251,579,1438,675,1689
350920,202104,12383,30081,10519,27106,396,1268,8706,21632,9102,22900
350925,202104,4195,11233,3010,9125,548,1799,1462,4101,2010,5900
350930,202104,1507,3869,1060,3010,70,209,671,1855,741,2064
350940,202104,2276,5887,1746,5036,174,578,1103,3023,1277,3601
350945,202104,856,2390,652,1993,101,346,319,892,420,1238
350950,202104,90766,229854,70357,192237,8617,25740,43877,114442,52494,140182
350960,202104,6528,17459,5070,14763,598,1998,3028,8374,3626,10372
350970,202104,3574,9863,2569,8025,730,2521,563,1499,1293,4020
350980,202104,646,1752,521,1516,131,396,237,691,368,1087
350990,202104,1793,4901,1332,4167,308,1083,476,1410,784,2493
350995,202104,782,2420,704,2266,55,212,492,1527,547,1739
351000,202104,2851,7365,1987,5856,356,1100,721,2067,1077,3167
351010,202104,332,813,223,629,29,94,112,300,141,394
351015,202104,841,2490,684,2157,108,366,314,895,422,1261
351020,202104,8765,23520,6702,20019,1466,4358,3061,9018,4527,13376
351030,202104,2859,8354,2308,7298,329,1157,1255,3830,1584,4987
351040,202104,5126,12553,4295,11325,204,642,3533,9058,3737,9700
351050,202104,16720,40426,12154,33436,2282,6658,5530,15039,7812,21697
351060,202104,49694,123427,38338,104239,3698,11103,26085,68420,29783,79523
351070,202104,1377,3361,751,2308,178,603,127,372,305,975
351080,202104,2804,6660,2016,5737,202,692,1369,3706,1571,4398
351090,202104,330,942,243,785,45,148,70,233,115,381
351100,202104,2643,7076,1720,5242,373,1208,508,1589,881,2797
351110,202104,6213,15658,4084,11788,644,2055,1841,4980,2485,7035
351120,202104,773,1961,531,1560,68,216,203,586,271,802
351130,202104,1219,3071,567,1718,95,299,154,419,249,718
351140,202104,2232,6171,1652,5087,317,1100,718,1968,1035,3068
351150,202104,2741,7734,1881,5871,306,1060,750,2104,1056,3164
351160,202104,1083,3331,787,2643,148,538,202,563,350,1101
351170,202104,1356,3698,1160,3353,80,258,835,2321,915,2579
351190,202104,1027,2807,692,2140,121,371,261,756,382,1127
351200,202104,1627,3828,1215,3227,90,278,861,2142,951,2420
351210,202104,1567,3816,992,2752,77,248,573,1459,650,1707
351220,202104,3371,9326,2881,8526,297,890,1929,5633,2226,6523
351230,202104,1794,4790,1342,3996,236,800,636,1735,872,2535
351240,202104,2406,6022,1474,4124,317,976,529,1328,846,2304
351250,202104,1095,2864,649,1974,81,267,241,716,322,983
351260,202104,909,2264,653,1800,129,367,248,643,377,1010
351270,202104,463,1237,371,1070,41,145,204,521,245,666
351280,202104,3836,9927,2964,8323,593,1689,1337,3627,1930,5316
351290,202104,1229,3008,865,2386,115,343,522,1374,637,1717
351300,202104,18738,50063,13044,39284,2222,7302,5756,16515,7978,23817
351310,202104,3476,8357,2646,7098,152,518,1973,5032,2125,5550
351320,202104,961,2734,715,2239,119,397,248,687,367,1084
351330,202104,498,1195,410,1034,22,72,290,653,312,725
351340,202104,6277,17538,5066,15415,1182,3761,2292,6946,3474,10707
351350,202104,11543,28466,9527,25322,912,2582,7013,18132,7925,20714
351360,202104,3795,9987,3110,8968,685,2135,1309,3492,1994,5627
351370,202104,2060,5643,1388,4260,314,1032,431,1200,745,2232
351380,202104,48527,115502,34373,91208,4094,11724,20074,50789,24168,62513
351385,202104,387,975,161,495,30,93,42,110,72,203
351390,202104,1363,3273,844,2513,110,386,488,1365,598,1751
351400,202104,929,2558,773,2251,104,301,492,1398,596,1699
351410,202104,2627,7190,1903,5788,311,944,764,2272,1075,3216
351420,202104,459,1082,260,732,26,66,154,412,180,478
351430,202104,950,2514,762,2213,63,184,533,1502,596,1686
351440,202104,3481,9036,2320,6701,414,1252,656,1632,1070,2884
351450,202104,1721,4498,1148,3459,226,756,207,483,433,1239
351460,202104,891,2287,705,1999,146,410,398,1122,544,1532
351470,202104,1210,3039,953,2618,85,294,629,1620,714,1914
351480,202104,2502,7260,1981,6380,367,1320,855,2567,1222,3887
351490,202104,2085,5757,1787,5231,65,263,1470,4156,1535,4419
351492,202104,356,951,292,816,7,21,225,613,232,634
351495,202104,187,476,144,396,16,37,83,229,99,266
351500,202104,38707,93558,29626,78692,4194,11831,18146,46141,22340,57972
351510,202104,12910,31543,9409,25651,1095,3420,5911,15368,7006,18788
351512,202104,487,1295,353,1007,64,190,117,308,181,498
351515,202104,3244,7212,2048,5375,362,1076,590,1635,952,2711
351518,202104,2378,5880,1548,4426,198,636,875,2273,1073,2909
351519,202104,690,1874,433,1369,81,257,71,201,152,458
351520,202104,1324,3250,578,1723,52,178,261,695,313,873
351530,202104,363,943,214,631,35,112,95,231,130,343
351535,202104,1863,4548,1351,3673,202,598,697,1768,899,2366
351540,202104,2634,6444,1755,4884,236,766,747,1828,983,2594
351550,202104,7253,17790,4903,13551,473,1493,2778,7096,3251,8589
351560,202104,441,1254,340,1060,82,279,96,272,178,551
351565,202104,244,675,195,586,39,129,54,137,93,266
351570,202104,21638,56811,16574,46870,1611,4912,10459,28351,12070,33263
351580,202104,232,591,132,404,14,44,55,174,69,218
351590,202104,528,1196,283,770,24,90,164,393,188,483
351600,202104,1366,3600,1049,3006,112,353,597,1604,709,1957
351610,202104,787,1853,492,1329,24,68,288,733,312,801
351620,202104,23077,59867,16753,49231,2597,8689,7775,20697,10372,29386
351630,202104,28949,74616,23334,65150,3026,9056,14880,40048,17906,49104
351640,202104,17956,46316,14147,39575,1328,4313,9603,25611,10931,29924
351650,202104,368,970,182,582,22,68,55,164,77,232
351660,202104,737,2033,474,1464,71,222,91,240,162,462
351670,202104,6068,16072,4000,11648,815,2366,1694,4602,2509,6968
351680,202104,432,1210,279,876,39,126,74,189,113,315
351685,202104,390,1105,313,982,84,267,99,291,183,558
351690,202104,1123,2804,623,1809,86,280,275,718,361,998
351700,202104,1296,3205,950,2626,183,519,484,1255,667,1774
351710,202104,774,2037,567,1660,48,163,314,827,362,990
351720,202104,1425,3629,953,2819,153,496,402,1104,555,1600
351730,202104,958,2507,797,2258,60,206,505,1358,565,1564
351740,202104,3482,8671,2779,7346,478,1367,1418,3426,1896,4793
351750,202104,1372,3513,859,2632,139,458,370,1080,509,1538
351760,202104,3279,9133,2422,7453,479,1673,935,2596,1414,4269
351770,202104,1815,5219,1473,4573,232,759,831,2500,1063,3259
351780,202104,1199,3007,728,2135,96,331,279,748,375,1079
351790,202104,1379,3294,1099,2924,169,465,636,1716,805,2181
351800,202104,531,1208,266,708,37,103,100,220,137,323
351810,202104,1064,2770,890,2522,53,135,619,1680,672,1815
351820,202104,2630,7282,1850,5780,471,1601,440,1259,911,2860
351830,202104,4552,12029,3521,10258,323,1115,2236,6189,2559,7304
351840,202104,8767,23679,6601,19737,872,2954,3591,9973,4463,12927
351850,202104,1550,4219,1030,3205,155,553,367,975,522,1528
351860,202104,2716,7681,2089,6531,332,1181,1146,3557,1478,4738
351870,202104,24097,60635,17930,50586,4209,12319,7491,21360,11700,33679
351880,202104,137360,347004,103651,289981,21144,65562,51594,136745,72738,202307
351885,202104,949,2501,744,2163,55,198,492,1366,547,1564
351890,202104,853,2176,541,1658,107,359,106,273,213,632
351900,202104,1139,2964,875,2573,118,339,522,1520,640,1859
351905,202104,441,1198,311,946,24,83,158,420,182,503
351907,202104,21267,54949,16597,46771,1819,5703,10736,29022,12555,34725
351910,202104,1671,4291,1167,3226,78,241,686,1721,764,1962
351920,202104,885,2357,668,1941,98,314,282,736,380,1050
351925,202104,914,2364,700,1983,89,298,362,936,451,1234
351930,202104,3301,9051,2957,8434,564,1624,1981,5559,2545,7183
351940,202104,1110,2812,803,2278,128,392,397,1110,525,1502
351950,202104,1719,3854,1300,3242,56,170,943,2263,999,2433
351960,202104,5055,12603,3671,10163,792,2347,1664,4276,2456,6623
351970,202104,7195,20869,5674,18246,846,3086,3152,9786,3998,12872
351980,202104,953,2198,613,1657,83,262,348,851,431,1113
351990,202104,1505,3517,1095,2912,48,177,539,1289,587,1466
352000,202104,2695,7557,2329,6799,243,802,1554,4259,1797,5061
352010,202104,2282,6002,1838,5277,492,1552,413,1196,905,2748
352020,202104,1363,3694,1052,3182,147,498,532,1520,679,2018
352030,202104,5870,15313,4569,13178,823,2575,2280,6348,3103,8923
352040,202104,3091,8070,2145,6211,317,1012,820,2067,1137,3079
352042,202104,3021,7236,2022,5665,350,1149,947,2502,1297,3651
352044,202104,2153,5587,1286,3967,198,691,256,729,454,1420
352050,202104,12832,33595,8504,25172,2014,6831,1714,4289,3728,11120
352060,202104,727,1930,542,1588,87,285,229,597,316,882
352070,202104,938,1889,604,1449,57,154,312,672,369,826
352080,202104,490,1227,280,811,29,99,93,239,122,338
352090,202104,1522,4441,1266,3940,153,548,616,1737,769,2285
352100,202104,3439,9526,2771,8276,554,1806,1228,3523,1782,5329
352110,202104,616,1767,468,1485,96,308,183,538,279,846
352115,202104,552,1458,456,1308,60,195,276,776,336,971
352120,202104,897,2598,737,2281,79,226,437,1271,516,1497
352130,202104,2113,5786,1421,4135,212,635,604,1630,816,2265
352140,202104,1164,3159,833,2510,141,447,377,1096,518,1543
352150,202104,893,2330,696,2004,70,216,499,1404,569,1620
352160,202104,1016,2467,735,2021,68,234,424,1107,492,1341
352170,202104,3007,7915,2389,6731,291,923,1497,3946,1788,4869
352180,202104,2382,6353,1819,5351,402,1342,566,1466,968,2808
352190,202104,1278,3404,1017,3002,181,479,523,1620,704,2099
352200,202104,323,960,226,762,35,139,81,268,116,407
352210,202104,20189,46848,15930,41253,918,2684,12518,31722,13436,34406
352215,202104,676,1712,569,1555,76,233,350,921,426,1154
352220,202104,21342,52019,14925,40839,2627,7886,7031,17727,9658,25613
352230,202104,14896,41973,11572,35812,2699,9314,4184,11899,6883,21213
352240,202104,10212,26017,7825,22116,1657,5246,3454,9093,5111,14339
352250,202104,22725,62646,18209,55035,2801,9081,11045,32806,13846,41887
352260,202104,4837,11951,3261,8950,461,1443,1866,4598,2327,6041
352265,202104,934,2551,825,2401,59,195,622,1764,681,1959
352270,202104,1439,4230,1070,3453,221,761,377,1145,598,1906
352280,202104,2450,6081,1848,5221,180,601,1127,2968,1307,3569
352290,202104,1147,3235,936,2851,119,407,515,1416,634,1823
352300,202104,864,2323,593,1759,75,262,312,858,387,1120
352310,202104,43053,113547,32189,94805,7681,23223,13996,41490,21677,64713
352320,202104,6626,17069,5150,14311,717,2237,2818,7064,3535,9301
352330,202104,2200,5787,1674,5054,275,982,930,2621,1205,3603
352340,202104,6151,16024,4560,13142,682,2255,2329,6159,3011,8414
352350,202104,2211,6216,1708,5112,161,592,1005,2756,1166,3348
352360,202104,1248,3286,1027,2904,79,271,773,2106,852,2377
352370,202104,1100,3067,954,2824,16,63,786,2284,802,2347
352380,202104,844,2257,631,1886,130,394,218,629,348,1023
352390,202104,14709,35868,10086,27820,1585,4793,5562,14490,7147,19283
352400,202104,3548,9700,2907,8518,601,2072,1411,3835,2012,5907
352410,202104,3344,8455,2551,7150,219,737,1593,4274,1812,5011
352420,202104,846,2050,603,1698,117,347,228,595,345,942
352430,202104,8308,20351,6014,16371,1089,3380,3028,7732,4117,11112
352440,202104,18535,49575,14003,40969,3344,10154,5147,14610,8491,24764
352450,202104,777,1855,396,1208,59,195,143,409,202,604
352460,202104,3010,8141,2114,6544,412,1394,878,2539,1290,3933
352470,202104,3347,8408,2543,7125,271,872,1602,4264,1873,5136
352480,202104,4050,9532,2720,7182,393,1211,1324,3083,1717,4294
352490,202104,772,2193,616,1915,99,344,283,829,382,1173
352500,202104,10327,26374,6992,20193,2767,8787,736,1221,3503,10008
352510,202104,3867,10412,2881,8684,554,1802,1358,3908,1912,5710
352520,202104,2936,7511,2287,6445,385,1241,1326,3392,1711,4633
352530,202104,10753,27313,7312,20862,1229,4039,2717,6668,3946,10707
352540,202104,596,1737,438,1393,65,220,157,455,222,675
352550,202104,1022,2789,721,2222,122,441,258,699,380,1140
352560,202104,570,1568,437,1312,74,243,218,603,292,846
352570,202104,2396,6717,1546,4886,371,1285,180,440,551,1725
352580,202104,650,1671,544,1479,44,136,376,973,420,1109
352585,202104,336,891,246,733,19,74,153,413,172,487
352590,202104,13172,34233,9253,26850,2187,6918,4234,11407,6421,18325
352600,202104,1914,5113,1507,4385,140,441,966,2681,1106,3122
352610,202104,2780,7694,2082,6487,404,1421,879,2574,1283,3995
352620,202104,5658,14178,4317,12285,1169,3376,1765,5063,2934,8439
352630,202104,841,2074,626,1768,112,353,292,761,404,1114
352640,202104,3034,7661,2205,6206,218,635,1273,3420,1491,4055
352650,202104,598,1680,415,1289,51,168,156,464,207,632
352660,202104,1084,3149,904,2788,97,311,553,1672,650,1983
352670,202104,9741,25924,6581,19716,1577,5139,1968,5398,3545,10537
352680,202104,3346,9725,2336,7462,356,1348,1109,3157,1465,4505
352690,202104,27601,68407,21660,58468,1293,4162,15569,40248,16862,44410
352700,202104,594,1465,450,1278,136,441,145,400,281,841
352710,202104,5216,13363,3730,10692,865,2731,1561,4129,2426,6860
352720,202104,7968,21251,6243,18105,2277,6805,1720,4640,3997,11445
352725,202104,586,1393,333,941,23,65,172,458,195,523
352730,202104,5463,15767,4967,14664,566,1803,2261,5842,2827,7645
352740,202104,2326,5522,1763,4698,176,547,1074,2686,1250,3233
352750,202104,430,1060,268,768,42,136,111,279,153,415
352760,202104,1710,4665,1347,3970,103,287,790,2332,893,2619
352770,202104,860,2309,593,1801,122,378,224,649,346,1027
352780,202104,641,1792,460,1427,100,281,118,390,218,671
352790,202104,458,1196,325,943,32,102,134,342,166,444
352800,202104,1251,3767,879,2894,236,796,112,325,348,1121
352810,202104,1184,2753,758,2012,128,361,449,1120,577,1481
352820,202104,470,1305,339,1068,67,204,72,220,139,424
352830,202104,591,1485,283,858,22,69,76,187,98,256
352840,202104,3972,11222,3252,9943,1020,3373,1106,3240,2126,6613
352850,202104,10957,26407,7607,21029,1967,5980,2569,6353,4536,12333
352860,202104,1050,2862,799,2417,140,458,304,870,444,1328
352870,202104,877,2168,617,1656,55,170,379,970,434,1140
352880,202104,1717,4040,1206,3163,207,564,610,1530,817,2094
352885,202104,311,845,234,714,23,73,141,416,164,489
352890,202104,701,1691,463,1199,44,132,271,614,315,746
352900,202104,18154,46825,12175,35156,1974,6073,5275,14306,7249,20379
352910,202104,415,1089,238,720,24,78,76,197,100,275
352920,202104,2621,6609,1916,5428,118,368,1334,3672,1452,4040
352930,202104,5806,15486,4369,12717,741,2406,2122,5757,2863,8163
352940,202104,22226,59152,16327,47127,3051,9610,7590,20556,10641,30166
352950,202104,550,1436,341,1053,90,281,71,196,161,477
352960,202104,741,1946,427,1296,67,214,120,296,187,510
352965,202104,220,615,141,460,41,132,35,103,76,235
352970,202104,2991,7103,2312,5977,227,635,1542,3901,1769,4536
352980,202104,1363,3574,1086,3169,255,829,560,1587,815,2416
352990,202104,4309,11677,3282,9978,630,2073,1629,4763,2259,6836
353000,202104,490,1307,283,828,39,126,74,171,113,297
353010,202104,2637,6483,1739,4844,329,1058,757,1894,1086,2952
353020,202104,3557,9118,2152,6259,296,965,750,2042,1046,3007
353030,202104,4517,11216,3116,8823,693,2128,924,2470,1617,4598
353040,202104,644,1444,448,1163,95,236,221,564,316,800
353050,202104,5203,14708,3695,11657,687,2342,1683,5068,2370,7410
353060,202104,48643,123067,40302,109851,2620,8516,30517,80343,33137,88859
353070,202104,9751,27490,7153,21959,1251,4221,3117,8773,4368,12994
353080,202104,4193,11323,2768,8578,492,1739,1096,2966,1588,4705
353090,202104,609,1789,489,1543,34,118,312,946,346,1064
353100,202104,291,781,140,446,24,80,38,97,62,177
353110,202104,7549,19663,6062,17564,1293,3842,3064,9233,4357,13075
353120,202104,405,990,309,838,38,123,158,379,196,502
353130,202104,2573,5963,1617,4340,391,1168,541,1299,932,2467
353140,202104,2721,6679,1975,5436,100,334,1409,3716,1509,4050
353150,202104,1631,3961,1169,3219,239,674,485,1267,724,1941
353160,202104,626,1605,458,1335,62,191,202,532,264,723
353170,202104,528,1401,395,1216,76,252,178,562,254,814
353180,202104,10095,24224,7997,20971,757,2202,5865,14899,6622,17101
353190,202104,3401,9016,2727,7691,360,1085,1591,4216,1951,5301
353200,202104,1815,4766,1005,3131,163,569,274,771,437,1340
353205,202104,405,1210,345,1080,52,169,167,506,219,675
353210,202104,911,2074,592,1565,23,63,414,1071,437,1134
353215,202104,379,1034,298,890,44,147,143,391,187,538
353220,202104,732,1937,477,1419,97,273,84,243,181,516
353230,202104,842,2291,661,2011,178,595,250,693,428,1288
353240,202104,2334,6266,1933,5618,271,910,1161,3224,1432,4134
353250,202104,1313,2939,830,2163,104,303,464,1149,568,1452
353260,202104,1183,2686,657,1839,84,259,315,842,399,1101
353270,202104,692,1782,592,1607,47,141,417,1069,464,1210
353280,202104,677,1797,476,1437,137,416,111,327,248,743
353282,202104,1833,5095,1544,4568,174,554,956,2691,1130,3245
353284,202104,357,805,199,521,20,73,96,216,116,289
353286,202104,178,442,109,331,18,57,39,109,57,166
353290,202104,1482,3911,928,2806,168,500,274,773,442,1273
353300,202104,2088,5516,1552,4472,242,795,710,1821,952,2616
353310,202104,401,980,295,793,21,72,197,501,218,573
353320,202104,656,1584,562,1459,6,23,494,1273,500,1296
353325,202104,686,1967,479,1512,96,296,169,516,265,812
353330,202104,553,1416,391,1121,52,150,208,552,260,702
353340,202104,2894,7811,2116,6287,411,1357,1028,2845,1439,4202
353350,202104,3714,9279,2613,7180,553,1561,830,2073,1383,3634
353360,202104,665,1835,511,1540,49,152,300,880,349,1032
353370,202104,577,1649,483,1502,43,130,342,1038,385,1168
353380,202104,296,868,249,777,23,72,132,383,155,455
353390,202104,6477,15794,4883,13162,443,1366,3015,7671,3458,9037
353400,202104,466,1230,356,1029,63,212,139,333,202,545
353410,202104,531,1415,401,1183,72,209,225,676,297,885
353420,202104,416,1084,260,768,59,175,17,40,76,215
353430,202104,2235,6078,1734,5160,317,1018,840,2384,1157,3402
353440,202104,65633,174569,48022,141148,7348,23609,26361,73096,33709,96705
353450,202104,368,907,246,696,34,112,119,305,153,417
353460,202104,3228,8679,2352,7040,185,603,1047,3023,1232,3626
353470,202104,8014,20680,5842,16723,926,3066,2650,6950,3576,10016
353475,202104,1565,3985,1110,3072,161,488,560,1438,721,1926
353480,202104,1617,4289,1294,3745,51,188,933,2616,984,2804
353490,202104,1107,2883,753,2227,104,344,349,963,453,1307
353500,202104,1086,2563,802,2130,171,467,440,1141,611,1608
353510,202104,798,2348,587,1852,140,457,158,429,298,886
353520,202104,1054,2717,677,2043,74,249,332,921,406,1170
353530,202104,2453,6399,1939,5475,260,823,1061,2776,1321,3599
353540,202104,2116,5618,1744,5028,272,823,1030,2877,1302,3700
353550,202104,5843,14834,4759,13111,737,2129,2761,7297,3498,9426
353560,202104,2330,6166,1769,5313,456,1474,544,1467,1000,2941
353570,202104,590,1523,437,1271,50,159,246,673,296,832
353580,202104,2149,5611,1623,4585,360,1028,713,1961,1073,2989
353590,202104,688,1784,469,1382,80,248,215,639,295,887
353600,202104,1719,4218,1296,3485,153,411,710,1863,863,2274
353610,202104,589,1767,434,1462,84,356,148,454,232,810
353620,202104,2696,7041,1929,5745,375,1245,651,1777,1026,3022
353625,202104,515,1279,350,991,26,87,214,585,240,672
353630,202104,1349,4065,1140,3621,226,802,468,1361,694,2163
353640,202104,1376,3545,1106,3132,156,437,610,1716,766,2153
353650,202104,7635,20088,5817,16726,618,1969,3483,9440,4101,11409
353657,202104,397,1033,290,858,27,89,131,356,158,445
353660,202104,1296,2729,887,2188,358,895,267,636,625,1531
353670,202104,4125,11281,3200,9488,591,1969,1559,4245,2150,6214
353680,202104,694,1787,514,1530,64,222,307,850,371,1072
353690,202104,419,1093,204,620,23,78,42,107,65,185
353700,202104,2089,5358,1739,4793,115,376,1291,3407,1406,3783
353710,202104,5420,12074,3266,8277,370,970,1740,3918,2110,4888
353715,202104,432,1129,258,808,4,19,91,273,95,292
353720,202104,1998,5169,1541,4485,216,660,879,2499,1095,3159
353730,202104,4454,11501,3396,9672,462,1549,1845,4804,2307,6353
353740,202104,2024,5255,1431,4222,327,1061,485,1290,812,2351
353750,202104,886,2643,647,2181,145,532,146,473,291,1005
353760,202104,12722,29107,9729,25144,1960,5169,5183,13209,7143,18378
353770,202104,685,2043,416,1392,73,266,54,161,127,427
353780,202104,5404,14581,4351,12635,918,2966,2183,5831,3101,8797
353790,202104,2739,8117,2002,6575,513,1858,411,1187,924,3045
353800,202104,18661,48058,14690,41718,2131,6344,8189,23206,10320,29550
353810,202104,1168,3107,752,2239,106,357,333,941,439,1298
353820,202104,1758,4670,1234,3641,253,805,415,1153,668,1958
353830,202104,652,1621,472,1324,80,239,211,569,291,808
353850,202104,1624,4432,1259,3763,256,765,473,1359,729,2124
353860,202104,2675,7233,2057,6197,459,1583,939,2551,1398,4134
353870,202104,29988,77541,21587,61530,2664,8484,11470,29873,14134,38357
353880,202104,3200,8702,2538,7472,207,693,1555,4394,1762,5087
353890,202104,2775,5933,1991,4814,140,374,1440,3257,1580,3631
353900,202104,759,2103,558,1711,80,275,226,640,306,915
353910,202104,2407,6588,2007,5974,197,682,1383,4040,1580,4722
353920,202104,1910,5205,1373,4164,311,1069,335,840,646,1909
353930,202104,4487,11746,3074,9088,494,1695,1339,3483,1833,5178
353940,202104,1089,3058,755,2410,133,450,270,788,403,1238
353950,202104,3344,8919,2573,7490,508,1587,1334,3634,1842,5221
353960,202104,745,1877,518,1457,94,274,224,607,318,881
353970,202104,645,1524,484,1281,40,120,334,861,374,981
353980,202104,16453,40919,12898,34845,783,2487,9412,24319,10195,26806
353990,202104,955,2302,584,1631,106,319,265,696,371,1015
354000,202104,2516,5984,1419,3964,314,914,239,638,553,1552
354010,202104,360,929,255,758,51,160,131,377,182,537
354020,202104,3628,9711,2881,8215,628,1921,1242,3244,1870,5165
354025,202104,725,2000,491,1543,70,240,140,417,210,657
354030,202104,512,1111,276,725,62,169,128,311,190,480
354040,202104,810,1857,523,1396,22,70,388,999,410,1069
354050,202104,933,2617,657,2122,140,493,217,661,357,1154
354060,202104,3317,9274,2334,7222,488,1645,910,2547,1398,4192
354070,202104,3730,9651,2516,7279,412,1382,1143,2853,1555,4235
354075,202104,2713,7628,2151,6616,276,927,1255,3779,1531,4706
354080,202104,1347,3638,892,2759,181,578,253,712,434,1290
354085,202104,443,922,350,801,0,0,262,549,262,549
354090,202104,1664,4589,1435,4126,73,223,1125,3169,1198,3392
354100,202104,19665,52485,13580,42023,2919,9795,5187,15872,8106,25667
354105,202104,1403,3536,975,2768,121,349,447,1195,568,1544
354110,202104,442,1244,314,996,51,166,106,326,157,492
354120,202104,1367,3658,931,2729,187,596,315,808,502,1404
354130,202104,5382,14046,3600,10673,849,2654,200,394,1049,3048
354140,202104,19426,47477,13245,36182,2097,6411,5866,14682,7963,21093
354150,202104,2930,6897,2239,5814,461,1250,891,2276,1352,3526
354160,202104,2804,8058,2105,6676,584,2021,584,1671,1168,3692
354165,202104,677,1989,522,1682,81,302,268,797,349,1099
354170,202104,1865,5139,1564,4576,102,348,973,2719,1075,3067
354180,202104,385,1062,279,839,45,141,123,335,168,476
354190,202104,1501,4156,1071,3295,70,241,532,1553,602,1794
354200,202104,872,2093,670,1788,67,199,440,1106,507,1305
354210,202104,839,2162,678,1900,42,140,496,1318,538,1458
354220,202104,3195,8493,2431,6999,349,1083,1309,3552,1658,4635
354230,202104,789,1927,635,1745,32,114,480,1273,512,1387
354240,202104,1715,4695,1158,3583,195,658,371,1015,566,1673
354250,202104,535,1273,332,961,87,262,86,259,173,521
354260,202104,8109,21285,6189,17947,1191,3741,2731,7581,3922,11322
354270,202104,1004,2994,819,2634,168,535,333,1039,501,1574
354280,202104,796,1955,674,1782,61,187,446,1097,507,1284
354290,202104,927,2918,782,2624,131,437,395,1368,526,1805
354300,202104,3560,10304,3007,9294,788,2452,1237,3778,2025,6230
354310,202104,721,2105,595,1858,137,460,229,664,366,1124
354320,202104,992,2406,658,1854,100,316,253,632,353,948
354323,202104,477,1122,314,828,48,107,138,347,186,454
354325,202104,1499,4433,1055,3418,168,534,345,1066,513,1600
354330,202104,9524,23853,6505,17820,766,2371,3869,9856,4635,12227
354340,202104,33662,83704,23046,65317,3251,10416,12606,34052,15857,44468
354350,202104,1204,3057,954,2640,119,339,601,1595,720,1934
354360,202104,613,1567,367,1165,82,267,83,263,165,530
354370,202104,1014,2851,816,2539,123,414,492,1484,615,1898
354380,202104,671,1759,486,1461,86,344,133,313,219,657
354390,202104,13811,32990,9136,24861,1565,4574,4191,10735,5756,15309
354400,202104,1541,4882,1185,4054,197,735,442,1485,639,2220
354410,202104,6119,16169,4680,13347,902,2773,2229,5988,3131,8761
354420,202104,1510,3866,1121,3187,150,457,673,1815,823,2272
354425,202104,2732,6556,1940,5197,450,1207,817,2189,1267,3396
354430,202104,1527,4046,1188,3522,109,360,730,2055,839,2415
354440,202104,562,1491,381,1128,61,204,166,452,227,656
354450,202104,435,1128,250,771,34,108,86,230,120,338
354460,202104,847,2118,566,1628,74,226,312,874,386,1100
354470,202104,474,1181,331,913,25,79,167,402,192,481
354480,202104,1270,2855,829,2154,71,181,541,1349,612,1530
354490,202104,817,2386,602,1920,107,355,270,795,377,1150
354500,202104,2124,5852,1726,5253,512,1621,394,1234,906,2855
354510,202104,727,2002,591,1746,46,146,335,896,381,1042
354515,202104,353,1001,258,807,39,138,112,338,151,476
354520,202104,7039,19050,4983,14714,661,2244,2759,7554,3420,9798
354530,202104,4455,12517,3469,10615,879,2681,1186,3756,2065,6437
354540,202104,1338,3495,977,2864,207,625,362,1065,569,1690
354550,202104,594,1527,470,1297,68,204,269,705,337,909
354560,202104,2310,5524,1237,3476,146,416,626,1635,772,2051
354570,202104,1247,3098,497,1404,83,248,54,145,137,393
354580,202104,8468,22015,5539,16456,830,2651,2789,7980,3619,10631
354600,202104,1970,5080,1539,4315,146,471,1029,2745,1175,3216
354610,202104,450,1149,266,786,23,70,139,393,162,463
354620,202104,470,1289,303,973,48,189,118,338,166,527
354625,202104,299,803,175,566,26,87,34,79,60,166
354630,202104,2073,6092,1670,5287,562,1878,300,883,862,2761
354640,202104,3318,9393,2489,7743,370,1266,1026,2958,1396,4224
354650,202104,902,2322,730,2047,58,159,467,1292,525,1451
354660,202104,3630,8456,1923,5624,169,603,903,2402,1072,3005
354670,202104,1053,2896,742,2262,148,479,280,794,428,1273
354680,202104,5420,13909,4080,11750,890,2717,2063,6020,2953,8737
354690,202104,496,1546,360,1240,74,275,107,345,181,620
354700,202104,910,2426,654,1930,78,255,347,944,425,1199
354710,202104,503,1343,361,1052,54,166,151,376,205,542
354720,202104,283,677,129,378,53,161,26,78,79,239
354730,202104,9835,27465,7530,23052,974,3267,4338,12786,5312,16053
354740,202104,306,821,132,433,17,67,26,74,43,141
354750,202104,2663,6787,1773,5161,259,824,798,2092,1057,2916
354760,202104,2162,5662,1528,4482,332,1058,516,1328,848,2386
354765,202104,348,915,147,456,19,65,35,90,54,155
354770,202104,2442,5989,1808,4885,308,882,848,2152,1156,3034
354780,202104,55353,138615,42330,113419,3940,11947,27625,69550,31565,81497
354790,202104,997,2726,779,2367,77,255,480,1399,557,1654
354800,202104,2577,6568,2035,5742,500,1431,921,2462,1421,3893
354805,202104,1361,3092,943,2483,109,288,547,1344,656,1632
354810,202104,641,1881,380,1329,48,197,102,330,150,527
354820,202104,951,2665,672,2144,117,424,189,474,306,898
354830,202104,468,1137,302,843,53,165,95,249,148,414
354840,202104,929,2298,575,1584,55,161,313,801,368,962
354850,202104,20901,53610,14573,42471,1584,5264,8751,24219,10335,29483
354860,202104,1747,4826,1067,3403,165,583,313,892,478,1475
354870,202104,59053,148312,45672,123749,4587,13617,29053,74492,33640,88109
354880,202104,5865,14299,2911,8172,324,1054,1142,2625,1466,3679
354890,202104,15927,39701,12356,33733,1644,5052,7233,19148,8877,24200
354900,202104,408,1027,261,767,58,185,65,151,123,336
354910,202104,5726,14841,3509,10820,799,2592,664,1921,1463,4513
354920,202104,514,1383,265,874,28,101,66,192,94,293
354925,202104,306,862,185,589,26,90,45,121,71,211
354930,202104,372,899,243,677,21,64,122,310,143,374
354940,202104,2359,6889,1680,5407,561,1930,362,1067,923,2997
354950,202104,1529,3867,1222,3445,54,207,926,2477,980,2684
354960,202104,928,2468,705,2134,62,218,403,1141,465,1359
354970,202104,4171,11418,3258,9887,355,1228,2110,6174,2465,7402
354980,202104,33708,79274,22967,60918,2341,7373,14248,35290,16589,42663
354990,202104,68526,171026,51640,140235,3928,12440,34384,87652,38312,100092
354995,202104,2875,6336,2164,5414,140,413,1617,3895,1757,4308
355000,202104,1588,3894,1195,3323,195,631,585,1481,780,2112
355010,202104,3812,10223,2316,7080,755,2367,301,952,1056,3319
355020,202104,3641,10098,2694,8432,534,1864,1094,3235,1628,5099
355030,202104,1379509,3361231,1006473,2649988,146369,423421,518035,1257238,664404,1680659
355040,202104,3013,7333,2347,6473,266,747,1703,4691,1969,5438
355050,202104,984,2258,718,1884,169,506,285,672,454,1178
355060,202104,6193,16483,4526,13438,719,2466,2252,6070,2971,8536
355070,202104,9240,23369,7518,20677,865,2734,4847,12552,5712,15286
355080,202104,930,2640,592,2008,116,423,84,228,200,651
355090,202104,1168,3279,908,2848,204,644,335,1022,539,1666
355100,202104,21598,55916,16689,48720,2589,7972,10040,29116,12629,37088
355110,202104,798,2161,571,1811,166,613,97,275,263,888
355120,202104,721,1867,519,1572,43,140,240,697,283,837
355130,202104,842,1872,436,1136,29,92,273,662,302,754
355140,202104,1964,4389,1654,3966,79,209,1380,3229,1459,3438
355150,202104,4234,11076,3381,9582,370,1176,2198,5974,2568,7150
355160,202104,2076,5610,1502,4603,372,1246,394,1125,766,2371
355170,202104,10835,26959,8440,22965,1463,4313,4557,11995,6020,16308
355180,202104,2892,7570,2056,6184,390,1303,813,2230,1203,3533
355190,202104,1868,4858,1465,4218,387,1098,730,2226,1117,3324
355200,202104,801,2479,678,2279,185,686,278,892,463,1578
355210,202104,3006,8115,2330,6740,424,1370,1154,3128,1578,4498
355220,202104,45753,119756,36349,101879,7705,22950,15929,41511,23634,64461
355230,202104,1143,2875,631,1873,106,302,221,606,327,908
355240,202104,25124,65727,17627,50837,2157,6779,9745,26356,11902,33135
355250,202104,37309,98752,27799,80463,6867,20927,10598,29387,17465,50314
355255,202104,676,1679,376,1139,59,192,130,389,189,581
355260,202104,1512,3662,1099,2977,131,416,639,1605,770,2021
355270,202104,1146,3355,880,2825,203,678,315,921,518,1599
355280,202104,31413,79077,22512,62597,2891,8721,11609,30260,14500,38981
355290,202104,878,2358,677,2008,134,381,295,858,429,1239
355300,202104,1300,3791,1032,3270,177,610,364,1075,541,1685
355310,202104,951,2611,709,2211,100,298,392,1248,492,1546
355320,202104,531,1381,398,1141,74,244,160,374,234,618
355330,202104,3004,7508,2306,6331,126,446,1754,4583,1880,5029
355340,202104,4206,9253,3219,7941,388,877,2012,5060,2400,5937
355350,202104,1319,3730,980,3096,195,648,384,1177,579,1825
355360,202104,1223,3095,945,2676,113,354,566,1556,679,1910
355365,202104,353,936,195,653,43,139,28,97,71,236
355370,202104,5428,13801,4189,11830,990,2573,1808,5656,2798,8229
355380,202104,2872,7646,2179,6384,366,1180,816,2070,1182,3250
355385,202104,1473,3837,1215,3460,101,345,785,2035,886,2380
355390,202104,824,2235,595,1745,128,406,237,631,365,1037
355395,202104,1985,5392,1394,4215,229,740,497,1333,726,2073
355400,202104,9051,25492,7174,21841,1676,5820,2644,7178,4320,12998
355410,202104,22812,62257,14156,44361,2789,9566,3894,11901,6683,21467
355420,202104,627,1972,524,1781,136,494,139,453,275,947
355430,202104,3701,9311,2781,7655,612,1688,1301,3535,1913,5223
355440,202104,772,2084,473,1460,78,248,136,392,214,640
355450,202104,3034,7721,1988,5694,320,994,870,2267,1190,3261
355460,202104,500,1201,315,900,42,152,157,400,199,552
355465,202104,429,1117,335,964,41,130,188,529,229,659
355470,202104,1090,2793,629,1882,168,550,189,497,357,1047
355475,202104,341,800,275,710,15,34,205,519,220,553
355480,202104,3974,10809,3227,9694,427,1506,2146,6271,2573,7777
355490,202104,934,2457,523,1602,40,133,275,773,315,906
355495,202104,820,2258,591,1869,64,250,219,604,283,854
355500,202104,6807,17311,4121,12159,606,1961,1489,4062,2095,6023
355510,202104,1355,3259,864,2427,109,349,377,944,486,1293
355520,202104,366,823,178,520,30,87,55,160,85,247
355530,202104,396,924,145,431,16,58,53,145,69,203
355535,202104,520,1397,397,1197,78,294,186,516,264,810
355540,202104,10981,27011,9003,24244,1188,3513,6063,15788,7251,19301
355550,202104,608,1776,502,1575,60,212,272,789,332,1001
355560,202104,1132,2885,641,1969,143,508,31,92,174,600
355570,202104,244,673,128,415,22,78,30,88,52,166
355580,202104,1199,2881,767,2155,142,465,292,732,434,1197
355590,202104,176,440,138,382,14,44,87,229,101,273
355600,202104,1551,3743,1018,2866,160,483,381,1077,541,1560
355610,202104,1783,4345,1184,3318,128,396,636,1684,764,2080
355620,202104,4848,12750,3640,10421,368,1270,2100,5552,2468,6822
355630,202104,2377,6460,1699,5205,260,836,861,2584,1121,3420
355635,202104,889,2587,659,2130,116,405,196,567,312,972
355640,202104,3074,8432,2062,6407,395,1302,597,1824,992,3126
355645,202104,4193,11676,3068,9710,446,1548,1640,5024,2086,6572
355650,202104,6339,17039,4894,14388,1291,3955,1460,3822,2751,7777
355660,202104,1335,3414,934,2700,153,457,288,819,441,1276
355670,202104,3742,9986,2519,7252,305,1037,1272,3220,1577,4257
355680,202104,2767,7531,1258,4004,317,1067,105,344,422,1411
355690,202104,806,2350,516,1777,124,471,11,21,135,492
355695,202104,257,723,157,495,12,56,31,74,43,130
355700,202104,7436,20951,6072,17963,957,3064,3385,9404,4342,12468
355710,202104,9102,21339,6016,15764,833,2469,2927,6799,3760,9268
355715,202104,480,1289,263,809,52,170,48,127,100,297
355720,202104,1453,4035,1149,3499,174,575,637,1816,811,2391
355730,202104,916,2526,754,2225,128,415,373,1028,501,1443
410010,202104,1298,3553,1000,2941,197,625,246,688,443,1313
410020,202104,1039,3082,797,2536,266,789,176,579,442,1368
410030,202104,1571,4220,1345,3875,184,560,751,2196,935,2756
410040,202104,12694,34728,9332,28429,2061,6701,2914,8246,4975,14947
410045,202104,851,2255,601,1768,91,296,222,605,313,901
410050,202104,2305,5720,1600,4506,268,843,585,1525,853,2368
410060,202104,2121,5911,1651,5007,366,1151,514,1495,880,2646
410070,202104,1977,4983,1477,4087,231,711,575,1436,806,2147
410080,202104,1354,3602,968,2887,271,838,204,622,475,1460
410090,202104,1123,2840,952,2573,104,264,545,1555,649,1819
410100,202104,1865,5302,1233,3812,180,640,133,389,313,1029
410105,202104,492,1230,285,829,32,91,104,287,136,378
410110,202104,3325,8257,2333,6402,274,833,1116,2862,1390,3695
410115,202104,574,1469,417,1199,55,170,164,447,219,617
410120,202104,2726,7393,2354,6842,442,1387,1323,3721,1765,5108
410130,202104,1260,3373,1094,3060,208,664,566,1464,774,2128
410140,202104,16286,39197,10824,29498,1949,5812,2904,7201,4853,13013
410150,202104,16696,38865,8575,23187,1443,4333,2091,5060,3534,9393
410160,202104,2901,7916,2321,6907,521,1659,779,2339,1300,3998
410165,202104,745,1968,613,1706,61,195,358,929,419,1124
410170,202104,2891,7411,1918,5341,408,1252,114,332,522,1584
410180,202104,14035,38553,10779,32033,1457,4763,5661,15700,7118,20463
410185,202104,427,1246,310,950,60,196,82,223,142,419
410190,202104,2170,5364,1580,4335,314,893,408,1060,722,1953
410200,202104,5534,12552,3087,8378,489,1504,429,1120,918,2624
410210,202104,3168,7860,2025,5845,329,1060,695,1729,1024,2789
410220,202104,526,1349,338,1001,56,173,82,241,138,414
410230,202104,1770,4663,1364,3872,202,611,617,1613,819,2224
410240,202104,5198,13491,3575,10379,755,2433,433,1121,1188,3554
410250,202104,2687,6307,1992,5206,143,453,973,2463,1116,2916
410260,202104,1802,4470,1136,3221,162,473,529,1446,691,1919
410270,202104,471,1242,337,1009,43,145,134,395,177,540
410275,202104,612,1705,452,1386,70,237,183,513,253,750
410280,202104,2314,6097,1543,4589,205,690,641,1742,846,2432
410290,202104,3417,9415,2358,7204,655,1953,600,1835,1255,3788
410300,202104,666,1665,536,1467,56,166,258,652,314,818
410302,202104,357,907,208,630,22,76,103,308,125,384
410304,202104,1267,3247,1050,2841,118,337,645,1686,763,2023
410305,202104,1735,4132,1212,3383,112,354,787,2118,899,2472
410310,202104,2572,7168,2075,6236,302,996,1065,3138,1367,4134
410315,202104,627,1494,385,1104,138,401,96,282,234,683
410320,202104,1075,2971,735,2285,107,377,133,383,240,760
410322,202104,577,1524,335,983,36,118,155,398,191,516
410330,202104,1531,3673,1057,2790,177,494,295,777,472,1271
410335,202104,866,2280,660,1897,99,302,277,732,376,1034
410337,202104,842,2043,600,1585,75,201,227,570,302,771
410340,202104,518,1457,349,1050,21,71,174,451,195,522
410345,202104,2500,6465,1349,3967,266,811,358,905,624,1716
410347,202104,755,1917,559,1556,57,186,184,517,241,703
410350,202104,1596,3914,1152,3175,142,412,541,1402,683,1814
410360,202104,4337,10619,3327,8854,476,1349,1546,3977,2022,5326
410370,202104,13828,36908,8975,25516,1036,3202,3796,9476,4832,12678
410380,202104,1639,4088,1209,3320,171,487,401,1001,572,1488
410390,202104,2686,6693,1799,5134,380,1213,575,1468,955,2681
410395,202104,930,2628,760,2272,156,475,294,897,450,1372
410400,202104,6727,17314,5108,14255,687,2053,2675,7029,3362,9082
410405,202104,892,2055,639,1691,107,320,305,755,412,1075
410410,202104,1314,3457,1233,3330,152,481,787,2202,939,2683
410420,202104,10896,29426,8332,24392,1254,4125,3522,9276,4776,13401
410425,202104,3327,9203,2294,7106,359,1201,822,2316,1181,3517
410430,202104,13211,32777,9320,25748,1393,4225,3443,8831,4836,13056
410440,202104,2295,6769,1966,6167,278,982,1055,3232,1333,4214
410442,202104,2226,6704,1832,5862,447,1473,510,1532,957,3005
410445,202104,2265,6470,1658,5301,319,1143,294,1029,613,2172
410450,202104,1469,3573,1095,2998,202,607,422,1086,624,1693
410460,202104,2173,5336,1649,4473,171,495,811,2111,982,2606
410465,202104,2774,7950,2212,6899,389,1265,774,2252,1163,3517
410470,202104,2069,5652,1474,4591,391,1390,207,701,598,2091
410480,202104,36938,87800,20242,58378,3081,9967,4516,11131,7597,21098
410490,202104,11232,30760,8193,24588,1401,4524,3406,9554,4807,14078
410500,202104,1895,4870,1312,3778,274,898,365,908,639,1806
410510,202104,1838,4577,1236,3462,229,618,373,1035,602,1653
410520,202104,3071,9508,2719,8801,962,3191,848,2825,1810,6016
410530,202104,1635,3938,790,2201,100,288,210,481,310,769
410540,202104,2816,7480,1952,5746,299,954,864,2419,1163,3373
410550,202104,7571,19957,5061,14555,834,2594,1409,3504,2243,6098
410560,202104,1486,3872,1113,3118,226,702,383,927,609,1629
410570,202104,2530,6826,1850,5635,488,1786,199,629,687,2415
410580,202104,25916,66528,18938,53945,3361,10250,8412,22427,11773,32677
410590,202104,1564,4432,1071,3288,146,474,307,791,453,1265
410600,202104,1791,4721,1392,3961,319,875,425,1283,744,2158
410610,202104,707,1809,537,1503,53,176,243,619,296,795
410620,202104,2508,7109,1696,5208,351,1195,271,757,622,1952
410630,202104,2491,6465,1650,4798,295,1015,358,835,653,1850
410640,202104,4820,11157,3285,8508,701,2095,404,1060,1105,3155
410645,202104,1089,3055,886,2799,279,897,394,1259,673,2156
410650,202104,2328,6239,1610,4815,312,1002,576,1565,888,2567
410655,202104,918,2187,643,1693,25,75,335,837,360,912
410657,202104,627,1696,397,1198,52,178,137,352,189,530
410660,202104,3446,8671,2035,5635,361,1012,605,1561,966,2573
410670,202104,1029,2535,636,1799,127,353,212,548,339,901
410680,202104,2586,7629,1788,5652,419,1339,269,885,688,2224
410685,202104,528,1351,399,1136,95,310,156,399,251,709
410690,202104,131784,317355,88568,238763,13220,40774,35308,84057,48528,124831
410700,202104,2494,6265,2070,5608,353,969,996,2637,1349,3606
410710,202104,905,2274,597,1703,109,324,232,602,341,926
410712,202104,654,1836,540,1626,110,369,243,682,353,1051
410715,202104,826,2371,533,1739,69,233,206,648,275,881
410720,202104,3206,8060,2567,6888,372,1192,640,1676,1012,2868
410725,202104,1128,2763,651,1870,127,397,88,213,215,610
410730,202104,702,1865,555,1595,121,415,124,346,245,761
410740,202104,916,2550,675,2084,80,279,273,828,353,1107
410750,202104,1776,4421,1419,3774,210,631,662,1671,872,2302
410752,202104,367,902,197,574,29,83,89,245,118,328
410753,202104,320,941,221,720,34,129,51,149,85,278
410754,202104,1101,2800,918,2527,62,141,626,1812,688,1953
410755,202104,565,1465,405,1152,53,160,183,466,236,626
410760,202104,3660,9371,2652,7575,665,2175,592,1557,1257,3732
410765,202104,14051,38774,11005,32826,1835,5907,2581,6825,4416,12732
410770,202104,1072,2499,751,1963,60,169,392,1025,452,1194
410773,202104,1297,3425,1138,3186,112,350,734,1994,846,2344
410775,202104,1529,3730,1340,3453,62,186,910,2276,972,2462
410780,202104,645,1581,434,1183,65,183,123,317,188,500
410785,202104,715,1839,552,1561,90,283,178,507,268,790
410790,202104,865,2413,714,2127,177,564,66,137,243,701
410800,202104,3463,7642,2811,6723,50,156,1839,4263,1889,4419
410810,202104,433,1118,336,932,30,84,165,413,195,497
410820,202104,930,2594,502,1515,103,318,83,211,186,529
410830,202104,40085,95714,27815,75464,5235,16060,10734,27302,15969,43362
410832,202104,1040,2701,837,2345,91,293,505,1328,596,1621
410840,202104,8716,21751,5222,15154,963,3019,1356,3658,2319,6677
410845,202104,1162,2887,908,2506,176,510,364,995,540,1505
410850,202104,2248,6360,1973,5864,320,991,966,2824,1286,3815
410855,202104,775,1934,504,1409,52,139,242,627,294,766
410860,202104,4336,10501,3413,9040,292,915,2055,5145,2347,6060
410865,202104,1468,4221,1266,3833,125,420,746,2293,871,2713
410870,202104,1239,3297,1014,2918,93,276,665,1888,758,2164
410880,202104,4670,12242,3287,9734,536,1638,491,1565,1027,3203
410890,202104,1007,2808,760,2325,161,557,219,627,380,1184
410895,202104,1008,3162,858,2836,259,944,203,636,462,1580
410900,202104,866,2291,611,1795,98,303,138,340,236,643
410910,202104,409,955,250,653,13,42,136,320,149,362
410920,202104,869,2062,628,1672,80,235,320,825,400,1060
410930,202104,1707,4331,1179,3415,280,942,219,614,499,1556
410940,202104,22891,61375,16681,50459,3375,11169,5268,15551,8643,26720
410950,202104,1926,5592,1732,5308,51,171,1431,4343,1482,4514
410960,202104,7680,18783,5359,14933,1203,3733,2146,5881,3349,9614
410965,202104,1165,2930,808,2267,85,258,462,1274,547,1532
410970,202104,4083,10841,2907,8615,636,2250,405,990,1041,3240
410975,202104,1343,3278,1022,2774,115,334,503,1340,618,1674
410980,202104,7723,19036,5023,14209,559,1736,2186,5590,2745,7326
410990,202104,1388,3342,955,2657,202,662,361,957,563,1619
411000,202104,663,1739,460,1367,64,217,132,321,196,538
411005,202104,466,1170,285,787,49,152,92,217,141,369
411007,202104,2261,6222,1834,5501,433,1383,624,1844,1057,3227
411010,202104,4185,12492,3298,10702,802,2848,355,1047,1157,3895
411020,202104,2360,6580,1910,5782,526,1662,500,1496,1026,3158
411030,202104,789,1920,558,1467,42,134,302,701,344,835
411040,202104,992,2498,540,1526,75,240,167,389,242,629
411050,202104,1982,6087,1616,5285,412,1470,225,616,637,2086
411060,202104,2013,5310,1303,3839,265,885,245,667,510,1552
411065,202104,413,1054,278,792,37,105,124,339,161,444
411070,202104,7505,18812,5921,16205,702,2122,3079,8175,3781,10297
411080,202104,2105,5479,1670,4752,405,1335,338,925,743,2260
411090,202104,826,2172,545,1620,46,161,157,444,203,605
411095,202104,2800,6478,1539,4174,181,519,397,1005,578,1524
411100,202104,1227,3126,854,2464,85,277,305,892,390,1169
411110,202104,634,1639,311,958,40,121,20,48,60,169
411120,202104,1327,3601,1096,3175,320,1074,236,628,556,1702
411125,202104,5220,15094,4667,14106,1037,3076,2237,7108,3274,10184
411130,202104,740,1962,527,1567,105,282,182,596,287,878
411140,202104,2271,6907,1932,6194,577,1970,510,1622,1087,3592
411150,202104,3912,9784,2654,7272,517,1665,247,485,764,2150
411155,202104,980,2494,597,1778,89,253,257,725,346,978
411160,202104,377,864,262,693,28,81,70,189,98,270
411170,202104,738,2151,581,1798,137,438,201,597,338,1035
411180,202104,5578,14572,4377,12521,615,1938,2154,5778,2769,7716
411190,202104,1778,4493,1321,3687,196,577,521,1319,717,1896
411200,202104,4844,13029,3491,10519,830,2791,751,1949,1581,4740
411210,202104,3271,7243,2200,5508,389,1060,749,1774,1138,2834
411220,202104,869,2206,621,1732,148,456,165,423,313,879
411230,202104,842,2238,615,1803,117,365,223,632,340,997
411240,202104,1622,3844,1101,2921,118,367,549,1334,667,1701
411250,202104,2264,5951,1661,4873,305,1059,513,1419,818,2478
411260,202104,326,834,225,634,20,55,91,223,111,278
411270,202104,2052,5389,1535,4367,206,609,765,2018,971,2627
411275,202104,1469,3351,1025,2634,135,422,484,1145,619,1567
411280,202104,1321,3564,900,2758,234,731,128,371,362,1102
411290,202104,840,2191,539,1610,70,219,265,770,335,989
411295,202104,1270,3176,901,2457,111,309,405,1048,516,1357
411300,202104,1050,2606,690,1909,67,201,317,761,384,962
411310,202104,888,2032,683,1751,66,166,298,762,364,928
411320,202104,5537,14108,4047,11480,601,1822,1785,4577,2386,6399
411325,202104,1422,4016,1209,3633,206,582,675,2101,881,2683
411330,202104,3342,8962,2437,7322,530,1734,748,2280,1278,4014
411340,202104,837,2261,502,1533,78,248,148,424,226,672
411342,202104,1067,2567,607,1663,109,318,204,516,313,834
411345,202104,1108,2822,838,2377,64,189,603,1723,667,1912
411350,202104,2863,7583,1842,5525,443,1436,312,843,755,2279
411360,202104,707,1687,499,1360,80,231,161,420,241,651
411370,202104,59623,144891,43418,117556,3082,9881,26048,65621,29130,75502
411373,202104,1393,3507,1126,3109,107,341,605,1681,712,2022
411375,202104,1109,2790,808,2231,130,365,311,849,441,1214
411380,202104,1165,2652,792,1967,42,114,488,1126,530,1240
411390,202104,1507,4121,1187,3421,190,595,485,1212,675,1807
411400,202104,2357,5714,1773,4625,149,462,963,2373,1112,2835
411410,202104,2662,7275,1979,5845,417,1339,439,1223,856,2562
411420,202104,4367,10510,2373,6728,296,944,473,1022,769,1966
411430,202104,3498,9374,2687,7861,544,1738,967,2617,1511,4355
411435,202104,402,1108,254,799,52,163,75,201,127,364
411440,202104,2517,6945,2034,6045,426,1358,683,1966,1109,3324
411450,202104,2454,6597,1859,5593,240,717,997,3059,1237,3776
411460,202104,4243,10797,2697,7890,404,1392,486,1267,890,2659
411470,202104,794,2016,598,1638,105,317,235,567,340,884
411480,202104,5052,13240,3742,10833,687,2399,1418,3644,2105,6043
411490,202104,1655,4259,1271,3624,161,525,537,1388,698,1913
411500,202104,1307,3463,880,2563,146,464,169,393,315,857
411510,202104,2353,5911,1898,5145,361,1143,513,1405,874,2548
411520,202104,31911,77392,18735,51966,2123,6807,7397,18321,9520,25128
411530,202104,963,2501,577,1756,93,314,88,238,181,552
411535,202104,516,1484,328,1043,36,126,94,256,130,382
411540,202104,2648,6442,1828,4967,132,424,981,2609,1113,3033
411545,202104,918,2632,773,2380,70,229,493,1514,563,1743
411550,202104,730,1834,541,1498,84,249,97,290,181,539
411560,202104,1975,5270,1140,3517,153,541,60,154,213,695
411570,202104,7238,16673,4878,13152,1109,3263,858,2332,1967,5595
411573,202104,774,2072,648,1854,102,297,304,853,406,1150
411575,202104,2054,5516,1529,4456,264,839,383,1068,647,1907
411580,202104,4836,11054,2939,8160,427,1452,542,1329,969,2781
411585,202104,616,1831,290,941,60,201,53,157,113,358
411590,202104,400,1084,293,873,45,133,140,391,185,524
411600,202104,330,823,203,617,38,121,62,174,100,295
411605,202104,1576,3635,1026,2784,136,468,519,1389,655,1857
411610,202104,2605,6047,1858,4771,64,216,1289,3090,1353,3306
411620,202104,2744,7270,2343,6645,379,1129,1283,3633,1662,4762
411630,202104,792,2011,512,1492,71,260,190,485,261,745
411640,202104,475,1221,336,933,46,137,108,266,154,403
411650,202104,217,613,141,453,26,90,30,70,56,160
411660,202104,924,2350,671,1888,55,160,275,732,330,892
411670,202104,1409,3355,964,2524,105,289,490,1181,595,1470
411680,202104,1427,3808,1064,3087,155,510,460,1288,615,1798
411690,202104,3984,9956,3026,8341,663,1833,835,2461,1498,4294
411695,202104,646,1921,441,1391,49,167,187,548,236,715
411700,202104,1726,4402,1167,3346,252,744,194,525,446,1269
411705,202104,1918,5791,1626,5301,279,849,988,3423,1267,4272
411710,202104,1996,4993,1378,3859,300,843,299,817,599,1660
411720,202104,1062,2424,760,1916,144,382,291,699,435,1081
411721,202104,1005,2459,757,2006,143,376,221,571,364,947
411722,202104,903,2351,527,1518,93,289,184,441,277,730
411725,202104,1174,3243,802,2535,197,672,169,517,366,1189
411727,202104,1508,4116,973,2973,215,677,148,410,363,1087
411729,202104,683,1635,442,1190,54,190,165,385,219,575
411730,202104,5348,13974,4216,11819,813,2451,1914,5229,2727,7680
411740,202104,527,1343,273,798,61,170,60,158,121,328
411745,202104,801,2272,559,1728,69,239,138,345,207,584
411750,202104,5612,14624,4120,11753,554,1690,1987,5346,2541,7036
411760,202104,6682,17725,5190,15184,1625,4950,1003,3309,2628,8259
411770,202104,3046,8741,2241,6999,504,1685,363,1026,867,2711
411780,202104,2690,7484,2339,6844,672,2054,781,2335,1453,4389
411790,202104,2823,6755,1613,4603,313,1020,369,907,682,1927
411800,202104,1006,2837,758,2278,126,408,149,403,275,811
411810,202104,1610,4100,1201,3290,200,556,520,1334,720,1890
411820,202104,11465,32411,9366,28798,2201,7280,4134,12345,6335,19625
411830,202104,549,1357,402,1096,80,231,82,236,162,467
411840,202104,12335,32478,8505,24640,1404,4379,2367,6197,3771,10576
411845,202104,590,1653,353,1106,48,177,84,228,132,405
411850,202104,7316,18485,5027,14535,1251,4010,879,2345,2130,6355
411860,202104,696,1913,501,1505,82,260,119,311,201,571
411870,202104,593,1713,415,1314,93,319,98,283,191,602
411880,202104,2322,5652,1696,4673,229,694,655,1695,884,2389
411885,202104,1110,2862,796,2295,118,399,244,635,362,1034
411890,202104,1401,3704,998,2959,166,554,107,311,273,865
411900,202104,776,2143,494,1534,103,343,83,238,186,581
411910,202104,1028,3012,767,2476,174,667,295,865,469,1532
411915,202104,15075,36867,10419,28477,1451,4445,4408,10830,5859,15275
411920,202104,1141,3303,960,2914,203,709,356,993,559,1702
411925,202104,481,1256,343,1009,76,240,133,363,209,603
411930,202104,4941,14820,4165,13388,1861,6503,238,918,2099,7421
411940,202104,3328,9638,2596,8089,612,1952,858,2427,1470,4379
411950,202104,14497,38680,11998,34575,1528,5014,7229,19912,8757,24926
411960,202104,5996,15859,4770,13393,827,2503,1969,5254,2796,7757
411965,202104,475,1307,348,1054,45,150,152,435,197,585
411970,202104,1180,2691,927,2352,178,424,408,1193,586,1617
411980,202104,1484,3600,1068,2925,273,737,385,1053,658,1790
411990,202104,37680,97871,24270,73563,4368,14597,8438,24271,12806,38868
411995,202104,3648,8865,2786,7552,790,2335,738,1956,1528,4291
412000,202104,1879,4318,1305,3365,33,105,902,2169,935,2274
412010,202104,610,1871,460,1544,76,264,125,366,201,630
412015,202104,547,1536,449,1359,64,206,265,789,329,995
412020,202104,445,1240,285,904,46,171,111,316,157,487
412030,202104,617,1715,455,1419,76,239,146,441,222,680
412033,202104,957,2520,684,1966,87,269,258,637,345,906
412035,202104,747,2010,478,1519,48,183,262,794,310,977
412040,202104,611,1622,383,1164,60,189,59,168,119,357
412050,202104,1601,3984,1102,3062,244,755,257,716,501,1471
412060,202104,7300,21069,6114,18705,1593,5506,1715,5044,3308,10550
412065,202104,615,1684,467,1397,103,334,106,312,209,646
412070,202104,1215,3125,957,2633,126,381,374,931,500,1312
412080,202104,2247,6179,1553,4806,231,746,430,1205,661,1951
412085,202104,306,725,107,326,11,34,24,63,35,97
412090,202104,6076,15507,4485,12580,1028,3064,1702,4783,2730,7847
412100,202104,1679,4509,1274,3750,408,1334,272,869,680,2203
412110,202104,831,2219,580,1710,87,276,184,513,271,789
412120,202104,2055,5774,1570,4839,324,1094,401,1041,725,2135
412125,202104,626,1755,441,1371,78,252,110,338,188,590
412130,202104,830,2058,577,1591,93,256,145,413,238,669
412135,202104,627,1653,293,880,52,166,86,219,138,385
412140,202104,1713,4098,1161,3148,178,610,262,669,440,1279
412150,202104,2837,7307,2419,6575,343,1070,1473,3782,1816,4852
412160,202104,890,2737,501,1686,66,245,72,202,138,447
412170,202104,4362,11838,3658,10716,694,2270,1533,4119,2227,6389
412175,202104,1311,3695,1097,3329,225,711,487,1472,712,2183
412180,202104,1660,4538,1218,3722,143,500,556,1577,699,2077
412190,202104,3391,8394,2502,6863,305,899,1086,2962,1391,3861
412200,202104,1715,5012,1227,3925,313,1101,179,521,492,1622
412210,202104,650,1526,407,1111,52,158,161,396,213,554
412215,202104,3423,9174,2658,7673,616,1742,1123,3533,1739,5275
412217,202104,1010,2590,852,2306,47,135,596,1546,643,1681
412220,202104,5576,15516,4563,13671,1310,3811,1418,4597,2728,8408
412230,202104,2691,7803,2129,6724,347,1250,523,1396,870,2646
412240,202104,7526,19198,4796,13819,813,2507,1453,3773,2266,6280
412250,202104,2036,5214,1519,4231,361,1041,317,816,678,1857
412260,202104,1244,3295,923,2628,140,413,282,750,422,1163
412265,202104,915,2468,721,2134,156,483,290,819,446,1302
412270,202104,1027,2774,661,2000,80,270,260,703,340,973
412280,202104,403,1110,318,966,79,243,93,274,172,517
412290,202104,1049,2643,732,2077,105,317,244,630,349,947
412300,202104,1668,4304,1172,3434,257,793,256,781,513,1574
412310,202104,749,2116,587,1786,104,367,185,519,289,886
412320,202104,816,2079,526,1487,45,150,157,448,202,598
412330,202104,1630,4283,1121,3336,230,735,375,1148,605,1883
412340,202104,1158,3142,747,2252,99,359,121,328,220,687
412350,202104,2980,7755,1934,5708,360,1143,319,857,679,2000
412360,202104,255,695,183,545,7,33,113,313,120,346
412370,202104,855,2415,584,1845,114,402,65,206,179,608
412380,202104,1521,4107,1089,3268,279,868,114,392,393,1260
412382,202104,493,1190,329,928,39,141,149,346,188,487
412385,202104,2199,5974,1807,5217,578,1581,564,1805,1142,3386
412390,202104,2512,5967,2015,5205,342,907,728,1865,1070,2772
412395,202104,693,1970,501,1541,64,184,216,674,280,858
412400,202104,925,2415,662,1920,119,380,196,553,315,933
412402,202104,2209,5405,1554,4342,410,1155,194,582,604,1737
412405,202104,3077,8057,2031,6111,510,1786,108,291,618,2077
412410,202104,6222,15887,4604,13271,746,2504,1569,4229,2315,6733
412420,202104,552,1387,365,1006,29,94,174,414,203,508
412430,202104,601,1501,316,912,32,101,131,352,163,453
412440,202104,2758,7334,1838,5584,430,1409,337,1045,767,2454
412450,202104,494,1407,339,1037,47,147,30,72,77,219
412460,202104,1088,2785,852,2393,164,497,382,1048,546,1545
412470,202104,1542,4853,1276,4262,306,1097,272,901,578,1998
412480,202104,1036,2724,706,2021,115,360,235,594,350,954
412490,202104,1327,3233,1067,2770,140,361,517,1267,657,1628
412500,202104,1964,4891,1494,4029,318,880,410,994,728,1874
412510,202104,1893,5705,1305,4233,306,1054,144,407,450,1461
412520,202104,1149,2974,652,1912,148,402,59,187,207,589
412530,202104,711,1866,515,1462,78,247,113,324,191,571
412535,202104,825,2131,560,1626,99,317,119,298,218,615
412540,202104,1192,3006,865,2415,89,305,296,865,385,1170
412545,202104,682,1750,468,1329,76,224,149,415,225,639
412550,202104,33561,88538,24072,69730,3748,11832,9850,25929,13598,37761
412555,202104,295,755,200,555,21,63,60,129,81,192
412560,202104,4712,13380,3597,10854,639,2124,1062,3179,1701,5303
412570,202104,4479,11148,2599,7550,486,1607,305,946,791,2553
412575,202104,1050,2625,841,2272,113,342,452,1138,565,1480
412580,202104,1434,3701,1027,2940,75,254,564,1540,639,1794
412590,202104,406,1059,228,699,34,111,23,62,57,173
412600,202104,1675,4445,1279,3659,187,596,583,1539,770,2135
412610,202104,834,2176,595,1666,81,244,275,670,356,914
412620,202104,1266,3289,968,2839,188,628,298,817,486,1445
412625,202104,8597,22486,5296,15976,735,2502,337,928,1072,3430
412627,202104,1155,3226,755,2391,140,486,204,645,344,1131
412630,202104,2906,8373,2117,6710,380,1235,633,1822,1013,3057
412635,202104,395,1065,265,789,31,109,86,208,117,317
412640,202104,1054,2755,605,1817,74,229,180,480,254,709
412650,202104,1691,4541,1348,3868,217,694,532,1314,749,2008
412660,202104,2451,6288,1756,4956,260,794,566,1424,826,2218
412665,202104,391,989,308,842,55,156,146,391,201,547
412667,202104,1814,4747,1361,3872,189,579,589,1605,778,2184
412670,202104,876,2033,564,1521,109,335,149,368,258,703
412680,202104,2073,5445,1451,4267,180,607,526,1372,706,1979
412690,202104,1142,2992,822,2380,134,428,300,817,434,1245
412700,202104,1957,5118,1631,4612,203,632,893,2467,1096,3099
412710,202104,5801,16671,4343,13579,809,2865,1167,3175,1976,6040
412720,202104,1133,3325,871,2758,138,463,183,494,321,957
412730,202104,2512,6545,1753,5041,310,1001,657,1762,967,2763
412740,202104,1916,5283,1315,4081,217,784,184,561,401,1345
412750,202104,3986,10286,3265,9273,257,864,2200,5944,2457,6808
412760,202104,2929,7831,2445,7024,456,1476,1306,3497,1762,4973
412770,202104,10321,26119,5665,17005,743,2404,1296,3266,2039,5670
412780,202104,1193,3135,907,2621,196,622,340,948,536,1570
412785,202104,2106,4930,1507,3938,132,362,1040,2651,1172,3013
412788,202104,1384,3849,1135,3417,316,965,437,1265,753,2230
412790,202104,1345,3529,781,2396,107,375,242,643,349,1018
412795,202104,1235,3140,664,2003,93,304,128,345,221,649
412796,202104,2158,6141,1781,5441,352,1145,608,1712,960,2857
412800,202104,3723,8960,2596,6894,279,870,1246,2920,1525,3790
412810,202104,12006,30362,7838,22014,927,3009,3084,7681,4011,10690
412820,202104,6329,17197,4504,13510,1068,3417,1289,3825,2357,7242
412830,202104,351,985,256,785,36,105,72,210,108,315
412840,202104,1876,4616,1348,3606,152,455,623,1500,775,1955
412850,202104,2769,7210,2003,5889,309,972,853,2469,1162,3441
412853,202104,1517,3785,1273,3375,167,493,667,1568,834,2061
412855,202104,1304,3373,807,2335,111,370,218,556,329,926
412860,202104,752,1848,511,1465,72,226,273,729,345,955
412862,202104,680,1640,465,1285,89,244,182,474,271,718
412863,202104,1262,3755,1123,3505,259,832,537,1664,796,2496
412865,202104,704,1912,520,1539,142,412,129,424,271,836
412870,202104,852,2188,621,1809,174,546,140,455,314,1001
412880,202104,864,2315,576,1729,97,331,101,269,198,600
420005,202104,406,1187,248,827,31,100,116,395,147,495
420010,202104,3269,7933,2203,6142,127,379,1619,4553,1746,4932
420020,202104,419,1307,281,949,44,174,64,164,108,338
420030,202104,80,275,48,189,12,54,18,65,30,119
420040,202104,500,1487,308,1063,61,229,24,63,85,292
420050,202104,708,1601,476,1197,66,194,296,663,362,857
420055,202104,157,476,85,303,18,81,24,74,42,155
420060,202104,98,259,58,166,8,24,16,33,24,57
420070,202104,699,2083,525,1727,108,351,206,658,314,1009
420075,202104,79,195,40,118,7,26,14,22,21,48
420080,202104,357,1004,281,831,66,216,110,317,176,533
420090,202104,412,1266,262,912,57,215,45,131,102,346
420100,202104,1254,3228,1051,2919,55,178,853,2329,908,2507
420110,202104,249,786,222,727,43,156,112,346,155,502
420120,202104,586,1552,400,1152,65,216,194,481,259,697
420125,202104,350,1065,247,839,58,218,95,307,153,525
420127,202104,300,771,114,343,14,47,39,110,53,157
420130,202104,3489,9485,2644,8085,376,1358,1236,3471,1612,4829
420140,202104,3541,9428,2554,7718,696,2379,419,1296,1115,3675
420150,202104,673,1692,466,1337,44,144,278,764,322,908
420160,202104,191,458,69,219,8,28,20,60,28,88
420165,202104,147,415,86,283,20,68,26,75,46,143
420170,202104,276,865,187,629,24,90,61,166,85,256
420180,202104,164,517,101,355,16,57,28,86,44,143
420190,202104,198,608,120,412,31,118,41,130,72,248
420195,202104,1387,3496,1024,2920,268,910,201,489,469,1399
420200,202104,4754,11359,2933,8017,379,1269,1247,2922,1626,4191
420205,202104,1789,4771,1196,3567,172,540,649,1907,821,2447
420207,202104,1762,4558,1114,3320,203,699,460,1286,663,1985
420208,202104,314,894,183,640,55,206,44,136,99,342
420209,202104,154,481,100,313,17,57,45,126,62,183
420210,202104,3033,7668,2069,6109,337,1146,1037,2945,1374,4091
420213,202104,772,2335,653,2105,139,476,331,1051,470,1527
420215,202104,199,595,143,471,43,163,35,107,78,270
420220,202104,270,769,164,540,26,99,74,227,100,326
420230,202104,5135,13736,3922,11490,560,1780,2124,5973,2684,7753
420240,202104,13760,37664,8862,26492,1080,3695,4337,11343,5417,15038
420243,202104,383,1073,312,937,50,174,195,557,245,731
420245,202104,1306,3354,959,2771,70,241,608,1669,678,1910
420250,202104,426,1181,359,1073,52,174,209,586,261,760
420253,202104,469,1140,332,939,32,94,194,545,226,639
420257,202104,159,410,100,305,14,53,53,159,67,212
420260,202104,1113,2863,812,2455,116,409,541,1599,657,2008
420270,202104,533,1382,278,807,36,112,123,338,159,450
420280,202104,1153,3423,912,2920,161,574,357,1093,518,1667
420285,202104,126,268,57,165,9,40,23,52,32,92
420287,202104,431,989,311,828,88,241,111,299,199,540
420290,202104,4747,13350,3658,10922,505,1708,2128,5894,2633,7602
420300,202104,7285,20438,4277,13328,739,2551,1379,3727,2118,6278
420310,202104,761,1745,389,1078,35,108,215,551,250,659
420315,202104,773,2142,535,1736,94,326,236,755,330,1081
420320,202104,5122,13694,3683,11308,993,3343,971,2781,1964,6124
420325,202104,319,880,230,704,31,91,104,296,135,387
420330,202104,967,2796,615,2046,99,375,187,574,286,949
420340,202104,918,2539,696,2147,151,478,134,376,285,854
420350,202104,1155,2992,858,2473,67,224,607,1713,674,1937
420360,202104,2835,7699,1539,4914,280,976,118,370,398,1346
420370,202104,1159,3060,957,2735,75,254,688,1906,763,2160
420380,202104,4298,11219,2903,8693,608,1940,1110,3170,1718,5110
420390,202104,1062,2566,736,1912,130,402,302,544,432,946
420395,202104,1114,3129,766,2439,123,443,120,280,243,723
420400,202104,967,2676,673,2065,108,382,287,824,395,1206
420410,202104,563,1480,437,1222,34,104,308,843,342,947
420415,202104,282,817,211,668,51,177,86,282,137,459
420417,202104,599,1739,467,1473,126,417,178,573,304,990
420419,202104,135,480,109,422,39,160,9,37,48,197
420420,202104,11104,28528,7489,21991,1995,6681,2145,5716,4140,12397
420425,202104,614,1628,415,1218,36,120,215,615,251,735
420430,202104,3070,8157,1830,5473,410,1282,594,1645,1004,2927
420435,202104,247,636,127,407,15,52,65,202,80,254
420440,202104,695,1864,428,1310,125,409,129,373,254,782
420445,202104,254,615,168,463,29,78,78,201,107,279
420450,202104,716,2077,523,1660,90,354,186,512,276,866
420455,202104,1965,4744,1431,3943,203,617,696,1827,899,2444
420460,202104,8981,23731,6758,19673,931,3054,3532,9847,4463,12901
420470,202104,570,1477,312,971,59,217,59,154,118,371
420475,202104,66,172,25,83,6,21,2,7,8,28
420480,202104,5204,12734,3233,9501,608,1956,1171,3410,1779,5366
420490,202104,349,971,253,779,54,189,97,287,151,476
420500,202104,1349,3690,871,2798,139,500,398,1251,537,1751
420510,202104,151,427,84,269,9,37,22,60,31,97
420515,202104,59,151,36,99,2,9,16,41,18,50
420517,202104,746,2030,634,1818,56,169,431,1238,487,1407
420519,202104,287,699,204,576,21,65,121,346,142,411
420520,202104,273,726,144,473,21,73,10,31,31,104
420530,202104,791,2317,546,1784,82,323,218,616,300,939
420535,202104,232,673,99,331,15,56,40,128,55,184
420540,202104,36591,86765,24172,66200,3391,10580,8852,20980,12243,31560
420543,202104,203,597,155,488,17,54,85,251,102,305
420545,202104,1205,3602,919,2970,156,571,347,992,503,1563
420550,202104,3438,9060,2241,7040,348,1294,955,3054,1303,4348
420555,202104,279,810,195,631,23,87,117,359,140,446
420560,202104,380,943,254,752,47,151,150,441,197,592
420570,202104,2298,6141,1815,5224,286,965,850,2332,1136,3297
420580,202104,1787,4547,1285,3784,288,918,441,1333,729,2251
420590,202104,2679,7130,1587,4781,273,978,442,1025,715,2003
420600,202104,1013,2886,784,2463,90,345,469,1399,559,1744
420610,202104,322,929,195,636,48,165,65,220,113,385
420620,202104,763,1869,513,1466,109,326,203,573,312,899
420630,202104,899,2702,661,2123,73,254,398,1219,471,1473
420640,202104,480,1289,243,807,75,246,31,97,106,343
420650,202104,3517,9206,2199,6490,296,951,872,2248,1168,3199
420660,202104,420,1074,273,766,53,159,68,165,121,324
420665,202104,628,1603,409,1233,72,245,180,478,252,723
420670,202104,1215,3356,778,2432,123,470,290,792,413,1262
420675,202104,178,492,106,348,18,82,58,171,76,253
420680,202104,309,716,160,508,30,102,78,239,108,341
420690,202104,841,2478,533,1763,72,280,138,393,210,673
420700,202104,2495,6502,1880,5483,208,668,1129,3180,1337,3848
420710,202104,977,2702,760,2240,74,290,484,1286,558,1576
420720,202104,1144,3177,833,2638,141,475,442,1339,583,1814
420730,202104,3041,7875,2267,6606,372,1209,1221,3403,1593,4612
420740,202104,484,1426,268,947,56,222,21,86,77,308
420750,202104,1903,5445,1232,3895,204,753,516,1489,720,2242
420757,202104,83,196,36,105,4,6,16,49,20,55
420760,202104,303,888,163,514,32,112,47,134,79,246
420765,202104,449,1302,217,733,24,90,102,328,126,418
420768,202104,1329,3701,1155,3417,136,402,863,2541,999,2943
420770,202104,438,1186,216,742,39,157,83,266,122,423
420775,202104,261,761,178,573,32,113,65,167,97,280
420780,202104,887,2467,540,1695,107,370,93,262,200,632
420785,202104,197,513,140,391,13,46,73,170,86,216
420790,202104,1011,3017,755,2504,124,480,427,1335,551,1815
420800,202104,635,1591,328,979,71,245,128,358,199,603
420810,202104,1410,4295,1143,3768,306,1170,436,1230,742,2400
420820,202104,12239,30261,8877,24844,1580,4916,4186,10852,5766,15768
420830,202104,4111,10663,3084,8841,539,1626,1341,3741,1880,5367
420840,202104,469,1378,230,839,70,256,25,92,95,348
420845,202104,2368,5971,1468,4365,268,966,600,1677,868,2643
420850,202104,1056,3350,666,2327,109,408,139,438,248,846
420860,202104,302,763,171,533,32,113,51,131,83,244
420870,202104,756,2094,565,1738,150,515,217,612,367,1127
420880,202104,1020,3065,782,2576,161,626,299,904,460,1530
420890,202104,8008,21602,5013,15490,678,2288,1773,4877,2451,7165
420895,202104,173,499,109,333,27,84,34,105,61,189
420900,202104,1489,3673,905,2658,121,432,415,1067,536,1499
420910,202104,30204,79011,19251,58011,2766,9459,7849,20965,10615,30424
420915,202104,495,1780,366,1409,54,199,201,795,255,994
420917,202104,400,982,190,515,30,83,96,260,126,343
420920,202104,71,197,30,108,1,2,5,20,6,22
420930,202104,15901,41170,11352,33238,1948,6286,5102,14260,7050,20546
420940,202104,3014,7292,1799,5210,412,1341,384,912,796,2253
420945,202104,129,369,101,310,23,79,39,110,62,189
420950,202104,335,967,188,618,30,117,49,143,79,260
420960,202104,1014,2475,735,2000,124,389,328,803,452,1192
420970,202104,2306,6264,1623,5013,458,1462,476,1467,934,2929
420980,202104,272,892,234,810,106,378,62,225,168,603
420985,202104,294,845,152,536,40,162,42,127,82,289
420990,202104,287,893,166,590,26,98,38,131,64,229
421000,202104,539,1610,394,1299,83,289,96,283,179,572
421003,202104,463,1099,158,462,2,4,16,37,18,41
421005,202104,59,164,44,142,9,27,20,68,29,95
421010,202104,3196,8704,2310,7066,432,1484,646,1731,1078,3215
421020,202104,363,1122,286,984,43,179,145,472,188,651
421030,202104,733,2174,555,1812,168,620,182,543,350,1163
421040,202104,623,1485,392,1132,28,99,246,692,274,791
421050,202104,1009,2674,668,1938,124,393,265,676,389,1069
421055,202104,169,461,95,290,15,50,59,162,74,212
421060,202104,639,1838,459,1452,83,304,228,649,311,953
421070,202104,648,1933,407,1317,66,235,154,459,220,694
421080,202104,506,1447,421,1290,40,148,252,759,292,907
421085,202104,369,1030,145,495,15,50,25,69,40,119
421090,202104,266,683,150,424,12,44,46,109,58,153
421100,202104,759,1700,325,980,80,271,84,208,164,479
421105,202104,1528,4122,1061,3212,165,529,511,1478,676,2007
421110,202104,1086,2781,889,2524,20,61,649,1946,669,2007
421120,202104,992,2945,726,2357,103,363,224,623,327,986
421125,202104,286,741,203,591,74,239,73,180,147,419
421130,202104,4712,13609,3895,12033,866,3054,1997,5789,2863,8843
421140,202104,337,920,206,633,36,107,74,215,110,322
421145,202104,429,1167,275,832,74,238,94,260,168,498
421150,202104,561,1514,362,1127,61,222,190,551,251,773
421160,202104,504,1370,377,1128,49,165,237,669,286,834
421165,202104,217,632,132,430,26,84,55,174,81,258
421170,202104,986,2720,843,2487,137,387,517,1576,654,1963
421175,202104,957,2376,589,1810,113,394,263,779,376,1173
421180,202104,379,987,215,657,37,148,99,257,136,405
421185,202104,310,813,211,609,21,65,127,356,148,421
421187,202104,274,838,172,581,25,79,62,207,87,286
421189,202104,339,984,268,845,49,169,107,313,156,482
421190,202104,10951,29370,7561,22970,1346,4389,2862,8024,4208,12413
421200,202104,663,1875,550,1677,77,279,334,965,411,1244
421205,202104,186,490,135,408,27,96,58,160,85,256
421210,202104,1044,2591,596,1843,117,378,227,688,344,1066
421220,202104,1344,3973,1042,3343,230,816,334,971,564,1787
421223,202104,311,851,194,637,45,143,93,303,138,446
421225,202104,832,2408,707,2199,112,412,439,1330,551,1742
421227,202104,625,1780,405,1312,74,257,182,603,256,860
421230,202104,564,1458,365,1086,64,225,145,421,209,646
421240,202104,283,823,137,475,12,54,30,93,42,147
421250,202104,2007,4986,1402,4010,133,443,856,2343,989,2786
421260,202104,201,612,48,172,10,43,6,17,16,60
421265,202104,658,1747,582,1637,18,48,500,1394,518,1442
421270,202104,338,896,142,498,24,80,47,162,71,242
421280,202104,1915,4996,1445,4227,197,698,833,2308,1030,3006
421290,202104,943,2513,492,1482,96,297,112,312,208,609
421300,202104,266,674,129,412,11,48,19,55,30,103
421310,202104,173,487,116,375,24,80,60,191,84,271
421315,202104,220,569,145,416,44,118,33,103,77,221
421320,202104,626,1971,339,1134,35,100,32,59,67,159
421330,202104,585,1714,423,1379,88,328,115,343,203,671
421335,202104,340,1025,279,923,62,226,118,386,180,612
421340,202104,1362,3743,986,3062,159,554,477,1377,636,1931
421350,202104,1461,3757,984,2926,191,632,391,1103,582,1735
421360,202104,2195,5808,1300,3967,229,824,494,1303,723,2127
421370,202104,700,2265,434,1546,74,279,124,377,198,656
421380,202104,817,2122,701,1943,82,253,418,1114,500,1367
421390,202104,163,433,62,211,15,44,22,65,37,109
421400,202104,313,968,227,769,37,144,117,371,154,515
421410,202104,175,490,82,295,21,83,24,74,45,157
421415,202104,175,513,113,351,24,81,26,64,50,145
421420,202104,554,1507,455,1321,50,164,282,802,332,966
421430,202104,94,299,71,239,8,28,16,51,24,79
421440,202104,597,1600,363,1162,66,207,155,480,221,687
421450,202104,443,1272,255,849,30,106,44,147,74,253
421460,202104,353,1051,193,713,19,74,24,75,43,149
421470,202104,279,777,169,545,31,101,63,218,94,319
421480,202104,2689,7164,1805,5398,341,1200,725,1971,1066,3171
421490,202104,114,390,68,255,11,44,14,42,25,86
421500,202104,2010,5831,1396,4569,349,1341,343,988,692,2329
421505,202104,284,790,236,722,31,118,158,459,189,577
421507,202104,419,1163,232,767,51,187,83,247,134,434
421510,202104,341,946,221,651,32,103,115,315,147,418
421520,202104,485,1286,320,919,28,85,185,481,213,566
421530,202104,275,800,153,520,24,103,36,95,60,198
421535,202104,368,971,233,733,38,138,128,389,166,527
421540,202104,298,701,162,482,24,78,55,141,79,219
421545,202104,616,1806,463,1541,98,397,230,708,328,1105
421550,202104,2001,5252,1624,4698,309,901,926,2682,1235,3583
421555,202104,160,486,72,254,6,24,10,20,16,44
421560,202104,83,280,55,209,10,42,17,59,27,101
421565,202104,887,2285,592,1823,147,511,171,517,318,1028
421567,202104,399,1257,260,880,83,301,72,217,155,518
421568,202104,327,969,244,774,35,128,104,322,139,450
421569,202104,150,417,72,227,10,32,39,123,49,155
421570,202104,1231,3334,865,2583,183,611,261,696,444,1307
421575,202104,286,827,216,639,31,99,103,285,134,384
421580,202104,4147,11158,2699,8170,376,1332,1057,2726,1433,4058
421590,202104,137,420,110,358,25,94,39,117,64,211
421600,202104,557,1498,382,1124,74,245,122,309,196,554
421605,202104,722,1869,521,1542,92,236,278,887,370,1123
421610,202104,1012,2752,693,2145,105,368,234,689,339,1057
421620,202104,3677,9673,2234,7051,424,1566,691,2043,1115,3609
421625,202104,125,348,60,185,11,31,16,46,27,77
421630,202104,2474,6441,1612,4798,274,979,610,1520,884,2499
421635,202104,260,691,186,541,14,45,120,321,134,366
421640,202104,660,1769,475,1489,98,350,205,629,303,979
421650,202104,2313,6299,1571,4933,341,1252,510,1378,851,2630
421660,202104,9942,27444,7018,21829,1031,3593,3206,9107,4237,12700
421670,202104,746,2108,527,1590,97,329,243,697,340,1026
421680,202104,1035,2771,794,2354,158,509,452,1239,610,1748
421690,202104,1285,3618,876,2768,155,530,309,972,464,1502
421700,202104,496,1435,343,1099,73,265,119,359,192,624
421710,202104,195,626,98,339,20,70,24,79,44,149
421715,202104,117,313,95,266,21,58,51,142,72,200
421720,202104,1885,5074,1137,3489,293,952,279,744,572,1696
421725,202104,249,593,130,387,23,76,59,147,82,223
421730,202104,381,1057,217,628,30,95,115,306,145,401
421740,202104,725,2050,495,1556,106,369,150,417,256,786
421750,202104,851,1999,409,1190,93,291,150,400,243,691
421755,202104,155,435,94,287,15,59,49,131,64,190
421760,202104,960,2488,660,1942,110,356,242,600,352,956
421770,202104,2283,5992,1649,4900,433,1261,574,1834,1007,3095
421775,202104,215,556,131,395,16,50,56,157,72,207
421780,202104,791,2311,517,1740,104,394,220,677,324,1071
421790,202104,847,2293,501,1638,108,373,218,682,326,1055
421795,202104,168,461,118,342,22,69,39,105,61,174
421800,202104,2506,6709,1837,5478,219,754,1071,3033,1290,3787
421810,202104,621,1682,421,1310,43,156,249,759,292,915
421820,202104,918,2653,552,1759,107,388,182,475,289,863
421825,202104,1315,3622,1169,3404,102,323,855,2433,957,2756
421830,202104,1948,5654,1592,5004,322,1090,644,1992,966,3082
421835,202104,218,530,144,409,30,104,53,135,83,239
421840,202104,206,658,145,519,30,116,34,112,64,228
421850,202104,364,1010,211,707,52,204,57,145,109,349
421860,202104,295,803,163,535,18,71,63,182,81,253
421870,202104,4255,10536,3153,8528,465,1493,1674,4021,2139,5514
421875,202104,278,809,119,364,17,57,32,80,49,137
421880,202104,661,1838,450,1374,91,304,124,360,215,664
421885,202104,214,601,137,423,32,107,41,108,73,215
421890,202104,816,2421,610,2016,102,400,334,1039,436,1439
421895,202104,388,983,332,910,39,110,225,649,264,759
421900,202104,1012,2663,772,2172,92,294,383,977,475,1271
421910,202104,307,884,192,617,29,123,44,109,73,232
421915,202104,363,1019,211,666,46,138,40,121,86,259
421917,202104,567,1309,326,1004,111,351,83,282,194,633
421920,202104,360,1085,259,886,96,343,77,261,173,604
421930,202104,2502,6241,1337,4048,271,940,489,1287,760,2227
421935,202104,392,1199,311,1026,59,200,180,581,239,781
421940,202104,361,1042,175,557,26,87,33,81,59,168
421950,202104,2907,7211,1698,4946,338,1067,438,1129,776,2196
421960,202104,178,442,93,281,14,61,31,70,45,131
421970,202104,1825,4666,1130,3240,218,725,453,1127,671,1852
421985,202104,289,789,180,566,21,75,68,198,89,273
422000,202104,1887,4828,1540,4294,145,485,1070,2942,1215,3427
430003,202104,570,1522,376,1175,63,210,170,533,233,743
430005,202104,262,690,167,520,24,83,85,252,109,335
430010,202104,1693,4051,1353,3529,194,520,900,2309,1094,2829
430020,202104,584,1321,441,1136,42,130,295,727,337,857
430030,202104,926,2180,505,1425,118,379,161,418,279,797
430040,202104,10304,24118,6244,17132,1601,4693,898,2581,2499,7274
430045,202104,462,1161,330,919,25,79,221,603,246,682
430047,202104,232,498,94,251,22,55,26,73,48,128
430050,202104,855,2169,508,1472,105,322,129,354,234,676
430055,202104,268,659,136,386,17,65,76,189,93,254
430057,202104,79,168,31,83,7,20,10,22,17,42
430060,202104,17117,44924,13300,38996,2595,8087,6335,18346,8930,26433
430063,202104,802,2218,653,1917,130,384,352,1034,482,1418
430064,202104,1047,2819,779,2278,194,594,340,969,534,1563
430066,202104,95,193,66,150,6,14,50,108,56,122
430070,202104,725,1850,120,396,19,78,18,39,37,117
430080,202104,862,2114,534,1483,79,260,291,683,370,943
430085,202104,864,1908,524,1366,106,290,219,558,325,848
430087,202104,787,1879,658,1710,61,168,463,1189,524,1357
430090,202104,502,1316,198,626,13,50,60,184,73,234
430100,202104,809,1907,492,1324,89,275,156,354,245,629
430105,202104,1190,3105,800,2444,111,393,400,1181,511,1574
430107,202104,175,513,103,325,22,68,26,72,48,140
430110,202104,2238,5490,1673,4665,300,874,847,2332,1147,3206
430120,202104,1174,3419,795,2484,142,462,350,1079,492,1541
430130,202104,3455,7781,2534,6486,837,2185,462,1446,1299,3631
430140,202104,982,2500,709,2007,162,419,370,1033,532,1452
430150,202104,553,1402,305,904,67,219,98,276,165,495
430155,202104,241,608,114,341,20,57,23,63,43,120
430160,202104,20009,45731,15703,39783,1734,4741,9543,23814,11277,28555
430163,202104,3097,7193,2184,5754,80,276,1624,4173,1704,4449
430165,202104,290,707,90,279,12,27,13,38,25,65
430170,202104,955,2490,335,1127,51,171,42,128,93,299
430175,202104,650,1886,552,1676,137,415,257,786,394,1201
430180,202104,640,1534,503,1311,65,153,327,867,392,1020
430185,202104,644,1605,333,955,92,235,49,133,141,368
430187,202104,737,1573,530,1316,71,183,303,761,374,944
430190,202104,1413,3602,1124,3158,244,725,514,1401,758,2126
430192,202104,123,326,41,121,5,15,8,19,13,34
430195,202104,406,1181,59,209,4,17,5,11,9,28
430200,202104,1029,3025,825,2659,284,945,223,749,507,1694
430205,202104,453,1183,406,1099,13,47,361,950,374,997
430210,202104,5845,14892,3968,10933,633,1881,1266,2770,1899,4651
430215,202104,300,772,192,560,38,114,72,214,110,328
430220,202104,646,1601,204,670,22,79,43,112,65,191
430222,202104,186,513,137,413,17,58,46,129,63,187
430223,202104,246,636,194,548,14,35,121,333,135,368
430225,202104,16,32,10,23,0,0,7,16,7,16
430230,202104,1946,5208,1599,4669,134,441,1162,3320,1296,3761
430235,202104,362,993,233,727,41,147,59,158,100,305
430237,202104,510,1183,380,976,17,47,289,727,306,774
430240,202104,1317,3035,749,2041,79,257,401,1003,480,1260
430245,202104,696,1928,546,1649,137,423,262,819,399,1242
430250,202104,937,2252,678,1849,242,707,37,91,279,798
430258,202104,138,371,100,292,6,15,54,153,60,168
430260,202104,662,1731,461,1349,59,199,258,756,317,955
430265,202104,214,617,142,475,27,85,47,163,74,248
430270,202104,2932,7131,2323,6187,367,1068,1438,3706,1805,4774
430280,202104,5102,11784,3574,9223,672,1757,1585,4025,2257,5782
430290,202104,2231,5043,1825,4575,44,142,1585,3874,1629,4016
430300,202104,10111,25031,7609,20746,1145,3426,4092,10793,5237,14219
430310,202104,11942,29068,8151,22179,1034,3097,4040,10262,5074,13359
430320,202104,1014,2540,570,1677,55,165,329,962,384,1127
430330,202104,698,1667,417,1113,77,218,161,390,238,608
430340,202104,596,1384,397,1063,63,158,238,631,301,789
430350,202104,7898,19492,6010,16230,690,2034,3705,9508,4395,11542
430355,202104,301,795,111,355,16,51,13,33,29,84
430360,202104,826,1957,548,1470,97,299,238,595,335,894
430367,202104,305,680,178,468,30,95,103,253,133,348
430370,202104,468,1252,218,639,31,89,62,148,93,237
430380,202104,705,1714,338,1039,76,269,98,288,174,557
430390,202104,3183,7550,1930,5296,391,1220,302,605,693,1825
430400,202104,1013,2154,779,1843,63,164,460,1060,523,1224
430410,202104,542,1266,380,1008,55,146,241,633,296,779
430420,202104,2581,6850,1979,5588,439,1304,970,2604,1409,3908
430430,202104,564,1411,258,786,60,175,56,182,116,357
430435,202104,1485,3714,1153,3186,194,588,622,1707,816,2295
430440,202104,3797,10145,2994,8794,283,936,1900,5544,2183,6480
430450,202104,6714,16433,5346,14038,989,2797,2597,6568,3586,9365
430460,202104,33570,83273,25179,69733,4073,12398,13155,34887,17228,47285
430461,202104,231,603,76,231,11,36,34,89,45,125
430462,202104,260,692,151,472,27,96,49,147,76,243
430463,202104,6075,15540,4504,12783,869,2762,2107,5663,2976,8425
430465,202104,444,1117,356,955,59,177,223,575,282,752
430466,202104,4162,10323,3258,8882,742,2105,1530,3949,2272,6054
430467,202104,503,1178,353,953,48,158,195,479,243,637
430468,202104,1275,3088,1010,2705,74,225,708,1847,782,2072
430469,202104,528,1391,75,234,9,29,16,34,25,63
430470,202104,5509,13995,3674,10744,1057,3345,917,2525,1974,5870
430471,202104,541,1496,440,1312,63,204,264,759,327,963
430480,202104,672,1877,438,1361,54,181,105,287,159,468
430485,202104,171,442,65,198,18,52,7,23,25,75
430490,202104,356,914,205,605,22,85,108,285,130,370
430495,202104,392,1047,259,796,34,109,115,328,149,437
430500,202104,984,2503,680,1991,230,721,181,482,411,1203
430510,202104,26801,68037,19301,53871,3030,9528,9223,23742,12253,33270
430511,202104,319,914,140,450,18,61,20,61,38,122
430512,202104,971,2140,754,1821,163,401,283,699,446,1100
430513,202104,799,1956,372,1060,61,188,177,466,238,654
430515,202104,369,1032,269,828,34,100,149,456,183,556
430517,202104,1187,3487,893,2821,161,506,446,1425,607,1931
430520,202104,1271,3179,691,1943,123,376,160,407,283,783
430530,202104,975,2410,402,1200,69,202,117,341,186,543
430535,202104,3475,8819,2528,7102,341,1007,1292,3460,1633,4467
430537,202104,347,1124,319,1054,19,54,259,858,278,912
430540,202104,603,1421,339,965,59,168,159,454,218,622
430543,202104,870,1490,509,1088,59,122,215,541,274,663
430544,202104,747,2073,516,1560,122,382,172,508,294,890
430545,202104,2339,5874,1733,4960,314,903,927,2702,1241,3605
430550,202104,342,941,252,752,47,147,96,268,143,415
430558,202104,116,266,55,148,8,17,19,51,27,68
430560,202104,278,643,135,397,21,65,51,135,72,200
430570,202104,848,2045,606,1607,102,315,304,734,406,1049
430580,202104,827,2033,590,1674,148,453,250,708,398,1161
430583,202104,202,497,37,113,4,12,12,30,16,42
430585,202104,225,543,117,321,17,56,53,121,70,177
430587,202104,196,525,149,441,23,73,59,163,82,236
430590,202104,1373,3281,1133,2922,55,165,932,2355,987,2520
430593,202104,20,62,14,41,2,4,5,15,7,19
430595,202104,435,1084,129,411,12,49,22,54,34,103
430597,202104,463,1160,247,723,25,76,80,186,105,262
430600,202104,1984,5041,901,2541,139,418,234,612,373,1030
430605,202104,1292,3340,935,2690,113,365,459,1258,572,1623
430607,202104,526,1227,440,1097,26,67,326,803,352,870
430610,202104,5847,13411,3925,10553,1065,3312,889,2276,1954,5588
430613,202104,271,622,75,214,11,28,22,47,33,75
430620,202104,641,1533,479,1239,66,197,291,673,357,870
430630,202104,397,1075,119,383,23,73,28,73,51,146
430632,202104,451,1160,200,593,31,88,85,242,116,330
430635,202104,540,1244,407,1027,46,126,298,747,344,873
430637,202104,460,1092,354,931,37,109,242,609,279,718
430640,202104,1080,2824,719,2090,111,332,282,752,393,1084
430642,202104,354,968,265,768,46,133,137,376,183,509
430645,202104,154,359,60,160,10,28,21,49,31,77
430650,202104,1667,4627,1329,4061,387,1167,560,1855,947,3022
430655,202104,279,694,173,489,29,95,82,200,111,295
430660,202104,5268,13193,4048,11212,847,2458,1819,4961,2666,7419
430670,202104,651,1561,497,1296,32,80,295,790,327,870
430673,202104,530,1196,224,627,37,102,88,229,125,331
430675,202104,238,688,52,187,5,17,19,68,24,85
430676,202104,5102,12424,4058,10827,503,1428,2549,6683,3052,8111
430680,202104,1059,2766,618,1855,165,511,144,412,309,923
430690,202104,2800,7462,2219,6417,755,2307,604,1685,1359,3992
430692,202104,216,665,169,586,15,46,124,444,139,490
430693,202104,930,2416,572,1724,107,382,150,412,257,794
430695,202104,408,1018,252,713,28,74,136,370,164,444
430697,202104,391,981,306,850,73,186,151,452,224,638
430700,202104,7441,18004,4601,12793,879,2653,1162,2906,2041,5559
430705,202104,402,934,200,561,21,58,82,207,103,265
430710,202104,1676,3532,1177,2867,148,404,716,1701,864,2105
430720,202104,675,1604,360,1067,43,121,185,550,228,671
430730,202104,999,2676,696,2104,92,285,378,1112,470,1397
430740,202104,646,1707,340,1081,58,180,88,283,146,463
430745,202104,343,920,229,682,54,181,71,181,125,362
430750,202104,1386,3439,967,2728,258,742,412,1147,670,1889
430755,202104,449,1088,292,772,20,63,163,400,183,463
430760,202104,2030,4915,1558,4200,312,932,755,1924,1067,2856
430770,202104,6314,15597,4892,13444,582,1821,3151,8365,3733,10186
430780,202104,1837,4487,1109,3250,196,659,458,1283,654,1942
430781,202104,462,1279,270,836,51,144,75,210,126,354
430783,202104,350,797,211,581,22,65,135,351,157,416
430786,202104,33,115,24,88,4,15,3,12,7,27
430790,202104,4430,10618,3125,8398,331,1054,1927,4825,2258,5879
430800,202104,763,1726,577,1456,45,113,376,943,421,1056
430805,202104,335,862,221,626,11,41,146,399,157,440
430807,202104,477,1181,253,751,35,113,94,249,129,362
430810,202104,684,1618,303,889,35,124,134,361,169,485
430820,202104,1145,3059,706,2224,128,422,225,672,353,1094
430825,202104,260,636,84,232,9,22,32,82,41,104
430830,202104,1698,4710,1379,4104,104,306,965,2839,1069,3145
430840,202104,1070,2553,729,1989,105,274,469,1306,574,1580
430843,202104,173,407,80,215,6,21,32,75,38,96
430845,202104,467,1090,310,838,49,141,139,359,188,500
430850,202104,2244,5749,1521,4384,226,700,586,1723,812,2423
430860,202104,851,1980,397,1119,50,172,181,425,231,597
430865,202104,515,1280,376,1039,92,260,130,356,222,616
430870,202104,578,1522,259,814,38,138,77,207,115,345
430880,202104,1496,3343,1019,2618,166,428,553,1385,719,1813
430885,202104,169,445,89,290,5,16,56,177,61,193
430890,202104,998,2421,674,1886,53,218,146,379,199,597
430900,202104,3128,6759,2191,5441,174,537,1477,3432,1651,3969
430905,202104,844,2075,541,1505,97,299,226,596,323,895
430910,202104,1990,5311,1492,4292,223,731,702,1778,925,2509
430912,202104,506,1410,351,1096,31,92,221,703,252,795
430915,202104,481,1428,367,1217,134,424,93,331,227,755
430920,202104,22314,56047,17027,47402,2151,6579,10327,28100,12478,34679
430925,202104,88,201,36,112,4,12,19,56,23,68
430930,202104,10284,24039,6649,18489,1268,3539,2716,7959,3984,11498
430940,202104,941,2414,576,1659,118,354,205,530,323,884
430950,202104,803,1785,518,1308,34,115,345,794,379,909
430955,202104,384,985,97,266,23,66,30,61,53,127
430957,202104,166,554,152,526,20,72,102,350,122,422
430960,202104,1302,3064,741,2048,149,442,321,836,470,1278
430965,202104,1599,3761,1239,3198,68,176,942,2483,1010,2659
430970,202104,340,811,179,500,23,74,90,222,113,296
430975,202104,510,1476,393,1210,77,253,209,611,286,864
430980,202104,386,871,225,598,26,81,105,252,131,333
430990,202104,520,1463,344,1060,54,172,156,478,210,650
430995,202104,552,1383,423,1177,50,147,250,673,300,820
431000,202104,1338,3154,580,1675,118,367,44,115,162,482
431010,202104,2192,5754,1458,4464,298,974,383,1070,681,2044
431020,202104,7562,16333,4503,11788,976,2928,1581,3597,2557,6525
431030,202104,359,965,171,569,32,121,21,63,53,184
431033,202104,3772,8639,2463,6610,511,1419,915,2442,1426,3861
431036,202104,335,732,69,206,7,24,22,51,29,75
431040,202104,873,2189,567,1665,64,212,279,755,343,967
431041,202104,441,1016,323,833,27,59,193,503,220,562
431043,202104,314,794,184,557,41,137,88,255,129,392
431046,202104,106,281,43,134,5,12,9,25,14,37
431050,202104,1352,3253,966,2624,181,537,436,1221,617,1758
431053,202104,646,1713,386,1165,73,256,127,327,200,583
431055,202104,580,1389,488,1244,57,131,350,890,407,1021
431057,202104,223,635,123,396,27,88,33,98,60,186
431060,202104,5549,13678,3745,10663,852,2672,1100,3010,1952,5682
431065,202104,401,988,290,803,42,125,149,405,191,530
431070,202104,415,1116,248,747,54,178,74,216,128,394
431075,202104,220,629,133,429,33,113,38,122,71,235
431080,202104,581,1576,408,1211,61,210,153,430,214,640
431085,202104,787,2015,503,1378,55,152,268,716,323,868
431087,202104,388,1088,314,939,18,55,227,692,245,747
431090,202104,402,938,160,488,29,97,43,130,72,227
431100,202104,3328,7175,2297,5848,293,761,1244,3213,1537,3974
431110,202104,1414,3215,971,2452,234,633,415,940,649,1573
431112,202104,607,1645,510,1470,53,176,342,948,395,1124
431113,202104,382,1021,321,904,52,162,189,513,241,675
431115,202104,954,2656,748,2278,81,306,465,1325,546,1631
431120,202104,2640,6825,1841,5330,490,1573,448,1197,938,2770
431123,202104,396,1053,257,755,58,152,134,413,192,565
431125,202104,969,2715,781,2351,283,837,265,854,548,1691
431127,202104,201,534,65,215,8,28,14,43,22,71
431130,202104,2927,7343,2178,6132,324,1024,1212,3329,1536,4353
431140,202104,5635,13095,3485,9108,409,1169,1600,3646,2009,4815
431142,202104,497,1291,372,1077,45,136,229,667,274,803
431150,202104,1035,2718,750,2201,134,439,336,946,470,1385
431160,202104,635,1812,420,1325,80,265,123,381,203,646
431162,202104,500,1186,296,826,30,93,160,409,190,502
431164,202104,163,365,40,119,9,29,4,10,13,39
431170,202104,445,1214,316,950,93,288,93,269,186,557
431171,202104,651,1518,531,1359,119,268,303,806,422,1074
431173,202104,375,985,287,859,79,271,121,337,200,608
431175,202104,1292,2964,823,2181,130,348,318,797,448,1145
431177,202104,796,2108,628,1844,115,405,404,1129,519,1534
431179,202104,333,728,101,295,19,54,26,72,45,126
431180,202104,2133,5368,1332,3802,307,905,414,1128,721,2033
431190,202104,589,1488,272,784,31,89,91,221,122,310
431198,202104,374,1057,297,913,90,295,93,301,183,596
431200,202104,361,887,88,234,17,49,11,29,28,78
431205,202104,205,556,109,344,31,99,36,119,67,218
431210,202104,601,1458,487,1302,127,347,216,607,343,954
431213,202104,260,678,198,571,13,42,105,300,118,342
431215,202104,598,1427,286,830,21,63,148,400,169,463
431217,202104,156,401,109,315,13,45,60,156,73,201
431220,202104,522,1335,323,948,29,105,183,496,212,601
431225,202104,1497,3487,1154,2929,115,301,788,1992,903,2293
431230,202104,661,1859,531,1588,75,234,329,947,404,1181
431235,202104,150,382,20,70,2,4,4,19,6,23
431237,202104,313,968,250,824,43,155,130,410,173,565
431238,202104,32,85,26,72,5,16,12,24,17,40
431240,202104,4454,10778,3542,9359,406,1252,2250,5598,2656,6850
431242,202104,248,630,215,577,39,111,123,313,162,424
431244,202104,303,729,160,449,21,78,59,134,80,212
431245,202104,1316,3009,838,2195,66,188,468,1173,534,1361
431247,202104,277,690,169,472,28,86,78,190,106,276
431250,202104,1689,4148,1250,3562,278,789,644,1972,922,2761
431260,202104,255,707,173,546,25,93,57,178,82,271
431261,202104,242,716,194,638,14,46,110,346,124,392
431262,202104,336,939,173,562,12,36,115,377,127,413
431265,202104,1591,3709,656,1886,81,267,217,542,298,809
431267,202104,252,625,166,447,6,25,123,305,129,330
431270,202104,2793,6182,1508,4048,314,851,514,1415,828,2266
431275,202104,114,326,64,210,22,66,11,41,33,107
431280,202104,236,633,77,241,4,13,10,22,14,35
431290,202104,336,955,217,662,40,118,37,89,77,207
431295,202104,68,166,20,59,3,8,5,13,8,21
431300,202104,286,747,62,196,9,24,20,55,29,79
431301,202104,301,845,69,212,8,23,8,24,16,47
431303,202104,575,1469,353,1012,21,75,164,422,185,497
431306,202104,2290,5364,1419,3921,186,570,616,1512,802,2082
431308,202104,25,76,23,72,10,34,10,31,20,65
431310,202104,550,1474,388,1122,48,137,179,486,227,623
431320,202104,617,1683,337,1079,56,173,73,198,129,371
431330,202104,1712,4003,875,2478,144,463,358,914,502,1377
431333,202104,213,552,116,339,21,60,40,102,61,162
431335,202104,35,100,21,70,4,8,1,2,5,10
431337,202104,2521,6560,1888,5527,303,1024,1081,3031,1384,4055
431339,202104,416,1067,309,874,87,258,116,317,203,575
431340,202104,18448,44332,13032,35372,1955,5826,6203,15793,8158,21619
431342,202104,424,931,312,755,27,51,254,615,281,666
431344,202104,384,970,231,683,9,30,122,350,131,380
431346,202104,232,571,93,295,16,54,26,77,42,131
431349,202104,624,1615,364,1043,82,217,143,415,225,632
431350,202104,4062,10208,3035,8478,386,1258,1684,4486,2070,5744
431360,202104,542,1286,265,747,83,239,67,190,150,429
431365,202104,2051,4730,1628,4160,120,346,1238,3123,1358,3469
431370,202104,4453,10585,3235,8634,605,1700,1664,4506,2269,6206
431380,202104,797,2112,641,1862,48,146,446,1296,494,1442
431390,202104,2648,6432,1678,4732,159,537,862,2131,1021,2668
431395,202104,1300,3147,926,2587,181,522,445,1274,626,1796
431400,202104,315,875,177,561,35,104,38,118,73,222
431402,202104,882,1941,651,1593,77,194,449,1078,526,1272
431403,202104,199,543,156,457,23,63,71,200,94,263
431405,202104,4628,12020,3596,10307,574,1816,1828,4976,2402,6792
431406,202104,528,1476,381,1159,70,202,201,627,271,829
431407,202104,448,1225,316,949,68,230,163,463,231,693
431410,202104,16993,41835,11585,32489,1579,5113,6195,16103,7774,21216
431413,202104,200,523,54,176,5,15,10,35,15,50
431415,202104,653,1569,410,1156,74,252,206,522,280,774
431417,202104,558,1226,375,941,61,180,199,482,260,662
431420,202104,1628,3581,1223,3028,154,391,718,1729,872,2120
431430,202104,562,1436,282,864,45,151,92,253,137,404
431440,202104,29507,67966,20512,54075,3307,9542,8422,20661,11729,30203
431442,202104,124,351,59,202,10,39,8,25,18,64
431445,202104,386,1074,109,349,15,41,11,29,26,70
431446,202104,249,716,188,594,34,125,94,289,128,414
431447,202104,743,1928,426,1249,85,264,139,409,224,673
431449,202104,775,1988,474,1369,90,240,179,534,269,774
431450,202104,2292,4646,1789,3941,65,152,1419,3056,1484,3208
431454,202104,38,121,31,101,8,23,10,29,18,52
431455,202104,589,1377,293,778,35,96,145,346,180,442
431460,202104,2871,6834,2013,5329,520,1440,516,1387,1036,2827
431470,202104,1400,3867,1025,3067,179,545,440,1332,619,1877
431475,202104,238,639,59,199,5,18,7,14,12,32
431477,202104,382,988,236,690,39,106,99,262,138,368
431478,202104,218,575,49,152,10,26,6,13,16,39
431480,202104,3342,8117,2681,7126,624,1665,1370,3660,1994,5325
431490,202104,106348,247018,80769,208527,5448,16706,59073,146492,64521,163198
431500,202104,483,1212,362,988,64,185,186,482,250,667
431505,202104,255,609,173,482,12,40,123,339,135,379
431507,202104,332,774,135,392,45,143,35,91,80,234
431510,202104,1595,4027,1083,3039,261,786,357,1010,618,1796
431513,202104,210,461,118,311,7,13,78,205,85,218
431514,202104,110,280,79,225,4,12,54,145,58,157
431515,202104,458,1136,342,930,80,219,193,489,273,708
431517,202104,55,166,44,139,6,17,20,60,26,77
431520,202104,394,983,164,504,15,54,72,192,87,246
431530,202104,4382,9126,2559,6431,554,1351,764,1989,1318,3340
431531,202104,210,501,133,358,19,43,51,130,70,173
431532,202104,544,1252,337,884,65,191,146,367,211,558
431535,202104,237,619,108,333,23,78,23,59,46,137
431540,202104,1793,5667,1666,5490,54,207,1358,4496,1412,4703
431545,202104,347,884,65,205,5,17,16,48,21,65
431550,202104,2122,5284,1526,4181,235,673,773,2041,1008,2714
431555,202104,671,1501,396,1043,30,87,234,610,264,697
431560,202104,22873,54508,15719,43418,3187,9065,5452,15819,8639,24884
431570,202104,4224,10220,3538,9217,433,1243,2507,6274,2940,7517
431575,202104,280,673,227,587,72,174,83,219,155,393
431580,202104,565,1457,362,1055,36,121,205,571,241,692
431590,202104,587,1623,443,1329,89,279,178,549,267,828
431595,202104,362,969,242,718,41,115,96,265,137,380
431600,202104,1356,3152,951,2565,210,610,382,1021,592,1631
431610,202104,1378,3467,934,2663,142,381,475,1386,617,1767
431620,202104,476,1209,221,636,39,114,86,230,125,344
431630,202104,1313,3199,633,1833,98,296,242,658,340,954
431640,202104,6305,14599,5333,13382,454,1195,4087,10274,4541,11469
431642,202104,570,1360,357,942,40,101,154,379,194,480
431643,202104,381,923,181,513,15,39,54,157,69,196
431645,202104,1850,4063,1456,3542,52,163,1198,2868,1250,3031
431647,202104,297,717,92,269,10,27,25,61,35,88
431650,202104,125,338,87,278,7,24,46,132,53,156
431660,202104,858,2244,416,1314,64,241,114,303,178,544
431670,202104,1145,2691,699,1890,108,295,339,869,447,1164
431673,202104,239,604,88,292,6,22,16,41,22,63
431675,202104,413,1075,116,386,8,33,21,58,29,91
431680,202104,7864,19671,5778,15878,1299,3692,2482,6665,3781,10357
431690,202104,24264,58460,16448,44630,3117,9019,7034,18830,10151,27849
431695,202104,175,423,107,314,22,75,53,136,75,211
431697,202104,465,1077,360,918,52,123,215,562,267,685
431700,202104,1332,3376,1100,2957,179,436,648,1760,827,2196
431710,202104,13369,31164,9424,25571,1421,4138,5007,13629,6428,17767
431720,202104,6568,15942,3983,11071,938,2718,833,2099,1771,4817
431725,202104,27,75,21,65,3,10,9,24,12,34
431730,202104,3967,9252,2484,6960,554,1625,801,2414,1355,4039
431740,202104,5183,12037,3449,9183,884,2743,911,2110,1795,4853
431750,202104,7406,18882,5606,16037,1282,3863,2192,6227,3474,10090
431755,202104,316,847,76,254,13,41,9,29,22,70
431760,202104,5406,11990,3711,9320,403,1134,2304,5496,2707,6630
431770,202104,1936,4424,1496,3842,120,313,1103,2782,1223,3095
431775,202104,201,505,101,310,19,59,14,37,33,96
431780,202104,2150,5174,1401,3827,214,627,592,1577,806,2204
431790,202104,774,2057,544,1616,99,283,252,754,351,1037
431795,202104,230,584,117,355,26,71,29,85,55,156
431800,202104,8206,19210,5135,14422,1241,4166,489,1439,1730,5605
431805,202104,289,673,85,274,12,43,12,30,24,73
431810,202104,3298,7623,2071,5431,386,1055,886,2224,1272,3279
431820,202104,2079,5502,1627,4785,474,1465,549,1702,1023,3167
431830,202104,8968,19184,6563,15995,1655,4800,1640,3935,3295,8735
431840,202104,2600,6619,2088,5808,295,835,1360,3766,1655,4601
431842,202104,516,1278,175,534,26,89,71,196,97,285
431843,202104,334,871,248,702,33,98,121,327,154,425
431844,202104,200,526,69,222,14,48,22,76,36,124
431845,202104,498,1306,354,1023,36,104,206,593,242,697
431846,202104,271,694,232,636,12,35,204,560,216,595
431848,202104,128,326,71,208,10,31,14,30,24,61
431849,202104,406,978,78,225,8,21,13,26,21,47
431850,202104,4130,10959,3187,9130,714,2210,1089,3038,1803,5248
431860,202104,637,1485,345,930,53,153,201,521,254,674
431861,202104,92,254,56,174,9,28,19,59,28,87
431862,202104,451,1402,371,1263,69,256,185,604,254,860
431870,202104,20619,51262,16652,45143,1771,5498,10564,27460,12335,32958
431880,202104,3922,9923,2802,7971,403,1323,1368,3682,1771,5005
431890,202104,4519,11268,2834,8061,785,2411,501,1598,1286,4009
431900,202104,948,2335,617,1749,90,282,320,852,410,1134
431910,202104,745,1767,286,787,36,112,91,204,127,316
431912,202104,482,1281,379,1103,74,226,212,619,286,845
431915,202104,1095,2568,867,2208,28,80,684,1713,712,1793
431920,202104,1241,2821,1026,2542,35,74,872,2161,907,2235
431930,202104,664,1732,456,1344,167,460,159,490,326,950
431935,202104,85,221,62,176,16,49,14,35,30,84
431936,202104,306,866,173,538,34,110,77,219,111,329
431937,202104,142,347,91,247,11,32,43,98,54,130
431940,202104,3062,7113,1778,4810,171,493,930,2414,1101,2907
431950,202104,1847,4768,1469,4144,376,1125,617,1679,993,2804
431960,202104,2956,7072,2215,5757,590,1647,623,1584,1213,3231
431970,202104,404,1010,172,502,35,115,48,115,83,230
431971,202104,85,206,37,110,4,16,7,12,11,28
431973,202104,467,1495,387,1339,36,125,280,970,316,1095
431975,202104,107,212,20,59,2,7,4,9,6,16
431980,202104,941,2432,726,2085,144,436,348,963,492,1399
431990,202104,5597,13237,3915,10827,430,1436,2130,5672,2560,7108
432000,202104,11425,26787,8383,22137,1931,5131,3695,9872,5626,15003
432010,202104,2343,5523,1678,4430,283,803,905,2252,1188,3055
432020,202104,1756,4538,1085,3107,225,670,388,1075,613,1745
432023,202104,512,1208,264,731,33,101,118,286,151,387
432026,202104,943,2583,697,2109,182,534,206,642,388,1176
432030,202104,358,871,208,569,15,44,123,325,138,369
432032,202104,334,842,229,631,23,70,131,329,154,399
432035,202104,649,1815,563,1669,172,483,247,779,419,1262
432040,202104,1050,2458,400,1224,57,190,151,416,208,606
432045,202104,153,435,100,324,20,62,37,123,57,185
432050,202104,530,1304,393,1071,80,225,169,473,249,698
432055,202104,567,1515,376,1165,128,403,68,198,196,601
432057,202104,183,498,146,398,12,31,71,182,83,213
432060,202104,427,1018,130,403,30,101,37,106,67,207
432065,202104,201,550,144,431,36,115,52,153,88,268
432067,202104,722,2050,613,1808,57,189,464,1321,521,1510
432070,202104,1666,4227,1118,3184,211,683,432,1109,643,1792
432080,202104,4797,11029,3656,9285,570,1707,1757,4238,2327,5945
432085,202104,365,970,261,808,58,188,120,378,178,566
432090,202104,1969,4834,1168,3294,192,586,558,1451,750,2037
432100,202104,973,2401,479,1426,103,327,84,203,187,530
432110,202104,2023,5237,1399,4135,325,1069,162,434,487,1503
432120,202104,2790,7400,2195,6425,377,1241,974,2684,1351,3925
432130,202104,2577,6416,2149,5790,631,1737,921,2521,1552,4258
432132,202104,179,512,110,359,21,70,54,153,75,223
432135,202104,976,2278,652,1733,40,124,474,1244,514,1368
432140,202104,1607,4716,1224,3950,176,612,755,2404,931,3016
432143,202104,1363,3514,1044,3036,60,194,693,1996,753,2190
432145,202104,1684,4391,1075,3133,157,486,350,880,507,1366
432146,202104,102,285,71,234,24,87,24,70,48,157
432147,202104,459,1263,278,890,91,316,69,194,160,510
432149,202104,441,1058,225,633,24,73,101,251,125,324
432150,202104,3169,7834,2352,6429,461,1351,1026,2723,1487,4074
432160,202104,4977,12797,3638,10694,824,2731,1305,3667,2129,6398
432162,202104,230,499,36,104,6,21,10,23,16,44
432163,202104,102,252,21,53,0,0,4,5,4,5
432166,202104,632,1724,503,1467,98,324,189,484,287,808
432170,202104,1502,3985,1029,3114,180,606,433,1239,613,1845
432180,202104,3097,7220,1687,4608,298,857,655,1561,953,2418
432183,202104,344,998,240,763,54,194,72,208,126,402
432185,202104,809,2075,470,1409,41,135,230,647,271,782
432190,202104,1947,4611,1335,3659,166,518,780,2005,946,2523
432195,202104,818,2065,553,1584,138,364,206,618,344,982
432200,202104,3322,8219,2423,6824,357,1035,1417,4009,1774,5044
432210,202104,390,1015,244,727,44,157,114,290,158,447
432215,202104,607,1770,553,1688,51,127,416,1299,467,1426
432218,202104,247,602,117,330,13,42,52,126,65,168
432220,202104,3507,8140,2595,6700,499,1293,1286,3318,1785,4611
432225,202104,91,253,70,213,9,23,41,132,50,155
432230,202104,721,1679,394,1077,44,124,177,428,221,552
432232,202104,467,1144,291,844,59,180,104,273,163,453
432234,202104,256,641,117,345,17,47,17,47,34,94
432235,202104,44,125,18,57,5,17,4,13,9,30
432237,202104,307,793,274,739,12,23,227,604,239,627
432240,202104,16006,38677,11693,32950,878,2466,7545,22229,8423,24695
432250,202104,5398,15122,4016,12397,1028,3300,1667,5121,2695,8421
432252,202104,413,981,266,717,32,90,142,362,174,452
432253,202104,856,2567,571,1845,141,486,52,153,193,639
432254,202104,695,1612,203,585,34,90,43,118,77,208
432255,202104,99,253,58,174,3,9,29,80,32,89
432260,202104,4862,12245,3632,9945,1003,2821,1287,3388,2290,6209
432270,202104,1875,5051,1521,4386,460,1436,392,1061,852,2497
432280,202104,1418,3487,760,2222,97,301,277,678,374,979
432285,202104,142,427,22,67,2,6,3,7,5,13
432290,202104,329,896,182,556,58,182,33,73,91,255
432300,202104,25795,63971,19352,53696,2582,8096,11539,30822,14121,38918
432310,202104,830,2188,601,1773,61,185,410,1211,471,1396
432320,202104,199,461,80,244,8,28,30,83,38,111
432330,202104,231,512,71,227,9,22,13,43,22,65
432335,202104,158,453,60,214,7,32,15,47,22,79
432340,202104,304,728,135,421,9,31,48,137,57,168
432345,202104,734,1609,633,1490,13,34,531,1227,544,1261
432350,202104,338,854,182,558,27,89,71,221,98,310
432360,202104,232,685,46,154,4,7,15,51,19,58
432370,202104,290,708,196,550,14,46,135,368,149,414
432375,202104,474,1169,358,944,73,190,172,453,245,643
432377,202104,171,549,35,128,6,25,3,5,9,30
432380,202104,1741,4578,1182,3575,178,590,629,1868,807,2458
500020,202104,2588,6613,1931,5534,208,670,1164,3246,1372,3916
500025,202104,1179,2874,753,2082,77,211,400,1071,477,1282
500060,202104,8025,22386,5520,17191,662,2144,3253,10345,3915,12489
500070,202104,4285,10870,3040,8747,556,1639,1346,3927,1902,5566
500080,202104,1639,3961,1011,2818,188,586,396,965,584,1551
500085,202104,1986,4909,1383,3883,347,1004,618,1672,965,2676
500090,202104,2174,5652,1474,4435,220,702,487,1579,707,2281
500100,202104,3590,9067,2739,7692,425,1337,1386,3668,1811,5005
500110,202104,8061,20254,5253,15928,1049,3503,1602,5736,2651,9239
500124,202104,2057,5911,1638,5214,281,821,854,2877,1135,3698
500150,202104,1345,2997,854,2287,128,366,357,928,485,1294
500190,202104,4922,12720,3171,9316,626,1834,814,2283,1440,4117
500200,202104,2521,5870,1777,4628,172,456,1081,2724,1253,3180
500210,202104,4663,10935,3307,9164,923,2461,1433,4129,2356,6590
500215,202104,1408,3814,1030,3141,100,338,583,1766,683,2104
500220,202104,2808,7708,1875,5956,296,982,583,1790,879,2772
500230,202104,2015,4641,1540,3985,179,441,1045,2680,1224,3121
500240,202104,4015,11633,2868,9255,427,1477,1207,3980,1634,5457
500260,202104,3334,7028,2155,5454,288,734,1178,2855,1466,3589
500270,202104,137607,320103,84599,231874,13094,39524,32958,84078,46052,123602
500280,202104,1382,3419,935,2741,155,467,440,1289,595,1756
500290,202104,3678,8829,2192,6232,325,1055,712,1779,1037,2834
500295,202104,3597,8564,2299,6286,383,1146,905,2152,1288,3298
500310,202104,998,2047,687,1662,94,204,368,916,462,1120
500315,202104,3835,10360,3077,9233,245,740,2238,6852,2483,7592
500320,202104,19613,51779,13627,41965,3471,11045,4499,14989,7970,26034
500325,202104,4605,10201,3212,8344,299,757,2094,5523,2393,6280
500330,202104,6642,14925,4402,11720,344,979,2354,6501,2698,7480
500345,202104,2070,5050,1387,3976,306,923,482,1364,788,2287
500348,202104,2379,6111,1786,5091,235,723,1036,2978,1271,3701
500350,202104,1317,3569,741,2325,81,247,288,872,369,1119
500370,202104,27119,68442,19546,56283,2323,7692,10624,30071,12947,37763
500375,202104,2466,6440,1663,4810,262,813,577,1533,839,2346
500380,202104,3343,8315,2336,6603,660,2010,456,1317,1116,3327
500390,202104,637,1330,390,1026,50,156,237,598,287,754
500400,202104,1554,3913,1035,2920,171,528,357,921,528,1449
500410,202104,2415,5850,1701,4795,170,448,968,2861,1138,3309
500430,202104,2619,6380,1814,5195,247,814,774,2352,1021,3166
500440,202104,1211,2911,766,2231,119,374,275,849,394,1223
500450,202104,1516,3702,883,2567,139,436,242,636,381,1072
500460,202104,3507,9323,2148,6662,339,1200,664,1999,1003,3199
500470,202104,2382,6339,1467,4475,397,1357,313,830,710,2187
500480,202104,2075,6325,1767,5857,159,528,1322,4440,1481,4968
500490,202104,1075,2455,639,1795,119,406,174,499,293,905
500500,202104,4230,11063,2727,8639,810,2998,317,1037,1127,4035
500510,202104,707,1762,472,1333,33,92,296,817,329,909
500515,202104,1689,4335,1302,3716,167,521,763,2065,930,2586
500520,202104,3280,9687,2557,8406,648,2097,1044,3786,1692,5883
500525,202104,937,2658,743,2376,64,224,484,1532,548,1756
500540,202104,4437,11462,2690,8370,649,2590,242,678,891,3268
500560,202104,5529,14797,4457,13462,289,854,3616,11132,3905,11986
500568,202104,4347,9439,2681,7016,698,1822,888,2424,1586,4246
500570,202104,7765,17873,4926,13146,810,2374,1996,4961,2806,7335
500580,202104,3064,8010,2250,6584,526,1576,976,2870,1502,4446
500600,202104,3405,8452,2450,6937,555,1626,1003,2911,1558,4537
500620,202104,7976,20592,5425,15793,1029,3171,2140,5964,3169,9135
500625,202104,539,1464,352,1081,73,233,86,243,159,476
500627,202104,769,1974,477,1458,91,298,139,395,230,693
500630,202104,7136,16007,4069,11015,817,2397,1153,3080,1970,5477
500635,202104,2980,9157,2280,8242,160,589,1571,6275,1731,6864
500640,202104,1705,3702,1137,2950,38,117,781,1995,819,2112
500660,202104,18164,45559,12586,37616,3763,12890,3293,10044,7056,22934
500690,202104,2437,6561,1550,5037,518,1978,106,274,624,2252
500710,202104,2764,7290,2139,6246,564,1779,695,1887,1259,3666
500720,202104,4861,12132,3213,9395,743,2322,978,2938,1721,5260
500730,202104,1110,2710,609,1797,124,347,136,428,260,775
500740,202104,4619,10979,3151,8684,422,1208,1531,4138,1953,5346
500750,202104,997,2502,693,1981,84,213,272,740,356,953
500755,202104,906,2301,508,1557,92,312,107,303,199,615
500769,202104,5202,12622,2952,8420,531,1645,427,1079,958,2724
500770,202104,1408,3779,938,2967,166,591,309,969,475,1560
500780,202104,1180,2817,765,2144,151,492,208,518,359,1010
500790,202104,6704,17800,5186,15260,1047,3318,2484,7340,3531,10658
500793,202104,2043,5150,1471,4182,346,1060,491,1273,837,2333
500795,202104,2691,6580,2159,5911,120,294,1700,4918,1820,5212
500797,202104,750,1894,482,1416,140,421,134,406,274,827
500800,202104,3323,7398,2051,5532,615,1981,251,746,866,2727
500830,202104,18096,44613,12508,34515,2591,7610,4465,11635,7056,19245
500840,202104,1407,3399,892,2428,120,326,361,923,481,1249
510010,202104,1817,4063,1240,3343,111,233,883,2428,994,2661
510020,202104,3889,9630,2043,6034,366,1177,505,1301,871,2478
510025,202104,6535,15607,4042,11675,576,1806,1777,4980,2353,6786
510030,202104,2784,6097,1852,4746,337,839,829,2089,1166,2928
510035,202104,1236,3204,792,2509,106,354,442,1502,548,1856
510040,202104,2394,5271,1779,4478,192,455,1098,2912,1290,3367
510050,202104,2123,4378,1422,3500,186,476,956,2331,1142,2807
510060,202104,1375,3419,870,2520,171,544,215,577,386,1121
510080,202104,1291,3324,846,2612,212,679,339,980,551,1659
510100,202104,661,1516,473,1221,57,147,268,666,325,813
510120,202104,276,498,154,354,9,19,113,260,122,279
510125,202104,1996,4949,1571,4333,148,535,876,2268,1024,2803
510130,202104,1518,3760,1053,3022,215,657,345,1017,560,1674
510140,202104,3070,7737,2080,6502,756,2677,733,2259,1489,4936
510160,202104,1705,4381,1263,3812,152,433,921,2854,1073,3287
510170,202104,4606,12026,3430,10134,823,2504,1356,4066,2179,6570
510180,202104,14757,32669,9626,25359,2005,5791,3089,9099,5094,14890
510185,202104,1745,4451,1117,3561,444,1455,244,1037,688,2492
510190,202104,2015,5697,1288,4490,352,1361,224,862,576,2223
510250,202104,17386,43133,12893,36408,2441,7187,6301,18489,8742,25676
510260,202104,1822,7729,1516,7199,249,1283,944,4862,1193,6145
510263,202104,3159,8756,1954,6292,308,1087,376,1065,684,2152
510267,202104,5154,14482,2956,9562,483,1702,430,1212,913,2914
510268,202104,1206,2952,934,2544,102,262,614,1676,716,1938
510269,202104,1010,2704,622,1966,142,496,196,578,338,1074
510270,202104,3014,8401,2065,6723,339,1256,831,2677,1170,3933
510279,202104,1744,4464,1051,3261,178,619,416,1210,594,1829
510285,202104,1117,2898,749,2269,230,790,174,466,404,1256
510300,202104,3677,9185,2727,7916,393,1166,1597,4890,1990,6056
510305,202104,1410,3867,875,2837,174,600,197,734,371,1334
510310,202104,906,2196,617,1723,175,491,180,526,355,1017
510320,202104,3575,8747,2471,6916,517,1634,545,1495,1062,3129
510325,202104,4140,12105,3037,10081,844,2972,842,2892,1686,5864
510330,202104,2591,7746,1742,6262,305,1111,634,2682,939,3793
510335,202104,4878,13857,3698,11971,556,1916,2052,6787,2608,8703
510336,202104,438,1220,316,1034,48,153,165,605,213,758
510337,202104,1437,4104,917,3175,351,1337,189,662,540,1999
510340,202104,92718,204703,60537,158899,14248,43477,18588,46525,32836,90002
510343,202104,1090,2869,719,2204,114,397,323,934,437,1331
510345,202104,1257,3562,948,2953,146,449,426,1307,572,1756
510350,202104,2868,7246,1933,5701,393,1210,851,2495,1244,3705
510360,202104,1987,3993,1233,3116,71,117,860,2368,931,2485
510370,202104,1701,4774,1261,4067,176,626,735,2479,911,3105
510380,202104,553,1344,316,950,47,165,135,401,182,566
510385,202104,1207,4015,906,3460,85,379,599,2368,684,2747
510390,202104,1292,3308,865,2791,273,877,273,1063,546,1940
510395,202104,723,1603,492,1265,24,62,317,863,341,925
510410,202104,4738,12898,3489,10761,662,2114,1755,5691,2417,7805
510420,202104,2523,5171,1699,4081,109,254,1142,2762,1251,3016
510450,202104,404,1009,243,707,68,205,29,99,97,304
510452,202104,803,2228,595,1854,77,258,352,1063,429,1321
510454,202104,948,2587,742,2239,78,227,467,1482,545,1709
510455,202104,946,2546,684,2039,105,333,298,832,403,1165
510460,202104,1781,4418,1301,3701,113,369,825,2271,938,2640
510480,202104,4753,11237,3213,8511,575,1681,1263,3204,1838,4885
510490,202104,1694,4333,1261,3790,238,695,758,2317,996,3012
510500,202104,1544,3776,950,2844,181,588,306,921,487,1509
510510,202104,3515,10001,2559,8334,616,2264,822,2822,1438,5086
510515,202104,5204,13110,3455,10030,753,2469,1035,2662,1788,5131
510517,202104,1038,2935,781,2500,239,865,146,426,385,1291
510520,202104,2204,4412,1240,3213,103,269,598,1668,701,1937
510523,202104,1167,2773,867,2325,154,411,537,1471,691,1882
510525,202104,7419,19992,5503,16272,810,2575,2647,7423,3457,9998
510530,202104,551,1407,405,1192,29,94,263,765,292,859
510550,202104,2264,6649,1657,5604,345,1230,781,2655,1126,3885
510558,202104,2363,6243,1720,5246,228,646,800,2699,1028,3345
510560,202104,1488,4223,912,3095,179,674,208,777,387,1451
510562,202104,5665,14232,4167,11659,957,2880,1418,4240,2375,7120
510590,202104,2997,7428,2205,6388,150,433,1615,4815,1765,5248
510600,202104,1371,3068,924,2421,156,406,453,1175,609,1581
510610,202104,2535,6065,1726,5029,173,572,1100,3201,1273,3773
510615,202104,2651,6510,1863,5264,278,840,1061,3036,1339,3876
510617,202104,1003,3005,786,2664,78,316,544,1886,622,2202
510618,202104,1203,3160,859,2591,187,617,391,1140,578,1757
510619,202104,754,1890,471,1411,66,191,117,333,183,524
510620,202104,1445,3247,678,1999,159,567,33,68,192,635
510621,202104,1553,4121,938,2943,199,694,288,822,487,1516
510622,202104,4696,12916,3220,9851,1012,3391,436,1225,1448,4616
510623,202104,2698,6664,1968,5515,462,1455,660,1830,1122,3285
510624,202104,1603,4089,794,2591,98,368,184,535,282,903
510625,202104,2991,7177,1637,4802,263,883,375,1121,638,2004
510626,202104,1417,3450,901,2637,226,770,209,626,435,1396
510627,202104,627,1597,347,1064,80,277,90,287,170,564
510628,202104,1433,3274,956,2657,212,621,355,983,567,1604
510629,202104,1589,4460,1149,3661,219,755,400,1279,619,2034
510630,202104,3403,9259,2014,6644,456,1599,369,1352,825,2951
510631,202104,573,1357,423,1133,13,30,324,895,337,925
510637,202104,3714,8672,2620,7083,627,1895,781,2138,1408,4033
510642,202104,5357,15065,4081,13156,930,3313,1866,6057,2796,9370
510645,202104,1010,1940,618,1459,184,391,254,642,438,1033
510650,202104,7054,17827,5595,16220,652,1679,3761,12212,4413,13891
510665,202104,1824,3920,1161,2879,255,590,419,1135,674,1725
510670,202104,431,917,249,657,31,84,129,345,160,429
510675,202104,6239,16949,4330,13451,1177,4040,867,2554,2044,6594
510677,202104,2140,5398,1476,4423,202,703,806,2355,1008,3058
510680,202104,690,1735,392,1183,68,232,99,247,167,479
510682,202104,1473,4232,1081,3600,369,1382,269,836,638,2218
510685,202104,470,1355,341,1103,51,169,177,568,228,737
510700,202104,4025,9487,2818,7845,251,756,2116,5894,2367,6650
510704,202104,10791,25185,7235,19217,1685,4781,1779,4604,3464,9385
510706,202104,2073,6093,1442,5043,286,1023,738,2802,1024,3825
510710,202104,2635,6460,1736,4784,374,1090,567,1491,941,2581
510715,202104,577,1229,415,1012,28,77,217,522,245,599
510718,202104,2333,5253,1384,3983,342,981,530,1838,872,2819
510719,202104,451,943,266,698,26,74,157,389,183,463
510720,202104,826,1933,560,1535,103,317,261,682,364,999
510724,202104,822,2217,570,1743,76,244,307,907,383,1151
510726,202104,1041,1890,551,1298,67,175,269,641,336,816
510729,202104,605,1398,285,810,34,112,72,223,106,335
510730,202104,2922,6965,1995,5571,240,778,1043,2800,1283,3578
510735,202104,1068,2965,814,2616,68,262,618,1972,686,2234
510740,202104,972,2388,635,1770,107,304,308,836,415,1140
510757,202104,478,1528,377,1373,109,443,151,517,260,960
510760,202104,43758,94976,26492,68968,5361,16028,8392,20086,13753,36114
510770,202104,4234,9476,2896,7786,196,487,2024,5673,2220,6160
510774,202104,343,851,241,696,35,105,125,372,160,477
510775,202104,619,1621,392,1250,89,309,78,232,167,541
510776,202104,508,1256,359,1000,72,207,141,389,213,596
510777,202104,1506,3970,1082,3434,129,425,727,2320,856,2745
510779,202104,698,1852,544,1612,54,151,319,1023,373,1174
510780,202104,3702,9415,2755,8069,655,1855,1214,4050,1869,5905
510785,202104,1957,5049,1153,3624,316,1070,188,681,504,1751
510787,202104,2657,7484,1802,5757,518,1725,219,735,737,2460
510788,202104,588,1367,408,1096,62,171,191,589,253,760
510790,202104,18045,45555,11548,34026,2648,8683,1878,5001,4526,13684
510792,202104,9160,25027,5768,18479,1188,4262,952,2798,2140,7060
510794,202104,1163,3106,819,2528,272,912,153,422,425,1334
510795,202104,8491,21842,5660,16850,1228,4034,1542,4493,2770,8527
510800,202104,1626,4110,1065,3195,319,966,136,388,455,1354
510805,202104,1490,4101,1062,3334,212,722,412,1216,624,1938
510810,202104,592,1194,373,905,102,247,138,363,240,610
510820,202104,763,1428,426,1011,30,88,223,538,253,626
510830,202104,839,1996,624,1728,38,97,469,1378,507,1475
510835,202104,554,1322,370,1063,46,151,226,632,272,783
510840,202104,57470,120106,39275,98041,7609,17851,19229,52918,26838,70769
510850,202104,1757,4182,1042,3074,311,1067,163,424,474,1491
510860,202104,2307,5967,1438,4522,441,1644,114,359,555,2003
510880,202104,734,2038,556,1711,133,439,198,604,331,1043
510885,202104,652,1533,427,1207,82,238,134,384,216,622
510890,202104,690,1980,517,1679,127,445,228,736,355,1181
510895,202104,1285,3231,842,2507,148,535,376,1048,524,1583
520005,202104,2831,7088,2197,6312,656,1904,865,2927,1521,4831
520010,202104,2362,6581,1716,5343,395,1365,571,1597,966,2962
520013,202104,3002,7435,1972,5589,455,1306,559,1747,1014,3053
520015,202104,508,1251,368,1049,85,234,150,457,235,691
520017,202104,1216,3011,903,2542,219,643,414,1139,633,1782
520020,202104,424,939,329,827,25,78,264,646,289,724
520025,202104,33291,91712,28492,85082,2831,8987,20452,60953,23283,69940
520030,202104,5634,14008,4530,12491,290,871,3289,9022,3579,9893
520050,202104,402,937,241,650,17,45,154,433,171,478
520055,202104,1839,4352,1209,3173,148,324,660,1740,808,2064
520060,202104,1455,3838,1082,3186,247,855,302,858,549,1713
520080,202104,1779,4614,1356,4037,244,738,666,2163,910,2901
520082,202104,942,2356,725,2001,77,213,384,1095,461,1308
520085,202104,871,2227,683,1938,125,376,334,941,459,1317
520090,202104,866,1702,605,1419,76,129,441,1100,517,1229
520110,202104,37053,98457,25753,79854,7433,26382,2412,6806,9845,33188
520120,202104,200,480,115,339,11,34,48,144,59,178
520130,202104,3816,9125,2993,7871,599,1620,1307,3518,1906,5138
520140,202104,39960,105002,27712,84405,9619,31945,3496,11133,13115,43078
520145,202104,605,1349,415,1096,69,204,241,584,310,788
520150,202104,632,1447,466,1247,73,207,242,652,315,859
520160,202104,752,1728,540,1399,107,269,215,608,322,877
520170,202104,4776,9604,3179,7788,172,492,2455,5977,2627,6469
520180,202104,2356,6277,1925,5654,329,1055,1045,3025,1374,4080
520215,202104,1723,4090,1230,3346,287,815,434,1138,721,1953
520235,202104,664,1488,414,1114,41,129,202,526,243,655
520250,202104,1521,3812,1084,3103,323,990,266,855,589,1845
520260,202104,821,1877,534,1440,98,257,210,577,308,834
520280,202104,756,1789,601,1559,110,284,295,833,405,1117
520310,202104,1004,2156,658,1648,141,397,253,670,394,1067
520320,202104,1640,4392,1241,3731,153,477,711,2123,864,2600
520330,202104,4287,11174,3181,9389,440,1506,1685,4850,2125,6356
520340,202104,2511,5443,1568,4150,181,448,920,2550,1101,2998
520350,202104,2741,6473,1967,5345,552,1596,792,2182,1344,3778
520355,202104,1887,5080,1355,4053,454,1442,219,563,673,2005
520357,202104,729,1715,528,1423,31,69,387,1087,418,1156
520360,202104,689,1784,533,1529,139,420,163,489,302,909
520380,202104,1420,3508,857,2490,104,309,394,1072,498,1381
520390,202104,1037,2267,613,1735,180,554,198,597,378,1151
520393,202104,476,1131,321,892,40,127,142,371,182,498
520396,202104,865,2176,724,1966,37,112,540,1445,577,1557
520400,202104,1591,3851,1229,3366,138,423,858,2333,996,2756
520410,202104,1940,4288,1229,3208,181,511,570,1402,751,1913
520420,202104,375,857,296,739,22,56,235,563,257,619
520425,202104,1492,3617,820,2346,216,657,149,430,365,1087
520430,202104,2309,5193,1325,3686,235,775,52,146,287,921
520440,202104,2854,6819,1725,4860,407,1259,444,1186,851,2445
520450,202104,11706,27325,7920,21764,2417,7350,1707,4879,4124,12229
520455,202104,693,1900,504,1612,140,460,136,470,276,930
520460,202104,1035,2363,808,2077,78,171,636,1678,714,1849
520465,202104,772,1938,629,1749,68,227,467,1259,535,1486
520470,202104,2069,5209,1577,4557,467,1428,592,1846,1059,3274
520480,202104,888,2408,620,1965,189,628,158,493,347,1121
520485,202104,1515,4309,1265,3973,149,473,907,2849,1056,3322
520490,202104,3984,10776,2993,9213,909,2956,1199,3775,2108,6731
520495,202104,1589,3466,1212,2956,61,147,970,2374,1031,2521
520500,202104,1254,3289,876,2576,185,585,389,1147,574,1732
520505,202104,778,1690,541,1395,64,166,352,911,416,1077
520510,202104,7302,17928,4937,14355,1040,3407,1547,4702,2587,8109
520520,202104,1174,2884,878,2433,198,598,331,913,529,1511
520530,202104,2116,5809,1628,4999,373,1236,762,2404,1135,3640
520540,202104,2917,7517,1908,5582,341,1090,536,1457,877,2547
520545,202104,970,2487,743,2116,160,426,327,961,487,1387
520547,202104,840,2254,686,2007,150,457,345,995,495,1452
520549,202104,13964,36390,11667,33196,1408,4199,8097,22883,9505,27082
520551,202104,4565,12069,3794,10932,395,1304,2706,7654,3101,8958
520552,202104,824,2092,677,1905,145,383,376,1145,521,1528
520570,202104,496,1107,335,872,80,173,124,375,204,548
520580,202104,2178,4916,1649,4293,130,390,1190,3051,1320,3441
520590,202104,1228,3014,852,2411,264,757,240,691,504,1448
520620,202104,7827,20963,6203,18579,1452,4537,2933,9051,4385,13588
520630,202104,719,1838,522,1490,83,262,194,520,277,782
520640,202104,2364,5713,1804,4761,416,1079,778,2136,1194,3215
520650,202104,980,2152,698,1759,113,291,369,988,482,1279
520660,202104,536,1297,292,865,45,146,84,261,129,407
520670,202104,931,2499,786,2292,60,185,533,1529,593,1714
520680,202104,674,1693,513,1438,77,216,271,772,348,988
520690,202104,299,691,206,555,63,159,61,184,124,343
520710,202104,394,969,287,795,16,41,197,534,213,575
520725,202104,1464,3427,1011,2697,108,337,647,1671,755,2008
520735,202104,756,1844,498,1414,104,276,197,602,301,878
520740,202104,2236,4875,1710,4274,323,728,959,2662,1282,3390
520750,202104,666,1575,462,1252,80,221,213,567,293,788
520753,202104,1211,3258,923,2720,159,499,371,1025,530,1524
520760,202104,1205,2692,1060,2516,30,55,970,2337,1000,2392
520780,202104,1486,3447,1069,2870,119,303,557,1500,676,1803
520790,202104,3481,8181,2456,6542,354,969,1292,3590,1646,4559
520800,202104,16265,41593,12778,36491,1770,5217,7710,22598,9480,27815
520810,202104,1275,2675,963,2321,151,367,625,1601,776,1968
520815,202104,534,1613,407,1353,77,265,119,401,196,666
520830,202104,1886,3925,1338,3301,64,127,1093,2693,1157,2820
520840,202104,2661,7037,2164,6386,844,2744,594,1857,1438,4601
520850,202104,651,1605,485,1369,147,487,146,413,293,900
520860,202104,6710,17753,4961,14935,1283,4179,1866,5481,3149,9660
520870,202104,108731,249575,74210,198471,15407,44550,27503,72152,42910,116702
520880,202104,6783,19236,5262,16527,1127,3707,1969,6207,3096,9914
520890,202104,4033,9459,2798,7552,485,1457,1307,3446,1792,4903
520910,202104,4611,11435,2973,8649,684,2166,730,2062,1414,4228
520915,202104,702,1947,414,1304,76,253,135,407,211,660
520920,202104,4470,9868,3168,8266,427,1139,1639,4530,2066,5669
520929,202104,679,1596,520,1371,53,116,298,839,351,955
520940,202104,946,2476,743,2192,51,116,562,1661,613,1777
520945,202104,518,1109,380,930,15,37,259,624,274,661
520960,202104,1078,2514,846,2176,244,563,386,1072,630,1635
520970,202104,2500,6704,1961,5850,421,1440,535,1718,956,3158
520980,202104,769,1862,567,1591,100,290,234,645,334,935
520990,202104,3005,7836,2411,7085,335,921,1613,4836,1948,5757
520993,202104,1144,2649,790,2105,134,395,422,1083,556,1478
520995,202104,2333,5840,1751,5023,256,746,718,2153,974,2899
521000,202104,8650,22373,5706,17028,1069,3287,1681,4939,2750,8226
521010,202104,3536,9113,2651,7591,247,707,1562,4451,1809,5158
521015,202104,779,1924,544,1509,41,138,344,907,385,1045
521020,202104,3323,8317,1977,5748,557,1824,159,486,716,2310
521030,202104,504,1098,342,855,63,139,154,412,217,551
521040,202104,7419,17975,5469,14942,1175,3350,2215,6247,3390,9597
521056,202104,917,2371,712,2073,230,655,199,655,429,1310
521060,202104,966,2583,716,2110,121,371,278,816,399,1187
521080,202104,1100,2347,570,1528,81,239,245,577,326,816
521090,202104,3133,8316,2105,6277,529,1721,258,803,787,2524
521100,202104,1729,3973,1283,3340,211,527,790,2098,1001,2625
521120,202104,4569,10802,3394,9352,179,461,1676,5395,1855,5856
521130,202104,993,2194,571,1493,18,49,294,816,312,865
521140,202104,1332,3384,997,2804,101,289,536,1514,637,1803
521150,202104,12260,26624,7711,20174,1298,3886,3621,9749,4919,13635
521160,202104,625,1290,448,1041,71,138,283,654,354,792
521170,202104,1031,2393,763,2001,59,165,497,1266,556,1431
521180,202104,7322,19798,6035,17631,967,3035,3172,9041,4139,12076
521190,202104,10757,26284,6374,19100,1576,5041,1291,4128,2867,9169
521200,202104,699,1661,494,1340,43,121,311,838,354,959
521205,202104,639,1545,488,1305,18,51,380,978,398,1029
521210,202104,655,1665,389,1147,68,211,88,205,156,416
521220,202104,3477,8313,2274,6477,360,1140,935,2684,1295,3824
521225,202104,388,808,280,687,58,137,156,394,214,531
521230,202104,1338,3342,1177,3149,349,932,595,1733,944,2665
521250,202104,30790,80282,24098,70573,8625,26119,7146,22660,15771,48779
521260,202104,527,1216,390,1003,61,159,226,567,287,726
521270,202104,1779,4422,1552,4158,77,178,1208,3262,1285,3440
521280,202104,1759,4666,1314,3921,302,979,562,1696,864,2675
521290,202104,488,1121,343,940,42,129,218,583,260,712
521295,202104,1094,2378,857,2126,66,111,718,1843,784,1954
521300,202104,1906,4604,1500,4033,282,701,912,2569,1194,3270
521305,202104,717,1667,518,1385,82,203,297,809,379,1012
521308,202104,4744,12494,3302,9806,286,841,1965,5723,2251,6564
521310,202104,8344,21103,5954,17136,1167,3685,2667,7338,3834,11023
521340,202104,406,939,295,778,23,63,197,515,220,578
521350,202104,2014,5034,1538,4335,126,416,1109,3013,1235,3429
521370,202104,1216,3053,734,2240,208,730,92,317,300,1047
521375,202104,1236,2978,849,2419,183,526,262,854,445,1380
521377,202104,1513,3170,1122,2698,110,177,888,2265,998,2442
521380,202104,6207,16182,4040,12250,433,1420,1058,3451,1491,4871
521385,202104,659,1560,519,1384,49,124,300,862,349,986
521390,202104,703,1701,494,1402,146,464,166,499,312,963
521400,202104,2628,6037,2070,5371,219,541,1440,3841,1659,4382
521405,202104,1318,3344,955,2710,153,456,495,1386,648,1842
521410,202104,775,2069,576,1724,93,268,287,913,380,1181
521440,202104,1106,2720,796,2263,263,831,222,643,485,1474
521450,202104,3917,11433,2867,9422,771,2508,651,2369,1422,4877
521460,202104,5505,14168,3879,11325,1192,3648,1025,3049,2217,6697
521470,202104,659,1724,415,1257,58,168,160,487,218,655
521480,202104,371,924,228,658,54,148,74,216,128,364
521483,202104,2352,5513,1644,4464,328,931,703,1912,1031,2843
521486,202104,1789,4263,1360,3666,89,217,965,2630,1054,2847
521487,202104,401,949,283,790,41,109,154,446,195,555
521490,202104,907,2371,683,2004,34,123,477,1356,511,1479
521500,202104,2210,5306,1658,4491,101,329,1204,3173,1305,3502
521520,202104,706,1625,504,1336,74,200,210,566,284,766
521523,202104,11867,35470,9730,32097,2668,9582,2638,8975,5306,18557
521525,202104,1062,2385,810,2042,73,191,586,1473,659,1664
521530,202104,2268,5775,1399,4058,293,847,391,1142,684,1989
521540,202104,821,2036,570,1644,76,244,278,836,354,1080
521550,202104,1608,4040,897,2618,166,548,218,649,384,1197
521560,202104,4345,11230,2964,9376,442,1610,1489,5053,1931,6663
521565,202104,645,1522,488,1301,67,164,300,794,367,958
521570,202104,3259,8921,2248,6967,449,1642,163,538,612,2180
521580,202104,485,1152,288,826,39,117,97,260,136,377
521590,202104,622,1444,459,1222,74,211,277,723,351,934
521600,202104,415,1097,272,820,29,69,125,384,154,453
521630,202104,1662,3576,1034,2687,216,603,346,876,562,1479
521640,202104,1905,4364,1256,3424,252,721,459,1243,711,1964
521645,202104,555,1409,362,1066,77,207,114,335,191,542
521680,202104,1062,3196,814,2722,233,851,135,502,368,1353
521690,202104,548,1304,457,1191,61,172,288,740,349,912
521710,202104,3207,7819,2096,6048,367,1207,589,1560,956,2767
521720,202104,2151,4894,1394,3763,148,448,779,2117,927,2565
521730,202104,3533,9631,2720,8267,723,2606,815,2070,1538,4676
521740,202104,3842,9822,2919,8512,668,2103,1085,3323,1753,5426
521760,202104,14817,39630,11490,34630,2690,8876,4383,14095,7073,22971
521770,202104,3081,7177,2019,5520,570,1701,532,1493,1102,3194
521800,202104,6528,17105,4763,14231,1023,3103,1996,6484,3019,9587
521805,202104,626,1403,462,1189,138,327,183,521,321,848
521810,202104,617,1429,439,1192,58,153,270,746,328,899
521830,202104,5498,15006,4377,13298,264,977,3209,9553,3473,10530
521839,202104,786,1853,566,1485,87,270,325,763,412,1033
521850,202104,5560,12693,3541,9772,725,2174,646,1775,1371,3949
521860,202104,1492,3925,1035,3116,177,579,342,985,519,1564
521870,202104,685,1896,497,1536,98,347,129,349,227,696
521878,202104,689,1748,487,1354,56,179,275,695,331,874
521880,202104,18398,44503,12620,35620,3290,9735,4369,12491,7659,22226
521890,202104,3099,7959,2072,6163,554,1808,428,1152,982,2960
521900,202104,1472,3411,828,2417,247,699,74,221,321,920
521910,202104,1297,2725,874,2230,81,191,501,1387,582,1578
521920,202104,488,1304,358,1087,58,200,165,480,223,680
521925,202104,753,1918,548,1612,81,258,308,906,389,1164
521930,202104,5413,12784,3585,10067,942,2493,1330,4218,2272,6711
521935,202104,1065,2496,722,1912,68,190,414,1050,482,1240
521940,202104,1304,2786,832,2162,184,543,349,876,533,1419
521945,202104,646,1691,513,1467,96,284,277,817,373,1101
521950,202104,760,1829,531,1471,116,333,228,617,344,950
521960,202104,731,1873,488,1420,47,155,265,726,312,881
521970,202104,2517,6113,2007,5507,164,426,1537,4293,1701,4719
521971,202104,740,1740,523,1412,146,373,134,375,280,748
521973,202104,1456,3705,1195,3356,48,103,975,2749,1023,2852
521975,202104,11923,31037,9800,28119,1677,4869,6047,17501,7724,22370
521980,202104,2539,5882,1958,5118,145,370,1487,3985,1632,4355
521990,202104,1048,2935,846,2574,183,592,319,961,502,1553
522000,202104,2676,6869,2124,6196,372,1097,1224,3756,1596,4853
522005,202104,316,756,234,632,48,135,110,297,158,432
522010,202104,4029,9701,2877,7860,569,1701,1152,3063,1721,4764
522015,202104,1032,2651,759,2229,238,659,283,883,521,1542
522020,202104,5545,12920,3607,9898,751,2203,1377,3958,2128,6161
522026,202104,762,2007,517,1582,90,299,181,511,271,810
522028,202104,424,1040,314,859,68,193,131,359,199,552
522040,202104,3206,7070,2303,5870,263,743,1598,3984,1861,4727
522045,202104,17229,47068,12832,39423,2970,9816,3600,10798,6570,20614
522050,202104,1145,2935,793,2325,178,571,295,782,473,1353
522060,202104,2962,7650,2082,6206,200,599,1186,3652,1386,4251
522068,202104,1785,4482,1425,4056,108,267,1137,3288,1245,3555
522070,202104,673,1596,550,1419,12,34,477,1212,489,1246
522100,202104,718,1803,490,1458,68,223,254,726,322,949
522108,202104,1073,2572,841,2242,52,135,680,1782,732,1917
522119,202104,1676,3974,1306,3498,191,524,727,2062,918,2586
522130,202104,421,1059,299,892,23,67,215,662,238,729
522140,202104,19474,50006,13721,39931,3369,10486,3902,10871,7271,21357
522145,202104,768,1879,524,1515,143,402,192,565,335,967
522150,202104,1082,2610,769,2101,199,555,223,643,422,1198
522155,202104,1099,2724,855,2354,168,393,482,1398,650,1791
522157,202104,632,1430,519,1291,26,73,417,1052,443,1125
522160,202104,5832,14877,3800,11201,1021,3246,316,1029,1337,4275
522170,202104,2538,6446,1917,5545,282,825,1093,3229,1375,4054
522180,202104,556,1290,351,911,58,158,88,244,146,402
522185,202104,20131,48712,14322,40771,5419,16970,3042,9329,8461,26299
522190,202104,748,1758,512,1359,102,265,198,523,300,788
522200,202104,1612,4503,1093,3550,221,782,214,662,435,1444
522205,202104,1717,3964,1289,3374,151,412,783,2051,934,2463
522220,202104,1303,3133,962,2629,110,298,590,1649,700,1947
522230,202104,1162,2874,924,2546,189,624,473,1245,662,1869
530010,202104,170874,453535,138599,406863,19897,63822,83891,242272,103788,306094
110001,202103,3991,10995,2689,8585,604,2081,1010,3293,1614,5374
110002,202103,13023,33357,9497,27436,2574,7911,2567,7544,5141,15455
110003,202103,587,1729,438,1419,115,388,125,379,240,767
110004,202103,11864,30329,8014,23651,1628,5184,2365,7071,3993,12255
110005,202103,2502,6411,1742,5189,345,1110,469,1522,814,2632
110006,202103,1741,4822,1089,3447,184,652,221,682,405,1334
110007,202103,1241,3141,795,2404,245,803,194,718,439,1521
110008,202103,3363,9032,2502,7759,279,820,1637,5472,1916,6292
110009,202103,4347,12035,2832,9310,581,2039,1134,3772,1715,5811
110010,202103,7901,24575,5804,20530,1123,4044,2852,10959,3975,15003
110011,202103,7116,18679,4809,14524,1585,5083,643,2033,2228,7116
110012,202103,15568,38666,9325,27793,2008,6612,789,2543,2797,9155
110013,202103,5284,15106,3712,11937,1445,4944,433,1564,1878,6508
110014,202103,3930,10200,2733,7958,545,1685,1197,3386,1742,5071
110015,202103,5743,14599,3470,10261,735,2396,866,2335,1601,4731
110018,202103,3768,9419,2184,6642,391,1384,570,1740,961,3124
110020,202103,74505,176426,54069,148768,12007,34186,21932,66928,33939,101114
110025,202103,5276,12605,3568,9707,664,1932,1643,4454,2307,6386
110026,202103,535,1331,385,1115,88,295,153,469,241,764
110028,202103,6995,17480,4267,12645,998,3255,602,1796,1600,5051
110029,202103,1539,3732,894,2601,186,556,326,1000,512,1556
110030,202103,12708,28891,7831,21724,1608,5155,1320,4100,2928,9255
110032,202103,3240,9003,1956,6290,619,1981,368,1317,987,3298
110033,202103,3496,10732,2648,9211,950,3331,670,2623,1620,5954
110034,202103,3316,7694,2204,6171,671,2128,715,2188,1386,4316
110037,202103,1662,4847,1241,4100,291,950,576,1977,867,2927
110040,202103,2941,8076,2139,6619,582,1960,694,2098,1276,4058
110045,202103,4872,13874,3586,11516,913,3156,1199,3983,2112,7139
110050,202103,1831,4916,1295,3989,490,1696,202,623,692,2319
110060,202103,882,2596,604,1938,184,641,89,283,273,924
110070,202103,1506,4691,1105,3814,332,1225,225,713,557,1938
110080,202103,6317,14596,4755,12747,678,1681,3090,8872,3768,10553
110090,202103,578,1541,396,1218,85,285,174,531,259,816
110092,202103,1206,3449,860,2804,146,487,426,1510,572,1997
110094,202103,2788,8243,2080,6861,838,2950,238,834,1076,3784
110100,202103,1676,4925,1343,4279,360,1218,552,1800,912,3018
110110,202103,1740,4698,1245,3900,425,1377,248,883,673,2260
110120,202103,1310,3739,1003,3141,233,800,347,1059,580,1859
110130,202103,2821,7019,1693,4867,163,493,224,571,387,1064
110140,202103,2050,5979,1406,4670,317,1110,412,1419,729,2529
110143,202103,1352,3673,960,2903,277,841,161,491,438,1332
110145,202103,885,2288,544,1659,115,359,214,677,329,1036
110146,202103,474,1214,338,1005,75,197,158,517,233,714
110147,202103,760,1969,487,1447,59,200,190,494,249,694
110148,202103,754,2064,449,1461,122,466,61,186,183,652
110149,202103,3093,8297,2132,6760,712,2392,467,1582,1179,3974
110150,202103,2803,6797,1819,5383,524,1714,441,1576,965,3290
110155,202103,741,2160,523,1643,119,400,170,497,289,897
110160,202103,1477,4519,1088,3660,299,1030,265,925,564,1955
110170,202103,2142,5433,1345,3958,232,720,704,2003,936,2723
110175,202103,1828,5145,1257,4008,181,601,511,1727,692,2328
110180,202103,1457,3916,1030,3061,137,445,548,1594,685,2039
120001,202103,3302,9604,2700,8717,451,1534,1674,5528,2125,7062
120005,202103,1964,7360,1790,7118,148,653,1441,5813,1589,6466
120010,202103,5402,15848,4582,14641,422,1287,3378,11142,3800,12429
120013,202103,2122,7328,1865,7021,388,1384,1199,4824,1587,6208
120017,202103,2540,7991,2225,7518,370,1255,1384,4969,1754,6224
120020,202103,15287,57705,14097,55442,1016,4452,11314,44805,12330,49257
120025,202103,3179,8803,2553,8058,351,1089,1799,5876,2150,6965
120030,202103,6390,25214,5921,24345,429,2148,4573,19022,5002,21170
120032,202103,1762,7633,1680,7487,95,596,1423,6223,1518,6819
120033,202103,4152,15155,3909,14723,110,650,3441,12784,3551,13434
120034,202103,2726,9732,2339,9066,98,567,1956,7484,2054,8051
120035,202103,3803,14644,3608,14310,274,1294,2994,11859,3268,13153
120038,202103,2682,8495,2274,7832,501,1781,1233,4343,1734,6124
120039,202103,2034,8699,1907,8456,111,697,1550,6824,1661,7521
120040,202103,44119,136527,37598,126091,5041,17843,23679,80576,28720,98419
120042,202103,3399,12365,3167,11945,120,642,2709,10118,2829,10760
120043,202103,1448,5810,1321,5613,32,196,1217,5175,1249,5371
120045,202103,6127,15637,5306,14720,127,514,4817,13207,4944,13721
120050,202103,9346,33537,8571,32357,364,1889,7232,27399,7596,29288
120060,202103,9528,37125,8723,35954,356,2204,7621,31150,7977,33354
120070,202103,3219,10133,2788,9560,258,873,2020,7182,2278,8055
120080,202103,4375,13675,3903,12979,452,1544,2896,9853,3348,11397
130002,202103,3176,12048,2843,11573,192,740,2438,10127,2630,10867
130006,202103,2496,9064,2079,8326,161,636,1599,6455,1760,7091
130008,202103,2722,9441,2421,9004,62,316,2116,7874,2178,8190
130010,202103,4004,11533,3373,10823,76,197,3086,10082,3162,10279
130014,202103,3341,9572,2587,8380,425,1389,1599,5292,2024,6681
130020,202103,2943,11182,2628,10698,111,645,2198,8899,2309,9544
130030,202103,10476,33048,9574,32006,366,1010,8543,29152,8909,30162
130040,202103,4202,12078,3469,11110,219,638,2842,9256,3061,9894
130050,202103,7577,27703,6338,26088,177,847,5728,23868,5905,24715
130060,202103,7777,30094,6679,28693,411,2136,5598,24068,6009,26204
130063,202103,6534,21008,5842,20250,194,822,5334,18592,5528,19414
130068,202103,3959,13398,3366,12573,186,1034,2588,9556,2774,10590
130070,202103,7654,21156,6290,19672,286,803,5201,16873,5487,17676
130080,202103,7442,26062,6544,25035,247,1275,5632,21928,5879,23203
130083,202103,2775,8970,2465,8591,136,544,2098,7377,2234,7921
130090,202103,3595,10996,3197,10510,49,208,2863,9604,2912,9812
130100,202103,8165,24260,6928,22979,76,147,6532,22245,6608,22392
130110,202103,8585,24297,7050,22411,1058,2689,5039,17410,6097,20099
130115,202103,5215,16219,4493,15409,97,335,3997,13909,4094,14244
130120,202103,14130,49675,12433,47440,1059,4424,10103,39003,11162,43427
130130,202103,5624,17236,4341,15575,383,1401,3306,12073,3689,13474
130140,202103,7364,25431,6458,24398,177,1022,5670,21529,5847,22551
130150,202103,3657,13668,3435,13422,65,414,3174,12440,3239,12854
130160,202103,5220,18303,4497,17391,284,1077,3809,15143,4093,16220
130165,202103,3256,12189,3064,11957,122,523,2773,10920,2895,11443
130170,202103,11776,33899,9530,31295,698,2466,7699,25820,8397,28286
130180,202103,4502,14459,4275,14205,44,213,4126,13689,4170,13902
130185,202103,18527,45355,15142,41753,1017,1815,12675,37209,13692,39024
130190,202103,18948,62025,15251,56574,1646,6148,10876,41870,12522,48018
130195,202103,2494,8941,2010,8293,74,423,1696,6987,1770,7410
130200,202103,2664,7328,2182,6712,93,356,1848,5656,1941,6012
130210,202103,1371,5113,1243,4963,97,567,1021,3954,1118,4521
130220,202103,2258,7722,1923,7297,44,249,1717,6533,1761,6782
130230,202103,4933,19430,4300,18537,206,1263,3763,16166,3969,17429
130240,202103,12532,37097,10201,34041,158,901,9230,30840,9388,31741
130250,202103,26559,78267,22807,74061,1590,4643,18502,62463,20092,67106
130255,202103,4662,15102,4073,14080,135,578,3348,11606,3483,12184
130260,202103,260088,714112,211762,646024,57358,184904,96429,307123,153787,492027
130270,202103,9908,34394,8230,31796,1383,5227,5272,21407,6655,26634
130280,202103,3597,14284,3311,13969,76,389,3106,13245,3182,13634
130290,202103,13419,43810,11669,41596,646,2352,9878,36022,10524,38374
130300,202103,4860,16501,4420,15907,138,749,3886,13948,4024,14697
130310,202103,6489,21202,5636,20113,268,1165,4848,17323,5116,18488
130320,202103,3421,11122,2843,10358,376,1328,2082,7877,2458,9205
130330,202103,4672,14837,3770,13753,204,907,3227,11788,3431,12695
130340,202103,24251,73197,20903,69420,1468,4000,17578,60471,19046,64471
130350,202103,4026,14387,3629,13888,147,761,3206,12223,3353,12984
130353,202103,7536,20066,6041,18199,761,2168,4344,13643,5105,15811
130356,202103,5319,16645,4411,15260,780,2604,2661,9838,3441,12442
130360,202103,2927,9666,2542,9135,83,367,2247,8037,2330,8404
130370,202103,5739,22678,5001,21631,322,1734,4000,17329,4322,19063
130380,202103,7391,30534,6877,29799,391,2157,5878,25289,6269,27446
130390,202103,5795,24356,5144,23281,553,2749,3912,17881,4465,20630
130395,202103,2377,7456,2059,6959,181,618,1614,5512,1795,6130
130400,202103,2849,8648,2446,8119,101,296,2189,7408,2290,7704
130406,202103,11003,37708,9206,35554,1711,6575,6130,24782,7841,31357
130410,202103,4414,15320,3781,14266,1093,4324,1729,6738,2822,11062
130420,202103,13880,47764,11564,44871,985,4582,8960,35141,9945,39723
130423,202103,4391,13603,3843,12984,191,805,3374,11333,3565,12138
130426,202103,2765,10988,2574,10765,61,339,2385,10047,2446,10386
130430,202103,4364,12069,3769,11290,225,810,3235,9588,3460,10398
130440,202103,4974,15318,4217,14415,76,342,3922,13480,3998,13822
140002,202103,2236,6528,1946,6180,92,346,1648,5314,1740,5660
140005,202103,3294,9136,2866,8639,142,372,2434,7570,2576,7942
140010,202103,55433,146400,44527,130402,10942,33882,18920,56848,29862,90730
140015,202103,3896,11411,3324,10717,228,698,2887,9511,3115,10209
140017,202103,4415,12135,3830,11393,254,670,3153,9693,3407,10363
140020,202103,5336,15278,4613,14341,241,954,3810,11780,4051,12734
140023,202103,2504,7405,2054,6760,203,666,1559,5272,1762,5938
140028,202103,2008,5152,1704,4772,80,254,1380,3868,1460,4122
140030,202103,5412,13597,4810,12907,332,619,4222,11720,4554,12339
140040,202103,2671,10190,2471,9929,82,507,2270,8980,2352,9487
140045,202103,2591,9512,2161,8916,355,1257,1416,6382,1771,7639
140047,202103,6356,17825,5341,16381,562,1751,3878,12090,4440,13841
140050,202103,1459,4231,1238,3920,114,335,940,3091,1054,3426
140060,202103,1730,4450,1506,4134,109,269,1235,3470,1344,3739
140070,202103,1902,9809,1839,9686,111,787,1566,8154,1677,8941
150010,202103,45590,113754,41180,108103,986,2194,36930,97111,37916,99305
150013,202103,2003,5012,1686,4676,149,267,1332,3956,1481,4223
150020,202103,14573,43264,13469,41842,1832,4717,10499,34157,12331,38874
150030,202103,8875,33084,8068,32096,497,2002,6972,28110,7469,30112
150034,202103,4317,10351,3538,9400,238,542,2946,8033,3184,8575
150040,202103,16337,42328,14397,40181,1299,1979,12037,36579,13336,38558
150050,202103,7043,24216,6439,23428,126,547,5934,21805,6060,22352
150060,202103,22248,59656,17915,53258,2741,8301,11559,35146,14300,43447
150070,202103,6985,25514,6138,24493,245,1091,5478,22100,5723,23191
150080,202103,93224,207930,77207,186102,19601,51880,20141,59960,39742,111840
150085,202103,8057,22791,7339,21946,113,351,6886,20761,6999,21112
150090,202103,10141,36302,9569,35199,797,2741,7687,28721,8484,31462
150095,202103,5790,16421,5074,15538,286,583,4347,13882,4633,14465
150100,202103,2861,9906,2525,9356,219,686,1986,7604,2205,8290
150110,202103,4425,17898,4111,17545,175,788,3793,16317,3968,17105
150120,202103,8254,25368,7832,24880,276,679,6981,22839,7257,23518
150125,202103,779,2005,576,1729,98,358,347,1026,445,1384
150130,202103,22528,64345,19470,59742,3661,10059,12100,39937,15761,49996
150140,202103,268122,605369,226415,548624,34014,78715,130325,328800,164339,407515
150145,202103,4294,13286,3626,12231,1014,3181,1726,6637,2740,9818
150150,202103,16406,41322,14294,38685,550,1637,11954,32289,12504,33926
150157,202103,3600,9651,2892,8743,303,873,2037,6471,2340,7344
150160,202103,3057,8807,2848,8506,522,1438,1794,5616,2316,7054
150170,202103,24803,79709,21753,74627,3974,12807,13217,48558,17191,61365
150172,202103,5119,13717,4111,12310,285,720,3093,9640,3378,10360
150175,202103,1679,5178,1410,4679,253,878,815,2741,1068,3619
150178,202103,10351,27723,8633,25737,205,481,7751,23469,7956,23950
150180,202103,22743,79157,20540,76655,1257,3652,17971,69174,19228,72826
150190,202103,6869,22306,6391,21727,200,843,5780,19588,5980,20431
150195,202103,5089,16105,4794,15651,104,478,4365,14118,4469,14596
150200,202103,5896,17147,5390,16590,59,155,5097,15798,5156,15953
150210,202103,26724,90846,25006,88629,1725,5727,20669,75919,22394,81646
150215,202103,8170,22782,7098,21218,1185,3453,4303,13363,5488,16816
150220,202103,12831,35356,11214,33068,1112,3019,7762,23526,8874,26545
150230,202103,12699,35502,11269,33600,1290,3430,7655,23953,8945,27383
150240,202103,32841,89542,27345,80386,6981,21044,9903,29457,16884,50501
150250,202103,4311,16093,4010,15759,586,2235,3139,12652,3725,14887
150260,202103,2787,8823,2515,8418,133,416,2056,6974,2189,7390
150270,202103,9099,25513,6412,20712,1983,6762,1506,5255,3489,12017
150275,202103,7044,21907,6422,21040,235,829,5541,18153,5776,18982
150276,202103,2394,6233,2070,5847,261,653,1382,4388,1643,5041
150277,202103,5195,13470,4160,12261,320,853,3151,9921,3471,10774
150280,202103,7037,27764,6788,27368,454,1780,5861,23889,6315,25669
150285,202103,3278,11413,2886,10806,273,997,2094,8047,2367,9044
150290,202103,10382,27968,9377,26900,297,574,8486,24995,8783,25569
150293,202103,9281,22737,7189,20013,920,2551,4489,13165,5409,15716
150295,202103,7512,20207,5506,17469,1793,6045,1873,6855,3666,12900
150300,202103,2372,7068,2147,6789,34,120,1977,6284,2011,6404
150304,202103,4215,12242,3494,11148,604,1778,2156,7301,2760,9079
150307,202103,6125,19422,5644,18632,296,996,4600,15323,4896,16319
150309,202103,6427,18766,5177,16649,857,2732,2963,9970,3820,12702
150310,202103,7472,29326,7144,28941,200,1054,6412,26241,6612,27295
150320,202103,9318,25238,8515,24075,375,1116,6677,18859,7052,19975
150330,202103,13862,43975,12834,42396,1172,3546,9714,33229,10886,36775
150340,202103,2567,7431,2279,7003,344,989,1555,4971,1899,5960
150345,202103,8271,23657,7431,22551,416,1296,6354,19362,6770,20658
150350,202103,8988,22382,8307,21512,662,1220,6880,18354,7542,19574
150360,202103,24299,65761,19477,59705,2105,4901,13755,45438,15860,50339
150370,202103,11059,32878,9126,30281,1060,2894,6598,23730,7658,26624
150375,202103,3694,14702,3346,14213,218,1049,2886,12353,3104,13402
150380,202103,11334,28578,9341,25982,112,427,8306,23089,8418,23516
150390,202103,7824,31096,7028,29888,1066,3923,5041,22816,6107,26739
150400,202103,6718,23670,6445,23165,256,896,5684,20536,5940,21432
150405,202103,9298,24172,8121,22773,506,1042,6587,19142,7093,20184
150410,202103,1969,6056,1676,5565,267,739,1033,3617,1300,4356
150420,202103,40114,109121,30872,95702,8422,27293,10860,39319,19282,66612
150430,202103,8696,24650,7917,23649,954,1978,6132,19380,7086,21358
150440,202103,5790,18028,5241,17274,1008,2902,3341,11882,4349,14784
150442,202103,26999,62663,22320,56907,2345,5765,15527,40481,17872,46246
150445,202103,6357,19344,5588,18191,207,666,4793,15682,5000,16348
150450,202103,5254,21950,4853,21421,373,1817,4105,18177,4478,19994
150460,202103,8443,27464,7721,26546,222,818,6678,23792,6900,24610
150470,202103,21431,55495,19121,52878,330,942,18039,49889,18369,50831
150475,202103,4969,15353,4267,14315,226,734,3510,11986,3736,12720
150480,202103,13829,43700,12413,41630,2305,6730,8208,29649,10513,36379
150490,202103,8488,29144,7780,28275,324,1218,6797,24924,7121,26142
150495,202103,5362,17942,5128,17620,107,509,4685,16021,4792,16530
150497,202103,2798,8831,2250,7896,484,1740,1198,4510,1682,6250
150500,202103,3368,8443,2995,7926,285,685,2266,6017,2551,6702
150503,202103,4737,12000,3249,10073,942,3172,1032,3698,1974,6870
150506,202103,10501,30622,8787,28305,1872,5282,5405,19516,7277,24798
150510,202103,9849,35527,8563,33190,1380,4910,5451,22559,6831,27469
150520,202103,6932,27263,6634,26894,210,1272,5989,24194,6199,25466
150530,202103,12200,41398,10554,39104,1434,4271,7648,30263,9082,34534
150540,202103,4961,13390,4257,12344,255,705,3543,10291,3798,10996
150543,202103,7142,19088,5885,17527,464,1382,4560,14194,5024,15576
150548,202103,10281,31856,9252,30444,225,888,8255,27265,8480,28153
150549,202103,2002,5826,1713,5419,44,151,1441,4598,1485,4749
150550,202103,20935,60497,17389,54734,4450,14164,7181,24253,11631,38417
150553,202103,31216,87367,24627,75929,7078,22057,9006,29526,16084,51583
150555,202103,2008,5231,1568,4536,175,383,1056,3262,1231,3645
150560,202103,1918,5678,1706,5268,294,845,985,3208,1279,4053
150563,202103,2606,7646,2172,6919,415,1358,1230,3994,1645,5352
150565,202103,4453,13974,3967,13226,96,410,3330,11206,3426,11616
150570,202103,6285,19693,5867,19121,288,986,5090,16612,5378,17598
150580,202103,10534,40815,9014,39128,584,2957,7254,32870,7838,35827
150590,202103,8385,28366,7194,26944,153,884,6602,24661,6755,25545
150600,202103,9749,31918,9084,31128,212,811,8444,29110,8656,29921
150610,202103,2918,8405,2612,7933,77,312,2234,6713,2311,7025
150611,202103,3308,8963,2952,8482,88,280,2624,7520,2712,7800
150613,202103,13776,37145,10439,31550,1884,6012,5234,15783,7118,21795
150616,202103,3561,9619,2597,8015,586,1881,1125,3471,1711,5352
150618,202103,6910,19701,5604,17715,497,1507,3615,12106,4112,13613
150619,202103,6710,18295,5558,16715,218,606,4708,14379,4926,14985
150620,202103,6845,22377,5898,20807,672,2252,3963,14454,4635,16706
150630,202103,6356,16771,5807,16106,317,827,4999,13924,5316,14751
150635,202103,4917,13313,4133,12068,576,1540,2676,8077,3252,9617
150640,202103,2283,6666,2087,6422,40,104,1945,6060,1985,6164
150650,202103,11468,31298,9958,28930,2861,7862,4359,13937,7220,21799
150655,202103,5733,16347,5193,15563,195,604,4509,13519,4704,14123
150658,202103,4566,12771,3543,11170,592,1924,1977,6605,2569,8529
150660,202103,5761,16189,5106,15289,485,1364,3571,10996,4056,12360
150670,202103,8718,19625,6923,17604,717,1365,5478,14788,6195,16153
150680,202103,69790,201477,54019,176685,12939,41286,23719,88390,36658,129676
150690,202103,2774,6788,2382,6341,72,158,2133,5794,2205,5952
150700,202103,6104,17883,5449,17044,353,848,4342,14013,4695,14861
150710,202103,3821,12567,3475,12023,295,964,2616,9273,2911,10237
150715,202103,4989,14115,4076,12728,296,837,3203,10228,3499,11065
150720,202103,6957,24177,6484,23479,431,1566,5392,19876,5823,21442
150730,202103,12375,36787,10632,34315,1177,3894,7955,26383,9132,30277
150740,202103,4086,11144,3590,10368,330,784,2685,7987,3015,8771
150745,202103,5063,14165,4076,12729,715,2309,2681,8545,3396,10854
150746,202103,1731,5039,1573,4819,68,178,1333,4130,1401,4308
150747,202103,5010,15449,4438,14547,703,1955,3025,10502,3728,12457
150750,202103,3703,11429,3098,10505,226,821,2356,8262,2582,9083
150760,202103,11825,34677,10726,33145,1499,4166,7517,24121,9016,28287
150770,202103,6615,23084,6235,22661,195,513,5678,21329,5873,21842
150775,202103,982,2659,771,2387,133,438,435,1367,568,1805
150780,202103,4485,13507,3977,12908,155,420,3562,11894,3717,12314
150790,202103,5918,16307,5105,15435,287,713,3827,13229,4114,13942
150795,202103,14350,43249,12500,40448,2993,9096,7063,24515,10056,33611
150796,202103,3936,9360,3435,8791,237,497,2875,7548,3112,8045
150797,202103,4106,12346,3562,11612,146,356,3048,10165,3194,10521
150800,202103,13425,41569,12095,39815,1511,4631,8997,30747,10508,35378
150803,202103,7291,22594,6824,21876,430,1126,5765,18842,6195,19968
150805,202103,3579,10768,3045,10006,259,799,2317,7833,2576,8632
150808,202103,6044,17025,4461,14433,1685,6014,648,2446,2333,8460
150810,202103,20896,54125,15925,48161,3351,10344,7937,26881,11288,37225
150812,202103,5548,15170,4894,14115,416,1264,3670,10396,4086,11660
150815,202103,9863,28204,8240,26307,665,2030,6801,22151,7466,24181
150820,202103,11780,32125,9960,29875,1086,2769,7526,23767,8612,26536
150830,202103,12172,43143,11254,42028,471,1766,9655,37438,10126,39204
150835,202103,2387,7674,2033,7099,324,1105,1217,4307,1541,5412
150840,202103,7660,21161,6183,18843,981,3257,3543,10687,4524,13944
160005,202103,1237,3328,1094,3151,68,227,921,2666,989,2893
160010,202103,2444,6406,2275,6222,19,103,2209,5968,2228,6071
160015,202103,2870,8172,2546,7781,68,221,2349,7212,2417,7433
160020,202103,2100,6575,1832,6243,158,483,1424,5083,1582,5566
160021,202103,1220,4437,1128,4320,53,276,910,3528,963,3804
160023,202103,1319,4511,1169,4259,139,463,793,3101,932,3564
160025,202103,1846,5558,1747,5446,12,38,1697,5306,1709,5344
160027,202103,8920,24787,7954,23549,651,1806,6367,19271,7018,21077
160030,202103,76820,213148,62285,193540,13076,38174,32878,113197,45954,151371
160040,202103,5904,19520,5386,18870,70,305,5066,17861,5136,18166
160050,202103,4762,14130,3722,12740,1394,4580,1281,5574,2675,10154
160053,202103,3876,11727,3498,11258,286,774,2818,9478,3104,10252
160055,202103,945,2695,911,2657,28,90,836,2455,864,2545
160060,202103,25123,65201,20375,59866,958,2852,16117,49916,17075,52768
160070,202103,2640,9997,2363,9573,185,735,1867,7834,2052,8569
160080,202103,3372,10543,2990,10116,26,131,2811,9579,2837,9710
170025,202103,644,1638,474,1382,78,214,251,781,329,995
170030,202103,1250,3725,969,3243,154,496,466,1624,620,2120
170035,202103,1470,3785,1090,3185,82,255,697,2029,779,2284
170040,202103,1928,5289,1530,4729,108,363,964,3062,1072,3425
170070,202103,1908,4409,1363,3722,90,260,806,2317,896,2577
170100,202103,2461,6963,2044,6277,228,615,1275,4072,1503,4687
170105,202103,730,2095,512,1630,137,395,163,546,300,941
170110,202103,989,2925,766,2517,112,385,400,1282,512,1667
170130,202103,1300,3809,941,3130,175,616,463,1569,638,2185
170190,202103,1409,3901,1033,3301,324,1110,226,851,550,1961
170200,202103,2075,4871,1359,3709,202,555,571,1576,773,2131
170210,202103,25002,67004,19078,57190,6108,20081,2803,9240,8911,29321
170215,202103,1320,3504,1056,3140,38,158,836,2478,874,2636
170220,202103,5919,18100,4945,16345,1370,4362,1829,6800,3199,11162
170230,202103,1213,3582,902,2976,253,852,145,533,398,1385
170240,202103,2575,7120,2044,6267,138,476,1478,4453,1616,4929
170255,202103,3969,11317,2868,9357,526,1724,1291,4358,1817,6082
170270,202103,943,2288,638,1854,40,107,381,1099,421,1206
170290,202103,2832,8326,2453,7825,126,393,1915,6305,2041,6698
170300,202103,2011,5336,1638,4787,190,520,1105,3309,1295,3829
170305,202103,637,1727,535,1561,78,239,265,784,343,1023
170307,202103,957,3199,782,2864,107,414,435,1603,542,2017
170310,202103,1584,3918,1127,3203,165,516,540,1546,705,2062
170320,202103,1046,2693,789,2284,75,221,500,1487,575,1708
170330,202103,922,2809,839,2687,43,186,696,2177,739,2363
170360,202103,528,1411,370,1163,19,68,244,726,263,794
170370,202103,1247,3324,901,2744,278,801,239,843,517,1644
170380,202103,1803,5128,1357,4442,88,327,801,2703,889,3030
170382,202103,549,1598,460,1452,28,121,350,1063,378,1184
170384,202103,1578,5517,1304,5001,264,1040,664,2617,928,3657
170386,202103,998,2677,626,1977,78,282,227,680,305,962
170388,202103,623,1770,442,1453,57,211,208,682,265,893
170389,202103,1035,3164,854,2874,48,189,621,2141,669,2330
170390,202103,1772,3990,1341,3474,34,80,1122,2982,1156,3062
170410,202103,576,1631,420,1350,29,115,259,793,288,908
170460,202103,355,955,295,860,34,97,205,606,239,703
170510,202103,940,2620,695,2181,43,161,450,1337,493,1498
170550,202103,6476,17083,4764,14343,1255,4065,1034,3403,2289,7468
170555,202103,1424,3776,1124,3313,78,234,552,1712,630,1946
170560,202103,1037,2857,790,2517,65,193,505,1726,570,1919
170600,202103,1237,3340,1003,3011,224,542,540,1791,764,2333
170610,202103,1609,4206,1168,3553,84,277,727,2189,811,2466
170625,202103,414,1111,263,819,43,127,86,261,129,388
170650,202103,1234,3628,977,3206,117,404,590,1987,707,2391
170700,202103,3363,9862,2549,8286,505,1642,1136,3771,1641,5413
170710,202103,1471,3821,1150,3322,162,481,694,2045,856,2526
170720,202103,1731,4346,1315,3669,335,973,554,1588,889,2561
170730,202103,1097,2912,824,2467,131,328,437,1395,568,1723
170740,202103,2113,6839,1823,6315,166,636,1300,4492,1466,5128
170755,202103,894,2411,627,1967,75,242,278,880,353,1122
170765,202103,1155,2975,821,2439,153,447,348,1094,501,1541
170770,202103,1863,5287,1513,4744,158,504,1012,3238,1170,3742
170820,202103,3280,9806,2575,8523,539,1826,1151,3963,1690,5789
170825,202103,1024,2333,836,2084,94,213,605,1526,699,1739
170830,202103,1412,3705,1158,3316,190,488,734,2200,924,2688
170900,202103,2788,8552,2345,7918,216,646,1830,6332,2046,6978
170930,202103,3685,10110,2821,8498,647,2064,896,2729,1543,4793
170950,202103,11201,30708,7828,24634,2120,7649,865,2981,2985,10630
170980,202103,467,1216,371,1068,28,92,246,687,274,779
171050,202103,1650,5099,1442,4748,51,223,1201,3931,1252,4154
171070,202103,1344,3785,1153,3506,304,886,500,1810,804,2696
171090,202103,1072,2639,848,2328,80,228,551,1482,631,1710
171110,202103,573,1531,403,1222,79,226,175,505,254,731
171150,202103,1068,2624,671,1957,62,208,413,1191,475,1399
171180,202103,784,2101,524,1615,102,282,220,689,322,971
171190,202103,1815,5928,1577,5527,245,905,968,3517,1213,4422
171195,202103,787,2480,635,2197,77,302,386,1325,463,1627
171200,202103,609,1661,457,1408,105,343,162,487,267,830
171215,202103,382,1042,315,931,33,113,212,601,245,714
171240,202103,786,2527,627,2233,30,176,426,1479,456,1655
171245,202103,702,2024,546,1716,44,142,350,1063,394,1205
171250,202103,1013,2678,743,2276,129,419,348,1086,477,1505
171270,202103,477,1659,377,1449,80,315,162,681,242,996
171280,202103,877,2605,701,2289,63,225,423,1432,486,1657
171320,202103,4012,11128,3124,9578,635,1858,1165,3819,1800,5677
171330,202103,2787,7613,2168,6520,488,1473,911,2865,1399,4338
171360,202103,1433,4076,1146,3655,86,271,833,2739,919,3010
171370,202103,700,1752,533,1520,46,128,365,1050,411,1178
171380,202103,1463,3916,1228,3593,154,428,822,2524,976,2952
171395,202103,996,2667,699,2130,63,212,438,1300,501,1512
171420,202103,1990,5725,1442,4647,252,840,642,2098,894,2938
171430,202103,1045,3039,882,2734,53,164,616,1855,669,2019
171488,202103,2332,6809,1847,6008,291,926,929,3169,1220,4095
171500,202103,987,2414,746,2048,55,137,535,1485,590,1622
171510,202103,836,2666,725,2459,43,174,524,1765,567,1939
171515,202103,482,1202,364,1032,36,104,222,600,258,704
171525,202103,738,2011,562,1733,33,115,338,993,371,1108
171550,202103,345,984,266,855,39,146,139,427,178,573
171570,202103,1112,3330,939,3026,126,401,553,1842,679,2243
171575,202103,1777,4756,1154,3641,134,438,505,1608,639,2046
171610,202103,5686,15694,4259,13272,875,3060,1127,3823,2002,6883
171620,202103,2577,7287,2191,6729,107,424,1795,5487,1902,5911
171630,202103,1035,2615,804,2305,88,250,558,1653,646,1903
171650,202103,2043,5727,1577,4957,382,1302,474,1652,856,2954
171660,202103,2352,5883,1632,4692,225,572,872,2547,1097,3119
171665,202103,1250,3478,985,3048,171,606,474,1463,645,2069
171670,202103,1926,5068,1484,4341,219,674,773,2306,992,2980
171700,202103,1211,3383,886,2789,112,341,477,1527,589,1868
171720,202103,799,2036,637,1786,57,167,466,1291,523,1458
171750,202103,1324,3668,918,2916,224,736,123,490,347,1226
171780,202103,1186,3036,872,2579,90,291,584,1708,674,1999
171790,202103,1413,4502,1169,4007,188,658,571,1981,759,2639
171800,202103,719,1941,545,1689,66,249,312,945,378,1194
171820,202103,11430,31684,8542,26751,2052,6672,2429,8294,4481,14966
171830,202103,1582,4966,1358,4576,129,505,882,2978,1011,3483
171840,202103,769,2044,596,1775,18,50,390,1169,408,1219
171845,202103,663,1587,507,1362,45,159,336,862,381,1021
171850,202103,898,2934,767,2640,68,300,540,1815,608,2115
171855,202103,1045,3151,894,2874,67,217,574,1828,641,2045
171865,202103,390,1186,330,1093,55,185,166,534,221,719
171870,202103,830,2252,585,1810,73,224,294,922,367,1146
171875,202103,1304,3673,1045,3265,35,143,800,2490,835,2633
171880,202103,1218,3571,1071,3379,42,120,852,2761,894,2881
171884,202103,871,2486,656,2115,144,530,229,747,373,1277
171886,202103,1376,3677,997,3082,273,959,213,678,486,1637
171888,202103,729,2016,506,1605,27,94,314,981,341,1075
171889,202103,376,1152,301,1005,62,224,123,408,185,632
171890,202103,1204,3330,874,2800,158,482,496,1621,654,2103
171900,202103,545,1853,411,1541,82,288,170,663,252,951
172000,202103,584,1708,491,1544,57,168,275,856,332,1024
172010,202103,958,3292,820,3024,67,276,502,1851,569,2127
172015,202103,376,1281,286,1099,61,233,109,444,170,677
172020,202103,2753,7651,2430,7231,164,494,1800,5596,1964,6090
172025,202103,698,1915,520,1626,37,137,378,1179,415,1316
172030,202103,1244,3618,1061,3326,60,206,820,2566,880,2772
172049,202103,1314,3107,887,2528,189,490,433,1372,622,1862
172065,202103,1441,3624,1137,3242,98,209,902,2767,1000,2976
172080,202103,2381,6949,1936,6175,115,378,1294,4126,1409,4504
172085,202103,473,1283,309,935,58,174,108,308,166,482
172090,202103,4018,9946,3133,8776,129,367,2386,6781,2515,7148
172093,202103,465,1385,335,1151,20,101,197,636,217,737
172097,202103,675,1752,476,1415,64,195,207,615,271,810
172100,202103,49019,119835,35312,98613,5942,18215,13093,37431,19035,55646
172110,202103,1605,5768,1387,5431,125,523,1033,4185,1158,4708
172120,202103,5068,14722,3973,12939,518,1738,2180,7339,2698,9077
172125,202103,390,1037,301,895,23,77,182,517,205,594
172130,202103,623,1522,491,1309,25,86,343,836,368,922
172208,202103,2614,6245,2103,5587,223,445,1497,4149,1720,4594
172210,202103,2666,6677,2042,5886,296,925,1192,3607,1488,4532
210005,202103,18922,53417,14294,45814,4037,13441,5463,18340,9500,31781
210010,202103,1931,5911,1747,5690,67,287,1533,5004,1600,5291
210015,202103,3315,9829,2940,9338,153,463,2444,7815,2597,8278
210020,202103,7348,17264,6272,16015,84,262,5782,14812,5866,15074
210030,202103,4620,15256,4259,14709,265,1028,3580,12441,3845,13469
210040,202103,1856,4351,1650,4101,35,92,1418,3442,1453,3534
210043,202103,6056,17315,5161,16053,381,1155,4058,12831,4439,13986
210047,202103,6490,20067,5320,18522,127,659,4614,16060,4741,16719
210050,202103,2190,7324,1745,6506,164,674,1205,4517,1369,5191
210055,202103,1869,5987,1698,5723,62,229,1446,4900,1508,5129
210060,202103,7233,26355,6443,24980,668,2628,4458,17820,5126,20448
210070,202103,6999,19927,6557,19349,47,209,6195,18225,6242,18434
210080,202103,4326,14297,4110,14065,42,244,3797,13073,3839,13317
210083,202103,5626,15872,4692,14878,60,202,4421,14122,4481,14324
210087,202103,2969,8076,2544,7511,83,240,2158,6420,2241,6660
210090,202103,9098,28390,8506,27364,487,1257,7236,23560,7723,24817
210095,202103,6514,20695,5957,19995,266,1019,4992,17180,5258,18199
210100,202103,6721,20416,5992,19248,450,1517,4574,14797,5024,16314
210110,202103,2890,9243,2666,8978,55,312,2397,8029,2452,8341
210120,202103,23064,62029,19106,56910,1922,4537,12945,41324,14867,45861
210125,202103,4410,11801,3834,11125,755,1748,2647,8267,3402,10015
210130,202103,4305,11135,3570,10225,163,342,3009,8752,3172,9094
210135,202103,1485,4300,1285,3980,59,133,1058,3370,1117,3503
210140,202103,19472,50270,15020,44543,2966,8221,8199,26088,11165,34309
210150,202103,4340,10455,3880,9828,142,384,3293,8208,3435,8592
210160,202103,16568,47671,14276,44822,1256,4110,10084,33031,11340,37141
210170,202103,15387,46804,14310,45441,818,2111,12497,40313,13315,42424
210173,202103,2283,8673,2141,8425,101,571,1835,7172,1936,7743
210177,202103,3476,9526,3022,8970,174,392,2577,7952,2751,8344
210180,202103,1442,3818,1256,3596,21,60,1151,3304,1172,3364
210190,202103,5377,14286,4566,13213,79,326,3937,11276,4016,11602
210193,202103,1336,3863,1176,3606,32,114,881,2764,913,2878
210197,202103,2102,6448,1942,6232,156,458,1580,5190,1736,5648
210200,202103,7693,24477,6829,23051,398,1486,5421,18295,5819,19781
210203,202103,7045,20683,5997,19280,376,1258,4798,15736,5174,16994
210207,202103,3984,9555,3051,8558,171,341,2533,7335,2704,7676
210210,202103,7981,25747,7289,24770,156,890,6253,21054,6409,21944
210215,202103,2508,7827,2149,7294,119,592,1609,5385,1728,5977
210220,202103,6144,21070,5842,20633,158,1056,5163,17876,5321,18932
210230,202103,5116,15378,4662,14703,480,1199,3797,12404,4277,13603
210232,202103,11086,34514,9106,31500,1634,5517,5535,20584,7169,26101
210235,202103,3358,10101,2967,9549,162,627,2488,8013,2650,8640
210237,202103,2856,9128,2459,8662,29,171,2282,8046,2311,8217
210240,202103,2614,8081,2412,7736,66,233,2012,6345,2078,6578
210250,202103,5768,17261,5252,16614,70,397,4805,15147,4875,15544
210255,202103,2485,7564,2114,6925,251,829,1404,4589,1655,5418
210260,202103,5446,16108,4817,15202,232,848,4092,12874,4324,13722
210270,202103,4980,13550,4449,12882,92,402,3994,11465,4086,11867
210275,202103,3446,8753,3013,8218,81,232,2503,6809,2584,7041
210280,202103,5588,15721,4499,14067,237,930,3368,10360,3605,11290
210290,202103,7329,19315,6566,18367,106,329,6137,17166,6243,17495
210300,202103,32440,88264,26517,79772,2169,6798,18303,57348,20472,64146
210310,202103,3103,7837,2747,7323,123,268,2399,6458,2522,6726
210312,202103,2765,6861,2459,6534,25,111,2329,6133,2354,6244
210315,202103,2992,8261,2586,7808,78,220,2286,7058,2364,7278
210317,202103,4070,12739,3684,12284,129,645,3276,10838,3405,11483
210320,202103,19186,56927,17551,54787,373,1620,15614,48585,15987,50205
210325,202103,3669,10261,3154,9593,111,322,2728,8517,2839,8839
210330,202103,24001,67149,19207,61054,5579,15910,9332,34378,14911,50288
210340,202103,10170,29398,9050,27906,798,2256,6841,21858,7639,24114
210350,202103,9046,26012,7988,24735,134,462,7167,22306,7301,22768
210355,202103,4273,14003,3787,13243,95,450,3226,11347,3321,11797
210360,202103,13839,42635,12344,40469,579,2618,9382,30200,9961,32818
210370,202103,10932,24394,8472,21805,245,407,7747,20433,7992,20840
210375,202103,3202,8489,2454,7461,661,2091,997,3370,1658,5461
210380,202103,5412,13792,4685,12945,205,501,4007,11182,4212,11683
210390,202103,2662,9025,2465,8689,113,508,2110,7402,2223,7910
210400,202103,4523,13590,4015,12989,120,366,3607,11874,3727,12240
210405,202103,6802,18218,5516,16412,1060,2904,3078,9842,4138,12746
210407,202103,1965,6459,1679,5955,78,334,1351,4743,1429,5077
210408,202103,2614,9495,2445,9250,147,673,1957,7446,2104,8119
210409,202103,3780,12920,3462,12486,96,497,2896,10555,2992,11052
210410,202103,3420,10180,2921,9359,133,475,2288,7283,2421,7758
210420,202103,3790,11998,3437,11380,195,583,2898,9712,3093,10295
210430,202103,2256,6548,1999,6215,95,269,1694,5354,1789,5623
210440,202103,4326,11618,3762,10911,79,266,3417,9851,3496,10117
210450,202103,2367,6992,2040,6523,88,293,1686,5377,1774,5670
210455,202103,4418,11434,3360,10101,932,2854,1534,4897,2466,7751
210460,202103,3730,10545,3162,9811,55,217,2774,8571,2829,8788
210462,202103,1661,4981,1425,4605,37,146,1160,3777,1197,3923
210465,202103,2740,7875,2387,7384,78,347,1911,5775,1989,6122
210467,202103,5878,18531,5148,17578,291,1091,4261,14769,4552,15860
210470,202103,1977,5261,1471,4539,105,237,1115,3610,1220,3847
210480,202103,16118,47243,13366,43860,1147,3412,9769,34707,10916,38119
210490,202103,3636,9120,2947,8176,76,201,2505,6958,2581,7159
210500,202103,6394,24086,5881,23215,388,1801,4810,18911,5198,20712
210510,202103,5900,19413,5160,18621,118,538,4656,17051,4774,17589
210515,202103,3727,10941,3249,10398,195,688,2651,8671,2846,9359
210520,202103,2530,7267,2271,6927,69,253,1937,5856,2006,6109
210530,202103,50881,125087,39303,108044,6788,22236,11362,38495,18150,60731
210535,202103,3228,10571,2990,10219,156,548,2504,8641,2660,9189
210540,202103,14669,41876,12179,38399,1520,4338,8395,27900,9915,32238
210542,202103,6650,15174,5309,13713,424,751,4237,11762,4661,12513
210545,202103,2220,6835,2095,6634,38,161,1867,5849,1905,6010
210547,202103,3573,12656,3184,11925,284,1017,2436,9323,2720,10340
210550,202103,6077,18184,4803,16185,327,1251,3414,11823,3741,13074
210560,202103,3633,10892,3251,10280,129,380,2749,8661,2878,9041
210565,202103,1482,4755,1236,4405,66,342,937,3354,1003,3696
210570,202103,10421,28170,9286,26783,327,882,8036,23710,8363,24592
210580,202103,2993,7933,2410,7165,123,278,1673,5196,1796,5474
210590,202103,4249,12601,3691,11894,66,357,3296,10557,3362,10914
210592,202103,2648,7708,2428,7354,22,106,2082,6229,2104,6335
210594,202103,2496,6669,1917,5776,96,282,1412,4420,1508,4702
210596,202103,2549,8910,2312,8450,107,423,1909,7004,2016,7427
210598,202103,1821,5242,1684,5036,52,188,1482,4387,1534,4575
210600,202103,3021,8021,2489,7276,119,291,1900,5631,2019,5922
210610,202103,2774,7568,2388,7106,62,251,2050,6101,2112,6352
210620,202103,2816,7364,2342,6796,52,150,2116,6178,2168,6328
210630,202103,3015,9999,2760,9575,116,512,2274,7822,2390,8334
210632,202103,4361,13888,3885,13201,223,934,3070,10370,3293,11304
210635,202103,1727,6129,1636,5973,101,346,1344,5020,1445,5366
210637,202103,2488,8122,2170,7673,147,627,1601,5773,1748,6400
210640,202103,4496,16011,4226,15696,71,344,3848,14342,3919,14686
210650,202103,7448,21078,6769,20211,129,413,6071,18172,6200,18585
210660,202103,8056,23803,7220,22459,262,1080,6123,18712,6385,19792
210663,202103,2636,7518,2415,7259,154,334,2025,6298,2179,6632
210667,202103,1990,6364,1787,6064,62,229,1588,5459,1650,5688
210670,202103,4509,14903,4115,14284,102,469,3625,12519,3727,12988
210675,202103,5103,13621,4361,12676,294,703,3511,10586,3805,11289
210680,202103,4614,11055,3906,10220,103,176,3537,9392,3640,9568
210690,202103,7591,23062,6332,21674,229,959,5598,19362,5827,20321
210700,202103,2761,7679,2191,6850,152,440,1578,5152,1730,5592
210710,202103,4762,14941,4192,14139,97,557,3710,12347,3807,12904
210720,202103,3017,9699,2682,9282,57,331,2370,8135,2427,8466
210725,202103,1285,4280,1123,4037,46,175,791,2955,837,3130
210730,202103,1186,3075,999,2811,47,128,858,2408,905,2536
210735,202103,4716,13532,4029,12638,193,518,3454,11150,3647,11668
210740,202103,5233,13711,4556,12947,80,244,3929,11185,4009,11429
210745,202103,4420,11933,4110,11545,106,308,3735,10455,3841,10763
210750,202103,23331,59560,20234,55659,2130,5165,13766,40323,15896,45488
210760,202103,5918,15476,5003,14515,41,85,4737,13911,4778,13996
210770,202103,6062,15563,5255,14631,56,247,4953,13701,5009,13948
210780,202103,7447,23046,6515,21503,624,1754,4976,16834,5600,18588
210790,202103,4268,13401,3872,12891,186,429,3199,11175,3385,11604
210800,202103,4869,12926,4195,12044,94,363,3721,10581,3815,10944
210805,202103,3994,14251,3811,13989,106,543,3388,12393,3494,12936
210810,202103,4802,13892,4395,13369,317,720,3597,11321,3914,12041
210820,202103,6843,19373,5725,17580,667,2074,3359,10711,4026,12785
210825,202103,6708,20646,6059,19792,274,860,5172,17199,5446,18059
210830,202103,7734,21474,7048,20670,318,739,6184,18522,6502,19261
210840,202103,3130,8308,2831,7925,51,172,2523,6997,2574,7169
210845,202103,6469,17290,5792,16556,36,114,5520,15925,5556,16039
210850,202103,5802,19513,4842,18078,202,1002,3854,14426,4056,15428
210860,202103,21409,53602,17855,49200,1064,2445,14024,40950,15088,43395
210870,202103,7329,18856,5823,17157,269,647,5037,15073,5306,15720
210880,202103,4251,12930,3814,12401,193,738,3042,9886,3235,10624
210890,202103,3803,11067,3438,10640,305,784,2681,8630,2986,9414
210900,202103,4418,12776,3427,10921,1335,4589,491,1806,1826,6395
210905,202103,2001,5442,1675,5026,45,76,1527,4698,1572,4774
210910,202103,7064,21305,5870,19366,731,2463,3850,12821,4581,15284
210920,202103,3183,10425,2754,9861,70,400,2464,8724,2534,9124
210923,202103,1568,4598,1330,4221,78,255,959,3074,1037,3329
210927,202103,5131,16294,4515,15556,402,1335,3457,12344,3859,13679
210930,202103,2405,8328,2118,7774,152,628,1596,5848,1748,6476
210940,202103,4081,11377,3795,11046,103,418,3483,10011,3586,10429
210945,202103,6636,18770,5942,17950,242,675,4988,15490,5230,16165
210950,202103,5175,14280,3997,12647,608,1460,2618,9118,3226,10578
210955,202103,1514,4763,1307,4418,196,631,819,2923,1015,3554
210960,202103,8892,26282,7721,24511,1399,4115,4901,16364,6300,20479
210970,202103,1338,4048,1074,3591,97,287,774,2585,871,2872
210975,202103,1735,5346,1562,5072,72,265,1259,4098,1331,4363
210980,202103,9951,23197,8726,21933,99,238,8229,20798,8328,21036
210990,202103,16406,45416,12904,40817,685,2253,9543,31333,10228,33586
211000,202103,14524,41949,12150,39009,874,2746,9215,31024,10089,33770
211003,202103,5650,16595,4758,15517,134,513,4111,13705,4245,14218
211010,202103,6376,22459,5708,21622,133,614,5075,19539,5208,20153
211020,202103,8105,23214,7020,21980,250,884,5938,19190,6188,20074
211023,202103,1955,6320,1824,6155,91,296,1539,5207,1630,5503
211027,202103,3063,9689,2912,9457,214,549,2454,8143,2668,8692
211030,202103,3807,10457,3410,9965,251,614,2732,8234,2983,8848
211040,202103,4690,16568,4345,15976,111,652,3905,14238,4016,14890
211050,202103,8912,23148,8120,22096,74,266,7448,20251,7522,20517
211060,202103,6920,20801,6306,19977,167,663,5571,17650,5738,18313
211065,202103,2253,6126,1890,5670,85,222,1538,4747,1623,4969
211070,202103,7834,24339,6672,22601,526,1693,5219,17936,5745,19629
211080,202103,1297,3552,1044,3156,32,175,825,2359,857,2534
211085,202103,2063,5720,1773,5346,109,243,1504,4750,1613,4993
211090,202103,3159,8688,2858,8344,31,143,2661,7734,2692,7877
211100,202103,6780,16967,6263,16352,41,131,5819,15276,5860,15407
211102,202103,3115,10450,2855,10071,146,668,2456,8557,2602,9225
211105,202103,2368,7342,1979,6645,171,591,1410,4713,1581,5304
211107,202103,4778,14718,4104,13747,155,619,3223,11272,3378,11891
211110,202103,5955,15989,4650,14016,368,1016,3429,10569,3797,11585
211120,202103,44522,107956,36452,98544,5448,13302,23121,67092,28569,80394
211125,202103,2096,6175,1777,5690,49,175,1503,4841,1552,5016
211130,202103,182823,430380,157113,397399,23958,56609,76729,220236,100687,276845
211140,202103,4971,14509,4367,13757,224,602,3654,11674,3878,12276
211150,202103,9345,25213,7896,23341,353,923,6623,19794,6976,20717
211153,202103,2405,7015,1922,6415,252,870,1269,4416,1521,5286
211157,202103,1138,3574,952,3233,29,136,696,2365,725,2501
211160,202103,4043,11320,3180,10081,133,467,2417,7580,2550,8047
211163,202103,1603,5132,1460,4929,50,218,1284,4348,1334,4566
211167,202103,1572,4848,1476,4702,24,96,1357,4300,1381,4396
211170,202103,6405,15710,5956,15203,71,153,5637,14380,5708,14533
211172,202103,2545,6797,2205,6304,110,334,1722,4816,1832,5150
211174,202103,2853,8189,2578,7882,32,165,2421,7370,2453,7535
211176,202103,4227,11915,3295,10541,146,609,2658,8481,2804,9090
211178,202103,4873,10932,4236,10251,23,93,4069,9765,4092,9858
211180,202103,4043,13228,3761,12821,218,780,3110,10666,3328,11446
211190,202103,3085,8962,2623,8285,28,156,2347,7356,2375,7512
211195,202103,1389,3885,1192,3585,85,153,983,3076,1068,3229
211200,202103,2160,6111,1738,5515,203,589,1208,3915,1411,4504
211210,202103,6279,18991,5715,18259,302,1123,4769,15171,5071,16294
211220,202103,37287,92913,30700,84866,3076,7798,22621,64245,25697,72043
211223,202103,5308,13787,4366,12543,380,1058,3165,9154,3545,10212
211227,202103,1747,5656,1569,5403,63,288,1212,4213,1275,4501
211230,202103,7694,21781,6747,20356,391,944,5479,16966,5870,17910
211240,202103,7980,25082,7588,24585,135,690,7057,22651,7192,23341
211245,202103,6975,17325,6196,16516,75,190,5988,15971,6063,16161
211250,202103,13161,41154,11918,39418,785,2786,9563,31670,10348,34456
211260,202103,8092,25945,7206,24778,239,980,6398,22196,6637,23176
211270,202103,10359,32719,8859,30708,364,1658,7187,25128,7551,26786
211280,202103,12353,33893,11110,32336,832,1933,9138,27653,9970,29586
211285,202103,1825,5855,1623,5574,124,462,1240,4362,1364,4824
211290,202103,7459,22129,6753,21213,191,714,5821,18291,6012,19005
211300,202103,7649,22024,6756,20617,233,780,5593,16875,5826,17655
211400,202103,11563,32303,9481,29473,1046,3226,6309,20703,7355,23929
220005,202103,1841,4707,1679,4491,34,111,1432,3774,1466,3885
220010,202103,1490,4221,1225,3750,24,98,958,2900,982,2998
220020,202103,3754,10097,3249,9398,133,438,2692,7739,2825,8177
220025,202103,2212,5018,1900,4562,27,73,1588,3698,1615,3771
220027,202103,1298,3203,1110,2955,19,61,959,2511,978,2572
220030,202103,3341,8358,3133,8089,85,229,2763,7076,2848,7305
220040,202103,7104,21259,6252,19654,1511,4283,3171,10620,4682,14903
220045,202103,1468,4433,1215,4021,25,130,1003,3266,1028,3396
220050,202103,4747,12736,4050,11844,58,271,3723,10762,3781,11033
220060,202103,2382,4967,2037,4572,27,63,1925,4310,1952,4373
220070,202103,2437,6071,2090,5558,74,137,1746,4676,1820,4813
220080,202103,741,2079,641,1936,21,68,550,1656,571,1724
220090,202103,1746,4164,1466,3765,15,43,1222,3266,1237,3309
220095,202103,644,1592,605,1553,27,43,540,1416,567,1459
220100,202103,1398,3777,1130,3356,46,147,910,2636,956,2783
220105,202103,2046,6252,1795,5773,107,383,1369,4393,1476,4776
220110,202103,3368,9280,3101,8816,35,175,2790,7829,2825,8004
220115,202103,2724,7763,2516,7491,68,198,2290,6807,2358,7005
220117,202103,1434,3360,1141,2959,4,18,975,2481,979,2499
220120,202103,12947,34219,11885,32925,82,274,11151,30871,11233,31145
220130,202103,1112,2960,952,2741,11,64,869,2466,880,2530
220140,202103,2138,4359,1809,3975,99,240,1581,3440,1680,3680
220150,202103,6377,18632,5833,17698,95,440,4975,14854,5070,15294
220155,202103,1199,3373,965,2960,34,102,700,2120,734,2222
220157,202103,1070,2577,907,2329,20,67,724,1804,744,1871
220160,202103,2892,7891,2499,7187,30,126,2052,5793,2082,5919
220170,202103,1625,4180,1395,3838,16,74,1246,3383,1262,3457
220173,202103,2200,6000,1797,5298,43,182,1427,4107,1470,4289
220177,202103,2019,5670,1917,5557,8,27,1895,5488,1903,5515
220180,202103,1120,2676,918,2350,4,16,726,1752,730,1768
220190,202103,7004,17256,5971,15849,364,988,4517,12258,4881,13246
220191,202103,1600,4704,1456,4469,80,260,1039,3150,1119,3410
220192,202103,2094,5428,1545,4463,27,78,1248,3561,1275,3639
220194,202103,1727,4863,1544,4572,52,185,1277,3742,1329,3927
220196,202103,2055,5242,1870,4969,29,112,1621,4233,1650,4345
220198,202103,1290,3488,1098,3240,6,22,1018,3031,1024,3053
220200,202103,5099,14585,4456,13757,69,310,3862,11906,3931,12216
220202,202103,2189,6100,1887,5610,25,127,1620,4738,1645,4865
220205,202103,2490,7101,2239,6649,52,198,1898,5553,1950,5751
220207,202103,783,2344,654,2123,59,195,432,1423,491,1618
220208,202103,1676,5069,1397,4538,180,628,818,2633,998,3261
220209,202103,1588,4477,1391,4130,22,94,1159,3396,1181,3490
220210,202103,1766,4217,1533,3860,11,44,1330,3263,1341,3307
220211,202103,1649,4078,1519,3902,16,62,1333,3435,1349,3497
220213,202103,1809,4717,1568,4315,19,64,1279,3427,1298,3491
220217,202103,2258,6496,2120,6334,41,82,1970,6001,2011,6083
220220,202103,10659,27279,8902,24646,607,1421,6034,17654,6641,19075
220225,202103,1006,2630,826,2396,5,33,779,2236,784,2269
220230,202103,5657,14026,4852,12917,147,338,4195,11244,4342,11582
220240,202103,3046,8692,2776,8252,108,345,2278,6762,2386,7107
220245,202103,1816,4090,1397,3580,12,47,1274,3296,1286,3343
220250,202103,3000,8251,2644,7799,13,74,2482,7281,2495,7355
220253,202103,1611,4322,1449,4058,54,170,1229,3367,1283,3537
220255,202103,1957,4506,1688,4138,28,124,1470,3485,1498,3609
220260,202103,4425,13310,3888,12341,167,575,3064,9710,3231,10285
220265,202103,1289,4095,1157,3926,31,167,961,3209,992,3376
220270,202103,6029,19251,5715,18686,199,955,4791,15181,4990,16136
220271,202103,1488,3778,1303,3521,26,90,1141,3067,1167,3157
220272,202103,1740,5011,1548,4666,47,144,1169,3444,1216,3588
220273,202103,1255,3527,1053,3159,37,143,812,2392,849,2535
220275,202103,2301,5346,1853,4742,40,88,1627,4195,1667,4283
220277,202103,2166,5363,1859,4927,33,80,1553,4066,1586,4146
220280,202103,1682,3846,1403,3490,20,60,1196,2966,1216,3026
220285,202103,1439,3592,1248,3374,10,38,1156,3104,1166,3142
220290,202103,6681,18252,5327,16356,360,1119,3898,12323,4258,13442
220300,202103,1979,5631,1624,5167,30,144,1375,4352,1405,4496
220310,202103,3023,7996,2383,7258,43,199,2001,6068,2044,6267
220320,202103,3106,8897,2407,7600,63,298,1895,5820,1958,6118
220323,202103,1634,4699,1293,4153,49,186,1069,3372,1118,3558
220325,202103,1249,3673,1077,3388,22,108,899,2772,921,2880
220327,202103,1583,4329,1387,4021,31,121,1158,3269,1189,3390
220330,202103,4525,10650,3847,9834,56,184,3471,8824,3527,9008
220335,202103,1674,5012,1516,4806,31,95,1351,4315,1382,4410
220340,202103,1901,4918,1470,4209,57,168,1009,2815,1066,2983
220342,202103,1194,3396,1067,3205,51,156,842,2533,893,2689
220345,202103,3125,6986,2417,5986,17,49,2189,5405,2206,5454
220350,202103,3346,8406,2691,7449,132,370,1921,5371,2053,5741
220360,202103,1245,3157,988,2727,16,43,793,2177,809,2220
220370,202103,8617,24747,7877,23571,146,581,6854,20288,7000,20869
220375,202103,1627,4541,1449,4323,3,14,1381,4146,1384,4160
220380,202103,1464,3458,1199,3094,14,36,1049,2694,1063,2730
220385,202103,831,1966,682,1701,6,15,596,1471,602,1486
220390,202103,10527,26809,8120,23127,2061,5730,2810,9047,4871,14777
220400,202103,1520,3555,1163,3008,27,82,895,2237,922,2319
220410,202103,1148,3142,947,2798,47,129,766,2242,813,2371
220415,202103,826,2076,698,1879,22,53,565,1503,587,1556
220420,202103,2038,5616,1647,4882,59,175,1255,3672,1314,3847
220430,202103,2482,6581,2323,6347,63,215,2012,5426,2075,5641
220435,202103,1773,4530,1539,4190,42,139,1287,3427,1329,3566
220440,202103,2387,7334,2038,6793,74,335,1746,5713,1820,6048
220450,202103,2517,6476,2052,5901,55,184,1757,5068,1812,5252
220455,202103,1261,3880,1201,3796,5,33,1075,3395,1080,3428
220460,202103,997,2426,930,2345,34,77,796,1995,830,2072
220465,202103,2316,7124,2051,6705,184,589,1494,5020,1678,5609
220470,202103,3528,9638,3196,9117,96,239,2606,7356,2702,7595
220480,202103,2846,7203,2298,6337,227,499,1476,4154,1703,4653
220490,202103,2492,6125,2157,5706,23,111,1885,4918,1908,5029
220500,202103,2980,7347,2614,6788,85,205,2056,5257,2141,5462
220510,202103,2555,7114,2046,6205,82,218,1594,4898,1676,5116
220515,202103,1669,3970,1544,3795,38,58,1346,3313,1384,3371
220520,202103,4987,12776,4526,12131,95,253,3934,10516,4029,10769
220525,202103,1385,3419,1203,3191,9,46,1111,2913,1120,2959
220527,202103,1309,3575,1131,3318,14,57,969,2889,983,2946
220530,202103,1416,3501,1232,3263,29,88,1129,2969,1158,3057
220535,202103,807,2176,757,2109,30,75,611,1707,641,1782
220540,202103,3243,10211,3039,9815,132,426,2571,8300,2703,8726
220545,202103,1446,4253,1345,4096,57,209,1136,3434,1193,3643
220550,202103,8564,26122,7654,24553,467,1570,5836,18601,6303,20171
220551,202103,1427,3935,1274,3692,26,98,1046,2978,1072,3076
220552,202103,1631,4630,1336,4109,24,121,1085,3230,1109,3351
220553,202103,1764,4480,1465,4087,56,101,1181,3428,1237,3529
220554,202103,920,2353,676,1963,52,119,445,1284,497,1403
220555,202103,2412,6903,2152,6565,40,152,1792,5607,1832,5759
220556,202103,1207,3443,1051,3145,44,180,774,2227,818,2407
220557,202103,1657,5011,1395,4447,63,241,1033,3187,1096,3428
220558,202103,1402,3616,1104,3205,16,66,953,2743,969,2809
220559,202103,1825,4416,1553,4005,14,31,1269,3310,1283,3341
220560,202103,1759,3940,1450,3550,41,76,1313,3251,1354,3327
220570,202103,7268,21338,6640,20451,496,1430,5246,16387,5742,17817
220580,202103,6959,18639,6366,17691,98,291,5747,15916,5845,16207
220585,202103,2074,6438,1707,5762,42,126,1402,4785,1444,4911
220590,202103,1372,3648,1132,3294,73,194,819,2429,892,2623
220595,202103,2587,6954,2364,6654,18,85,2114,5896,2132,5981
220600,202103,1381,3069,1170,2816,87,108,972,2432,1059,2540
220605,202103,1596,4652,1374,4252,16,93,1123,3370,1139,3463
220610,202103,2815,8059,2645,7801,26,112,2481,7301,2507,7413
220620,202103,7899,23996,7294,23187,154,783,6672,20986,6826,21769
220630,202103,379,1097,295,942,23,77,197,621,220,698
220635,202103,1690,5182,1510,4795,44,226,1178,3620,1222,3846
220640,202103,2450,6756,2090,6246,71,283,1704,5042,1775,5325
220650,202103,2043,5610,1788,5232,37,136,1437,4205,1474,4341
220660,202103,2558,7945,2184,7316,70,340,1832,6021,1902,6361
220665,202103,1248,3722,1055,3399,26,141,894,2806,920,2947
220667,202103,1630,4977,1468,4681,57,206,1192,3786,1249,3992
220669,202103,1634,4871,1567,4768,47,204,1404,4179,1451,4383
220670,202103,2224,5665,1788,5056,18,76,1557,4397,1575,4473
220672,202103,3229,7853,2621,7116,88,293,2334,6250,2422,6543
220675,202103,1291,3493,1154,3241,32,97,952,2657,984,2754
220680,202103,2754,7319,2630,7150,112,218,2392,6609,2504,6827
220690,202103,1588,4149,1407,3880,54,165,1116,3070,1170,3235
220695,202103,911,2484,846,2369,21,63,742,2067,763,2130
220700,202103,10300,24677,8359,22040,334,864,6438,16884,6772,17748
220710,202103,927,2463,685,2015,31,81,520,1498,551,1579
220720,202103,2135,4998,1921,4715,17,70,1689,4094,1706,4164
220730,202103,1309,3623,1120,3311,12,65,945,2733,957,2798
220735,202103,996,2253,792,1947,23,64,658,1570,681,1634
220740,202103,1365,3492,1105,3159,30,74,927,2695,957,2769
220750,202103,3801,9565,3345,8919,203,466,2897,7793,3100,8259
220755,202103,1369,3267,1142,2929,20,69,947,2372,967,2441
220760,202103,3079,8349,2715,7857,62,178,2462,7184,2524,7362
220770,202103,23700,68907,20104,62845,5980,19728,6953,22792,12933,42520
220775,202103,1151,2886,1023,2723,12,40,981,2599,993,2639
220777,202103,1597,4005,1220,3431,30,75,941,2660,971,2735
220779,202103,1270,3261,1103,3019,19,63,974,2639,993,2702
220780,202103,5774,14118,5001,12968,215,620,4059,10335,4274,10955
220785,202103,1497,3285,1314,3053,8,27,1261,2907,1269,2934
220790,202103,10250,28726,9253,27287,186,812,7797,22787,7983,23599
220793,202103,936,2439,754,2123,7,11,633,1801,640,1812
220795,202103,1383,3533,1236,3336,22,73,1089,2938,1111,3011
220800,202103,18315,39912,15641,36451,609,1344,12248,28532,12857,29876
220810,202103,3064,8366,2601,7558,45,127,2151,6193,2196,6320
220820,202103,4835,12621,4231,11738,254,625,3207,8886,3461,9511
220830,202103,7262,19004,6532,18000,255,776,5413,14712,5668,15488
220840,202103,11997,36582,10052,32629,2226,6893,4671,15822,6897,22715
220850,202103,3162,9605,2857,9225,52,263,2552,8240,2604,8503
220855,202103,709,1751,619,1631,20,61,559,1462,579,1523
220860,202103,1063,2616,930,2412,16,66,842,2150,858,2216
220865,202103,2454,6400,1907,5426,77,284,1396,3854,1473,4138
220870,202103,3094,8326,2590,7668,26,123,2394,7076,2420,7199
220880,202103,5325,12436,4592,11529,73,267,4207,10455,4280,10722
220885,202103,1416,4164,1179,3769,57,182,930,3027,987,3209
220887,202103,1583,3348,1334,3033,14,31,1233,2791,1247,2822
220890,202103,1412,4233,1242,3986,44,150,1032,3364,1076,3514
220900,202103,2032,4769,1701,4349,32,71,1495,3820,1527,3891
220910,202103,1533,4133,1298,3787,55,149,1064,3142,1119,3291
220915,202103,975,2581,806,2277,9,32,612,1679,621,1711
220920,202103,1432,4387,1243,4142,53,221,1026,3443,1079,3664
220930,202103,1766,4677,1489,4278,19,54,1390,3988,1409,4042
220935,202103,1093,3121,891,2695,23,95,582,1668,605,1763
220937,202103,1510,3916,1303,3593,21,78,1048,2840,1069,2918
220940,202103,1575,4307,1265,3758,29,87,991,2914,1020,3001
220945,202103,441,1513,384,1393,16,96,291,1023,307,1119
220950,202103,1426,3259,951,2529,21,63,756,1941,777,2004
220955,202103,1633,4078,1356,3608,24,66,1165,3060,1189,3126
220960,202103,797,2006,598,1668,19,55,426,1136,445,1191
220965,202103,1807,4858,1574,4520,20,123,1365,3838,1385,3961
220970,202103,2011,4678,1484,3907,25,58,1242,3243,1267,3301
220975,202103,692,1924,598,1809,12,70,532,1559,544,1629
220980,202103,1131,3183,1002,3007,38,140,831,2473,869,2613
220985,202103,1280,3257,1115,3014,47,117,911,2401,958,2518
220987,202103,1443,4267,1270,3963,53,190,1027,3192,1080,3382
220990,202103,1730,4696,1528,4398,14,80,1309,3713,1323,3793
220995,202103,1124,3285,938,2945,35,109,694,2190,729,2299
220997,202103,2339,7064,2164,6784,45,199,1930,5993,1975,6192
221000,202103,4488,12153,3973,11394,82,356,3407,9669,3489,10025
221005,202103,1482,3814,1359,3614,17,82,1180,3052,1197,3134
221010,202103,1258,2781,1004,2473,18,49,881,2133,899,2182
221020,202103,1535,4658,1426,4456,19,70,1093,3382,1112,3452
221030,202103,1670,4019,1439,3740,22,57,1248,3295,1270,3352
221035,202103,1509,3868,1335,3635,19,25,1185,3310,1204,3335
221037,202103,700,1879,583,1679,8,25,423,1166,431,1191
221038,202103,527,1469,416,1277,12,49,288,876,300,925
221039,202103,868,2351,754,2163,25,107,617,1705,642,1812
221040,202103,4052,11835,3553,10951,148,457,2843,8805,2991,9262
221050,202103,3919,10179,3475,9616,69,222,3127,8652,3196,8874
221060,202103,8719,24045,7250,21642,319,783,5817,17577,6136,18360
221062,202103,1138,3640,987,3395,37,169,799,2715,836,2884
221063,202103,1072,2890,924,2676,51,153,729,2081,780,2234
221065,202103,2674,6764,2357,6202,17,58,2075,5381,2092,5439
221070,202103,3420,10433,2778,9102,285,890,1720,5769,2005,6659
221080,202103,3524,8561,2902,7645,60,208,2391,6189,2451,6397
221090,202103,1409,3563,1171,3181,8,28,1004,2678,1012,2706
221093,202103,1368,3802,1250,3571,140,370,835,2361,975,2731
221095,202103,871,2257,743,2063,10,33,631,1726,641,1759
221097,202103,862,2180,665,1831,23,54,493,1292,516,1346
221100,202103,118202,311400,98634,278265,10066,30399,63771,174989,73837,205388
221110,202103,9874,29223,9075,28187,133,676,8154,25113,8287,25789
221120,202103,4835,13168,4313,12346,154,441,3750,10768,3904,11209
221130,202103,5397,13800,4077,11271,824,2126,1921,5403,2745,7529
221135,202103,1677,4323,1509,4104,39,101,1346,3678,1385,3779
221140,202103,1329,3076,1122,2819,11,34,1014,2506,1025,2540
221150,202103,1096,2711,862,2312,21,96,665,1671,686,1767
221160,202103,734,1800,652,1696,22,28,528,1388,550,1416
221170,202103,1004,2838,923,2687,9,35,812,2328,821,2363
230010,202103,3036,7872,2516,7001,33,115,2091,5696,2124,5811
230015,202103,3082,9784,2727,9063,152,552,1935,6432,2087,6984
230020,202103,12910,40177,12093,38937,355,1376,10316,33113,10671,34489
230030,202103,13122,32109,11027,29397,213,572,9662,25787,9875,26359
230040,202103,4538,11512,3759,10243,42,192,3157,8469,3199,8661
230050,202103,2745,8421,2104,6946,335,1064,937,3025,1272,4089
230060,202103,2380,6460,1921,5640,29,118,1525,4393,1554,4511
230070,202103,4032,10415,3248,8936,192,554,2298,6248,2490,6802
230075,202103,8801,28559,8081,27310,493,1991,6410,21416,6903,23407
230080,202103,3029,6362,2312,5493,6,18,2113,5035,2119,5053
230090,202103,4388,10635,3730,9613,184,442,2987,7660,3171,8102
230100,202103,18345,46650,16110,43670,1316,3424,11531,31618,12847,35042
230110,202103,12733,37242,10702,33319,1734,5324,5591,17614,7325,22938
230120,202103,7752,20315,6839,18868,564,1332,5000,14013,5564,15345
230125,202103,3189,8344,2590,7393,87,283,2000,5623,2087,5906
230130,202103,5626,17203,4579,14927,403,1381,2940,9477,3343,10858
230140,202103,3430,10195,2937,9179,87,347,2252,6882,2339,7229
230150,202103,1617,4810,1332,4186,202,558,773,2505,975,3063
230160,202103,6493,16637,5618,15302,156,516,4650,12464,4806,12980
230170,202103,6423,17957,5293,15689,322,865,3783,11111,4105,11976
230180,202103,1655,4528,1404,4046,18,79,1153,3219,1171,3298
230185,202103,4487,12463,3808,11342,282,879,2817,8405,3099,9284
230190,202103,13650,39096,11475,35084,1369,4262,6727,20412,8096,24674
230195,202103,5339,15450,4879,14582,395,1145,3621,10836,4016,11981
230200,202103,5002,13694,4201,12204,149,461,3234,9229,3383,9690
230205,202103,4167,12117,3662,11358,212,665,2766,8572,2978,9237
230210,202103,10131,24195,8562,22114,352,1095,6730,17100,7082,18195
230220,202103,13709,34303,12045,31931,581,1533,9935,26130,10516,27663
230230,202103,6827,20175,6100,18706,413,1229,4496,13801,4909,15030
230240,202103,12885,34292,11151,31318,259,1108,9243,25360,9502,26468
230250,202103,8989,24795,8350,23802,240,811,6780,18799,7020,19610
230260,202103,14965,43457,12964,39953,2127,6156,7013,22334,9140,28490
230270,202103,7743,20494,5936,17126,542,1507,3830,11142,4372,12649
230280,202103,20469,54054,16814,47951,445,1765,13233,36379,13678,38144
230290,202103,5030,13603,4152,11968,225,561,3185,9156,3410,9717
230300,202103,4876,12754,4414,12130,91,253,3884,10655,3975,10908
230310,202103,4649,13099,3943,11842,126,514,2863,8412,2989,8926
230320,202103,7905,22469,6654,20191,208,854,5149,15269,5357,16123
230330,202103,4706,12639,3748,10828,121,382,2849,8033,2970,8415
230340,202103,3718,11320,3187,10233,242,812,2210,7017,2452,7829
230350,202103,18185,49024,15901,45682,789,2584,10883,31427,11672,34011
230360,202103,2972,7712,2351,6628,121,339,1641,4557,1762,4896
230365,202103,3082,7522,2541,6728,52,229,2172,5661,2224,5890
230370,202103,59470,161788,50754,149075,7102,20962,30939,91838,38041,112800
230380,202103,6297,17248,5001,14892,118,472,3748,10881,3866,11353
230390,202103,3415,9915,2961,9189,85,338,2322,7116,2407,7454
230393,202103,3386,9755,2703,8351,80,405,2100,6232,2180,6637
230395,202103,5723,15553,4990,14335,340,935,3517,10131,3857,11066
230400,202103,5372,14706,4805,13780,85,429,3878,10820,3963,11249
230410,202103,13768,40420,11449,36177,878,2980,7860,24853,8738,27833
230420,202103,29351,79142,23985,70030,2878,8677,13565,39303,16443,47980
230423,202103,4851,14077,4253,12897,94,382,3488,10411,3582,10793
230425,202103,5719,17246,5218,16228,436,1393,3714,11487,4150,12880
230426,202103,2842,7321,2078,5836,28,107,1574,4317,1602,4424
230427,202103,1845,5133,1360,4128,65,192,894,2627,959,2819
230428,202103,9632,25369,8249,23328,1189,3260,4745,13448,5934,16708
230430,202103,5039,13891,3987,12079,165,536,2956,8842,3121,9378
230435,202103,6152,15716,5135,13941,720,1768,2998,8300,3718,10068
230440,202103,423353,1029400,353342,928069,32723,90723,233531,604616,266254,695339
230445,202103,4271,11237,3466,9849,181,491,2362,6560,2543,7051
230450,202103,3613,10215,3158,9561,236,850,2317,6824,2553,7674
230460,202103,2143,5865,1868,5432,50,203,1582,4566,1632,4769
230465,202103,4088,11307,3482,10149,100,378,2646,7428,2746,7806
230470,202103,11358,36940,10191,34806,896,3386,7130,24048,8026,27434
230480,202103,1471,4212,1236,3789,63,254,924,2720,987,2974
230490,202103,2603,7152,2211,6419,167,557,1405,3841,1572,4398
230495,202103,5697,16717,5039,15560,416,1461,3334,10193,3750,11654
230500,202103,9462,29830,8437,27956,230,935,6925,22953,7155,23888
230510,202103,1629,4772,1287,4041,164,548,681,2099,845,2647
230520,202103,4697,12854,4074,11775,343,898,2827,8225,3170,9123
230523,202103,15485,44967,12401,38501,2713,8415,3157,10471,5870,18886
230526,202103,3733,10483,3203,9595,189,520,2324,7048,2513,7568
230530,202103,5389,16683,4540,15020,275,1031,3306,10755,3581,11786
230533,202103,4656,10764,3822,9464,104,266,3188,7765,3292,8031
230535,202103,5278,14572,4478,13228,307,903,2994,8938,3301,9841
230540,202103,16067,43287,13806,39974,270,998,11431,32873,11701,33871
230550,202103,21411,55473,17275,48543,1478,4225,11186,31267,12664,35492
230560,202103,8099,19593,6606,17252,57,225,5688,14725,5745,14950
230565,202103,3076,8429,2592,7545,106,415,1986,5655,2092,6070
230570,202103,3397,8641,2911,7967,84,214,2390,6540,2474,6754
230580,202103,11148,28295,9576,26068,377,1001,7899,21448,8276,22449
230590,202103,8957,24981,7481,22311,418,1422,5577,16089,5995,17511
230600,202103,3770,9504,2993,8159,92,234,2050,5637,2142,5871
230610,202103,6778,18358,6027,17106,440,1190,4775,13482,5215,14672
230620,202103,2114,5629,1650,4751,110,338,1030,2866,1140,3204
230625,202103,8221,22705,6935,20418,1998,6100,1966,6176,3964,12276
230630,202103,10728,31579,9332,28856,1397,4097,5470,17292,6867,21389
230640,202103,27479,82157,24909,78116,1145,4430,20032,61934,21177,66364
230650,202103,5325,14004,4512,12603,129,467,3683,10039,3812,10506
230655,202103,9362,31057,8817,30134,693,2301,6997,24261,7690,26562
230660,202103,6102,17864,4992,15927,134,710,4060,12676,4194,13386
230670,202103,6228,14591,4585,12000,127,412,3688,9419,3815,9831
230680,202103,2726,7316,2299,6564,125,331,1652,4734,1777,5065
230690,202103,7223,20994,6226,19061,392,1370,3984,11976,4376,13346
230700,202103,10391,26117,8461,22617,370,859,6230,16425,6600,17284
230710,202103,6890,21510,6055,19733,649,1980,4009,13070,4658,15050
230720,202103,1860,5457,1529,4807,107,304,1059,3276,1166,3580
230725,202103,4126,11897,3699,11165,378,1261,2220,6584,2598,7845
230730,202103,57244,151886,45090,133700,9920,31514,14922,47047,24842,78561
230740,202103,6133,16774,5209,15290,129,413,4166,12226,4295,12639
230750,202103,8488,22275,7105,20008,159,514,5689,15651,5848,16165
230760,202103,11128,28885,9679,26715,474,1542,7385,19905,7859,21447
230763,202103,5069,13372,4256,11935,111,496,3460,9380,3571,9876
230765,202103,41380,110374,34387,99206,5190,15484,17777,50691,22967,66175
230770,202103,25229,61613,21102,56205,2141,5686,14075,37601,16216,43287
230780,202103,6479,22362,5890,20960,848,2893,3438,12633,4286,15526
230790,202103,3098,8649,2795,8172,103,414,2155,6104,2258,6518
230800,202103,8208,25725,7208,23705,941,3241,4149,13505,5090,16746
230810,202103,11105,33135,9979,31336,369,1344,7786,24079,8155,25423
230820,202103,3412,10995,2800,9645,271,1055,1648,5430,1919,6485
230830,202103,7557,20352,6478,18557,117,486,5367,14987,5484,15473
230835,202103,4264,10023,3309,8541,97,274,2625,6666,2722,6940
230837,202103,3092,9294,2767,8745,109,439,2212,6878,2321,7317
230840,202103,9365,26871,8075,24677,955,2660,5594,17371,6549,20031
230850,202103,9772,27825,8209,24770,351,1181,5963,17733,6314,18914
230860,202103,5445,13400,4529,12098,56,181,4010,10650,4066,10831
230870,202103,16498,39605,14223,35857,396,1075,11678,28905,12074,29980
230880,202103,2122,6306,1948,6032,49,250,1544,4648,1593,4898
230890,202103,4502,14228,4110,13457,329,1145,3000,9709,3329,10854
230900,202103,2989,8491,2587,7745,178,603,1757,5137,1935,5740
230910,202103,3189,8404,2591,7486,58,263,2100,6055,2158,6318
230920,202103,4735,13099,3986,11914,110,453,3191,9323,3301,9776
230930,202103,6629,18193,5570,16324,282,773,3905,11480,4187,12253
230940,202103,8285,20510,7195,18871,211,497,6016,15699,6227,16196
230945,202103,6626,18634,5681,16856,285,975,4061,11785,4346,12760
230950,202103,6244,15512,5532,14546,104,247,4765,12589,4869,12836
230960,202103,13472,38294,11823,35205,2011,5805,5765,17428,7776,23233
230970,202103,13636,35621,11394,32182,1649,4468,6648,19050,8297,23518
230980,202103,2696,7700,2390,7166,343,967,1502,4664,1845,5631
230990,202103,1693,4667,1397,4090,60,241,1005,2796,1065,3037
231000,202103,2528,6702,2064,5798,79,198,1530,4198,1609,4396
231010,202103,3699,8482,2909,7150,32,125,2543,6065,2575,6190
231020,202103,7956,24367,7120,22781,1255,3625,4114,13721,5369,17346
231025,202103,7578,20423,6595,18827,718,1982,4638,13367,5356,15349
231030,202103,7388,21617,5837,18381,1008,3001,2918,9330,3926,12331
231040,202103,2950,8308,2565,7605,121,366,2007,5857,2128,6223
231050,202103,11664,29530,9565,25872,622,1606,7134,18950,7756,20556
231060,202103,2914,8072,2578,7537,55,168,2166,6331,2221,6499
231070,202103,7876,22534,6790,20652,660,2074,4544,13701,5204,15775
231080,202103,3977,11083,3382,10113,138,519,2579,7555,2717,8074
231085,202103,6952,16399,5540,14752,214,502,4361,11662,4575,12164
231090,202103,4598,11770,3400,9488,99,374,2308,6193,2407,6567
231095,202103,2272,6657,1806,5676,147,449,1207,3796,1354,4245
231100,202103,3232,9161,2651,8064,115,406,1988,5988,2103,6394
231110,202103,3713,10615,3383,10002,138,480,2571,7488,2709,7968
231120,202103,2319,6616,1919,5926,80,281,1387,4250,1467,4531
231123,202103,1934,4910,1635,4401,80,155,1194,3250,1274,3405
231126,202103,5495,14895,4523,13064,295,786,3221,9245,3516,10031
231130,202103,21878,54473,18197,49881,1068,3401,13532,36549,14600,39950
231135,202103,4176,11632,3478,10284,178,569,2462,7187,2640,7756
231140,202103,16526,45863,13325,40358,670,2420,9399,27864,10069,30284
231150,202103,5965,15887,4532,13193,632,1852,1971,5918,2603,7770
231160,202103,6260,18927,5590,17717,766,2330,3188,10447,3954,12777
231170,202103,4151,12043,3484,10817,166,590,2470,7428,2636,8018
231180,202103,14286,39845,11695,34511,2980,8572,4196,12813,7176,21385
231190,202103,3948,10962,3244,9688,62,253,2503,7325,2565,7578
231195,202103,5049,14831,4230,13174,278,932,3041,9456,3319,10388
231200,202103,7812,23972,6864,22077,181,895,5438,16965,5619,17860
231210,202103,4899,14114,4189,12948,145,522,3250,9874,3395,10396
231220,202103,12223,31195,9637,26401,431,1226,7020,18698,7451,19924
231230,202103,9182,29041,8114,27070,541,2028,5925,19852,6466,21880
231240,202103,11574,33238,10208,30696,1601,4622,6114,18697,7715,23319
231250,202103,2175,5492,1439,3898,116,322,852,2243,968,2565
231260,202103,3294,9098,2865,8422,274,752,1950,5880,2224,6632
231270,202103,6374,16467,5132,14431,150,549,3890,10668,4040,11217
231280,202103,1728,5304,1587,5050,79,234,1210,3830,1289,4064
231290,202103,38255,112272,31869,99568,5318,16392,14767,45876,20085,62268
231300,202103,4145,11256,3276,9532,170,557,2246,6369,2416,6926
231310,202103,7550,19055,6038,16307,524,1413,4094,10813,4618,12226
231320,202103,7776,21080,6105,18138,86,383,4789,14030,4875,14413
231325,202103,2472,6284,2040,5648,160,330,1435,4098,1595,4428
231330,202103,9604,28049,7989,24862,1502,4387,4202,13783,5704,18170
231335,202103,5683,14850,4864,13565,61,286,4304,11864,4365,12150
231340,202103,18112,54200,16350,51093,1231,3797,12205,38502,13436,42299
231350,202103,15831,42923,14496,41005,235,829,13067,36640,13302,37469
231355,202103,4398,12894,3976,12100,224,717,3112,9362,3336,10079
231360,202103,7570,22421,6556,20681,274,929,5216,16432,5490,17361
231370,202103,2174,5940,1745,5170,33,98,1333,3940,1366,4038
231375,202103,4279,13253,3911,12654,118,523,3277,10485,3395,11008
231380,202103,6069,16305,5495,15517,193,482,4475,12817,4668,13299
231390,202103,3322,9607,2987,9040,116,440,2214,6524,2330,6964
231395,202103,4090,11744,3397,10655,375,1184,2090,6593,2465,7777
231400,202103,9809,27807,8238,24953,247,1042,6275,18598,6522,19640
231410,202103,14913,45275,13649,43203,634,2057,11044,34824,11678,36881
240010,202103,2636,6778,2066,5762,213,592,1213,3342,1426,3934
240020,202103,12772,35048,10714,31430,622,2179,7131,20612,7753,22791
240030,202103,3005,7080,2697,6621,106,281,2339,5705,2445,5986
240040,202103,827,2350,702,2118,30,115,482,1404,512,1519
240050,202103,3343,8833,2715,7709,45,124,2082,5804,2127,5928
240060,202103,1393,3690,1148,3249,23,81,941,2611,964,2692
240070,202103,2165,6132,1959,5700,196,586,1417,4025,1613,4611
240080,202103,2924,7803,2375,6836,68,247,1802,5103,1870,5350
240090,202103,2244,5498,1837,4817,18,47,1544,4005,1562,4052
240100,202103,10267,24781,8206,21144,185,545,6493,16179,6678,16724
240110,202103,4546,12753,3828,11461,173,631,2811,8232,2984,8863
240120,202103,3296,9042,2671,8271,177,575,1926,6105,2103,6680
240130,202103,3742,7627,3113,6816,29,86,2852,6167,2881,6253
240140,202103,1706,5118,1468,4647,148,520,1010,3171,1158,3691
240145,202103,6546,17989,5366,15987,828,2515,3069,9257,3897,11772
240150,202103,951,2719,838,2486,44,144,655,1894,699,2038
240160,202103,1457,4307,1224,3874,39,162,936,2973,975,3135
240165,202103,978,2645,814,2335,25,93,675,1896,700,1989
240170,202103,2651,6981,2239,6253,201,594,1524,4162,1725,4756
240180,202103,3015,8806,2411,7586,565,1696,1055,3529,1620,5225
240185,202103,1227,3774,1134,3610,51,195,955,3008,1006,3203
240190,202103,1086,3144,936,2898,16,75,802,2493,818,2568
240200,202103,10752,27114,8575,23467,860,2537,4940,13237,5800,15774
240210,202103,3335,8082,2705,7079,22,109,2288,5800,2310,5909
240220,202103,7252,21574,6522,20442,321,1368,5189,16011,5510,17379
240230,202103,5856,14680,4691,12773,229,559,3683,10109,3912,10668
240240,202103,1798,5155,1165,3702,107,355,385,1089,492,1444
240250,202103,3034,7752,2653,7235,76,227,2278,6162,2354,6389
240260,202103,13722,40334,11905,37296,1687,4950,7362,24210,9049,29160
240270,202103,2329,6824,2045,6351,111,330,1482,4768,1593,5098
240280,202103,1713,4299,1446,3869,57,144,1157,3060,1214,3204
240290,202103,1167,3379,954,2911,31,137,688,1986,719,2123
240300,202103,2326,5853,1685,4692,71,211,1042,2841,1113,3052
240310,202103,8412,22078,6620,18898,863,2609,3394,9534,4257,12143
240320,202103,2103,5622,1529,4510,33,140,1148,3230,1181,3370
240325,202103,31620,83125,25312,72241,4191,12296,11675,33319,15866,45615
240330,202103,1787,4806,1379,4036,54,176,958,2682,1012,2858
240340,202103,1932,4418,1586,3902,53,123,1311,3175,1364,3298
240350,202103,2231,5565,1999,5305,38,99,1805,4814,1843,4913
240360,202103,9329,25117,8296,23533,807,2275,5869,16852,6676,19127
240370,202103,1973,5027,1546,4185,59,160,1097,2891,1156,3051
240375,202103,918,2296,768,2036,25,85,616,1572,641,1657
240380,202103,2228,6295,1671,5073,145,404,955,2875,1100,3279
240390,202103,1053,2509,754,1950,27,62,476,1146,503,1208
240400,202103,1515,3642,1174,3059,31,102,841,2068,872,2170
240410,202103,586,1686,478,1477,37,134,314,922,351,1056
240420,202103,4484,15624,3955,14450,437,1887,2358,8450,2795,10337
240430,202103,3450,8690,2872,7706,165,494,2148,5591,2313,6085
240440,202103,2490,5382,2117,4877,140,263,1719,3997,1859,4260
240450,202103,4570,12220,3598,10445,353,1046,2108,5899,2461,6945
240460,202103,2907,8213,2577,7678,215,697,2022,5999,2237,6696
240470,202103,3636,10793,2758,8970,552,1690,1293,4451,1845,6141
240480,202103,593,1605,401,1189,33,95,192,546,225,641
240485,202103,2217,6072,1800,5329,126,364,1234,3655,1360,4019
240490,202103,1618,4104,1281,3480,85,185,950,2613,1035,2798
240500,202103,2186,5808,1901,5323,108,281,1519,4288,1627,4569
240510,202103,1692,4412,1472,4086,70,233,1202,3282,1272,3515
240520,202103,1522,3595,1185,3136,76,188,866,2357,942,2545
240530,202103,2208,6097,1994,5760,97,287,1664,4775,1761,5062
240540,202103,2323,5731,2040,5293,66,111,1752,4586,1818,4697
240550,202103,692,1935,628,1807,16,66,532,1485,548,1551
240560,202103,3265,8418,2766,7754,269,656,2008,5777,2277,6433
240570,202103,2832,7325,1917,5347,287,783,697,1862,984,2645
240580,202103,7971,23213,7064,21548,576,1633,5595,17276,6171,18909
240590,202103,760,1911,670,1762,16,47,512,1320,528,1367
240600,202103,1827,4886,1353,3906,46,137,911,2534,957,2671
240610,202103,4178,10991,3577,9917,118,364,2778,7561,2896,7925
240615,202103,1270,3226,1022,2793,111,282,694,1875,805,2157
240620,202103,1841,5064,1593,4649,106,265,1260,3689,1366,3954
240630,202103,2067,5716,1862,5366,133,282,1334,4008,1467,4290
240640,202103,969,2561,777,2248,26,94,578,1637,604,1731
240650,202103,4094,11282,3529,10127,235,651,2671,7576,2906,8227
240660,202103,3056,7751,2715,7319,47,147,2471,6663,2518,6810
240670,202103,2462,6865,1988,5901,147,446,1279,3713,1426,4159
240680,202103,1630,4257,1328,3750,58,165,1002,2764,1060,2929
240690,202103,1034,2536,817,2179,15,63,652,1672,667,1735
240700,202103,2480,7084,2027,6243,64,216,1569,4769,1633,4985
240710,202103,16141,41173,13561,36822,1689,4491,8565,23192,10254,27683
240720,202103,5056,12307,4371,11365,390,1037,3231,8324,3621,9361
240725,202103,1139,3205,878,2699,38,115,590,1759,628,1874
240730,202103,2304,6304,1851,5409,48,156,1415,4079,1463,4235
240740,202103,1890,5020,1525,4303,48,178,1123,3010,1171,3188
240750,202103,2130,6915,1814,6261,247,919,989,3452,1236,4371
240760,202103,1676,3794,1212,3094,65,84,930,2449,995,2533
240770,202103,3241,8844,2734,8111,121,426,2228,6537,2349,6963
240780,202103,4645,12820,3835,11480,522,1535,2355,7252,2877,8787
240790,202103,888,2477,744,2200,19,85,565,1617,584,1702
240800,202103,49026,115321,38176,99109,5111,13420,20025,51900,25136,65320
240810,202103,91153,231673,77441,209351,8590,24021,50677,134611,59267,158632
240820,202103,5989,17508,5204,16108,712,2156,3212,10131,3924,12287
240830,202103,8838,24726,7856,23276,245,937,6504,19084,6749,20021
240840,202103,1125,2754,900,2398,26,70,650,1669,676,1739
240850,202103,1375,3693,990,2893,47,141,569,1612,616,1753
240860,202103,1346,3528,1016,2934,17,78,779,2148,796,2226
240870,202103,1092,2729,830,2288,139,389,446,1266,585,1655
240880,202103,1263,3966,1112,3673,75,321,856,2758,931,3079
240890,202103,4414,11942,3400,10043,442,1414,1739,4946,2181,6360
240895,202103,2868,8669,2649,8326,170,494,2234,7154,2404,7648
240910,202103,3519,9272,2985,8323,47,151,2459,6731,2506,6882
240920,202103,930,2475,771,2216,70,162,440,1335,510,1497
240930,202103,3671,8243,3033,7472,210,307,2244,5877,2454,6184
240933,202103,1692,4115,1424,3736,33,133,1257,3245,1290,3378
240940,202103,5911,14547,4639,12374,532,1422,2768,7244,3300,8666
240950,202103,1058,3100,931,2872,29,124,753,2259,782,2383
240960,202103,684,2095,614,1955,25,83,476,1496,501,1579
240970,202103,1854,4757,1493,4148,61,217,1210,3263,1271,3480
240980,202103,3363,9832,2967,9129,102,452,2422,7313,2524,7765
240990,202103,2605,7219,2303,6637,250,794,1638,4546,1888,5340
241000,202103,936,2443,741,2097,27,67,550,1532,577,1599
241010,202103,2825,8842,2576,8311,163,598,1900,6057,2063,6655
241020,202103,2174,5663,1645,4623,124,334,1093,3000,1217,3334
241025,202103,1814,5109,1451,4447,41,168,1058,3177,1099,3345
241030,202103,2496,7720,2021,6712,235,773,1281,4290,1516,5063
241040,202103,2287,7118,2014,6640,84,381,1598,5224,1682,5605
241050,202103,1381,3814,1141,3381,33,117,838,2416,871,2533
241060,202103,773,2134,682,1949,29,84,481,1334,510,1418
241070,202103,676,1801,581,1643,11,28,449,1232,460,1260
241080,202103,1126,3167,874,2667,14,52,661,1990,675,2042
241090,202103,1974,5721,1612,5103,48,224,1267,3952,1315,4176
241100,202103,1208,3286,931,2735,66,193,608,1742,674,1935
241105,202103,945,2846,776,2534,239,763,254,859,493,1622
241110,202103,992,2740,748,2237,39,112,505,1457,544,1569
241120,202103,7651,21408,6476,19348,896,2612,3884,11950,4780,14562
241140,202103,3345,8754,2610,7293,136,392,1897,5193,2033,5585
241142,202103,795,2111,587,1720,30,100,348,974,378,1074
241150,202103,5979,15229,5307,14147,153,437,4352,11463,4505,11900
241160,202103,1174,3141,937,2709,135,401,598,1688,733,2089
241170,202103,1370,3425,1162,3066,33,106,963,2451,996,2557
241180,202103,1058,2666,792,2156,98,277,389,1053,487,1330
241190,202103,1161,3010,972,2637,16,65,713,1857,729,1922
241200,202103,19993,51267,17313,46896,2702,7272,10087,27340,12789,34612
241210,202103,1443,3767,1051,2997,109,331,599,1673,708,2004
241220,202103,9080,25930,7942,24036,1711,5154,3896,12233,5607,17387
241230,202103,2972,7723,2637,7206,113,319,2172,5887,2285,6206
241240,202103,1237,3419,799,2463,71,224,340,1053,411,1277
241250,202103,5678,15977,4552,13876,147,634,3361,9862,3508,10496
241255,202103,2267,6942,2014,6414,112,436,1545,4837,1657,5273
241260,202103,4917,12620,3903,10952,81,318,3108,8535,3189,8853
241270,202103,1664,4787,1397,4281,103,345,1006,3094,1109,3439
241280,202103,2244,5494,1933,4937,67,161,1637,4127,1704,4288
241290,202103,3391,8234,2507,6820,77,237,1963,5210,2040,5447
241300,202103,1528,4004,1233,3497,39,133,842,2320,881,2453
241310,202103,2160,5268,1863,4850,19,62,1610,4233,1629,4295
241320,202103,936,3007,806,2763,83,341,529,1798,612,2139
241330,202103,1781,4506,1397,3998,15,83,1226,3472,1241,3555
241335,202103,3328,9140,2930,8417,113,355,2380,6758,2493,7113
241340,202103,1576,4356,1236,3664,244,785,522,1475,766,2260
241350,202103,2185,5948,1915,5467,112,316,1496,4236,1608,4552
241355,202103,1323,3528,1089,3081,13,31,843,2357,856,2388
241360,202103,2061,5288,1562,4286,43,111,1151,3081,1194,3192
241370,202103,1377,3732,1073,3099,48,141,763,2146,811,2287
241380,202103,668,1821,514,1521,76,187,257,787,333,974
241390,202103,2732,7922,2437,7484,191,514,1880,5900,2071,6414
241400,202103,3567,9764,3180,9169,135,453,2594,7411,2729,7864
241410,202103,2440,7145,1994,6231,333,1066,1028,3233,1361,4299
241415,202103,1698,4896,1410,4344,49,171,1036,3157,1085,3328
241420,202103,2342,7224,2017,6679,447,1629,1024,3408,1471,5037
241430,202103,618,1649,435,1259,15,44,282,782,297,826
241440,202103,7851,23425,7032,21993,369,1235,5587,17502,5956,18737
241445,202103,1169,2875,1038,2703,47,104,886,2402,933,2506
241450,202103,2712,6532,2316,5904,362,787,1540,4081,1902,4868
241460,202103,3882,10310,3164,8830,211,560,2184,5982,2395,6542
241470,202103,1407,3701,1157,3326,24,78,966,2785,990,2863
241475,202103,1243,3391,988,2902,23,106,733,2047,756,2153
241480,202103,2997,9188,2465,8035,747,2414,802,2919,1549,5333
241490,202103,659,1531,528,1344,23,48,407,1025,430,1073
241500,202103,786,2180,703,2076,3,10,655,1954,658,1964
250010,202103,2616,7682,2200,6835,56,198,1615,4907,1671,5105
250020,202103,1685,4393,1229,3516,52,89,868,2514,920,2603
250030,202103,7062,18984,6268,17737,543,1513,4681,13155,5224,14668
250040,202103,3989,12091,3453,11116,237,830,2519,7996,2756,8826
250050,202103,3650,9591,3302,9138,95,343,2779,7670,2874,8013
250053,202103,1196,3298,1095,3140,79,208,788,2285,867,2493
250057,202103,674,2309,625,2232,8,38,570,2056,578,2094
250060,202103,5453,14039,4900,13364,253,668,4090,11241,4343,11909
250070,202103,4080,11131,3438,10028,30,114,2780,7921,2810,8035
250073,202103,776,2028,634,1812,10,20,513,1437,523,1457
250077,202103,2261,5914,1713,5020,53,181,1318,3823,1371,4004
250080,202103,5014,12250,4237,11274,62,265,3737,9812,3799,10077
250090,202103,3448,8167,3010,7594,55,151,2598,6440,2653,6591
250100,202103,3646,10877,3286,10232,156,523,2578,7893,2734,8416
250110,202103,4891,13605,4427,12948,244,895,3468,9952,3712,10847
250115,202103,733,1830,537,1532,13,51,405,1136,418,1187
250120,202103,1890,5395,1588,4900,27,127,1261,3860,1288,3987
250130,202103,5656,15207,4781,13958,66,351,4098,11812,4164,12163
250135,202103,1220,3310,1065,3049,16,56,935,2674,951,2730
250140,202103,2289,6563,2130,6369,106,405,1844,5482,1950,5887
250150,202103,4765,14590,4271,13756,131,527,3441,10929,3572,11456
250153,202103,1399,3656,1168,3317,35,92,927,2615,962,2707
250157,202103,1842,5253,1667,4929,60,222,1345,3914,1405,4136
250160,202103,3897,9602,3099,8539,42,145,2711,7489,2753,7634
250170,202103,1842,4713,1658,4454,24,88,1445,3833,1469,3921
250180,202103,20529,48511,17559,44771,712,2140,13936,34662,14648,36802
250190,202103,4071,10710,3416,9751,290,848,2440,6827,2730,7675
250200,202103,1996,5190,1728,4830,65,186,1452,4076,1517,4262
250205,202103,879,2651,760,2469,7,28,621,1999,628,2027
250210,202103,1558,4645,1410,4419,62,269,1124,3464,1186,3733
250215,202103,1604,4298,1345,3937,77,242,790,2343,867,2585
250220,202103,666,1818,531,1611,23,86,354,1060,377,1146
250230,202103,1689,3755,1185,3013,15,44,954,2369,969,2413
250240,202103,2370,7033,2093,6529,35,170,1792,5497,1827,5667
250250,202103,4627,12668,4044,11827,85,256,3456,10154,3541,10410
250260,202103,1695,4675,1438,4233,51,123,1136,3330,1187,3453
250270,202103,1209,3621,1100,3485,52,190,839,2732,891,2922
250280,202103,3487,9306,3134,8795,132,314,2490,7033,2622,7347
250290,202103,1541,4034,1330,3733,17,51,1062,2970,1079,3021
250300,202103,5544,14578,4992,13934,164,704,4222,11396,4386,12100
250310,202103,1182,3239,985,2915,40,127,745,2182,785,2309
250320,202103,12396,27305,10693,25363,247,663,9621,22546,9868,23209
250330,202103,2365,6461,1987,5940,134,354,1575,4757,1709,5111
250340,202103,1146,2865,1026,2713,13,34,949,2504,962,2538
250350,202103,4202,11637,3722,10829,204,451,2933,8819,3137,9270
250355,202103,2041,6040,1834,5763,30,166,1647,5156,1677,5322
250360,202103,1803,4849,1623,4605,36,120,1377,3870,1413,3990
250370,202103,13897,34873,11564,31363,230,827,9811,26219,10041,27046
250375,202103,1199,3051,971,2777,4,16,923,2652,927,2668
250380,202103,1650,4162,1516,3995,30,107,1338,3433,1368,3540
250390,202103,1852,4687,1566,4242,75,202,1254,3377,1329,3579
250400,202103,70054,170006,51889,142249,14337,42438,13955,40790,28292,83228
250403,202103,1783,4889,1589,4664,69,344,1248,3480,1317,3824
250407,202103,1339,3161,1056,2749,96,195,680,1919,776,2114
250410,202103,643,1722,555,1573,4,9,462,1281,466,1290
250415,202103,1896,5202,1662,4833,32,145,1431,4136,1463,4281
250420,202103,1189,3272,1083,3123,32,107,976,2799,1008,2906
250430,202103,6261,15255,5322,14029,152,435,4393,11356,4545,11791
250435,202103,1566,4335,1269,3833,12,64,979,2902,991,2966
250440,202103,4669,12150,4049,11371,71,185,3606,10123,3677,10308
250450,202103,1818,4746,1505,4318,29,98,1242,3584,1271,3682
250460,202103,7153,19317,6364,18169,340,1022,5084,14487,5424,15509
250470,202103,1544,3961,1285,3565,46,144,1027,2799,1073,2943
250480,202103,3974,10696,3384,9991,41,135,2982,8877,3023,9012
250485,202103,736,1633,554,1379,46,72,392,961,438,1033
250490,202103,5213,12212,4638,11559,167,483,4124,10099,4291,10582
250500,202103,2010,5481,1796,5110,76,229,1455,4143,1531,4372
250510,202103,5438,13566,4689,12573,75,182,4106,11099,4181,11281
250520,202103,1815,4844,1542,4459,114,345,1113,3208,1227,3553
250523,202103,2203,5420,1949,5097,68,261,1624,4106,1692,4367
250527,202103,1694,4264,1522,4074,23,63,1352,3637,1375,3700
250530,202103,623,1588,537,1465,5,11,476,1301,481,1312
250535,202103,1401,4015,1266,3766,24,99,1030,2971,1054,3070
250540,202103,3112,6922,2600,6350,81,145,2277,5685,2358,5830
250550,202103,784,2470,692,2290,18,60,518,1700,536,1760
250560,202103,1761,4804,1553,4511,39,146,1314,3735,1353,3881
250570,202103,2684,7892,2306,7210,77,278,1804,5562,1881,5840
250580,202103,1067,2741,939,2564,43,152,792,2117,835,2269
250590,202103,836,2265,750,2137,20,61,624,1781,644,1842
250600,202103,8176,20954,6812,19176,234,724,5522,15441,5756,16165
250610,202103,2987,8355,2676,7898,112,415,2223,6493,2335,6908
250620,202103,839,2140,724,1948,12,23,525,1397,537,1420
250625,202103,2451,6990,2190,6562,42,209,1868,5444,1910,5653
250630,202103,10393,28129,8500,24896,873,2568,5466,15709,6339,18277
250640,202103,3548,9488,3180,9002,87,331,2760,7716,2847,8047
250650,202103,972,2307,822,2103,13,36,720,1819,733,1855
250660,202103,1648,4026,1318,3574,36,101,1087,2870,1123,2971
250670,202103,2306,7153,2095,6782,40,176,1832,5830,1872,6006
250680,202103,5892,13542,5267,12844,51,195,4908,11807,4959,12002
250690,202103,6796,15209,5727,13884,106,232,5057,12209,5163,12441
250700,202103,4265,11930,3724,11115,479,1403,2498,7488,2977,8891
250710,202103,4403,12520,3858,11757,271,827,2828,8631,3099,9458
250720,202103,2826,7408,2537,6999,29,143,2271,6207,2300,6350
250730,202103,4153,10929,3642,10253,101,411,3067,8397,3168,8808
250740,202103,1947,4778,1628,4362,96,222,1281,3455,1377,3677
250750,202103,106632,257834,90732,235766,7231,19960,66326,169376,73557,189336
250760,202103,2373,6017,2079,5544,70,192,1683,4379,1753,4571
250770,202103,3991,11990,3574,11436,387,1199,2566,8345,2953,9544
250780,202103,1775,4705,1495,4201,62,195,1151,3159,1213,3354
250790,202103,2510,7268,2174,6775,102,409,1559,4737,1661,5146
250800,202103,2444,6397,2144,5911,92,186,1746,4868,1838,5054
250810,202103,1290,3343,1079,3046,31,63,904,2598,935,2661
250820,202103,1988,5443,1829,5271,29,122,1661,4756,1690,4878
250830,202103,5946,17622,4896,15493,281,1040,3311,10201,3592,11241
250840,202103,747,2357,643,2153,14,56,490,1651,504,1707
250850,202103,1798,5250,1613,4915,30,132,1338,3983,1368,4115
250855,202103,1017,2878,876,2651,62,192,660,2005,722,2197
250860,202103,3193,9348,2674,8495,438,1452,1542,4947,1980,6399
250870,202103,1032,2819,881,2576,38,138,712,2050,750,2188
250880,202103,1625,4131,1344,3721,85,239,1029,2847,1114,3086
250890,202103,10363,26235,9155,24631,455,1576,7306,18879,7761,20455
250900,202103,2921,7855,2537,7188,98,250,2117,5945,2215,6195
250905,202103,2525,6895,2334,6632,41,144,2137,6074,2178,6218
250910,202103,6149,14896,5074,13680,69,224,4453,12046,4522,12270
250915,202103,2154,4937,1501,4234,26,56,1313,3791,1339,3847
250920,202103,3621,8999,3187,8343,283,638,2427,6363,2710,7001
250930,202103,2315,6159,2096,5873,47,199,1822,4999,1869,5198
250933,202103,1201,3494,1067,3256,22,94,851,2543,873,2637
250937,202103,683,1832,563,1637,21,70,434,1281,455,1351
250939,202103,1840,4762,1608,4467,57,161,1266,3500,1323,3661
250940,202103,4058,10636,3575,10002,16,59,3204,8971,3220,9030
250950,202103,1763,4462,1424,4030,24,87,1156,3222,1180,3309
250960,202103,1120,3257,988,3050,22,113,819,2449,841,2562
250970,202103,8296,21123,7320,19569,205,630,6087,15987,6292,16617
250980,202103,2391,6317,2161,5985,24,107,1890,5115,1914,5222
250990,202103,2044,6125,1717,5570,57,251,1279,4101,1336,4352
251000,202103,2039,5711,1654,5047,35,155,1358,4117,1393,4272
251010,202103,2727,7447,2477,7066,24,89,2235,6374,2259,6463
251020,202103,1617,4400,1449,4134,31,139,1252,3507,1283,3646
251030,202103,1043,2727,862,2412,45,120,584,1624,629,1744
251040,202103,1807,5054,1518,4565,33,162,1249,3733,1282,3895
251050,202103,1035,2812,872,2503,45,151,625,1723,670,1874
251060,202103,1076,2278,823,1968,10,29,631,1488,641,1517
251065,202103,486,1312,373,1099,9,26,260,746,269,772
251070,202103,745,1887,628,1712,8,32,541,1439,549,1471
251080,202103,18789,47238,15240,41912,2131,6017,9292,25871,11423,31888
251090,202103,2912,8215,2460,7427,62,188,1942,5848,2004,6036
251100,202103,805,2535,714,2360,24,86,560,1790,584,1876
251110,202103,1748,4554,1488,4104,70,155,1130,3125,1200,3280
251120,202103,7511,20537,6345,19128,275,961,5021,15176,5296,16137
251130,202103,3916,8591,3456,8075,54,145,3147,7319,3201,7464
251140,202103,4292,11831,3830,11186,66,273,3214,9281,3280,9554
251150,202103,2673,7622,2440,7240,74,318,2078,6021,2152,6339
251160,202103,2174,6278,1881,5857,37,175,1625,4967,1662,5142
251170,202103,1639,4322,1435,4061,23,75,1282,3597,1305,3672
251180,202103,2635,6965,2161,6301,148,437,1507,4386,1655,4823
251190,202103,4409,11436,4008,10985,42,233,3643,9783,3685,10016
251200,202103,4428,12719,3915,12078,71,293,3458,10686,3529,10979
251203,202103,957,3067,879,2889,22,104,666,2130,688,2234
251207,202103,1112,2964,845,2538,16,79,602,1770,618,1849
251210,202103,7770,19281,6385,17407,297,640,4865,13568,5162,14208
251220,202103,1258,2955,943,2543,59,130,707,1957,766,2087
251230,202103,4687,12911,4052,11799,113,406,3213,9114,3326,9520
251240,202103,3663,9975,3085,9014,164,424,2315,6708,2479,7132
251250,202103,10599,28079,9304,25895,710,1978,6897,18734,7607,20712
251260,202103,505,1403,457,1326,15,65,365,1027,380,1092
251270,202103,4267,13179,3841,12610,107,422,3141,10532,3248,10954
251272,202103,1318,3570,1201,3414,48,177,1001,2783,1049,2960
251274,202103,897,2487,720,2167,57,196,477,1374,534,1570
251275,202103,1187,3341,1013,3055,26,121,806,2365,832,2486
251276,202103,1321,3571,1150,3346,24,129,938,2635,962,2764
251278,202103,608,1647,551,1567,41,107,417,1202,458,1309
251280,202103,2240,6012,2042,5725,51,143,1723,4797,1774,4940
251290,202103,6011,13873,5458,13208,162,489,4795,11279,4957,11768
251300,202103,883,2561,800,2436,9,46,680,2055,689,2101
251310,202103,2712,7695,2356,7154,40,220,1945,5773,1985,5993
251315,202103,1763,5402,1605,5098,113,307,1193,3783,1306,4090
251320,202103,1633,4295,1200,3540,28,94,903,2620,931,2714
251330,202103,2113,4879,1750,4454,24,73,1565,4019,1589,4092
251335,202103,1108,3115,991,2928,22,103,879,2542,901,2645
251340,202103,3787,8905,3040,7925,124,334,2357,6140,2481,6474
251350,202103,1054,3000,961,2847,27,89,792,2318,819,2407
251360,202103,1844,5109,1498,4615,11,60,1254,3864,1265,3924
251365,202103,731,1973,578,1674,5,14,457,1309,462,1323
251370,202103,24468,63580,20936,58570,2905,8095,12495,35983,15400,44078
251380,202103,1231,3408,1062,3120,14,88,900,2574,914,2662
251385,202103,749,1922,584,1624,27,74,427,1154,454,1228
251390,202103,6457,18438,5711,17291,516,1557,3805,11639,4321,13196
251392,202103,997,2671,847,2442,28,116,666,1878,694,1994
251394,202103,604,1729,493,1539,19,80,366,1127,385,1207
251396,202103,655,1765,565,1604,13,35,401,1118,414,1153
251398,202103,1005,2488,705,1968,21,67,526,1441,547,1508
251400,202103,1282,3011,1012,2642,22,87,821,2068,843,2155
251410,202103,1577,3651,1280,3233,21,83,1091,2651,1112,2734
251420,202103,1966,5083,1617,4669,39,125,1300,3716,1339,3841
251430,202103,1579,4702,1423,4429,27,136,1233,3817,1260,3953
251440,202103,1105,3049,899,2661,41,95,700,2111,741,2206
251445,202103,1549,4254,1432,4095,29,94,1230,3469,1259,3563
251450,202103,4408,12868,3946,12160,81,299,3296,10077,3377,10376
251455,202103,865,2587,791,2453,17,70,638,1935,655,2005
251460,202103,941,2654,813,2458,12,40,669,2029,681,2069
251465,202103,452,1310,389,1194,6,26,296,880,302,906
251470,202103,1188,3238,899,2650,75,238,517,1460,592,1698
251480,202103,1028,2670,844,2349,15,61,659,1764,674,1825
251490,202103,1907,4965,1515,4415,68,205,1130,3321,1198,3526
251500,202103,1997,5480,1835,5277,31,112,1674,4808,1705,4920
251510,202103,2642,7847,2205,6995,118,402,1513,4718,1631,5120
251520,202103,1017,2599,785,2171,72,183,502,1364,574,1547
251530,202103,14812,35131,11930,31553,92,507,10589,27537,10681,28044
251540,202103,3050,8506,2753,7968,64,225,2337,6676,2401,6901
251550,202103,3878,8997,3143,8105,122,197,2601,6798,2723,6995
251560,202103,559,1687,499,1596,54,182,348,1079,402,1261
251570,202103,964,2681,793,2344,20,87,633,1820,653,1907
251580,202103,1942,4606,1740,4319,32,126,1504,3602,1536,3728
251590,202103,1608,3916,1358,3626,62,149,1126,2968,1188,3117
251593,202103,914,2667,821,2512,88,273,527,1605,615,1878
251597,202103,2131,5915,1916,5631,18,95,1715,4973,1733,5068
251600,202103,6403,17135,5601,15918,204,577,4595,12922,4799,13499
251610,202103,3140,8960,2730,8201,237,644,1859,5720,2096,6364
251615,202103,1307,3186,1055,2814,19,58,856,2211,875,2269
251620,202103,19407,43782,14929,38319,84,293,12920,33463,13004,33756
251630,202103,4804,11082,3884,9816,202,496,2927,7350,3129,7846
251640,202103,2228,5928,1993,5564,21,94,1777,4865,1798,4959
251650,202103,3950,10526,3454,9877,130,388,2903,8325,3033,8713
251660,202103,3546,10461,3146,9769,65,290,2630,8047,2695,8337
251670,202103,4097,11337,3646,10683,40,194,3268,9521,3308,9715
251675,202103,685,1866,619,1786,89,236,416,1228,505,1464
251680,202103,2562,6608,2149,6076,40,123,1766,5041,1806,5164
251690,202103,3093,8614,2641,7842,89,255,2016,5960,2105,6215
251700,202103,2207,6066,1838,5608,46,190,1560,4674,1606,4864
251710,202103,790,2027,557,1558,35,110,326,865,361,975
251720,202103,1319,3694,1071,3271,19,86,835,2479,854,2565
251740,202103,609,1681,489,1453,40,148,329,933,369,1081
260005,202103,29995,63065,24756,56350,1774,3896,18877,42211,20651,46107
260010,202103,10299,26678,8524,23830,487,1390,5060,14256,5547,15646
260020,202103,6898,15905,5850,14414,70,297,4993,12087,5063,12384
260030,202103,6934,17470,5852,15894,133,388,4770,12894,4903,13282
260040,202103,7587,19078,6386,17363,426,1142,4640,12799,5066,13941
260050,202103,14051,36108,11724,33541,178,657,10810,31013,10988,31670
260060,202103,4188,10117,3616,9214,256,530,2763,7179,3019,7709
260070,202103,10838,26692,9305,24514,301,1040,7614,19512,7915,20552
260080,202103,6521,14797,5691,13704,106,333,4786,11341,4892,11674
260090,202103,4625,11834,4127,11156,400,1098,3068,8314,3468,9412
260100,202103,2954,7955,2490,7257,42,212,2078,5959,2120,6171
260105,202103,5014,13599,4500,12908,115,388,3824,10830,3939,11218
260110,202103,22407,61397,20002,57915,880,2946,16639,47545,17519,50491
260120,202103,14657,38283,12408,34974,1441,3906,7960,22856,9401,26762
260130,202103,3199,7983,2837,7463,237,578,2099,5479,2336,6057
260140,202103,12809,28641,11074,26618,516,1386,9361,22168,9877,23554
260150,202103,3562,8233,3082,7645,85,222,2716,6695,2801,6917
260160,202103,6569,16861,5589,15684,94,324,5059,14315,5153,14639
260170,202103,20828,48193,17727,44040,903,2178,14204,34958,15107,37136
260180,202103,3539,9266,3070,8628,67,247,2661,7360,2728,7607
260190,202103,18187,36326,15357,33005,183,445,13688,28913,13871,29358
260200,202103,10990,26287,9475,24356,452,998,7919,20715,8371,21713
260210,202103,11669,32642,9935,29812,291,1067,7941,23697,8232,24764
260220,202103,10728,24929,9925,23917,169,473,8839,21003,9008,21476
260230,202103,10909,26201,9527,24378,186,544,8092,20399,8278,20943
260240,202103,2764,8158,2425,7509,94,317,1873,5737,1967,6054
260250,202103,2203,5712,1928,5280,127,273,1461,4024,1588,4297
260260,202103,12772,32802,11382,30702,352,1163,9104,24080,9456,25243
260270,202103,4346,10366,3843,9769,100,369,3266,8156,3366,8525
260280,202103,13000,38290,11736,36500,402,1653,10075,30863,10477,32516
260290,202103,41094,102285,35377,94171,3764,10190,24120,64018,27884,74208
260300,202103,9627,25664,8424,24037,176,738,7193,20436,7369,21174
260310,202103,5426,13433,4801,12657,335,762,3718,9962,4053,10724
260320,202103,7820,22204,6643,20209,240,731,5427,16560,5667,17291
260330,202103,2574,7821,2254,7168,68,227,1787,5561,1855,5788
260340,202103,2075,5480,1805,5085,26,117,1578,4349,1604,4466
260345,202103,25857,65453,21609,59378,3284,9503,11404,30846,14688,40349
260350,202103,5723,13128,4957,12260,53,152,4451,10953,4504,11105
260360,202103,2507,6486,2270,6058,47,170,1617,4231,1664,4401
260370,202103,5599,15808,4830,14537,207,652,3757,11253,3964,11905
260380,202103,5119,14689,4396,13505,167,494,3357,10230,3524,10724
260390,202103,4611,13599,3828,12018,228,648,2570,7979,2798,8627
260392,202103,3431,10757,3107,10356,100,603,2563,8511,2663,9114
260400,202103,18816,42598,16238,39268,443,1168,12959,30202,13402,31370
260410,202103,73833,176317,57500,153817,10187,28486,25691,71064,35878,99550
260415,202103,4407,11590,3810,10630,45,173,3167,8686,3212,8859
260420,202103,12566,26058,10699,23987,90,247,9949,22122,10039,22369
260430,202103,2755,8472,2381,7732,108,413,1694,5428,1802,5841
260440,202103,3779,9571,3363,8967,65,214,2876,7549,2941,7763
260450,202103,5822,14375,5214,13602,290,567,4330,11518,4620,12085
260460,202103,5221,15277,4457,13950,468,1611,2689,8299,3157,9910
260470,202103,4953,12869,4188,11990,73,151,3850,11172,3923,11323
260480,202103,3941,10416,3321,9548,230,773,2310,6661,2540,7434
260490,202103,5385,12293,4793,11441,31,138,4377,10274,4408,10412
260500,202103,6056,14981,5169,13759,431,1071,3674,9929,4105,11000
260510,202103,9842,24031,8269,21837,108,418,7306,19120,7414,19538
260515,202103,4453,11703,3497,9938,163,403,2374,6588,2537,6991
260520,202103,16744,38533,14582,35798,692,1656,11956,28988,12648,30644
260530,202103,9890,28033,8449,25832,125,592,7302,22031,7427,22623
260540,202103,7304,15755,6467,14709,139,335,5837,13183,5976,13518
260545,202103,70,214,45,153,3,12,20,65,23,77
260550,202103,3113,8382,2552,7493,118,423,1772,5076,1890,5499
260560,202103,6050,15280,5095,13897,116,419,4304,11525,4420,11944
260570,202103,7722,20758,6816,19543,344,1055,5452,15703,5796,16758
260580,202103,4527,10606,4070,10002,24,74,3727,9107,3751,9181
260590,202103,6889,15495,5801,14289,236,533,4872,12149,5108,12682
260600,202103,31102,79199,25413,70675,1034,3105,19467,53169,20501,56274
260610,202103,7497,18996,6698,17961,407,1102,5037,13505,5444,14607
260620,202103,17018,42917,14923,39955,1250,3703,10957,28750,12207,32453
260630,202103,2412,6440,1977,5771,42,149,1612,4621,1654,4770
260640,202103,22582,49754,18903,45539,816,1936,15446,37002,16262,38938
260650,202103,6307,16023,5064,14519,448,837,4081,12141,4529,12978
260660,202103,6901,17998,5979,16787,167,653,5133,14109,5300,14762
260670,202103,2288,5888,1910,5304,82,201,1361,3702,1443,3903
260680,202103,29309,68978,24754,62595,1793,4696,17454,43372,19247,48068
260690,202103,3545,9070,2970,8181,71,260,2353,6430,2424,6690
260700,202103,6337,17355,5880,16839,18,60,5705,16421,5723,16481
260710,202103,1375,3563,1183,3284,31,124,938,2603,969,2727
260720,202103,24294,59049,20960,54747,1895,4883,15512,40534,17407,45417
260730,202103,7972,22265,6992,20920,235,783,5892,17427,6127,18210
260740,202103,1310,3698,1112,3380,13,67,877,2721,890,2788
260750,202103,7172,19480,5996,18020,248,479,5226,16232,5474,16711
260760,202103,5867,13512,5050,12562,175,449,4224,10548,4399,10997
260765,202103,8271,23214,7185,21729,358,1372,5146,15270,5504,16642
260770,202103,3909,9805,3258,8740,110,330,2575,6821,2685,7151
260775,202103,5264,13822,4630,12882,179,637,3655,9836,3834,10473
260780,202103,3714,10850,3324,10237,354,1173,2059,6195,2413,7368
260790,202103,121661,268143,100796,241473,15209,35201,62456,150182,77665,185383
260795,202103,2989,7509,2564,6968,74,240,2046,5606,2120,5846
260800,202103,5364,12356,4850,11672,130,388,4240,9900,4370,10288
260805,202103,3715,10206,3152,9241,200,596,2332,6771,2532,7367
260810,202103,6495,17409,5716,15919,455,1144,4136,11386,4591,12530
260820,202103,4603,10487,4083,9878,94,309,3435,8147,3529,8456
260825,202103,3006,8720,2648,8096,110,361,2000,6058,2110,6419
260830,202103,4243,12189,3538,10948,474,1261,2222,7136,2696,8397
260840,202103,4240,10849,3802,10254,210,509,3185,8619,3395,9128
260845,202103,4533,11694,4020,10837,233,643,3032,8037,3265,8680
260850,202103,5220,13963,4379,12409,343,1033,2813,7695,3156,8728
260860,202103,3372,9539,2913,8765,97,338,2344,6899,2441,7237
260870,202103,4558,10854,3909,10070,64,244,3503,8902,3567,9146
260875,202103,7410,17635,6073,15706,541,1368,4205,10971,4746,12339
260880,202103,9742,26990,8493,24863,472,1375,6661,19493,7133,20868
260890,202103,13082,32910,11365,30331,594,1646,8321,21713,8915,23359
260900,202103,5414,14723,4452,13398,295,905,3002,9046,3297,9951
260910,202103,3306,8754,2877,8119,105,298,2273,6387,2378,6685
260915,202103,5089,14881,4479,14180,54,251,4092,12974,4146,13225
260920,202103,3508,8244,2986,7686,113,214,2562,6709,2675,6923
260930,202103,3841,11743,3322,10844,171,655,2520,8037,2691,8692
260940,202103,15077,35201,13158,32578,1099,2641,9823,24038,10922,26679
260950,202103,7254,18913,5877,16567,359,1195,3860,10346,4219,11541
260960,202103,72394,158099,58459,140498,6127,14914,37911,90073,44038,104987
260970,202103,5887,14892,5238,14024,260,544,3891,10690,4151,11234
260980,202103,4676,13286,4110,12585,53,163,3760,11623,3813,11786
260990,202103,18526,49275,15728,45468,845,2509,12379,35449,13224,37958
261000,202103,16613,38307,13993,35028,382,1188,11324,27718,11706,28906
261010,202103,2353,6107,2066,5729,74,184,1801,5024,1875,5208
261020,202103,6064,16167,5271,14862,187,644,4358,11873,4545,12517
261030,202103,4087,11673,3601,10824,117,450,2880,8427,2997,8877
261040,202103,5443,15403,4454,13544,150,571,3398,10033,3548,10604
261050,202103,7920,20106,7197,19004,438,809,5607,14981,6045,15790
261060,202103,14414,35449,12578,33254,259,801,10612,27763,10871,28564
261070,202103,65920,141315,54829,126895,2982,6585,41910,94998,44892,101583
261080,202103,6856,16069,6240,15322,138,318,5785,14189,5923,14507
261090,202103,19861,45789,17687,42990,355,1057,15514,37111,15869,38168
261100,202103,8426,22854,7370,21313,507,1509,5435,15775,5942,17284
261110,202103,68674,187670,57854,168305,7801,23766,34343,98571,42144,122337
261120,202103,3625,9062,3172,8443,75,181,2742,7299,2817,7480
261130,202103,7413,17814,6550,16679,123,349,5787,14616,5910,14965
261140,202103,3802,8569,3386,8023,194,473,2683,6264,2877,6737
261150,202103,5179,13478,4597,12606,66,247,3993,10823,4059,11070
261153,202103,1923,5724,1625,5144,58,186,1093,3487,1151,3673
261160,202103,217772,494681,177041,439453,42442,108443,74077,187434,116519,295877
261170,202103,6236,15070,5558,14114,279,596,4517,11429,4796,12025
261180,202103,9703,23701,8465,22087,487,1146,6172,16310,6659,17456
261190,202103,4674,13305,4186,12515,152,650,3347,9701,3499,10351
261200,202103,3378,7725,3004,7226,155,407,2511,5942,2666,6349
261210,202103,1931,4636,1659,4253,64,167,1387,3504,1451,3671
261220,202103,13734,38275,11506,34246,1430,4563,6610,19402,8040,23965
261230,202103,4079,11457,3411,10552,41,152,2868,8965,2909,9117
261240,202103,5464,13386,4823,12384,296,707,3923,10005,4219,10712
261245,202103,3803,10417,3191,9349,77,353,2554,7200,2631,7553
261247,202103,2970,8743,2475,7863,165,536,1694,5358,1859,5894
261250,202103,22707,50906,19692,47427,2219,4850,14291,35542,16510,40392
261255,202103,4104,11878,3366,10446,135,567,2567,7755,2702,8322
261260,202103,12873,34216,11228,32074,331,1258,9723,27460,10054,28718
261270,202103,4617,10962,4042,10248,201,472,3318,8395,3519,8867
261280,202103,2541,7026,2246,6524,56,192,1807,5111,1863,5303
261290,202103,2985,7637,2501,7092,63,237,2033,5819,2096,6056
261300,202103,12638,34482,10800,31426,552,1937,7982,22655,8534,24592
261310,202103,9037,22411,7734,20662,587,1705,5780,15131,6367,16836
261320,202103,6026,16720,5278,15496,73,301,4498,13022,4571,13323
261330,202103,5752,14036,5189,13309,118,427,4520,11374,4638,11801
261340,202103,4320,11810,3759,11099,136,491,3146,9191,3282,9682
261350,202103,8804,25543,7782,23812,117,491,6332,19175,6449,19666
261360,202103,8240,19458,6993,17709,235,617,5625,13886,5860,14503
261370,202103,24191,59291,20290,53982,2164,5517,13107,35263,15271,40780
261380,202103,4134,12261,3658,11446,447,1473,2419,7477,2866,8950
261390,202103,17051,47526,14466,43400,1171,3816,9710,28828,10881,32644
261400,202103,4633,14487,4062,13242,174,730,3054,9683,3228,10413
261410,202103,9817,23989,8095,21376,403,1170,6500,16735,6903,17905
261420,202103,7353,21524,6624,20642,701,2468,4764,14797,5465,17265
261430,202103,3491,9696,2967,8870,61,261,2503,7373,2564,7634
261440,202103,1491,4367,1247,3907,43,193,896,2689,939,2882
261450,202103,14926,39825,13200,37190,163,573,10934,30922,11097,31495
261460,202103,7705,20721,6795,19307,299,882,5437,15422,5736,16304
261470,202103,4181,10236,3645,9508,18,91,3179,8268,3197,8359
261480,202103,5068,15337,4384,14196,201,789,3402,10804,3603,11593
261485,202103,4871,13665,4222,12680,324,1060,3089,9159,3413,10219
261500,202103,6147,15333,5375,14281,381,863,3773,10430,4154,11293
261510,202103,1914,5590,1667,5186,58,214,1274,3985,1332,4199
261520,202103,2361,7132,2124,6650,63,216,1577,4907,1640,5123
261530,202103,12183,34953,9877,30838,871,3181,5118,15381,5989,18562
261540,202103,8412,23493,7590,22325,1147,3210,4316,13482,5463,16692
261550,202103,3709,9715,3203,8940,236,698,2299,6287,2535,6985
261560,202103,7811,22737,6786,21214,278,987,5279,16507,5557,17494
261570,202103,3524,9389,2817,8248,173,576,1964,5662,2137,6238
261580,202103,6949,17921,6010,16652,99,436,5414,14812,5513,15248
261590,202103,2736,6932,2228,6215,76,245,1687,4685,1763,4930
261600,202103,5354,13050,4564,11909,297,631,3248,8676,3545,9307
261610,202103,2153,6106,1727,5324,102,375,1155,3527,1257,3902
261618,202103,2571,6247,2250,5777,81,190,1814,4633,1895,4823
261620,202103,4237,11715,3856,11153,746,1913,2519,7618,3265,9531
261630,202103,6176,17229,5278,15564,364,1253,3559,10105,3923,11358
261640,202103,37612,83183,32028,76346,1894,3459,24192,59556,26086,63015
261650,202103,4211,10307,3596,9508,162,461,2712,7124,2874,7585
270010,202103,4383,14404,3813,13437,137,771,3077,10513,3214,11284
270020,202103,3930,9669,3445,9054,126,410,2955,7591,3081,8001
270030,202103,34078,91130,28383,82011,3373,9593,19222,55426,22595,65019
270040,202103,11000,28618,9472,26815,373,1203,7931,22354,8304,23557
270050,202103,5484,12657,4685,11755,282,606,4034,10254,4316,10860
270060,202103,2243,5574,1885,5168,158,378,1493,4165,1651,4543
270070,202103,4738,13130,4120,12274,123,447,3452,10113,3575,10560
270080,202103,1441,3867,1218,3484,47,143,932,2560,979,2703
270090,202103,1771,5340,1599,5006,59,241,1329,4063,1388,4304
270100,202103,5632,14364,4874,13268,201,620,4064,10892,4265,11512
270110,202103,3302,7477,2678,6765,146,297,2131,5661,2277,5958
270120,202103,2672,7333,2330,6879,69,301,1971,5713,2040,6014
270130,202103,5141,12939,4475,12141,133,385,3891,10597,4024,10982
270135,202103,2049,4839,1738,4493,34,110,1601,4102,1635,4212
270140,202103,9619,22270,7727,19658,330,1019,6068,14764,6398,15783
270150,202103,2703,8063,2463,7712,3,19,2326,7271,2329,7290
270160,202103,6224,16563,5292,15514,98,356,4880,14355,4978,14711
270170,202103,3361,9761,2836,9036,169,770,2162,6610,2331,7380
270180,202103,2246,6898,2066,6670,35,169,1875,5990,1910,6159
270190,202103,1724,4963,1541,4738,26,130,1382,4214,1408,4344
270200,202103,2450,7295,2138,6868,81,280,1612,5180,1693,5460
270210,202103,5862,13465,5001,12492,59,214,4633,11403,4692,11617
270220,202103,1666,4217,1322,3727,176,502,814,2268,990,2770
270230,202103,9191,25078,7625,22682,652,2078,5435,16123,6087,18201
270235,202103,5702,17378,4920,16143,112,488,4115,13378,4227,13866
270240,202103,10904,29322,8931,26592,946,2932,6271,18839,7217,21771
270250,202103,2847,7032,2506,6542,174,441,2021,5271,2195,5712
270255,202103,4442,12624,3507,10932,108,434,2720,8338,2828,8772
270260,202103,5555,16310,5036,15457,97,462,4411,13270,4508,13732
270270,202103,1051,2713,875,2496,100,289,647,1839,747,2128
270280,202103,3871,9215,3110,8263,483,746,2204,6323,2687,7069
270290,202103,7375,23273,6655,22088,132,666,5880,19283,6012,19949
270300,202103,4281,10934,3344,9918,185,462,2600,7923,2785,8385
270310,202103,7015,19367,6038,17849,79,416,5221,15096,5300,15512
270320,202103,5562,16164,4815,14723,359,1122,3462,10305,3821,11427
270330,202103,4002,12698,3567,12033,250,945,2780,9356,3030,10301
270340,202103,1579,4217,1363,3939,45,135,1166,3324,1211,3459
270350,202103,1905,4397,1558,3995,130,350,1135,2938,1265,3288
270360,202103,2643,6503,2361,6189,92,181,2167,5738,2259,5919
270370,202103,1393,4236,1276,4025,35,166,1088,3371,1123,3537
270375,202103,3129,7239,2595,6652,23,67,2431,6248,2454,6315
270380,202103,5539,15222,4666,14107,555,1577,3218,10059,3773,11636
270390,202103,1214,3011,981,2748,23,89,817,2288,840,2377
270400,202103,6484,16679,5467,15160,268,650,4343,12014,4611,12664
270410,202103,4605,13089,3995,12178,135,471,3361,10205,3496,10676
270420,202103,5568,16208,4996,15373,118,531,4361,13176,4479,13707
270430,202103,134182,314441,105652,278146,20459,55757,50382,134969,70841,190726
270440,202103,4757,12698,4124,11925,79,316,3645,10431,3724,10747
270450,202103,7140,18795,6267,17745,263,795,5257,15112,5520,15907
270460,202103,3773,8277,3240,7644,162,298,2908,6904,3070,7202
270470,202103,11145,30516,9720,28527,612,1965,7617,22344,8229,24309
270480,202103,2987,7775,2520,7104,90,321,2071,5714,2161,6035
270490,202103,955,2591,836,2445,52,153,675,1970,727,2123
270500,202103,4966,14942,4415,14031,275,1002,3488,10948,3763,11950
270510,202103,5502,14444,4631,13349,327,1243,3464,9564,3791,10807
270520,202103,4049,11301,3220,9913,664,2095,1309,4223,1973,6318
270530,202103,1318,3680,1108,3353,59,158,792,2443,851,2601
270540,202103,2267,6275,1949,5859,56,230,1705,5058,1761,5288
270550,202103,6796,17289,5416,15768,643,1497,3956,12064,4599,13561
270560,202103,2966,7560,2556,7017,131,404,2094,5693,2225,6097
270570,202103,4057,11301,3442,10391,124,388,2806,8428,2930,8816
270580,202103,2282,6347,2069,6045,103,311,1776,5157,1879,5468
270590,202103,1603,4796,1478,4626,15,75,1397,4353,1412,4428
270600,202103,2751,8429,2492,8039,46,226,2224,7097,2270,7323
270610,202103,3679,9420,3192,8785,100,270,2845,7811,2945,8081
270620,202103,1273,3745,1175,3563,25,99,1030,3048,1055,3147
270630,202103,17418,42142,14977,38789,607,1848,12529,31787,13136,33635
270640,202103,5373,15250,4690,14152,170,666,3881,11511,4051,12177
270642,202103,2505,7969,2225,7535,141,594,1713,5697,1854,6291
270644,202103,3656,9015,3023,8205,336,808,2210,6218,2546,7026
270650,202103,3164,9159,2782,8635,335,1091,2040,6328,2375,7419
270660,202103,2013,5061,1720,4642,75,247,1322,3510,1397,3757
270670,202103,16476,37214,13745,33879,362,1033,11825,28458,12187,29491
270680,202103,5637,13168,5045,12526,125,188,4714,11859,4839,12047
270690,202103,9370,22653,7866,20765,381,1025,6323,16541,6704,17566
270700,202103,518,1544,456,1441,34,124,338,1047,372,1171
270710,202103,5471,16244,4871,15326,237,899,3923,12186,4160,13085
270720,202103,3672,10488,3277,9831,54,288,2925,8605,2979,8893
270730,202103,8271,17920,7279,16867,268,476,5720,14709,5988,15185
270740,202103,2391,6192,2109,5867,90,292,1761,4840,1851,5132
270750,202103,5784,14875,5073,13975,67,302,4565,12472,4632,12774
270760,202103,3242,9060,2805,8479,43,210,2385,7136,2428,7346
270770,202103,21249,51388,17075,46280,2751,6609,10443,29989,13194,36598
270780,202103,1857,4918,1715,4720,62,208,1521,4132,1583,4340
270790,202103,1668,4445,1404,4088,112,339,1050,3030,1162,3369
270800,202103,11120,29657,10041,28129,330,1125,8663,23973,8993,25098
270810,202103,3383,9477,2684,8308,166,597,1894,5766,2060,6363
270820,202103,1582,4703,1345,4328,43,212,1069,3372,1112,3584
270830,202103,5077,12100,4116,10920,156,520,3361,8762,3517,9282
270840,202103,8283,24471,7388,23198,155,830,6482,19882,6637,20712
270850,202103,9032,21166,7976,19921,719,1910,6551,16191,7270,18101
270860,202103,14639,31812,11629,28447,586,1257,9466,23169,10052,24426
270870,202103,2198,6100,1819,5510,242,670,1169,3680,1411,4350
270880,202103,8090,23978,7227,22674,207,874,6050,18671,6257,19545
270890,202103,2943,7817,2463,7138,179,518,1698,4923,1877,5441
270895,202103,3147,9400,2860,9030,65,349,2551,7897,2616,8246
270900,202103,1781,4564,1351,3881,34,99,1067,3037,1101,3136
270910,202103,3866,11036,3333,10211,87,289,2757,8332,2844,8621
270915,202103,9594,26807,7751,23841,637,2213,5308,15978,5945,18191
270920,202103,5328,16007,4855,15222,108,487,4131,12634,4239,13121
270930,202103,17316,39518,13389,34973,1743,4121,9020,24841,10763,28962
270940,202103,6726,17185,5706,15974,197,763,4719,12901,4916,13664
280010,202103,693,1873,554,1590,15,62,393,1030,408,1092
280020,202103,4918,12278,4169,11102,413,1049,2887,7734,3300,8783
280030,202103,77191,178512,61503,156606,12294,31428,28463,75160,40757,106588
280040,202103,2949,8051,2583,7500,251,698,1776,5177,2027,5875
280050,202103,3913,11030,3365,10200,591,1813,1934,5865,2525,7678
280060,202103,5901,15194,4712,13375,887,2654,2215,6547,3102,9201
280067,202103,7070,17080,6020,15482,295,757,4449,11303,4744,12060
280070,202103,1887,5552,1756,5349,120,375,1454,4398,1574,4773
280100,202103,4024,10483,3390,9500,340,967,2305,6462,2645,7429
280110,202103,1435,3775,1269,3528,14,66,1131,3066,1145,3132
280120,202103,7654,21705,6829,20394,790,2129,4916,15137,5706,17266
280130,202103,9033,21030,7932,19491,412,1087,6430,15659,6842,16746
280140,202103,5568,13043,4917,12160,242,661,4120,10105,4362,10766
280150,202103,4233,10522,3674,9756,425,996,2722,7350,3147,8346
280160,202103,1206,3399,1018,3089,93,316,698,2076,791,2392
280170,202103,5179,13478,4655,12820,249,619,3765,10421,4014,11040
280190,202103,1302,2813,1164,2631,51,124,979,2169,1030,2293
280200,202103,1276,3292,1064,2999,59,206,815,2257,874,2463
280210,202103,17043,41646,14817,38493,1544,4017,9517,24834,11061,28851
280220,202103,1749,4626,1500,4301,47,200,1240,3520,1287,3720
280230,202103,4467,10977,3744,9923,333,715,2596,7018,2929,7733
280240,202103,3332,8801,2980,8262,41,213,2593,7011,2634,7224
280250,202103,941,2204,782,1963,82,215,541,1319,623,1534
280260,202103,2252,5310,1983,4974,39,93,1793,4541,1832,4634
280270,202103,2464,6517,2191,6104,159,413,1765,4929,1924,5342
280280,202103,4206,12254,3744,11558,523,1380,2583,8372,3106,9752
280290,202103,18507,47680,15921,44071,1321,3808,10776,30020,12097,33828
280300,202103,12491,28937,10940,27271,318,767,8047,22147,8365,22914
280310,202103,1411,3578,1179,3197,42,128,893,2360,935,2488
280320,202103,8705,23136,7554,21420,941,2566,5013,14192,5954,16758
280330,202103,4729,11539,4038,10586,243,671,2978,7786,3221,8457
280340,202103,5568,11619,4621,10590,235,386,3992,9326,4227,9712
280350,202103,26438,60967,23286,56831,1069,2681,18554,44513,19623,47194
280360,202103,5613,15390,4932,14262,713,2079,2926,8632,3639,10711
280370,202103,2144,5245,1808,4704,76,179,1427,3672,1503,3851
280380,202103,1012,2631,862,2430,76,206,588,1683,664,1889
280390,202103,3713,8883,3154,8029,174,364,2490,6385,2664,6749
280400,202103,3852,9571,3344,8879,531,1245,2064,5766,2595,7011
280410,202103,2333,6298,1903,5634,161,480,1154,3360,1315,3840
280420,202103,4358,11393,4023,10975,67,244,3707,10053,3774,10297
280430,202103,2089,4981,1840,4659,62,208,1513,3718,1575,3926
280440,202103,4319,11224,3821,10500,143,449,3242,8699,3385,9148
280445,202103,2372,5965,2132,5557,47,126,1634,4110,1681,4236
280450,202103,10282,23790,8936,21991,1063,2238,5811,15012,6874,17250
280460,202103,6943,16133,6282,15237,386,839,5309,12807,5695,13646
280470,202103,1705,4733,1456,4279,71,225,1083,3125,1154,3350
280480,202103,44356,105391,38331,96982,3177,8373,27263,67671,30440,76044
280490,202103,3797,10707,3264,9795,94,384,2525,7352,2619,7736
280500,202103,1014,2373,875,2189,27,83,744,1827,771,1910
280510,202103,2630,6437,2286,5967,145,392,1707,4404,1852,4796
280520,202103,1637,4096,1438,3823,58,153,1162,3048,1220,3201
280530,202103,2465,6120,2148,5683,247,550,1541,4185,1788,4735
280540,202103,8891,23552,8119,22450,252,823,7119,19462,7371,20285
280550,202103,6613,15175,5496,13631,155,557,4595,10981,4750,11538
280560,202103,7430,20001,6996,19352,115,418,6238,17016,6353,17434
280570,202103,6482,15577,5282,14065,229,684,3937,10520,4166,11204
280580,202103,5755,14836,5036,13798,561,1339,3618,10087,4179,11426
280590,202103,2927,6566,2518,6089,118,406,1997,4631,2115,5037
280600,202103,3608,9372,3206,8816,248,643,2252,6253,2500,6896
280610,202103,2452,5971,2212,5616,141,341,1807,4567,1948,4908
280620,202103,5538,13242,4778,12260,421,907,3352,9002,3773,9909
280630,202103,3906,10615,3602,10200,173,564,2956,8318,3129,8882
280640,202103,2346,6241,2074,5934,48,143,1856,5332,1904,5475
280650,202103,1203,3126,981,2797,82,278,714,1939,796,2217
280660,202103,3753,8078,3233,7474,245,414,2661,6306,2906,6720
280670,202103,19910,44719,17168,41207,1323,3072,13147,31575,14470,34647
280680,202103,2777,6580,2397,6047,226,414,1736,4477,1962,4891
280690,202103,985,2333,835,2139,52,120,666,1683,718,1803
280700,202103,1176,2922,1021,2692,20,61,815,2125,835,2186
280710,202103,15524,34320,13187,31666,568,1027,11091,27405,11659,28432
280720,202103,2689,6095,2237,5557,49,151,1673,4284,1722,4435
280730,202103,1101,2762,980,2575,53,153,741,1884,794,2037
280740,202103,14299,34125,12285,31109,797,2061,8934,22097,9731,24158
280750,202103,3660,10057,3190,9263,185,566,2308,6597,2493,7163
280760,202103,6555,16936,5721,15664,601,1464,3764,10673,4365,12137
290010,202103,3209,6661,2101,4957,5,16,1740,3936,1745,3952
290020,202103,5408,14116,4931,13519,340,619,4149,11789,4489,12408
290030,202103,4725,10531,3814,9538,182,403,3226,8180,3408,8583
290035,202103,5250,11142,4366,10015,347,508,3481,8306,3828,8814
290040,202103,4203,10163,3587,9423,108,287,2824,7857,2932,8144
290050,202103,2030,6490,1702,5781,107,438,1160,3842,1267,4280
290060,202103,1344,3122,995,2593,119,302,628,1647,747,1949
290070,202103,37695,81093,32502,74723,1820,4326,25455,57858,27275,62184
290080,202103,5278,15311,4573,14252,482,1559,3157,9973,3639,11532
290090,202103,2187,4169,1543,3484,15,40,1405,3163,1420,3203
290100,202103,9854,25312,8006,22605,1372,3620,4257,12712,5629,16332
290110,202103,5110,13414,4550,12564,315,887,3290,8987,3605,9874
290115,202103,4015,11515,3388,10399,253,797,2535,7778,2788,8575
290120,202103,6624,16065,5585,14623,129,417,4816,12404,4945,12821
290130,202103,4782,11499,3725,10115,163,447,2890,7866,3053,8313
290135,202103,4304,10003,3559,8816,145,384,2841,6803,2986,7187
290140,202103,4492,11596,3471,10248,83,306,2949,8681,3032,8987
290150,202103,2544,6361,2184,5920,138,351,1705,4679,1843,5030
290160,202103,3495,7733,3103,7202,245,487,2507,5830,2752,6317
290170,202103,3409,8495,3023,8078,107,245,2697,7325,2804,7570
290180,202103,2998,8105,2484,7268,74,269,2045,5920,2119,6189
290190,202103,4292,11761,3784,11072,125,461,3139,9070,3264,9531
290195,202103,2288,5629,1832,5034,23,117,1560,4262,1583,4379
290200,202103,4126,11337,3365,10073,162,533,2560,7595,2722,8128
290205,202103,3462,8779,3082,8224,121,389,2489,6477,2610,6866
290210,202103,12837,35421,11406,33269,803,2148,8939,26468,9742,28616
290220,202103,2937,7064,2576,6607,113,291,2127,5433,2240,5724
290225,202103,3196,6802,2481,6046,134,231,2118,5259,2252,5490
290230,202103,2478,6481,2264,6224,31,84,2044,5619,2075,5703
290240,202103,3755,9305,2990,8356,67,224,2529,7067,2596,7291
290250,202103,3981,11452,3328,10476,101,319,2746,8788,2847,9107
290260,202103,5501,13188,4648,11973,161,516,3919,9858,4080,10374
290265,202103,3586,10247,2924,9000,226,626,2044,6338,2270,6964
290270,202103,10818,36649,10106,35450,508,2182,8174,28475,8682,30657
290280,202103,6164,18146,5328,16491,282,981,3873,11838,4155,12819
290290,202103,10003,28589,8189,25326,771,2568,5486,16720,6257,19288
290300,202103,4184,11306,3106,9273,150,484,2234,6650,2384,7134
290310,202103,1647,3924,1315,3529,41,175,1077,2808,1118,2983
290320,202103,24417,62782,19448,55327,4231,11738,9304,28065,13535,39803
290323,202103,3737,10109,3262,9380,103,315,2569,7416,2672,7731
290327,202103,4094,11737,3526,10662,263,736,2544,7663,2807,8399
290330,202103,2289,4655,1792,4123,42,63,1605,3744,1647,3807
290340,202103,5775,14048,4378,12357,403,1125,3188,9134,3591,10259
290350,202103,4793,13155,4008,11829,280,813,2844,8465,3124,9278
290360,202103,5099,13119,4477,12314,135,321,3851,10690,3986,11011
290370,202103,5309,12638,3893,10782,211,478,2732,7737,2943,8215
290380,202103,5643,14825,4694,13532,119,282,4006,11778,4125,12060
290390,202103,14705,41420,12252,37523,1381,4081,7881,24602,9262,28683
290395,202103,2922,8252,2356,7295,55,252,1815,5536,1870,5788
290400,202103,3823,10106,3116,8941,101,362,2419,6806,2520,7168
290405,202103,4710,13506,4030,12353,306,961,2756,8622,3062,9583
290410,202103,5744,15347,4419,13243,119,508,3346,9785,3465,10293
290420,202103,3091,8320,2572,7515,72,215,2036,5921,2108,6136
290430,202103,3217,8621,2644,7737,220,658,1824,5256,2044,5914
290440,202103,2889,7009,2077,5744,57,134,1475,4162,1532,4296
290450,202103,3502,8771,2755,7641,150,373,2003,5638,2153,6011
290460,202103,11902,33199,10055,29748,2056,6166,4375,12979,6431,19145
290470,202103,4585,11050,3384,9401,417,1232,1922,5433,2339,6665
290475,202103,6571,18851,5584,17127,76,415,4632,13937,4708,14352
290480,202103,1791,4463,1463,4001,70,241,1051,2745,1121,2986
290485,202103,4594,13156,4062,12413,94,454,3494,10534,3588,10988
290490,202103,9042,21132,8126,19885,468,992,6400,15928,6868,16920
290500,202103,4015,11899,3141,10056,524,1764,1377,4299,1901,6063
290510,202103,3559,8632,2984,7893,58,180,2630,6920,2688,7100
290515,202103,3682,10142,3197,9469,43,140,2889,8693,2932,8833
290520,202103,11587,32558,9036,27694,594,1925,5529,16781,6123,18706
290530,202103,5021,14212,4236,12944,123,495,3596,10913,3719,11408
290540,202103,3370,8731,3019,8347,45,140,2805,7751,2850,7891
290550,202103,4290,11178,3767,10558,11,61,3476,9846,3487,9907
290560,202103,6334,16241,4835,14067,380,1368,3202,8999,3582,10367
290570,202103,44483,108402,39480,102111,2389,6291,31866,81950,34255,88241
290580,202103,7955,22773,6869,21216,610,1771,5067,16094,5677,17865
290590,202103,7092,21560,5999,19624,145,544,4825,15877,4970,16421
290600,202103,19271,52420,16966,48706,719,2033,13674,39209,14393,41242
290610,202103,2598,7904,2043,6768,85,333,1443,4731,1528,5064
290620,202103,6204,17388,5371,16025,191,547,4528,13507,4719,14054
290630,202103,9410,22230,7529,19841,637,1580,5712,15263,6349,16843
290640,202103,2814,7076,2187,6184,113,307,1552,4527,1665,4834
290650,202103,12972,31709,11451,30011,2453,6147,7212,19771,9665,25918
290660,202103,3673,9385,3071,8499,53,151,2331,6636,2384,6787
290670,202103,6591,18078,5604,16470,363,1018,4265,12744,4628,13762
290680,202103,11019,30055,9237,27431,176,914,7697,22428,7873,23342
290682,202103,4802,12204,4166,11358,128,290,3522,9703,3650,9993
290685,202103,3507,7829,2534,6444,212,477,1531,4194,1743,4671
290687,202103,6501,17374,5314,15459,686,1910,3433,10248,4119,12158
290689,202103,2900,7886,2214,6632,188,602,1500,4497,1688,5099
290690,202103,5302,13748,4312,12373,284,888,3152,8901,3436,9789
290700,202103,2729,7155,2415,6753,49,185,2106,5866,2155,6051
290710,202103,8281,23022,7118,21424,191,632,5985,18120,6176,18752
290720,202103,18567,50271,16904,47734,883,2779,13679,38137,14562,40916
290730,202103,7043,16608,6005,15408,292,577,4711,12335,5003,12912
290740,202103,1009,2725,793,2375,34,107,656,1975,690,2082
290750,202103,11021,27082,9556,24806,634,1764,7107,17931,7741,19695
290755,202103,2015,5645,1641,4972,88,262,1159,3554,1247,3816
290760,202103,3689,10706,3011,9424,164,471,2062,6655,2226,7126
290770,202103,2711,8363,2479,8072,48,227,2093,6900,2141,7127
290780,202103,8226,20208,7123,18765,253,543,5560,15033,5813,15576
290790,202103,4701,12873,4095,11992,170,463,3363,10010,3533,10473
290800,202103,7070,14402,4966,11977,252,563,3743,9110,3995,9673
290810,202103,5328,13795,4314,12328,111,336,3306,9651,3417,9987
290820,202103,4809,12903,4350,12271,176,507,3289,9416,3465,9923
290830,202103,4525,10229,4006,9571,25,75,3518,8284,3543,8359
290840,202103,17429,45107,14891,41189,1981,4514,9489,28024,11470,32538
290850,202103,6676,15833,5960,15068,236,538,5102,13058,5338,13596
290860,202103,6181,17392,5384,16484,206,628,4559,14251,4765,14879
290870,202103,4728,12922,3597,10776,144,442,2529,7532,2673,7974
290880,202103,1406,3442,1133,3085,81,197,753,2171,834,2368
290890,202103,9467,18830,8547,17807,152,320,8018,16622,8170,16942
290900,202103,2448,6283,1901,5333,115,257,1184,3334,1299,3591
290910,202103,5217,12273,3994,10427,44,125,3420,8846,3464,8971
290920,202103,5174,12889,4691,12334,89,136,4388,11731,4477,11867
290930,202103,7604,20972,6175,18492,208,822,4814,14052,5022,14874
290940,202103,3606,10117,3041,9298,163,535,2444,7461,2607,7996
290950,202103,1460,3640,1193,3243,71,183,832,2278,903,2461
290960,202103,5741,14423,5155,13695,209,472,4365,11664,4574,12136
290970,202103,3267,9581,2680,8510,102,376,2082,6626,2184,7002
290980,202103,12270,28885,10328,25987,776,2113,6546,15994,7322,18107
290990,202103,9720,25479,8640,23762,255,986,7283,19408,7538,20394
291000,202103,3390,8605,2636,7653,113,328,2161,6346,2274,6674
291005,202103,15438,37662,13639,35356,1415,3228,10405,27376,11820,30604
291010,202103,3080,9202,2516,7995,124,435,1652,5113,1776,5548
291020,202103,1262,3046,1022,2632,26,82,746,1813,772,1895
291030,202103,2544,6113,1795,4837,117,278,1111,2942,1228,3220
291040,202103,5416,14600,4530,13364,154,540,3592,10569,3746,11109
291050,202103,7668,19513,6546,17998,625,1837,4795,13043,5420,14880
291060,202103,6148,18257,5208,16995,297,1241,3977,12914,4274,14155
291070,202103,16316,43120,13690,38939,394,1303,11225,31733,11619,33036
291072,202103,24646,61631,17921,50477,3185,9246,7851,22271,11036,31517
291075,202103,5475,13302,4943,12509,104,250,4172,10393,4276,10643
291077,202103,1670,4294,1303,3656,61,120,929,2624,990,2744
291080,202103,113475,272588,89533,239644,25332,68975,26047,75841,51379,144816
291085,202103,5595,14031,4714,12671,163,478,3945,10581,4108,11059
291090,202103,2029,3811,1479,3196,39,77,1212,2576,1251,2653
291100,202103,3246,6992,2256,5822,100,264,1735,4434,1835,4698
291110,202103,5998,17586,5120,16125,274,1074,3985,12137,4259,13211
291120,202103,7711,18527,6512,17028,318,846,5036,13173,5354,14019
291125,202103,2250,3894,1711,3297,83,121,1403,2737,1486,2858
291130,202103,3316,9307,2456,7638,59,286,1847,5532,1906,5818
291140,202103,4906,13013,3571,10620,473,1263,2168,6486,2641,7749
291150,202103,2507,5404,1931,4758,3,9,1832,4515,1835,4524
291160,202103,5074,13758,4223,12545,365,1145,2856,8438,3221,9583
291165,202103,2180,5861,1634,4788,30,122,1203,3419,1233,3541
291170,202103,20946,52463,17507,46741,947,2757,11655,30534,12602,33291
291180,202103,6405,14475,4701,12242,247,614,3682,9600,3929,10214
291185,202103,3034,8050,2674,7488,100,282,2069,5822,2169,6104
291190,202103,7744,18626,6405,16920,282,792,5117,13538,5399,14330
291200,202103,2825,7621,2099,6255,73,229,1329,3797,1402,4026
291210,202103,7079,15009,5287,12955,121,406,3909,9635,4030,10041
291220,202103,4230,11685,3835,11108,209,658,3045,8780,3254,9438
291230,202103,4552,9598,3453,8400,40,95,3135,7690,3175,7785
291240,202103,4154,10587,3540,9557,59,204,3041,8104,3100,8308
291250,202103,3367,9780,2638,8445,144,427,1713,5527,1857,5954
291260,202103,1459,3390,1196,3046,29,89,981,2515,1010,2604
291270,202103,5495,13938,4281,12202,532,1517,2837,8201,3369,9718
291280,202103,2633,6246,1941,5250,156,426,1248,3347,1404,3773
291290,202103,5786,15029,4462,13001,348,1072,3035,8804,3383,9876
291300,202103,3849,10310,3053,8997,115,377,2341,6828,2456,7205
291310,202103,5044,13313,4326,12029,119,366,3656,10060,3775,10426
291320,202103,6093,16714,4759,14264,1052,2955,2349,7479,3401,10434
291330,202103,1825,4583,1529,4110,70,180,1171,3090,1241,3270
291340,202103,4355,11021,3520,9589,87,264,2688,7227,2775,7491
291345,202103,2922,8636,2656,8225,97,332,2246,6968,2343,7300
291350,202103,6912,16717,5381,14894,44,136,4704,13225,4748,13361
291360,202103,36762,83334,28924,74004,2700,6780,19143,50264,21843,57044
291370,202103,8150,21820,7196,20363,537,1563,5361,14920,5898,16483
291380,202103,3448,9258,3027,8694,103,391,2541,7232,2644,7623
291390,202103,13276,28111,10227,24753,437,988,8468,20540,8905,21528
291400,202103,14007,34969,11592,31404,1451,3439,7104,20552,8555,23991
291410,202103,3017,7818,2367,6703,37,150,1742,4843,1779,4993
291420,202103,1999,4775,1563,4239,22,92,1392,3751,1414,3843
291430,202103,2753,7675,2388,7079,63,274,1927,5537,1990,5811
291440,202103,6461,18237,5610,16850,328,1005,4372,13201,4700,14206
291450,202103,9906,22901,8177,20925,72,124,7250,19024,7322,19148
291460,202103,15733,41121,13800,38266,667,2019,10456,28775,11123,30794
291465,202103,9307,22536,7325,20275,121,533,6378,17518,6499,18051
291470,202103,17551,38347,14643,35042,853,1754,10806,26670,11659,28424
291480,202103,42296,92575,31466,78040,3666,9327,16837,41823,20503,51150
291490,202103,5500,13585,4733,12720,133,433,4278,11431,4411,11864
291500,202103,5113,12274,4301,11195,54,220,3952,10256,4006,10476
291510,202103,4354,10568,3243,9180,44,254,2732,7653,2776,7907
291520,202103,4589,10221,3464,8744,181,481,2699,6755,2880,7236
291530,202103,2360,5261,1681,4390,314,737,920,2663,1234,3400
291535,202103,3416,9930,3002,9197,159,437,2308,7306,2467,7743
291540,202103,2274,4992,1570,4162,70,212,1291,3402,1361,3614
291550,202103,5662,12811,4407,11241,415,860,2990,7859,3405,8719
291560,202103,18487,43325,13478,36740,1514,3919,7809,22317,9323,26236
291570,202103,2393,5650,1888,5032,55,155,1563,4312,1618,4467
291580,202103,6384,16211,5020,14401,238,700,3702,10577,3940,11277
291590,202103,2237,5298,1955,4978,68,222,1753,4383,1821,4605
291600,202103,5408,12408,4174,10544,357,956,2880,7051,3237,8007
291610,202103,5632,14477,5050,13839,68,251,4643,12695,4711,12946
291620,202103,3147,7005,2375,6161,108,263,1848,4906,1956,5169
291630,202103,3452,7473,2578,6361,259,697,1896,4624,2155,5321
291640,202103,16556,39439,12531,33713,1756,4390,5970,16557,7726,20947
291650,202103,9422,23227,8360,21980,559,1014,7018,19005,7577,20019
291660,202103,2065,4989,1525,4177,136,411,997,2597,1133,3008
291670,202103,2036,5342,1720,4891,100,251,1302,3760,1402,4011
291680,202103,4069,9805,3304,8727,305,812,2343,6202,2648,7014
291685,202103,4867,11468,3902,10207,218,452,2980,8041,3198,8493
291690,202103,4170,9080,2919,7287,278,547,2176,5534,2454,6081
291700,202103,8783,24862,7744,23074,335,1109,6314,18521,6649,19630
291710,202103,5252,12307,3920,10468,221,660,2847,7497,3068,8157
291720,202103,4478,13353,3763,11926,590,1912,2236,6990,2826,8902
291730,202103,6317,15849,5452,14725,254,754,4541,12190,4795,12944
291733,202103,2790,7099,2387,6577,56,155,1753,5084,1809,5239
291735,202103,2958,7723,2373,6695,73,167,1819,5104,1892,5271
291740,202103,3985,10180,2955,8274,98,232,2054,5733,2152,5965
291750,202103,20002,46619,16386,41390,1667,4007,10924,28127,12591,32134
291760,202103,10356,29253,8116,25714,2439,8714,2245,7086,4684,15800
291770,202103,7248,19105,6092,17139,298,935,4679,12811,4977,13746
291780,202103,5210,13623,4696,12914,87,292,4118,11230,4205,11522
291790,202103,2746,7451,2494,7131,231,546,1882,5569,2113,6115
291800,202103,29490,72848,22079,61986,3640,9802,10585,31148,14225,40950
291810,202103,10578,24836,8912,22823,310,752,7483,19428,7793,20180
291820,202103,3955,10104,3451,9448,88,262,2810,7702,2898,7964
291830,202103,4560,10510,3736,9413,205,398,2959,7514,3164,7912
291835,202103,6558,19410,5186,16815,486,1667,3366,11071,3852,12738
291840,202103,47740,129454,41616,120052,4135,12741,29561,84694,33696,97435
291845,202103,2536,6504,1998,5845,116,342,1621,4811,1737,5153
291850,202103,3924,10933,3249,9830,186,544,2457,7600,2643,8144
291855,202103,2263,4334,1752,3770,34,83,1587,3421,1621,3504
291860,202103,2291,5906,1595,4562,43,111,1088,3004,1131,3115
291870,202103,1290,3218,867,2478,37,103,599,1689,636,1792
291875,202103,2978,8789,2573,7953,60,245,1915,5741,1975,5986
291880,202103,5712,15935,4859,14517,230,655,3610,10893,3840,11548
291890,202103,1632,3300,1059,2641,140,310,695,1759,835,2069
291900,202103,1326,3052,1027,2604,21,75,818,2015,839,2090
291905,202103,2436,6168,2020,5520,73,255,1575,4147,1648,4402
291910,202103,3037,7433,2572,6867,55,194,2207,6041,2262,6235
291915,202103,7276,20488,5938,18252,212,748,4489,13962,4701,14710
291920,202103,26200,67134,22204,61693,2007,6104,15633,42591,17640,48695
291930,202103,2534,6628,2181,6154,228,648,1499,4283,1727,4931
291940,202103,3970,9916,2679,7758,203,569,1578,4554,1781,5123
291950,202103,9102,27302,7725,24673,263,977,5424,17150,5687,18127
291955,202103,15298,38350,13592,36158,1131,3153,10666,28424,11797,31577
291960,202103,3101,7997,2614,7348,125,343,2059,5924,2184,6267
291970,202103,4614,11406,3868,10502,125,420,2983,8112,3108,8532
291980,202103,9548,27051,7643,23744,1038,2990,4672,14914,5710,17904
291990,202103,2356,5997,1931,5486,24,91,1790,5091,1814,5182
291992,202103,3857,9266,3112,8310,244,540,2462,6738,2706,7278
291995,202103,2161,5817,1787,5206,51,203,1377,3937,1428,4140
292000,202103,2656,6098,2172,5524,83,277,1737,4395,1820,4672
292010,202103,5760,13249,4723,11804,151,405,3982,9761,4133,10166
292020,202103,4596,13044,3830,11708,175,631,2872,8511,3047,9142
292030,202103,1817,5469,1651,5165,85,285,1078,3320,1163,3605
292040,202103,4528,11302,3542,9833,213,525,2698,7655,2911,8180
292045,202103,4143,10513,3090,8972,33,88,2744,8121,2777,8209
292050,202103,6527,17976,5311,15890,243,825,3434,10155,3677,10980
292060,202103,11165,25674,10310,24616,417,951,9087,21464,9504,22415
292070,202103,5745,14772,5020,13917,297,806,4317,11915,4614,12721
292080,202103,3050,7686,2549,7037,73,251,2267,6197,2340,6448
292090,202103,4547,9781,3203,8165,223,587,2416,6190,2639,6777
292100,202103,11147,26669,9590,24742,1018,2593,6565,17081,7583,19674
292105,202103,3695,8864,3227,8234,80,173,2715,6934,2795,7107
292110,202103,6074,14412,4329,11714,879,2432,2167,5850,3046,8282
292120,202103,6992,17612,5816,15686,348,955,4397,11690,4745,12645
292130,202103,3479,8184,2888,7461,117,341,2244,5721,2361,6062
292140,202103,5129,11821,4347,10677,240,572,3603,8830,3843,9402
292145,202103,2432,6798,2058,6173,97,235,1582,4812,1679,5047
292150,202103,14785,39008,12842,35894,280,1030,10561,28984,10841,30014
292160,202103,3039,7228,2294,6270,36,92,1869,5386,1905,5478
292170,202103,8555,22335,7174,20124,348,1093,5470,15058,5818,16151
292180,202103,2876,7787,2132,6414,145,432,1342,3969,1487,4401
292190,202103,2913,7617,2491,6979,89,298,1960,5451,2049,5749
292200,202103,8848,21381,6608,18266,1172,3341,3191,9212,4363,12553
292205,202103,3819,10482,3320,9748,56,251,2896,8474,2952,8725
292210,202103,6639,15087,5377,13506,69,292,4876,12132,4945,12424
292220,202103,2212,5099,1945,4704,57,134,1541,3608,1598,3742
292225,202103,3180,9164,2813,8608,65,298,2433,7306,2498,7604
292230,202103,8765,20615,7872,19491,160,501,6810,16599,6970,17100
292240,202103,4727,13551,4169,12561,267,790,3003,9058,3270,9848
292250,202103,5996,15030,5398,14166,391,1014,4117,10729,4508,11743
292260,202103,3387,8723,3018,8245,91,243,2631,7198,2722,7441
292265,202103,3470,9206,2919,8372,62,264,2368,6658,2430,6922
292270,202103,4336,9895,3454,8847,109,260,2882,7410,2991,7670
292273,202103,2837,5962,2270,5276,58,94,1652,4130,1710,4224
292275,202103,1621,4175,1273,3716,51,145,963,2853,1014,2998
292280,202103,2676,6187,2154,5587,82,148,1820,4857,1902,5005
292285,202103,2586,6152,2073,5462,76,161,1703,4523,1779,4684
292290,202103,7622,19558,6023,17347,165,569,4963,14244,5128,14813
292300,202103,10573,25870,8350,22934,804,2302,5772,15925,6576,18227
292303,202103,2956,8307,2571,7690,86,194,2140,6480,2226,6674
292305,202103,2283,6054,2114,5827,39,165,1917,5211,1956,5376
292310,202103,6927,16861,6019,15770,123,385,5336,13831,5459,14216
292320,202103,6108,16498,4864,14211,265,855,3545,10092,3810,10947
292330,202103,2752,5957,2238,5378,106,185,1731,4364,1837,4549
292335,202103,4837,12391,4295,11601,220,503,3624,9906,3844,10409
292340,202103,5472,15279,4555,13549,215,607,3369,9977,3584,10584
292350,202103,2523,6767,2118,6213,74,269,1729,5093,1803,5362
292360,202103,4953,13008,4138,11642,231,706,2922,8126,3153,8832
292370,202103,10255,23945,8862,22146,107,369,8262,20412,8369,20781
292380,202103,6778,18807,6084,17573,370,1080,4704,13459,5074,14539
292390,202103,4646,8707,3446,7314,124,225,3029,6438,3153,6663
292400,202103,22359,62438,19326,57687,1886,5642,13288,39975,15174,45617
292405,202103,4586,10904,3876,9788,81,192,3248,8079,3329,8271
292410,202103,2234,5257,1855,4778,67,147,1632,4235,1699,4382
292420,202103,3455,10104,3171,9687,113,437,2762,8291,2875,8728
292430,202103,4881,14375,3704,12226,274,908,2421,8040,2695,8948
292440,202103,8597,26769,7973,25830,120,589,7179,23136,7299,23725
292450,202103,4066,11425,3189,9749,88,323,2507,7609,2595,7932
292460,202103,5101,13508,4208,12041,259,695,3205,9163,3464,9858
292465,202103,2735,6857,2348,6370,95,190,1590,4739,1685,4929
292467,202103,1940,5310,1707,4993,265,666,1166,3575,1431,4241
292470,202103,2914,7329,2267,6339,52,101,1778,4983,1830,5084
292480,202103,6330,14754,5162,13344,69,246,4699,12055,4768,12301
292490,202103,2168,5397,1850,4937,113,227,1452,3964,1565,4191
292500,202103,6649,17777,5328,15492,436,1338,3541,10175,3977,11513
292510,202103,13575,35560,10620,30952,518,1607,7513,21898,8031,23505
292520,202103,7161,17528,6343,16366,407,1095,5029,12828,5436,13923
292525,202103,6067,14152,4986,12947,124,262,4354,11494,4478,11756
292530,202103,28735,74556,22298,63970,5032,14598,9278,27206,14310,41804
292540,202103,4452,8071,3514,7072,128,207,3177,6424,3305,6631
292550,202103,8368,21290,6452,19014,495,1358,4515,14316,5010,15674
292560,202103,4482,11020,3870,10207,100,250,3024,7977,3124,8227
292570,202103,3640,9456,3072,8413,59,214,2623,7024,2682,7238
292575,202103,6883,19400,6328,18675,403,1135,5073,15177,5476,16312
292580,202103,7612,18911,6303,16991,130,411,5339,14238,5469,14649
292590,202103,7422,19521,6304,17569,296,880,5119,14081,5415,14961
292593,202103,2872,7060,2393,6273,70,175,2021,5249,2091,5424
292595,202103,5435,14255,4641,13284,134,453,3946,11234,4080,11687
292600,202103,10775,29087,9342,26912,342,959,7500,21679,7842,22638
292610,202103,4253,10854,3626,9761,176,382,2775,7559,2951,7941
292620,202103,6431,17380,5331,16055,131,289,4833,14871,4964,15160
292630,202103,8632,20797,6956,18151,724,1858,4424,11680,5148,13538
292640,202103,8387,24006,7285,22187,191,678,5272,16209,5463,16887
292650,202103,4474,10987,4028,10410,105,282,3676,9403,3781,9685
292660,202103,11454,30423,9731,27930,456,1405,7422,21405,7878,22810
292665,202103,2205,6406,1906,6009,64,183,1594,5108,1658,5291
292670,202103,3575,9571,2778,8098,124,372,1883,5387,2007,5759
292680,202103,3997,10358,3176,8936,167,413,2353,6512,2520,6925
292690,202103,2653,6727,1840,5409,199,534,1108,3404,1307,3938
292700,202103,10045,26867,8787,24942,753,1836,6082,17898,6835,19734
292710,202103,2659,7770,2479,7530,34,101,2281,6945,2315,7046
292720,202103,9128,21296,7706,19657,207,539,6168,16041,6375,16580
292730,202103,4856,10929,4492,10402,328,549,3744,8887,4072,9436
292740,202103,316715,753933,272815,692397,36979,93483,171807,434754,208786,528237
292750,202103,6071,16100,5352,15078,216,613,4186,11996,4402,12609
292760,202103,3928,11103,3440,10254,195,633,2573,7603,2768,8236
292770,202103,6405,16273,5187,14594,737,2111,3386,9773,4123,11884
292780,202103,2131,4110,1587,3462,68,157,1278,2670,1346,2827
292790,202103,4090,8533,3108,7467,170,367,2560,6225,2730,6592
292800,202103,11376,28164,9755,25723,301,812,8188,21339,8489,22151
292805,202103,3725,8680,2938,7669,112,306,2345,6063,2457,6369
292810,202103,10860,27587,8688,24188,415,1147,6461,17619,6876,18766
292820,202103,7373,20203,5419,16910,374,1268,3834,11782,4208,13050
292830,202103,2945,6834,2519,6311,86,218,2147,5424,2233,5642
292840,202103,8697,22560,7388,20805,136,496,6495,18038,6631,18534
292850,202103,2481,6530,2092,5973,146,429,1470,4180,1616,4609
292860,202103,16908,36987,15205,35003,383,969,13236,30091,13619,31060
292870,202103,18574,44844,16063,41417,970,2433,11226,28629,12196,31062
292880,202103,10997,29697,9390,27284,240,972,7468,21004,7708,21976
292890,202103,7238,19524,6406,18353,165,646,5643,16082,5808,16728
292895,202103,3148,6496,2351,5332,104,219,1921,4318,2025,4537
292900,202103,2629,6940,2385,6566,51,199,1987,5329,2038,5528
292905,202103,4328,10950,3459,9674,102,329,2635,7295,2737,7624
292910,202103,4792,12908,4384,12338,203,555,3407,9534,3610,10089
292920,202103,9695,26430,8993,25461,258,931,7735,21584,7993,22515
292925,202103,5417,15207,4545,13654,224,639,3263,9785,3487,10424
292930,202103,6444,18580,5594,17067,470,1568,3623,10825,4093,12393
292935,202103,2526,6134,1953,5499,15,80,1764,4982,1779,5062
292937,202103,2781,6953,2415,6484,61,156,2028,5455,2089,5611
292940,202103,2816,7058,2247,6225,173,386,1635,4727,1808,5113
292950,202103,9416,23625,8248,21961,510,1180,6260,16653,6770,17833
292960,202103,5197,12492,4356,11312,127,311,3488,8991,3615,9302
292970,202103,3844,10783,3415,10143,74,329,2884,8572,2958,8901
292975,202103,4432,9373,3946,8838,113,186,3607,8169,3720,8355
292980,202103,3451,7972,2820,7061,81,238,2375,5848,2456,6086
292990,202103,11212,30806,9420,27639,536,1700,7032,20258,7568,21958
293000,202103,2708,6279,2329,5714,42,143,1884,4622,1926,4765
293010,202103,18250,46088,14783,40773,1802,5123,9145,25278,10947,30401
293015,202103,8370,25202,6649,21915,435,1515,4414,14903,4849,16418
293020,202103,9878,28299,8893,26898,129,508,8034,24348,8163,24856
293030,202103,5235,13573,4005,11679,104,314,2777,8328,2881,8642
293040,202103,4453,11421,3757,10438,68,247,3304,9145,3372,9392
293050,202103,22835,54576,20184,50690,1170,2887,15320,38003,16490,40890
293060,202103,3570,9366,2897,8116,243,719,1997,5494,2240,6213
293070,202103,24987,59619,21951,55803,1867,4948,16498,41776,18365,46724
293075,202103,3609,11095,3144,10304,133,571,2551,8339,2684,8910
293076,202103,3571,8580,3272,8232,55,125,2940,7469,2995,7594
293077,202103,6426,17371,5192,15422,454,1439,3231,10054,3685,11493
293080,202103,4815,13911,4139,12752,81,371,3377,10204,3458,10575
293090,202103,3268,9344,2524,8113,213,649,1635,5358,1848,6007
293100,202103,5793,15180,4804,13427,203,565,3800,10528,4003,11093
293105,202103,3806,11897,3332,10926,240,796,2345,7659,2585,8455
293110,202103,2411,5918,2006,5333,60,200,1654,4305,1714,4505
293120,202103,4473,11912,4002,11186,155,345,3328,9393,3483,9738
293130,202103,3702,10116,3239,9518,65,258,2826,8225,2891,8483
293135,202103,30491,70266,22773,60238,3327,9594,11028,29516,14355,39110
293140,202103,2451,5281,2131,4899,53,98,1829,4208,1882,4306
293150,202103,5482,16120,4519,14320,324,1036,3110,9906,3434,10942
293160,202103,3763,9200,3210,8599,233,370,2708,7618,2941,7988
293170,202103,5029,10250,4401,9479,103,207,3897,8350,4000,8557
293180,202103,4371,12153,3644,10828,70,275,2919,8470,2989,8745
293190,202103,14240,38015,12634,35742,122,531,11317,31787,11439,32318
293200,202103,8608,20921,6978,18348,173,549,5694,14728,5867,15277
293210,202103,5184,13515,4470,12412,262,718,3499,9716,3761,10434
293220,202103,4955,12490,3668,10381,792,2250,1602,4651,2394,6901
293230,202103,3945,9876,2919,8445,206,621,2047,5992,2253,6613
293240,202103,4610,11915,3720,10475,71,148,2810,8274,2881,8422
293245,202103,3818,10248,3474,9751,151,451,2949,8199,3100,8650
293250,202103,5975,13693,4881,12302,168,412,4071,10269,4239,10681
293260,202103,4754,12319,3925,11047,136,364,2729,7759,2865,8123
293270,202103,7315,15873,5793,14249,402,559,4544,12067,4946,12626
293280,202103,4463,11604,3923,10846,238,580,3063,8608,3301,9188
293290,202103,14826,41860,13127,39240,1591,4840,8898,26803,10489,31643
293300,202103,5757,13794,4964,12651,279,684,3663,9409,3942,10093
293305,202103,4164,9731,3654,9115,61,128,3305,8271,3366,8399
293310,202103,2084,5272,1769,4792,46,138,1419,3801,1465,3939
293315,202103,4169,9632,3461,8579,203,441,2843,7057,3046,7498
293317,202103,2681,6194,2395,5803,154,276,1893,4612,2047,4888
293320,202103,12276,28942,10877,27397,216,605,9829,24602,10045,25207
293325,202103,1748,4245,1356,3734,208,555,822,2320,1030,2875
293330,202103,61031,167470,49853,148150,8488,26086,24060,71055,32548,97141
293340,202103,2187,6081,1819,5434,81,258,1290,3823,1371,4081
293345,202103,3619,9646,2898,8538,387,898,1827,5941,2214,6839
293350,202103,6529,18647,5641,17587,55,272,5161,16292,5216,16564
293360,202103,15111,37720,12883,34747,283,1175,11384,30155,11667,31330
310010,202103,957,2115,619,1654,43,157,229,558,272,715
310020,202103,2801,7377,2107,6168,433,1360,532,1505,965,2865
310030,202103,1911,5270,1472,4517,212,723,954,2823,1166,3546
310040,202103,871,2249,692,1940,30,120,469,1213,499,1333
310050,202103,1480,4353,1239,3977,116,465,828,2566,944,3031
310060,202103,3094,8688,2694,8151,73,293,2255,6759,2328,7052
310070,202103,343,769,244,629,11,23,181,464,192,487
310080,202103,681,1789,490,1446,72,231,235,656,307,887
310090,202103,4759,12284,3929,10952,265,784,2923,8027,3188,8811
310100,202103,3559,9566,3011,8675,64,295,2515,7049,2579,7344
310110,202103,4681,12055,3649,10293,711,2188,1701,4597,2412,6785
310120,202103,637,1518,414,1166,42,134,251,664,293,798
310130,202103,367,938,312,859,26,100,237,624,263,724
310140,202103,266,756,189,630,40,157,73,210,113,367
310150,202103,5667,14527,4235,11942,508,1638,2091,5574,2599,7212
310160,202103,8250,20170,5977,16434,1046,3147,2282,6251,3328,9398
310163,202103,1029,3032,839,2676,183,650,277,811,460,1461
310170,202103,9491,23604,7602,20696,628,1732,5389,14676,6017,16408
310180,202103,1814,4420,1335,3650,163,478,775,2072,938,2550
310190,202103,2698,7703,2205,6812,489,1687,368,1075,857,2762
310200,202103,1949,5631,1446,4667,161,603,735,2315,896,2918
310205,202103,1129,3041,905,2692,124,418,523,1548,647,1966
310210,202103,2556,6781,2120,6017,104,293,1533,4244,1637,4537
310220,202103,1266,3405,979,2849,76,239,657,1835,733,2074
310230,202103,2217,6028,1787,5237,217,686,1133,3102,1350,3788
310240,202103,1000,2960,850,2702,47,165,607,1880,654,2045
310250,202103,1071,2792,866,2457,18,72,628,1755,646,1827
310260,202103,3172,8043,2112,6206,592,2012,669,1611,1261,3623
310270,202103,2766,6618,2221,5888,88,273,1845,4875,1933,5148
310280,202103,2503,5706,1966,4940,228,614,1221,2947,1449,3561
310285,202103,1880,5859,1568,5304,156,567,969,3262,1125,3829
310290,202103,1146,2960,941,2609,184,581,509,1273,693,1854
310300,202103,1543,4386,1310,3993,132,489,775,2198,907,2687
310310,202103,316,752,202,554,37,99,98,263,135,362
310320,202103,531,1327,369,1078,21,78,208,578,229,656
310330,202103,486,1126,299,805,45,142,118,277,163,419
310340,202103,8143,21091,6596,18524,866,2416,3383,9666,4249,12082
310350,202103,12819,30447,8883,24204,1430,4178,4253,11119,5683,15297
310360,202103,522,1173,404,1024,12,34,279,705,291,739
310370,202103,1284,3901,1098,3559,206,735,355,1220,561,1955
310375,202103,880,2157,625,1779,91,267,352,1001,443,1268
310380,202103,399,899,220,616,33,98,103,269,136,367
310390,202103,461,1348,369,1171,81,263,109,309,190,572
310400,202103,10645,25644,7804,21375,681,2169,4898,13067,5579,15236
310410,202103,857,2452,566,1921,83,313,225,711,308,1024
310420,202103,4546,11619,3164,9052,395,1240,1373,3654,1768,4894
310430,202103,1525,4052,1027,3137,206,689,390,1055,596,1744
310440,202103,678,1769,471,1383,39,138,253,692,292,830
310445,202103,1397,3887,1024,3146,59,164,731,2217,790,2381
310450,202103,4542,11305,3447,9593,136,505,2647,7151,2783,7656
310460,202103,1771,4656,1341,3865,215,669,497,1325,712,1994
310470,202103,3707,8100,2912,7059,273,635,2089,5190,2362,5825
310480,202103,1004,2541,785,2186,93,270,484,1305,577,1575
310490,202103,2866,7677,2267,6705,247,869,1279,3539,1526,4408
310500,202103,1324,3677,1005,3147,172,611,540,1629,712,2240
310510,202103,2117,5419,1428,4170,245,786,548,1596,793,2382
310520,202103,1181,3040,867,2478,143,392,455,1315,598,1707
310530,202103,748,1858,504,1437,67,227,176,406,243,633
310540,202103,2994,8371,2483,7471,508,1626,1135,3259,1643,4885
310550,202103,1285,3203,920,2600,75,280,528,1366,603,1646
310560,202103,15211,39060,10948,31616,1404,4578,4916,12814,6320,17392
310570,202103,1042,2706,825,2404,53,193,621,1777,674,1970
310590,202103,4080,10691,3260,9156,193,601,1909,5053,2102,5654
310600,202103,1375,3942,1123,3420,141,478,600,1736,741,2214
310610,202103,481,1280,308,997,115,382,42,123,157,505
310620,202103,177213,442762,130231,359403,16809,53789,66335,166592,83144,220381
310630,202103,4566,12272,3595,10383,373,1132,2185,6110,2558,7242
310640,202103,1100,3221,908,2851,182,624,380,1137,562,1761
310650,202103,2458,6765,1809,5525,157,517,1106,3262,1263,3779
310660,202103,1322,3505,1081,3176,29,97,916,2675,945,2772
310665,202103,1437,3608,1168,3232,20,76,957,2689,977,2765
310670,202103,59288,149762,50271,134653,4435,13428,34905,89126,39340,102554
310680,202103,774,1793,644,1615,18,65,551,1329,569,1394
310690,202103,1996,5078,1444,4154,110,359,837,2283,947,2642
310700,202103,483,1045,378,915,21,68,303,715,324,783
310710,202103,5763,16047,4249,13784,845,3210,806,2334,1651,5544
310720,202103,1061,2411,831,2124,28,85,639,1576,667,1661
310730,202103,10326,26741,8853,24432,352,1194,6662,17977,7014,19171
310740,202103,6492,17432,4708,13847,641,2113,1874,4983,2515,7096
310750,202103,1252,2982,952,2554,101,309,530,1316,631,1625
310760,202103,663,1675,470,1379,36,118,251,739,287,857
310770,202103,1097,2893,758,2380,79,299,398,1149,477,1448
310780,202103,4282,10078,3568,9153,64,164,2937,7546,3001,7710
310790,202103,1823,5690,1570,5150,344,1202,265,758,609,1960
310800,202103,2391,6962,1764,5700,337,1322,104,269,441,1591
310810,202103,1307,3162,1077,2789,48,132,781,1952,829,2084
310820,202103,1255,3124,765,2301,161,496,170,536,331,1032
310825,202103,2630,7739,2113,6878,60,349,1728,5419,1788,5768
310830,202103,1916,5266,1387,4246,231,827,610,1755,841,2582
310840,202103,2108,5636,1568,4731,330,1149,417,1090,747,2239
310850,202103,1441,3954,1204,3616,37,191,942,2703,979,2894
310855,202103,3110,8092,2408,6956,157,545,1734,4879,1891,5424
310860,202103,6855,19654,5545,17158,558,1775,3386,10624,3944,12399
310870,202103,962,2289,764,2005,57,131,560,1483,617,1614
310880,202103,998,2939,797,2540,110,358,442,1379,552,1737
310890,202103,2168,6153,1410,4646,252,892,213,610,465,1502
310900,202103,3881,10610,2683,8016,395,1218,1173,3273,1568,4491
310910,202103,2195,5268,1546,4257,136,435,341,872,477,1307
310920,202103,1909,4897,1465,4235,187,588,858,2427,1045,3015
310925,202103,929,2494,757,2209,59,201,527,1463,586,1664
310930,202103,5867,14988,4124,12192,782,2320,1878,5817,2660,8137
310940,202103,6617,15481,5338,13645,187,577,4117,10240,4304,10817
310945,202103,1290,3318,1011,2872,177,519,492,1366,669,1885
310950,202103,1917,5612,1283,4199,218,775,373,1037,591,1812
310960,202103,730,1934,409,1254,67,243,79,215,146,458
310970,202103,1150,3341,816,2652,208,738,134,400,342,1138
310980,202103,251,593,163,460,17,56,105,289,122,345
310990,202103,1328,3565,1049,3095,142,452,576,1660,718,2112
311000,202103,3920,10737,2878,9038,701,2333,1165,3585,1866,5918
311010,202103,906,2543,733,2209,201,671,323,946,524,1617
311020,202103,1146,2863,733,2112,41,124,393,1105,434,1229
311030,202103,1693,4109,1207,3326,231,723,549,1442,780,2165
311040,202103,269,833,223,734,68,231,76,234,144,465
311050,202103,3009,7230,2258,6147,349,1078,1166,3005,1515,4083
311060,202103,3224,8125,2409,6644,327,1030,984,2474,1311,3504
311070,202103,2348,5718,1719,4763,146,519,1001,2585,1147,3104
311080,202103,1180,2627,958,2284,56,147,746,1695,802,1842
311090,202103,2063,6460,1631,5655,375,1414,512,1735,887,3149
311100,202103,2413,6755,1434,4768,258,970,261,755,519,1725
311110,202103,3625,7362,2037,5151,366,970,721,1882,1087,2852
311115,202103,1402,3054,1185,2773,66,149,960,2225,1026,2374
311120,202103,6843,17707,5287,14947,774,2434,2002,4990,2776,7424
311130,202103,1893,4881,1437,4252,100,371,862,2479,962,2850
311140,202103,1452,3547,1163,3155,59,193,844,2244,903,2437
311150,202103,1450,4585,1137,3972,176,692,616,2097,792,2789
311160,202103,3869,10950,2736,8839,705,2476,789,2428,1494,4904
311170,202103,880,2209,695,1966,39,111,440,1317,479,1428
311180,202103,1338,2985,836,2249,154,456,371,985,525,1441
311190,202103,865,2354,659,1964,113,386,273,710,386,1096
311200,202103,2064,5524,1496,4421,263,858,556,1492,819,2350
311205,202103,879,2545,722,2244,37,152,465,1370,502,1522
311210,202103,1005,2888,871,2697,114,309,621,1989,735,2298
311220,202103,764,2060,643,1842,39,137,437,1178,476,1315
311230,202103,8080,23657,6154,19785,1162,3894,2245,7304,3407,11198
311240,202103,1070,2746,832,2409,178,523,360,1055,538,1578
311250,202103,1158,3284,904,2795,187,549,348,1028,535,1577
311260,202103,2734,6571,1765,4917,225,709,787,1961,1012,2670
311265,202103,1298,3336,958,2766,37,145,658,1857,695,2002
311270,202103,2978,8794,2607,8196,124,532,1930,5838,2054,6370
311280,202103,1037,2637,483,1513,72,254,40,92,112,346
311290,202103,1883,5573,1718,5233,123,375,1195,3640,1318,4015
311300,202103,4779,12986,3933,11584,178,678,3148,9089,3326,9767
311310,202103,562,1540,480,1399,41,128,307,864,348,992
311320,202103,3270,9753,2824,8810,322,1198,1458,4132,1780,5330
311330,202103,5309,13548,4219,11795,446,1328,2400,6834,2846,8162
311340,202103,10493,28768,8318,24959,2000,6510,2449,6941,4449,13451
311350,202103,2477,5969,1762,4696,173,462,938,2269,1111,2731
311360,202103,1124,2703,736,2143,194,634,257,731,451,1365
311370,202103,4716,11192,3484,9277,164,573,2347,5870,2511,6443
311380,202103,362,1083,262,876,63,212,119,423,182,635
311390,202103,1764,5260,1409,4770,593,2228,378,1177,971,3405
311400,202103,1558,4204,1141,3395,202,621,364,961,566,1582
311410,202103,1768,5062,1420,4533,210,754,813,2509,1023,3263
311420,202103,1523,4400,1082,3503,193,704,289,804,482,1508
311430,202103,4172,10782,2800,8117,461,1393,977,2735,1438,4128
311440,202103,2955,8123,2245,6935,581,2097,481,1362,1062,3459
311450,202103,1722,5055,1259,4217,327,1252,328,937,655,2189
311455,202103,993,2172,667,1699,172,451,250,677,422,1128
311460,202103,497,1501,328,1133,66,280,76,203,142,483
311470,202103,512,1533,344,1152,79,301,49,155,128,456
311480,202103,1084,2704,887,2396,62,157,673,1819,735,1976
311490,202103,253,736,192,621,31,126,92,262,123,388
311500,202103,475,1147,376,1005,18,61,252,647,270,708
311510,202103,3296,8379,2311,6713,301,976,1011,2756,1312,3732
311520,202103,647,1762,568,1616,72,257,324,902,396,1159
311530,202103,8580,19791,5499,14894,1293,3883,1467,3776,2760,7659
311535,202103,806,2197,544,1649,90,286,194,543,284,829
311540,202103,498,1530,444,1428,64,239,317,989,381,1228
311545,202103,2006,5654,1717,5205,91,308,1330,3995,1421,4303
311547,202103,1487,3721,1305,3451,47,116,938,2502,985,2618
311550,202103,2836,7707,2277,6716,310,1024,1009,2801,1319,3825
311560,202103,303,654,196,496,77,183,47,118,124,301
311570,202103,1620,3702,1154,3056,37,107,916,2454,953,2561
311580,202103,2158,4027,1455,3193,167,312,965,2124,1132,2436
311590,202103,506,1330,408,1179,71,227,229,659,300,886
311600,202103,1711,3847,1434,3484,69,161,1215,2918,1284,3079
311610,202103,2270,7109,1902,6369,166,649,1150,3754,1316,4403
311615,202103,3278,9027,2669,8022,108,395,2125,6269,2233,6664
311620,202103,432,1091,376,1029,10,37,329,889,339,926
311630,202103,1357,3672,1119,3197,89,297,739,2037,828,2334
311640,202103,701,1844,565,1637,59,197,287,760,346,957
311650,202103,1943,4885,1601,4358,176,499,991,2630,1167,3129
311660,202103,2879,8173,2151,6757,353,1211,581,1538,934,2749
311670,202103,1551,3976,1143,3251,162,512,471,1327,633,1839
311680,202103,2163,6030,1638,5066,136,399,1126,3489,1262,3888
311690,202103,603,1288,478,1135,35,66,353,890,388,956
311700,202103,2224,5239,1773,4611,19,99,1518,3835,1537,3934
311710,202103,1505,4291,1099,3576,265,935,381,1240,646,2175
311720,202103,431,1243,342,1088,40,144,174,559,214,703
311730,202103,3538,9099,2355,6781,666,2055,501,1479,1167,3534
311740,202103,913,2321,762,2139,72,193,619,1795,691,1988
311750,202103,3915,11444,3161,10101,375,1304,1910,5880,2285,7184
311760,202103,655,1810,539,1609,65,240,283,738,348,978
311770,202103,2160,6045,1697,5234,282,883,767,2284,1049,3167
311780,202103,1341,3798,967,3074,145,537,336,920,481,1457
311783,202103,2292,6085,1872,5383,34,159,1521,4200,1555,4359
311787,202103,802,2275,614,1847,88,294,268,691,356,985
311790,202103,1483,3983,973,3041,222,764,276,811,498,1575
311800,202103,4907,14534,3989,12603,845,2778,562,1508,1407,4286
311810,202103,939,2797,748,2464,45,161,507,1645,552,1806
311820,202103,792,1900,588,1590,60,195,376,956,436,1151
311830,202103,8293,23335,5783,18000,1601,5377,708,2149,2309,7526
311840,202103,3677,9097,2970,8093,203,597,2240,6052,2443,6649
311850,202103,369,959,299,829,13,41,201,530,214,571
311860,202103,61252,151938,47377,128510,6317,18592,27225,70234,33542,88826
311870,202103,1881,4927,1310,3920,208,714,553,1506,761,2220
311880,202103,6461,16370,5423,14952,291,675,4088,11528,4379,12203
311890,202103,1724,4066,1332,3526,90,262,930,2338,1020,2600
311900,202103,747,1875,561,1625,52,171,360,1016,412,1187
311910,202103,4085,10411,3097,9121,534,1536,1570,4823,2104,6359
311920,202103,2134,5521,1725,4932,118,283,1090,3241,1208,3524
311930,202103,3830,8826,2776,7377,815,2363,853,2094,1668,4457
311940,202103,15637,40329,11623,32794,1543,4766,5383,14163,6926,18929
311950,202103,2316,6106,1769,5200,123,401,1063,3189,1186,3590
311960,202103,485,1180,387,1037,25,92,247,601,272,693
311970,202103,415,1299,309,1036,55,225,75,211,130,436
311980,202103,454,1216,244,806,21,69,88,286,109,355
311990,202103,532,1243,338,948,59,204,147,367,206,571
311995,202103,971,2661,515,1626,22,71,73,151,95,222
312000,202103,777,1902,580,1608,56,144,356,1018,412,1162
312010,202103,970,2607,751,2257,44,147,496,1430,540,1577
312015,202103,1362,3915,1211,3676,44,193,993,2946,1037,3139
312020,202103,1649,4986,1239,4087,206,739,297,881,503,1620
312030,202103,2007,4862,1749,4578,14,49,1651,4318,1665,4367
312040,202103,840,2417,598,1956,70,230,265,842,335,1072
312050,202103,1192,3624,967,3201,214,859,323,943,537,1802
312060,202103,860,2068,562,1698,134,412,261,798,395,1210
312070,202103,912,2555,650,2029,36,130,372,1094,408,1224
312080,202103,2673,6491,2021,5530,110,312,1355,3571,1465,3883
312083,202103,850,2198,640,1873,49,179,437,1236,486,1415
312087,202103,2500,6420,2025,5692,41,126,1603,4543,1644,4669
312090,202103,10292,26428,8072,22967,1086,3400,4289,11780,5375,15180
312100,202103,1573,4453,1257,3871,89,340,782,2308,871,2648
312110,202103,1059,3197,875,2834,176,662,333,980,509,1642
312120,202103,1018,2685,693,2121,181,645,202,500,383,1145
312125,202103,1747,4397,1471,4017,101,309,1123,2966,1224,3275
312130,202103,1043,2527,787,2101,67,198,356,874,423,1072
312140,202103,706,2018,577,1756,112,387,260,719,372,1106
312150,202103,469,1276,403,1150,19,68,288,767,307,835
312160,202103,9057,24165,6970,20543,802,2621,3450,9771,4252,12392
312170,202103,896,2389,697,2007,38,128,460,1286,498,1414
312180,202103,1401,3692,1122,3173,150,436,595,1640,745,2076
312190,202103,676,1839,505,1528,74,254,191,542,265,796
312200,202103,4369,11955,3451,10472,1027,3108,1205,3779,2232,6887
312210,202103,1394,3050,1018,2523,41,119,768,1864,809,1983
312220,202103,1585,4851,1374,4455,103,348,882,2870,985,3218
312230,202103,13871,35220,9412,27305,2138,7056,2031,4944,4169,12000
312235,202103,1973,4888,1552,4303,84,272,1134,3051,1218,3323
312240,202103,722,2280,552,1927,112,424,164,554,276,978
312245,202103,2706,6829,2237,6117,54,135,1873,5096,1927,5231
312247,202103,984,2332,716,1948,121,341,391,1066,512,1407
312250,202103,964,2545,624,1878,75,237,230,672,305,909
312260,202103,957,2532,763,2241,39,154,589,1659,628,1813
312270,202103,738,2009,564,1668,32,126,315,850,347,976
312280,202103,419,1216,325,1045,91,307,48,136,139,443
312290,202103,796,2298,650,2043,120,423,214,640,334,1063
312300,202103,1006,3013,674,2193,163,578,128,343,291,921
312310,202103,952,2798,771,2438,116,399,363,1098,479,1497
312320,202103,2012,5107,1484,4204,318,941,339,941,657,1882
312330,202103,851,2467,693,2131,64,231,434,1289,498,1520
312340,202103,249,644,178,523,37,131,89,236,126,367
312350,202103,247,496,177,423,16,44,125,291,141,335
312352,202103,1569,4657,1395,4344,94,294,845,2812,939,3106
312360,202103,2845,8071,2118,6719,396,1408,749,2197,1145,3605
312370,202103,1891,4795,1548,4222,159,484,969,2528,1128,3012
312380,202103,2146,4805,1782,4341,4,13,1602,3852,1606,3865
312385,202103,1237,3313,974,2854,154,465,430,1277,584,1742
312390,202103,1871,5318,1419,4494,187,686,535,1549,722,2235
312400,202103,2887,8080,2423,7306,688,2258,803,2397,1491,4655
312410,202103,12000,32382,9807,28786,1683,5030,5500,15950,7183,20980
312420,202103,3841,10122,3199,9081,598,1846,1688,4648,2286,6494
312430,202103,7939,20773,6545,18301,350,1134,4740,12916,5090,14050
312440,202103,958,3056,784,2668,369,1331,126,395,495,1726
312450,202103,1190,3462,909,2971,251,852,285,986,536,1838
312460,202103,446,1129,313,927,51,148,159,495,210,643
312470,202103,478,1148,301,834,31,87,105,265,136,352
312480,202103,1021,2497,714,2045,93,302,359,971,452,1273
312490,202103,2150,5156,1695,4504,201,579,949,2459,1150,3038
312500,202103,1043,2519,857,2262,42,149,625,1621,667,1770
312510,202103,3759,9902,2687,7892,642,1829,649,1939,1291,3768
312520,202103,249,647,195,561,42,138,83,233,125,371
312530,202103,580,1405,499,1308,19,60,437,1151,456,1211
312540,202103,1609,4374,1104,3394,139,453,631,1882,770,2335
312550,202103,796,2056,618,1716,46,146,410,1056,456,1202
312560,202103,1948,5040,1568,4446,73,204,1165,3319,1238,3523
312570,202103,2315,5478,1743,4763,477,1309,690,1993,1167,3302
312580,202103,618,1660,437,1284,56,190,194,524,250,714
312590,202103,1612,4614,1277,3935,84,357,815,2310,899,2667
312595,202103,2021,5769,1696,5238,250,705,1022,3333,1272,4038
312600,202103,1181,2785,689,1854,110,375,123,376,233,751
312610,202103,6879,17216,4591,13029,666,2089,1628,4170,2294,6259
312620,202103,2532,6459,1889,5546,54,209,1511,4520,1565,4729
312630,202103,307,853,213,676,32,120,81,260,113,380
312640,202103,511,1379,360,1122,38,133,153,479,191,612
312650,202103,2041,5137,1431,4010,61,180,1020,2742,1081,2922
312660,202103,1323,3191,1015,2677,90,240,685,1753,775,1993
312670,202103,4982,12940,4161,11649,180,688,3082,8268,3262,8956
312675,202103,1297,3306,1065,2969,55,168,879,2422,934,2590
312680,202103,1409,3905,1222,3609,42,174,1010,2906,1052,3080
312690,202103,2957,6157,2298,5374,45,116,1929,4519,1974,4635
312695,202103,973,2559,830,2334,48,99,645,1824,693,1923
312700,202103,2089,5425,1533,4414,143,476,894,2441,1037,2917
312705,202103,1424,3330,1228,3046,14,43,1125,2766,1139,2809
312707,202103,1321,3795,1024,3272,64,287,676,2046,740,2333
312710,202103,6436,14634,3859,10660,915,2720,1091,3154,2006,5874
312720,202103,1081,2808,811,2386,94,295,496,1416,590,1711
312730,202103,1644,3827,1165,3169,93,281,687,1803,780,2084
312733,202103,1373,3577,1038,2946,31,115,737,1978,768,2093
312735,202103,723,1892,599,1656,76,215,345,879,421,1094
312737,202103,799,1752,577,1440,65,182,388,947,453,1129
312738,202103,709,1779,509,1441,46,146,299,805,345,951
312740,202103,418,1039,253,760,45,149,59,132,104,281
312750,202103,1565,4457,1167,3708,185,621,526,1591,711,2212
312760,202103,1790,5190,1292,4171,234,779,469,1473,703,2252
312770,202103,44544,105746,28290,78065,5462,16240,9707,25978,15169,42218
312780,202103,2427,7108,2047,6489,236,774,1335,4245,1571,5019
312790,202103,238,551,128,383,5,21,39,91,44,112
312800,202103,4977,13743,3809,11533,840,2670,1450,4232,2290,6902
312810,202103,1527,4059,1031,3248,257,892,376,1092,633,1984
312820,202103,1736,4554,1411,3997,58,204,1064,2940,1122,3144
312825,202103,1358,3124,1188,2908,17,55,1033,2475,1050,2530
312830,202103,2769,7700,1718,5554,318,1162,456,1394,774,2556
312840,202103,1369,3610,1105,3169,71,274,671,1790,742,2064
312850,202103,949,2250,671,1844,16,61,425,1073,441,1134
312860,202103,1084,2779,738,2252,188,597,169,483,357,1080
312870,202103,6099,16160,3808,11804,587,1961,951,2710,1538,4671
312880,202103,1464,3598,1135,3051,42,137,673,1820,715,1957
312890,202103,2255,5530,1678,4601,122,304,861,2406,983,2710
312900,202103,1239,3130,1009,2831,146,462,476,1450,622,1912
312910,202103,1559,2837,842,1908,187,365,306,730,493,1095
312920,202103,991,2593,692,2118,111,396,281,778,392,1174
312930,202103,2405,5814,1858,5012,390,1056,835,2317,1225,3373
312940,202103,986,2652,782,2363,62,241,451,1301,513,1542
312950,202103,3035,7426,2016,5797,484,1542,652,1800,1136,3342
312960,202103,1808,4731,1531,4319,77,192,1177,3415,1254,3607
312965,202103,1608,4367,1335,3951,95,270,949,2780,1044,3050
312970,202103,1421,3916,1142,3470,140,502,710,2043,850,2545
312980,202103,24238,65391,19646,57303,3828,11993,9129,25056,12957,37049
312990,202103,511,1247,341,962,55,188,171,428,226,616
313000,202103,480,1363,365,1153,25,110,219,652,244,762
313005,202103,2556,7226,2173,6575,143,406,1571,4719,1714,5125
313010,202103,5128,13775,4118,12181,694,2240,2464,7163,3158,9403
313020,202103,1084,3200,782,2536,130,440,157,446,287,886
313030,202103,1118,2539,766,2033,79,260,501,1255,580,1515
313040,202103,827,2502,683,2218,37,159,421,1292,458,1451
313050,202103,1769,4809,1243,4027,198,772,408,1163,606,1935
313055,202103,1870,4987,1663,4693,52,171,1445,4049,1497,4220
313060,202103,965,2313,704,1877,154,501,137,330,291,831
313065,202103,1659,4837,1463,4520,45,156,1147,3462,1192,3618
313070,202103,956,2468,734,2098,69,212,424,1177,493,1389
313080,202103,392,1077,291,882,53,176,109,278,162,454
313090,202103,5203,13507,4419,12255,325,1010,3015,8264,3340,9274
313100,202103,1339,3434,1035,2997,25,102,794,2241,819,2343
313110,202103,1474,3867,1102,3234,102,358,606,1662,708,2020
313115,202103,2710,7637,2171,6596,270,937,1159,3263,1429,4200
313120,202103,3809,8915,2797,7591,195,591,1889,5114,2084,5705
313130,202103,31870,80476,24405,67009,2422,7574,14019,36282,16441,43856
313140,202103,650,1372,396,1018,29,73,273,701,302,774
313150,202103,1364,3765,1020,3156,313,1042,172,477,485,1519
313160,202103,1217,2971,952,2573,21,72,738,1934,759,2006
313170,202103,11118,31150,8210,25812,1314,4540,3377,9926,4691,14466
313180,202103,2121,5558,1528,4360,221,625,873,2465,1094,3090
313190,202103,4299,12202,3171,9948,551,1876,1115,3255,1666,5131
313200,202103,1108,3027,969,2786,14,48,818,2279,832,2327
313210,202103,3873,10938,3184,9706,377,1223,1929,5726,2306,6949
313220,202103,1727,4479,1150,3351,161,520,469,1215,630,1735
313230,202103,2995,8208,2460,7546,40,136,2062,6460,2102,6596
313240,202103,9937,24031,6425,18488,976,3209,2894,7801,3870,11010
313250,202103,6094,17721,4685,14681,826,2579,2111,6385,2937,8964
313260,202103,678,1739,495,1417,63,232,249,648,312,880
313270,202103,5854,14235,4722,12687,525,1280,3284,9080,3809,10360
313280,202103,469,1308,303,964,38,137,129,387,167,524
313290,202103,982,3000,734,2556,192,731,250,872,442,1603
313300,202103,1614,4253,1181,3507,283,917,318,824,601,1741
313310,202103,1206,3519,943,2977,149,563,285,776,434,1339
313320,202103,2098,5551,1530,4636,264,904,600,1851,864,2755
313330,202103,4203,10780,3185,9241,157,558,2078,5988,2235,6546
313340,202103,1394,3102,992,2545,80,217,705,1790,785,2007
313350,202103,2940,8077,1920,5798,231,779,704,1849,935,2628
313360,202103,1529,3682,1058,2931,149,497,562,1433,711,1930
313370,202103,1462,4006,1202,3495,149,502,655,1753,804,2255
313375,202103,1804,4703,1160,3483,221,709,241,658,462,1367
313380,202103,6335,15607,4574,12433,735,2247,2224,5405,2959,7652
313390,202103,809,2551,705,2377,52,233,471,1513,523,1746
313400,202103,3633,8868,2819,7764,117,359,2188,5915,2305,6274
313410,202103,1349,3401,1052,2896,52,171,799,2142,851,2313
313420,202103,15672,34561,8227,22187,1852,5555,1091,2924,2943,8479
313430,202103,961,2794,744,2349,124,480,318,871,442,1351
313440,202103,6004,13002,3994,10383,368,996,2493,6498,2861,7494
313450,202103,740,1941,524,1529,88,279,182,455,270,734
313460,202103,2118,5920,1682,5239,342,1201,781,2300,1123,3501
313470,202103,2873,7208,2277,6338,215,597,1527,4301,1742,4898
313480,202103,1003,2840,575,1887,59,217,180,542,239,759
313490,202103,2878,6980,1474,4422,353,1148,330,977,683,2125
313500,202103,531,1468,388,1162,36,108,152,424,188,532
313505,202103,10208,26599,8695,24545,321,1086,7002,19772,7323,20858
313507,202103,1485,3793,1215,3376,32,129,982,2645,1014,2774
313510,202103,14203,38618,11096,32479,1305,3792,5200,14987,6505,18779
313520,202103,14509,39990,11689,35227,546,1935,8854,26094,9400,28029
313530,202103,545,1589,412,1308,49,175,168,469,217,644
313535,202103,2359,6441,1950,5667,248,656,1224,3578,1472,4234
313540,202103,794,2311,644,1954,115,359,270,740,385,1099
313545,202103,1139,3737,966,3387,133,500,532,1798,665,2298
313550,202103,1771,5311,1471,4608,280,972,769,2300,1049,3272
313560,202103,2730,5300,2057,4483,56,89,1743,3829,1799,3918
313570,202103,990,2821,811,2500,197,636,324,975,521,1611
313580,202103,5901,14844,4611,12718,488,1381,2786,7677,3274,9058
313590,202103,1068,2939,870,2655,184,608,434,1393,618,2001
313600,202103,4145,10720,3453,9653,82,300,2942,8079,3024,8379
313610,202103,1074,2657,863,2302,82,249,565,1422,647,1671
313620,202103,5463,14238,4290,12140,482,1563,2539,6894,3021,8457
313630,202103,8744,20751,6256,17062,600,1910,3852,10264,4452,12174
313640,202103,1206,2572,735,1976,121,345,381,1025,502,1370
313650,202103,1715,5059,1358,4459,100,386,884,2942,984,3328
313652,202103,778,2384,701,2235,99,330,456,1420,555,1750
313655,202103,1155,2856,906,2547,49,142,680,1930,729,2072
313657,202103,1133,2995,912,2652,32,124,692,1907,724,2031
313660,202103,959,2673,781,2357,71,262,499,1439,570,1701
313665,202103,5004,13079,3977,11300,384,1226,2536,6866,2920,8092
313670,202103,49334,119190,32105,90402,4357,13510,14759,39228,19116,52738
313680,202103,1037,2722,861,2436,58,186,586,1605,644,1791
313690,202103,801,2442,624,2119,147,555,181,586,328,1141
313695,202103,1867,4899,1409,4145,95,281,927,2796,1022,3077
313700,202103,2909,9145,2535,8643,236,774,1932,6654,2168,7428
313710,202103,1481,3289,1054,2726,74,201,708,1842,782,2043
313720,202103,5632,15343,4011,11971,529,1664,1696,4683,2225,6347
313730,202103,1382,3032,1045,2585,81,169,690,1733,771,1902
313740,202103,1687,5915,1424,5246,295,1249,280,888,575,2137
313750,202103,2045,5333,1590,4549,278,898,789,2107,1067,3005
313753,202103,2210,5231,1483,4060,154,460,815,2149,969,2609
313760,202103,5541,14972,4254,12517,787,2603,1989,5415,2776,8018
313770,202103,4065,11210,3240,9898,156,475,2468,7639,2624,8114
313780,202103,4013,10483,2952,8731,248,832,903,2725,1151,3557
313790,202103,504,1499,451,1407,43,143,271,838,314,981
313800,202103,1392,3107,1018,2597,105,303,543,1322,648,1625
313810,202103,1628,4068,1307,3613,43,152,1024,2755,1067,2907
313820,202103,17841,45049,11275,31208,1858,5260,2977,8017,4835,13277
313830,202103,393,1115,283,869,52,190,96,269,148,459
313835,202103,906,2632,755,2356,60,233,427,1252,487,1485
313840,202103,7415,19109,5728,16344,1282,3934,1255,3665,2537,7599
313850,202103,996,2392,787,2110,143,453,373,899,516,1352
313860,202103,2619,6867,1988,5692,280,931,896,2330,1176,3261
313862,202103,1313,2747,643,1773,41,114,301,826,342,940
313865,202103,2612,6807,2162,6075,76,204,1645,4562,1721,4766
313867,202103,1370,4089,1143,3679,191,597,635,2113,826,2710
313868,202103,1683,5107,1387,4533,41,198,1071,3381,1112,3579
313870,202103,884,2297,625,1838,92,285,249,676,341,961
313880,202103,1784,4556,1302,3732,160,518,650,1695,810,2213
313890,202103,2129,4471,1615,3806,29,89,1258,2876,1287,2965
313900,202103,4210,11977,3029,9588,747,2590,733,2115,1480,4705
313910,202103,669,1908,512,1619,101,344,113,348,214,692
313920,202103,2983,8904,2494,7899,508,1589,1243,3966,1751,5555
313925,202103,1584,3959,1290,3445,162,413,856,2289,1018,2702
313930,202103,4606,13700,3750,12138,273,1005,2427,7759,2700,8764
313940,202103,8940,25428,6653,21466,681,2701,1623,5944,2304,8645
313950,202103,5319,11527,4027,9959,311,978,2616,6494,2927,7472
313960,202103,5750,13657,3870,10516,722,2224,1280,3173,2002,5397
313970,202103,1532,4046,1288,3646,20,62,835,2318,855,2380
313980,202103,1324,3406,881,2731,139,475,367,1079,506,1554
313990,202103,1908,5931,1386,4765,332,1325,462,1393,794,2718
314000,202103,9732,24584,8186,21964,617,2082,5436,14328,6053,16410
314010,202103,1475,3503,1171,3094,37,120,908,2326,945,2446
314015,202103,1958,5336,1512,4577,186,642,848,2503,1034,3145
314020,202103,513,1377,355,1111,82,309,65,225,147,534
314030,202103,787,2227,625,1923,61,186,336,1013,397,1199
314040,202103,602,1621,494,1427,80,265,255,700,335,965
314050,202103,1889,4947,1393,4043,141,480,772,2078,913,2558
314053,202103,1835,5395,1516,4771,319,977,810,2653,1129,3630
314055,202103,2188,5842,1845,5304,44,164,1510,4335,1554,4499
314060,202103,1310,3406,989,2903,34,116,708,2055,742,2171
314070,202103,4805,12893,3790,11119,736,2147,1700,4949,2436,7096
314080,202103,2144,5474,1499,4395,179,582,643,1702,822,2284
314085,202103,2254,6114,1846,5496,195,585,1097,3335,1292,3920
314090,202103,4809,12599,4126,11603,228,722,2758,8010,2986,8732
314100,202103,3039,7243,2354,6290,35,109,1769,4756,1804,4865
314110,202103,4982,13672,4088,12011,453,1493,2281,6245,2734,7738
314120,202103,725,1688,317,942,56,196,77,211,133,407
314130,202103,663,1741,430,1315,26,96,251,744,277,840
314140,202103,4546,12607,3651,10972,484,1486,1861,5520,2345,7006
314150,202103,1524,3753,1124,3069,60,153,774,2076,834,2229
314160,202103,2242,5770,1655,4687,220,684,704,1991,924,2675
314170,202103,913,2532,749,2212,36,136,500,1375,536,1511
314180,202103,5471,14957,4424,13271,328,1048,2722,8181,3050,9229
314190,202103,619,1507,450,1265,76,247,230,588,306,835
314200,202103,3005,8294,2494,7432,160,516,1744,5077,1904,5593
314210,202103,2068,5285,1636,4523,209,578,775,2103,984,2681
314220,202103,1393,3768,1029,3137,216,740,377,1060,593,1800
314225,202103,1029,2901,861,2625,70,175,634,1983,704,2158
314230,202103,807,2065,656,1875,84,251,418,1238,502,1489
314240,202103,1074,2863,830,2487,188,592,322,974,510,1566
314250,202103,497,1381,314,990,47,130,112,332,159,462
314260,202103,1014,2657,790,2353,163,527,440,1285,603,1812
314270,202103,3230,9058,2662,8190,72,303,1976,6022,2048,6325
314280,202103,3457,7900,2358,6236,246,727,1339,3351,1585,4078
314290,202103,4396,11317,3650,10000,305,856,2505,6718,2810,7574
314300,202103,2010,5617,1315,4154,218,745,465,1362,683,2107
314310,202103,3915,10091,2621,7886,797,2670,403,1047,1200,3717
314315,202103,965,3140,827,2848,46,203,593,1972,639,2175
314320,202103,3080,8238,2032,6278,350,1183,750,2195,1100,3378
314330,202103,49649,137601,37825,116862,9670,31127,8023,26097,17693,57224
314340,202103,2464,6080,1553,4469,283,938,397,989,680,1927
314345,202103,1456,4202,1170,3685,143,452,709,2221,852,2673
314350,202103,802,2151,519,1638,114,365,117,322,231,687
314360,202103,554,1605,368,1217,49,176,122,371,171,547
314370,202103,760,1986,615,1772,48,149,412,1145,460,1294
314380,202103,1103,2956,729,2304,163,583,153,460,316,1043
314390,202103,14072,34964,9418,26684,1475,4522,3180,8020,4655,12542
314400,202103,3852,11466,2945,9654,740,2520,1090,3720,1830,6240
314410,202103,2702,7500,1906,6018,248,917,616,2024,864,2941
314420,202103,848,2045,615,1665,34,123,420,1074,454,1197
314430,202103,7874,18934,5544,15109,795,2281,2637,6842,3432,9123
314435,202103,1912,5012,1493,4331,144,455,952,2690,1096,3145
314437,202103,910,2296,659,1889,72,217,332,951,404,1168
314440,202103,616,1741,441,1400,132,463,85,214,217,677
314450,202103,1435,3771,1213,3406,126,395,694,1869,820,2264
314460,202103,3171,9516,2333,7813,587,2100,567,1817,1154,3917
314465,202103,2229,6325,1902,5717,52,184,1486,4360,1538,4544
314467,202103,899,2349,760,2128,21,57,611,1673,632,1730
314470,202103,2356,6596,1953,5801,335,1054,922,2564,1257,3618
314480,202103,6748,18738,5022,15189,801,2735,1962,5257,2763,7992
314490,202103,1104,2854,809,2255,65,197,528,1426,593,1623
314500,202103,1694,4002,1225,3378,319,852,411,1196,730,2048
314505,202103,2044,4942,1675,4412,89,256,1248,3190,1337,3446
314510,202103,1989,5102,1415,4216,282,942,646,1878,928,2820
314520,202103,4983,14966,3779,12537,751,2735,496,1483,1247,4218
314530,202103,5412,17127,4886,16124,314,1224,3631,11726,3945,12950
314535,202103,2426,6314,1981,5677,72,283,1525,4330,1597,4613
314537,202103,1101,3081,847,2676,38,150,628,1943,666,2093
314540,202103,399,981,275,779,23,66,161,435,184,501
314545,202103,1967,4637,1763,4400,30,83,1549,3952,1579,4035
314550,202103,712,1702,530,1432,34,110,307,760,341,870
314560,202103,4538,13365,3361,10791,470,1716,1215,3451,1685,5167
314570,202103,305,840,224,689,29,100,97,299,126,399
314580,202103,451,1329,359,1150,94,303,117,371,211,674
314585,202103,661,2024,509,1695,52,202,226,735,278,937
314587,202103,2046,5496,1555,4717,181,522,936,2896,1117,3418
314590,202103,4144,11014,3066,9044,389,1274,1420,3851,1809,5125
314600,202103,1910,5136,1149,3702,243,818,132,421,375,1239
314610,202103,8948,21863,6440,18248,941,3205,2839,8230,3780,11435
314620,202103,2264,5233,1798,4642,43,138,1509,3886,1552,4024
314625,202103,1555,4186,1342,3889,28,165,1165,3304,1193,3469
314630,202103,5519,13578,4526,12230,105,414,3794,10149,3899,10563
314640,202103,700,1632,516,1350,67,206,298,722,365,928
314650,202103,823,1877,515,1397,49,153,296,720,345,873
314655,202103,1584,4321,1140,3536,169,515,562,1761,731,2276
314660,202103,322,723,212,535,11,23,140,341,151,364
314670,202103,1628,3650,1145,2976,18,56,775,1978,793,2034
314675,202103,1732,4481,1479,4062,66,199,1171,3134,1237,3333
314690,202103,2039,5549,1555,4847,387,1339,545,1665,932,3004
314700,202103,10529,28669,6999,21967,1297,4495,2360,7137,3657,11632
314710,202103,8022,22189,5911,17771,929,3102,2213,5792,3142,8894
314720,202103,2146,6272,1517,5008,291,1038,365,1127,656,2165
314730,202103,2346,6012,1701,4880,273,864,668,1750,941,2614
314740,202103,2986,8290,2331,7119,295,942,1201,3571,1496,4513
314750,202103,281,769,216,637,27,91,131,344,158,435
314760,202103,1991,5805,1304,4260,215,793,340,866,555,1659
314770,202103,1090,3129,608,1952,59,200,182,538,241,738
314780,202103,360,860,247,690,37,124,138,345,175,469
314790,202103,11693,30693,8239,24326,1563,5285,3075,8353,4638,13638
314795,202103,1547,4002,1317,3608,27,113,1067,2813,1094,2926
314800,202103,10700,27086,6771,19932,1174,3738,1842,4849,3016,8587
314810,202103,8895,23374,6501,19263,1658,5214,2075,6038,3733,11252
314820,202103,1264,3001,1000,2598,70,231,632,1557,702,1788
314830,202103,1600,4712,1347,4247,209,740,680,2066,889,2806
314840,202103,856,2637,670,2309,48,212,458,1497,506,1709
314850,202103,2211,4917,1804,4409,50,128,1562,3816,1612,3944
314860,202103,3271,9333,2732,8374,156,617,1958,5834,2114,6451
314870,202103,6441,15727,4905,13729,246,702,3682,10469,3928,11171
314875,202103,1827,5359,1612,5081,150,365,1279,4172,1429,4537
314880,202103,820,1995,640,1718,36,100,392,1065,428,1165
314890,202103,420,1226,325,1036,52,184,137,406,189,590
314900,202103,718,1906,564,1636,73,248,260,709,333,957
314910,202103,1677,4675,1248,3977,188,694,650,1951,838,2645
314915,202103,2207,6447,1861,5838,119,376,1236,3807,1355,4183
314920,202103,472,1227,311,985,8,19,206,667,214,686
314930,202103,5551,15399,4222,12928,684,2344,1748,4952,2432,7296
314940,202103,414,998,344,882,41,106,224,548,265,654
314950,202103,554,1385,384,1113,26,94,204,541,230,635
314960,202103,848,1967,651,1651,28,84,473,1132,501,1216
314970,202103,964,2821,738,2360,136,479,326,939,462,1418
314980,202103,1596,4025,1206,3455,197,646,621,1722,818,2368
314990,202103,2414,6907,1744,5421,333,1090,378,1055,711,2145
314995,202103,1607,4389,1279,3808,30,121,887,2499,917,2620
315000,202103,1118,2799,800,2312,60,176,528,1509,588,1685
315010,202103,379,1023,289,870,47,169,142,406,189,575
315015,202103,2316,6393,2015,5886,187,634,1367,3919,1554,4553
315020,202103,804,2322,572,1810,63,248,250,730,313,978
315030,202103,601,1583,414,1239,93,282,85,219,178,501
315040,202103,857,2323,691,2029,90,292,422,1214,512,1506
315050,202103,1229,3136,912,2637,52,189,498,1380,550,1569
315053,202103,1132,2915,877,2485,54,158,516,1393,570,1551
315057,202103,1758,5167,1429,4618,133,403,963,3196,1096,3599
315060,202103,595,1742,435,1420,90,297,113,353,203,650
315070,202103,520,1349,362,1079,81,272,101,285,182,557
315080,202103,3016,8220,2357,6991,163,547,1605,4512,1768,5059
315090,202103,799,2368,598,1998,86,313,254,814,340,1127
315100,202103,1324,3810,882,2835,130,486,387,1092,517,1578
315110,202103,1996,4695,1457,3892,132,348,739,2035,871,2383
315120,202103,12564,28832,9370,24082,1147,2667,5250,13965,6397,16632
315130,202103,1659,4465,1383,3992,138,453,580,1561,718,2014
315140,202103,2936,8045,2316,6955,429,1404,1158,3280,1587,4684
315150,202103,4362,10432,3112,8460,431,1370,1510,4006,1941,5376
315160,202103,1803,4352,1192,3386,254,774,536,1475,790,2249
315170,202103,1342,4204,961,3287,201,749,263,855,464,1604
315180,202103,17209,41286,9714,27727,1210,3907,3280,8242,4490,12149
315190,202103,2230,4853,1736,4207,198,477,1257,3096,1455,3573
315200,202103,4003,11165,2947,9333,808,2770,777,2359,1585,5129
315210,202103,8720,22304,6053,16791,680,2026,3017,7570,3697,9596
315213,202103,1122,2909,977,2712,22,75,814,2211,836,2286
315217,202103,2855,8132,2191,7031,93,405,1512,4665,1605,5070
315220,202103,8564,22966,6756,19812,1038,3183,3047,8986,4085,12169
315230,202103,3042,7055,2567,6425,202,273,1944,5203,2146,5476
315240,202103,2401,6932,2006,6251,431,1400,969,3053,1400,4453
315250,202103,13466,35797,9873,29116,1478,4678,4226,11857,5704,16535
315260,202103,867,2342,465,1505,71,238,40,106,111,344
315270,202103,875,2477,641,2043,85,289,229,629,314,918
315280,202103,2806,6915,1749,5052,426,1320,286,802,712,2122
315290,202103,1150,2805,695,2081,187,630,198,579,385,1209
315300,202103,643,1567,456,1303,63,199,254,736,317,935
315310,202103,1232,3406,942,2864,73,242,545,1561,618,1803
315320,202103,665,1932,470,1540,70,254,186,556,256,810
315330,202103,756,2527,427,1646,63,286,140,479,203,765
315340,202103,2937,7038,2121,5852,314,874,1092,3003,1406,3877
315350,202103,1578,4239,1270,3754,163,568,743,2146,906,2714
315360,202103,1730,5040,1330,4229,189,627,564,1674,753,2301
315370,202103,512,1423,420,1243,70,198,193,559,263,757
315380,202103,205,592,153,480,42,150,36,81,78,231
315390,202103,1149,3199,923,2788,131,473,460,1281,591,1754
315400,202103,4032,10781,3200,9306,386,1206,1855,5135,2241,6341
315410,202103,2505,5620,1874,4690,418,1164,362,936,780,2100
315415,202103,1383,3728,1122,3324,243,849,412,1236,655,2085
315420,202103,1473,4084,1027,3243,180,600,229,682,409,1282
315430,202103,3636,8776,2579,7189,446,1441,1143,3011,1589,4452
315440,202103,1048,2733,833,2377,63,211,501,1340,564,1551
315445,202103,1930,4597,1388,3825,86,283,1019,2761,1105,3044
315450,202103,2290,6213,1887,5556,237,621,1181,3520,1418,4141
315460,202103,38664,104948,32031,93247,4304,14218,18248,49807,22552,64025
315470,202103,636,1761,453,1320,28,90,258,713,286,803
315480,202103,1078,3099,767,2430,138,467,254,777,392,1244
315490,202103,2917,7319,2057,5930,275,823,792,2160,1067,2983
315500,202103,521,1383,328,966,37,125,173,451,210,576
315510,202103,1226,3140,1050,2899,17,69,932,2538,949,2607
315520,202103,1004,2707,829,2421,45,153,647,1842,692,1995
315530,202103,611,1701,489,1480,119,412,251,712,370,1124
315540,202103,1532,4043,1082,3226,94,345,509,1460,603,1805
315550,202103,1880,4906,1229,3715,250,875,310,929,560,1804
315560,202103,6181,18621,5225,16893,304,915,3442,11401,3746,12316
315570,202103,2099,5541,1662,4803,128,415,905,2548,1033,2963
315580,202103,3031,7044,2326,5950,345,967,927,2274,1272,3241
315590,202103,895,2229,690,1913,61,212,415,1069,476,1281
315600,202103,2526,7724,1806,6296,287,925,889,3309,1176,4234
315610,202103,987,2461,741,2026,101,347,344,808,445,1155
315620,202103,520,1357,397,1177,42,138,221,663,263,801
315630,202103,1043,2735,800,2289,118,367,394,1029,512,1396
315640,202103,345,839,255,726,28,104,157,422,185,526
315645,202103,985,2519,687,2033,149,480,192,537,341,1017
315650,202103,1677,4040,1357,3599,34,111,1102,2835,1136,2946
315660,202103,2488,6102,1872,5044,99,300,1356,3527,1455,3827
315670,202103,13679,36740,10479,31062,1977,6141,4783,13582,6760,19723
315680,202103,3218,9032,2378,7443,271,992,1314,3886,1585,4878
315690,202103,3504,8410,2142,6106,463,1313,580,1796,1043,3109
315700,202103,8199,22239,6257,18468,974,3037,2772,7860,3746,10897
315710,202103,1844,4491,1324,3708,42,164,942,2543,984,2707
315720,202103,4410,12111,3674,10780,191,719,2576,7260,2767,7979
315725,202103,2247,5739,1728,4906,199,543,1057,3154,1256,3697
315727,202103,563,1440,431,1229,58,200,181,489,239,689
315730,202103,567,1749,502,1614,99,357,158,452,257,809
315733,202103,1190,3003,882,2502,135,447,326,880,461,1327
315737,202103,1144,3182,902,2715,25,102,657,1898,682,2000
315740,202103,794,2197,646,1904,62,213,432,1192,494,1405
315750,202103,1251,3264,1001,2870,91,275,616,1793,707,2068
315760,202103,1131,2633,995,2453,45,136,832,2004,877,2140
315765,202103,1981,5137,1633,4678,25,99,1452,4140,1477,4239
315770,202103,1009,2749,780,2428,306,1043,162,434,468,1477
315780,202103,30386,81336,25432,72656,1324,4685,17732,48302,19056,52987
315790,202103,3615,10997,3097,10037,312,1059,1903,6313,2215,7372
315800,202103,1301,4380,979,3575,131,549,350,1116,481,1665
315810,202103,1286,3205,1055,2806,59,195,818,2087,877,2282
315820,202103,2574,6803,2093,6130,190,588,1457,4297,1647,4885
315830,202103,1234,3606,838,2741,85,299,275,778,360,1077
315840,202103,867,2062,615,1627,44,145,316,752,360,897
315850,202103,1190,3420,937,2980,183,623,452,1348,635,1971
315860,202103,489,1393,353,1155,55,198,129,379,184,577
315870,202103,467,1224,375,1082,23,75,266,734,289,809
315880,202103,1112,2810,757,2178,91,277,198,545,289,822
315890,202103,1689,4750,1369,4308,332,1151,689,2144,1021,3295
315895,202103,6251,16663,4714,13683,424,1394,2477,6673,2901,8067
315900,202103,806,2050,696,1895,60,163,528,1404,588,1567
315910,202103,516,1393,435,1266,67,189,296,867,363,1056
315920,202103,1441,3640,817,2476,121,451,271,735,392,1186
315930,202103,1087,2383,741,1895,142,350,327,853,469,1203
315935,202103,845,2525,672,2197,131,454,244,786,375,1240
315940,202103,608,1642,486,1457,60,187,262,756,322,943
315950,202103,1141,3131,944,2810,79,225,737,2191,816,2416
315960,202103,5489,15286,3745,11769,1013,3571,434,962,1447,4533
315970,202103,589,1542,469,1382,59,183,313,937,372,1120
315980,202103,4277,9100,2388,6062,442,1171,897,2088,1339,3259
315990,202103,3584,9088,2820,7795,310,897,1562,4176,1872,5073
316000,202103,612,1516,473,1313,51,173,237,623,288,796
316010,202103,817,2194,613,1839,54,191,333,904,387,1095
316020,202103,939,2779,753,2414,117,419,406,1222,523,1641
316030,202103,2743,7609,2125,6498,247,752,1350,4213,1597,4965
316040,202103,2411,6793,1830,5710,298,1063,529,1437,827,2500
316045,202103,2074,5297,1908,5099,76,144,1661,4552,1737,4696
316050,202103,386,1052,305,919,39,115,169,473,208,588
316060,202103,672,1648,490,1406,18,77,349,958,367,1035
316070,202103,5386,14678,4410,12866,775,2258,2040,5837,2815,8095
316080,202103,742,2287,578,1960,143,512,91,265,234,777
316090,202103,410,1150,318,967,43,133,162,457,205,590
316095,202103,1313,3999,1035,3300,267,909,364,1090,631,1999
316100,202103,2508,7187,1849,5818,313,1083,708,2031,1021,3114
316105,202103,820,2138,677,1907,39,126,467,1348,506,1474
316110,202103,13948,39229,11695,35442,847,2903,8045,24019,8892,26922
316120,202103,1249,3465,820,2471,122,393,260,608,382,1001
316130,202103,1259,2837,831,2131,67,194,499,1238,566,1432
316140,202103,1226,3223,789,2405,92,310,376,1127,468,1437
316150,202103,2031,4456,1621,3884,215,643,687,1546,902,2189
316160,202103,1028,2731,828,2363,37,126,584,1626,621,1752
316165,202103,837,2067,654,1784,93,297,370,947,463,1244
316170,202103,1189,2922,900,2489,40,138,634,1683,674,1821
316180,202103,1384,3890,960,3040,141,528,175,508,316,1036
316190,202103,2705,7576,1619,4995,235,749,626,1717,861,2466
316200,202103,3183,9070,2424,7766,549,1881,691,2120,1240,4001
316210,202103,4551,13236,3298,10366,1147,3952,175,452,1322,4404
316220,202103,620,1847,417,1400,88,340,49,191,137,531
316225,202103,1577,3537,1180,2913,50,182,896,2050,946,2232
316230,202103,419,1131,326,980,53,167,161,485,214,652
316240,202103,5582,16002,4893,14794,354,1170,3712,11058,4066,12228
316245,202103,3047,9659,2768,9184,112,621,2181,6907,2293,7528
316250,202103,10527,24892,7807,20660,1596,4557,2964,7793,4560,12350
316255,202103,2858,7873,2518,7342,112,339,1906,5624,2018,5963
316257,202103,1404,3337,1032,2689,98,257,644,1595,742,1852
316260,202103,2213,5407,1756,4680,217,563,934,2541,1151,3104
316265,202103,1125,2993,882,2588,19,74,665,1908,684,1982
316270,202103,3705,11216,3191,10110,471,1574,1625,4950,2096,6524
316280,202103,2878,8004,2469,7252,309,1011,1404,3979,1713,4990
316290,202103,3339,9179,2683,7966,304,1021,1143,3259,1447,4280
316292,202103,5123,13417,4157,11875,527,1596,2674,7353,3201,8949
316294,202103,832,2443,633,2105,118,453,167,516,285,969
316295,202103,3304,9142,2696,8089,140,507,1900,5448,2040,5955
316300,202103,1027,2863,832,2550,38,133,614,1856,652,1989
316310,202103,795,2107,527,1631,114,411,99,256,213,667
316320,202103,682,1880,538,1659,59,214,257,764,316,978
316330,202103,1090,2778,838,2354,49,162,645,1763,694,1925
316340,202103,999,2649,746,2197,76,278,424,1189,500,1467
316350,202103,1297,3612,1073,3246,119,364,711,2138,830,2502
316360,202103,623,1655,513,1477,53,161,374,1069,427,1230
316370,202103,5107,13316,3846,11110,580,1960,1675,4334,2255,6294
316380,202103,1730,4139,1376,3632,57,118,959,2557,1016,2675
316390,202103,786,2115,563,1719,238,815,81,216,319,1031
316400,202103,1194,3349,796,2559,103,357,268,779,371,1136
316410,202103,1145,3113,960,2835,59,189,772,2234,831,2423
316420,202103,1989,5347,1737,5020,39,135,1451,4112,1490,4247
316430,202103,856,2207,563,1702,92,312,208,576,300,888
316440,202103,816,2459,647,2158,113,435,174,528,287,963
316443,202103,541,1499,399,1226,99,353,90,254,189,607
316447,202103,1963,5217,1729,4825,20,72,1519,4188,1539,4260
316450,202103,2151,6445,1658,5417,226,806,981,3126,1207,3932
316460,202103,1248,3117,1021,2765,120,371,663,1702,783,2073
316470,202103,6953,19703,5037,15696,757,2623,1985,5655,2742,8278
316480,202103,189,510,159,469,46,135,72,207,118,342
316490,202103,326,874,229,695,36,112,82,216,118,328
316500,202103,1198,3665,798,2721,162,601,186,591,348,1192
316510,202103,785,2488,627,2176,100,357,322,1114,422,1471
316520,202103,1350,3217,1060,2754,119,396,567,1337,686,1733
316530,202103,1137,2937,828,2381,81,297,433,1111,514,1408
316540,202103,915,2288,729,2009,104,325,385,958,489,1283
316550,202103,1327,3841,1145,3505,46,162,888,2701,934,2863
316553,202103,4416,12816,3204,9934,455,1550,1277,3507,1732,5057
316555,202103,2593,7963,2355,7630,94,336,2001,6507,2095,6843
316556,202103,521,1286,402,1071,27,75,241,579,268,654
316557,202103,1056,3200,922,2982,288,1013,345,1070,633,2083
316560,202103,331,911,231,760,44,164,82,258,126,422
316570,202103,1318,3734,1101,3339,281,845,372,1186,653,2031
316580,202103,387,807,236,566,34,93,116,255,150,348
316590,202103,1354,3428,950,2650,203,494,454,1246,657,1740
316600,202103,940,2844,807,2578,121,397,414,1321,535,1718
316610,202103,601,1865,491,1687,60,261,289,958,349,1219
316620,202103,2124,5467,1869,5115,81,242,1506,4095,1587,4337
316630,202103,1564,4631,1295,4129,331,1062,508,1781,839,2843
316640,202103,137,358,110,322,16,57,51,124,67,181
316650,202103,1065,3267,851,2930,85,308,536,1859,621,2167
316660,202103,179,436,76,226,7,26,14,31,21,57
316670,202103,1783,4466,1347,3781,331,983,466,1285,797,2268
316680,202103,2298,5815,1713,4707,103,301,1280,3429,1383,3730
316690,202103,1434,3965,1087,3348,175,582,488,1447,663,2029
316695,202103,1018,2927,839,2608,26,107,596,1832,622,1939
316700,202103,395,922,323,832,16,48,250,619,266,667
316710,202103,3138,10092,2446,8668,432,1643,1063,3698,1495,5341
316720,202103,20656,55574,15367,45589,2555,8134,6722,18835,9277,26969
316730,202103,471,1231,378,1061,41,142,193,508,234,650
316740,202103,770,2190,665,2025,75,266,416,1282,491,1548
316750,202103,393,1150,305,986,71,241,127,390,198,631
316760,202103,3329,10658,2767,9522,1083,4034,602,1953,1685,5987
316770,202103,1637,3638,1256,3127,28,80,1021,2599,1049,2679
316780,202103,547,1606,431,1382,165,578,81,235,246,813
316790,202103,734,1966,534,1568,98,317,162,439,260,756
316800,202103,6365,17615,5132,15393,611,2025,2516,7329,3127,9354
316805,202103,1017,2239,825,2030,57,157,638,1583,695,1740
316810,202103,608,1671,433,1339,82,282,230,675,312,957
316820,202103,296,726,164,479,19,70,63,165,82,235
316830,202103,797,2067,643,1830,75,223,389,1092,464,1315
316840,202103,2819,7111,2241,6153,176,594,1591,4161,1767,4755
316850,202103,1894,4964,1385,4044,230,726,604,1680,834,2406
316860,202103,19534,49354,14359,41652,2183,7355,6659,18824,8842,26179
316870,202103,7922,21237,5934,17443,844,2704,2713,7460,3557,10164
316880,202103,938,2466,769,2229,137,427,393,1099,530,1526
316890,202103,1155,2546,693,1938,85,306,442,1151,527,1457
316900,202103,2311,6133,1811,5152,372,1147,535,1424,907,2571
316905,202103,515,1524,417,1335,109,378,164,532,273,910
316910,202103,868,2244,527,1645,127,431,48,142,175,573
316920,202103,1786,4333,1276,3583,205,619,639,1752,844,2371
316930,202103,7819,22099,5860,18599,1343,4579,1602,4777,2945,9356
316935,202103,4048,10861,2968,8878,513,1675,1203,3422,1716,5097
316940,202103,6465,18719,5012,15775,712,2456,2102,6127,2814,8583
316950,202103,1900,4395,1489,3837,39,127,1256,3189,1295,3316
316960,202103,5085,11341,3662,9427,342,959,2495,6280,2837,7239
316970,202103,3776,10543,3272,9622,492,1523,1393,3890,1885,5413
316980,202103,665,1968,510,1671,168,612,60,206,228,818
316990,202103,12199,32228,9023,25879,2160,6761,1502,3877,3662,10638
317000,202103,2494,7272,2194,6834,159,430,1641,5168,1800,5598
317005,202103,2563,7088,2054,6078,318,977,1119,3245,1437,4222
317010,202103,23989,55781,15116,42290,2814,8735,5944,16950,8758,25685
317020,202103,61550,145602,36750,102992,6520,19992,11957,31025,18477,51017
317030,202103,688,1792,537,1584,13,54,416,1211,429,1265
317040,202103,11005,27427,7787,21978,1656,5060,2772,8039,4428,13099
317043,202103,847,1892,605,1552,45,116,444,1128,489,1244
317047,202103,1167,2788,809,2218,73,218,517,1360,590,1578
317050,202103,1165,3556,846,2820,110,380,346,1011,456,1391
317052,202103,2392,6549,1928,5804,278,807,1182,3604,1460,4411
317057,202103,1890,4339,1398,3569,34,116,952,2391,986,2507
317060,202103,513,1316,333,965,41,129,137,346,178,475
317065,202103,1137,3331,933,2933,57,177,586,1752,643,1929
317070,202103,7300,20087,5281,16227,900,3088,1680,4882,2580,7970
317075,202103,916,2350,670,1940,92,296,333,880,425,1176
317080,202103,6153,14155,4574,11679,1162,3242,1616,3967,2778,7209
317090,202103,4807,13715,4270,12849,286,799,3184,9643,3470,10442
317100,202103,2647,6272,1723,4759,394,1118,631,1729,1025,2847
317103,202103,2257,5842,1942,5384,72,318,1547,4127,1619,4445
317107,202103,1471,3848,1127,3217,74,252,690,1771,764,2023
317110,202103,674,1575,349,1059,58,207,112,347,170,554
317115,202103,1069,3049,925,2783,60,160,628,1911,688,2071
317120,202103,15230,40308,12381,35787,1038,3581,7834,21605,8872,25186
317130,202103,11461,26330,7482,19869,1123,3304,2619,6891,3742,10195
317140,202103,878,2074,687,1790,44,114,466,1253,510,1367
317150,202103,983,2350,752,2059,29,90,597,1607,626,1697
317160,202103,3577,8460,2400,6607,144,410,1357,3828,1501,4238
317170,202103,1796,4456,1323,3655,174,564,631,1552,805,2116
317180,202103,1988,6105,1462,4847,280,1000,404,1228,684,2228
317190,202103,1210,3245,895,2722,217,640,380,1164,597,1804
317200,202103,5862,15420,4428,12659,1020,3136,993,2615,2013,5751
317210,202103,1205,2881,941,2521,23,90,705,1910,728,2000
317220,202103,235,731,202,668,47,160,76,267,123,427
320010,202103,4532,13038,3654,11293,414,1400,2277,6847,2691,8247
320013,202103,2062,5505,1436,4279,229,702,636,1987,865,2689
320016,202103,3004,7627,2396,6723,173,451,1764,4988,1937,5439
320020,202103,3938,10040,2912,8284,596,1889,1081,3164,1677,5053
320030,202103,1731,4799,1148,3617,210,720,405,1230,615,1950
320035,202103,1934,5220,1587,4634,386,1242,715,2012,1101,3254
320040,202103,4199,11736,3508,10510,465,1450,1981,5709,2446,7159
320050,202103,1761,3983,1516,3635,185,528,905,2089,1090,2617
320060,202103,13201,35433,9879,28909,1497,4733,4628,12627,6125,17360
320070,202103,1549,4285,1110,3409,193,656,405,1166,598,1822
320080,202103,5835,14810,4087,11358,799,2348,1470,3845,2269,6193
320090,202103,8702,22852,5799,16927,1273,3966,2050,5556,3323,9522
320100,202103,3127,8372,2566,7414,416,1293,1349,3904,1765,5197
320110,202103,2108,4838,1433,3762,200,555,731,1832,931,2387
320115,202103,1896,5961,1604,5472,687,2513,405,1428,1092,3941
320120,202103,24525,61944,17245,48912,2370,7194,8060,21635,10430,28829
320130,202103,48196,131435,39832,116500,4875,15654,23616,66857,28491,82511
320140,202103,3602,9751,2424,7441,341,1228,1003,2996,1344,4224
320150,202103,13889,35594,10089,28447,2482,7722,1570,3925,4052,11647
320160,202103,6178,16975,4580,13930,728,2440,2032,6102,2760,8542
320170,202103,1755,4958,1276,3996,349,1075,465,1552,814,2627
320180,202103,692,2164,554,1899,207,753,147,452,354,1205
320190,202103,2869,9047,2210,7603,514,1892,567,1815,1081,3707
320200,202103,1354,3601,926,2834,206,707,346,1038,552,1745
320210,202103,4331,10927,3349,9259,539,1602,1733,4587,2272,6189
320220,202103,3080,7884,2369,6740,351,1092,1291,3501,1642,4593
320225,202103,1367,4212,981,3310,339,1254,194,641,533,1895
320230,202103,5117,13917,3937,11979,822,2739,1549,4553,2371,7292
320240,202103,16473,41191,12273,34513,2958,9100,3882,10733,6840,19833
320245,202103,3157,9182,2480,7843,846,2831,418,1290,1264,4121
320250,202103,2481,6840,1683,4960,384,1243,485,1228,869,2471
320255,202103,1935,5935,1657,5418,412,1397,769,2578,1181,3975
320260,202103,1444,4015,876,2747,169,577,219,588,388,1165
320265,202103,2483,7572,2007,6619,869,3099,304,975,1173,4074
320270,202103,2254,6387,1735,5369,446,1487,598,1857,1044,3344
320280,202103,7369,19391,6033,17134,1133,3506,3011,8255,4144,11761
320290,202103,1352,3980,879,2851,238,847,220,662,458,1509
320300,202103,3688,10953,2929,9414,806,2815,752,2261,1558,5076
320305,202103,5218,14556,4066,12307,728,2410,2002,5866,2730,8276
320310,202103,2285,6172,1610,4782,281,888,718,1989,999,2877
320313,202103,2460,6075,1645,4590,323,996,443,1116,766,2112
320316,202103,1496,4204,1221,3739,192,599,715,2195,907,2794
320320,202103,22400,57968,16050,47024,3657,11166,5729,16866,9386,28032
320330,202103,2956,7929,2305,6757,402,1202,1217,3615,1619,4817
320332,202103,7800,20739,6215,17873,1385,4283,2724,7683,4109,11966
320334,202103,1778,4923,1251,3856,266,992,309,716,575,1708
320335,202103,1490,4380,1076,3437,237,851,296,868,533,1719
320340,202103,4933,12128,4098,10910,499,1429,2419,6490,2918,7919
320350,202103,5507,13345,3919,10536,425,1278,2153,5409,2578,6687
320360,202103,1432,3651,1067,2971,135,370,518,1389,653,1759
320370,202103,2562,7795,1887,6346,565,2008,573,1909,1138,3917
320380,202103,2637,6950,2190,6224,246,747,1393,3858,1639,4605
320390,202103,7271,19308,5384,15591,1113,3450,2139,5806,3252,9256
320400,202103,3348,9350,2530,7623,707,2292,790,2235,1497,4527
320405,202103,5039,12997,3852,10963,538,1675,1957,5382,2495,7057
320410,202103,4800,12307,3635,10438,651,1824,1811,5440,2462,7264
320420,202103,2911,7565,2235,6380,519,1657,477,1321,996,2978
320425,202103,2192,5248,1673,4371,132,344,1043,2671,1175,3015
320430,202103,3209,7967,2535,6780,348,1008,1542,3943,1890,4951
320435,202103,2067,6424,1633,5574,580,2109,509,1746,1089,3855
320440,202103,1524,4173,1124,3410,180,591,500,1435,680,2026
320450,202103,1775,4995,1384,4257,259,900,629,1804,888,2704
320455,202103,4405,13178,2999,9851,713,2521,740,2207,1453,4728
320460,202103,2104,6135,1508,4902,360,1262,415,1243,775,2505
320465,202103,1361,3759,1047,3170,151,453,564,1739,715,2192
320470,202103,3668,9994,2673,7940,586,1851,664,1781,1250,3632
320480,202103,1713,4599,1407,4092,179,578,858,2433,1037,3011
320490,202103,21841,56416,16398,46987,2664,8261,6997,19881,9661,28142
320495,202103,1278,3468,922,2775,197,680,328,927,525,1607
320500,202103,52667,138757,42234,121055,5657,17641,24562,67382,30219,85023
320501,202103,4469,12872,3348,10839,915,3328,1065,3376,1980,6704
320503,202103,2320,6654,1526,5002,411,1458,409,1295,820,2753
320506,202103,2666,7920,1970,6379,602,2099,177,586,779,2685
320510,202103,10432,27803,8514,24564,871,2869,5288,14753,6159,17622
320515,202103,1806,4916,1402,4089,361,1165,468,1283,829,2448
320517,202103,2184,6500,1761,5593,535,1853,541,1691,1076,3544
320520,202103,37657,95872,28380,80375,4604,14383,12271,33365,16875,47748
320530,202103,33724,87603,26796,75511,2316,7712,17095,45460,19411,53172
330010,202103,23645,61237,19615,54668,2272,6950,13203,35678,15475,42628
330015,202103,1386,3367,1092,2943,188,567,628,1617,816,2184
330020,202103,19771,48962,16631,44493,2300,6855,11519,30146,13819,37001
330022,202103,1892,5038,1468,4336,232,679,835,2452,1067,3131
330023,202103,5213,12195,3829,10290,571,1724,2228,5867,2799,7591
330025,202103,6953,15960,4096,11254,892,2720,814,2137,1706,4857
330030,202103,10481,27546,7993,23550,787,2696,4957,13927,5744,16623
330040,202103,14956,38252,11968,33315,1004,3140,8186,21889,9190,25029
330045,202103,85511,199469,70500,180584,5296,13217,55932,143024,61228,156241
330050,202103,2527,6602,1870,5500,350,1098,952,2672,1302,3770
330060,202103,5279,13557,4127,11525,781,2438,1772,4556,2553,6994
330070,202103,22675,56313,18282,50112,2683,7909,11038,29969,13721,37878
330080,202103,8831,21990,7529,20188,902,2593,5244,13865,6146,16458
330090,202103,3415,7110,2388,5703,147,377,1691,4027,1838,4404
330093,202103,2692,6378,2030,5471,114,328,1545,4148,1659,4476
330095,202103,1305,3600,1034,3115,82,272,630,1766,712,2038
330100,202103,71978,187174,61543,171998,3399,11189,47600,131087,50999,142276
330110,202103,2093,5751,1675,5060,254,838,972,2838,1226,3676
330115,202103,2564,6066,1813,4915,247,764,1036,2684,1283,3448
330120,202103,3583,7856,2701,6739,206,584,1938,4651,2144,5235
330130,202103,4431,11819,3619,10614,482,1470,2262,6608,2744,8078
330140,202103,3894,9905,3109,8791,391,1227,2055,5669,2446,6896
330150,202103,2159,5656,1645,4856,296,887,819,2390,1115,3277
330160,202103,1355,3638,1003,3014,186,604,527,1506,713,2110
330170,202103,112894,273529,90745,243892,11997,31670,61369,167151,73366,198821
330180,202103,1950,4635,1498,4015,87,266,1037,2712,1124,2978
330185,202103,9912,24560,8278,22326,454,1487,6687,17608,7141,19095
330187,202103,4522,11186,3565,9649,455,1338,2178,5808,2633,7146
330190,202103,34443,81581,28979,74177,1867,5184,23039,58248,24906,63432
330200,202103,16260,40345,13158,36553,2552,6611,8174,23630,10726,30241
330205,202103,2173,5300,1649,4464,102,319,1141,2963,1243,3282
330210,202103,3546,8659,2591,7027,353,1025,1310,3323,1663,4348
330220,202103,12278,29822,8714,23960,1685,5225,3336,8487,5021,13712
330225,202103,3971,9827,3035,8431,195,666,2186,5919,2381,6585
330227,202103,16941,40378,14090,36952,519,1479,12083,31372,12602,32851
330230,202103,2126,4562,1386,3642,120,342,812,2149,932,2491
330240,202103,23497,60352,19437,54194,2129,6549,13278,36199,15407,42748
330245,202103,1785,4338,1077,3108,199,592,401,1139,600,1731
330250,202103,38869,97501,32017,87531,5146,14498,19988,54299,25134,68797
330260,202103,5003,11846,3784,10204,317,996,2750,7163,3067,8159
330270,202103,32355,72123,19979,51950,3002,8368,8254,20390,11256,28758
330280,202103,2356,6069,1771,5085,179,551,1058,2936,1237,3487
330285,202103,25579,59831,20184,52186,1262,3855,15284,38222,16546,42077
330290,202103,3994,9521,3221,8520,330,987,2325,5937,2655,6924
330300,202103,5856,13596,4280,11366,313,923,3023,7852,3336,8775
330310,202103,2738,6585,1957,5307,131,299,1333,3617,1464,3916
330320,202103,17379,40003,13339,35016,1511,3734,9574,25492,11085,29226
330330,202103,42705,91313,33214,78561,2746,7165,23985,55378,26731,62543
330340,202103,18125,41766,12972,33951,1810,5482,6942,16857,8752,22339
330350,202103,146753,332773,121152,301815,7477,19290,99956,247356,107433,266646
330360,202103,7474,17942,6385,16637,198,504,5424,14074,5622,14578
330370,202103,5021,14095,3874,12168,903,2912,1614,5267,2517,8179
330380,202103,5506,14349,4177,12042,628,2145,2221,6078,2849,8223
330385,202103,4073,11408,3318,10316,717,2467,1626,4972,2343,7439
330390,202103,26985,71087,20666,60503,2658,9013,12335,33990,14993,43003
330395,202103,3246,7892,2672,7171,144,458,1965,5134,2109,5592
330400,202103,3442,8908,2925,8107,149,545,2204,5751,2353,6296
330410,202103,3372,8791,2410,7142,491,1563,1032,2886,1523,4449
330411,202103,2764,7397,2141,6268,135,474,1499,4219,1634,4693
330412,202103,1564,4352,1271,3873,131,459,801,2312,932,2771
330414,202103,23897,59362,19389,53260,1389,4100,14624,39573,16013,43673
330415,202103,4448,11926,3461,10235,358,1120,2028,5912,2386,7032
330420,202103,12183,29684,8682,24053,955,3035,4673,12029,5628,15064
330430,202103,9732,23053,8169,20943,287,923,6537,16273,6824,17196
330440,202103,2691,6995,2046,5922,285,941,1217,3391,1502,4332
330450,202103,1444,3992,1136,3471,142,463,638,1908,780,2371
330452,202103,17970,44775,14450,39417,1625,5033,9502,24952,11127,29985
330455,202103,559208,1304850,434329,1128512,57082,158461,283098,721657,340180,880118
330460,202103,1178,3141,885,2727,143,482,485,1460,628,1942
330470,202103,4908,11992,3553,9942,1121,3285,986,2820,2107,6105
330475,202103,9908,25021,7998,22577,1175,3803,5205,14329,6380,18132
330480,202103,6061,15400,5096,14004,417,1243,3542,9429,3959,10672
330490,202103,113604,257367,92118,228705,9988,25626,65876,162087,75864,187713
330500,202103,7506,18209,6203,16446,603,1793,4461,11629,5064,13422
330510,202103,40956,99123,30303,84239,4567,13681,18901,51638,23468,65319
330513,202103,1253,3162,1000,2822,195,585,519,1480,714,2065
330515,202103,2531,6614,2030,5923,362,1161,1149,3246,1511,4407
330520,202103,11500,29675,9398,26474,1108,3477,5968,16350,7076,19827
330530,202103,1735,4126,1276,3452,251,732,590,1577,841,2309
330540,202103,2810,7358,2191,6303,536,1573,917,2573,1453,4146
330550,202103,9201,23027,7029,20213,1845,5853,3074,8692,4919,14545
330555,202103,18722,38703,15513,34954,740,1837,12804,29136,13544,30973
330560,202103,4132,10835,3352,9581,520,1505,1981,5538,2501,7043
330570,202103,2700,7298,2306,6725,337,1067,1538,4446,1875,5513
330575,202103,5474,13936,4706,12654,281,852,3790,9893,4071,10745
330580,202103,17998,47044,14102,40162,2326,7135,7168,19544,9494,26679
330590,202103,1456,3862,1197,3527,217,639,752,2250,969,2889
330600,202103,12583,32273,10186,28474,890,2897,6613,17902,7503,20799
330610,202103,9137,24176,7319,21360,538,1828,5090,14526,5628,16354
330615,202103,2128,5742,1697,5172,309,961,1062,3310,1371,4271
330620,202103,4090,11419,3209,9924,677,2253,1411,4096,2088,6349
330630,202103,24639,60923,19409,52905,1245,4038,14000,36891,15245,40929
350010,202103,2064,5352,1129,3378,219,697,220,490,439,1187
350020,202103,712,1802,410,1233,55,180,133,376,188,556
350030,202103,3534,9735,2673,8262,639,2194,1186,3406,1825,5600
350040,202103,741,2099,431,1436,50,190,145,372,195,562
350050,202103,1375,3331,900,2521,187,606,326,751,513,1357
350055,202103,928,2408,737,2110,81,248,435,1181,516,1429
350060,202103,229,585,136,393,16,50,58,161,74,211
350070,202103,3253,8541,2116,6494,412,1396,692,1889,1104,3285
350075,202103,604,1734,450,1436,172,576,59,197,231,773
350080,202103,652,1680,431,1293,57,192,173,466,230,658
350090,202103,600,1397,362,1000,67,199,159,408,226,607
350100,202103,2337,6115,1643,4917,120,455,1032,2884,1152,3339
350110,202103,481,1190,333,936,17,55,194,532,211,587
350115,202103,1227,3518,1010,3078,169,577,520,1425,689,2002
350120,202103,677,1564,381,1028,34,115,208,494,242,609
350130,202103,3143,8235,2472,7009,440,1263,1201,3244,1641,4507
350140,202103,794,2196,556,1754,48,192,290,850,338,1042
350150,202103,544,1640,439,1437,95,307,129,390,224,697
350160,202103,11185,28021,7607,21474,965,3060,4542,12183,5507,15243
350170,202103,2344,6561,1915,5645,307,983,909,2423,1216,3406
350180,202103,1007,2452,549,1614,96,296,154,416,250,712
350190,202103,2838,7972,1942,6071,345,1230,807,2141,1152,3371
350200,202103,464,1291,357,1091,18,65,236,673,254,738
350210,202103,5900,13486,4032,10604,483,1403,2487,6273,2970,7676
350220,202103,2910,7893,1986,6067,412,1312,646,1781,1058,3093
350230,202103,979,2451,802,2208,144,421,459,1229,603,1650
350240,202103,644,1852,411,1308,98,303,101,295,199,598
350250,202103,2695,7480,2031,6378,594,2055,544,1681,1138,3736
350260,202103,841,1943,550,1461,55,170,337,847,392,1017
350270,202103,4576,12057,3652,10335,506,1597,1982,5183,2488,6780
350275,202103,2341,6216,1841,5461,297,971,1075,3046,1372,4017
350280,202103,18733,42273,11436,30510,1806,5059,4663,11821,6469,16880
350290,202103,3202,8771,2205,6743,393,1314,876,2500,1269,3814
350300,202103,630,1672,473,1384,57,168,260,710,317,878
350310,202103,921,2613,685,2151,106,379,276,780,382,1159
350315,202103,591,1460,391,1128,21,76,206,542,227,618
350320,202103,15451,39126,11334,31927,2208,6875,4556,11823,6764,18698
350330,202103,14018,33954,10100,26621,1040,3017,6408,15895,7448,18912
350335,202103,374,1061,290,900,38,133,129,375,167,508
350340,202103,1195,3015,742,2200,118,404,311,811,429,1215
350350,202103,757,1873,584,1684,65,215,360,1026,425,1241
350360,202103,1068,3138,815,2622,206,669,249,828,455,1497
350370,202103,626,1546,443,1222,150,387,136,379,286,766
350380,202103,4446,12062,3186,9492,903,2622,839,2578,1742,5200
350390,202103,10936,28241,8625,24385,1584,4711,4304,11636,5888,16347
350395,202103,429,1096,225,705,25,75,85,245,110,320
350400,202103,8025,19482,5575,15502,1351,4063,1543,4211,2894,8274
350410,202103,10080,27663,7384,22522,1462,4932,2907,8209,4369,13141
350420,202103,751,1995,519,1496,79,254,122,294,201,548
350430,202103,678,1799,553,1612,65,221,351,945,416,1166
350440,202103,2098,5175,1704,4588,127,360,1128,2979,1255,3339
350450,202103,6449,17609,4990,15088,1082,3603,2054,5826,3136,9429
350460,202103,1740,4453,957,2893,138,444,299,816,437,1260
350470,202103,257,645,200,548,12,38,143,375,155,413
350480,202103,1013,2450,666,1867,137,467,180,391,317,858
350490,202103,1974,5066,1409,4167,316,951,463,1254,779,2205
350500,202103,674,1768,509,1479,64,205,246,667,310,872
350510,202103,1211,3097,906,2551,95,303,551,1469,646,1772
350520,202103,2164,6499,1680,5563,261,967,741,2208,1002,3175
350530,202103,2831,7061,2125,5742,228,696,1270,3185,1498,3881
350535,202103,1453,3929,1257,3657,182,580,783,2210,965,2790
350540,202103,2016,4666,1508,3931,180,477,969,2421,1149,2898
350550,202103,8395,20518,5830,16296,600,2022,3377,8730,3977,10752
350560,202103,3890,10800,3114,9467,281,903,2005,5896,2286,6799
350570,202103,25181,69085,20500,60242,3516,11453,10765,30184,14281,41637
350580,202103,2075,5504,1274,3878,332,1098,237,582,569,1680
350590,202103,5115,13645,3769,10681,493,1592,2221,5787,2714,7379
350600,202103,35080,80360,21950,57908,3173,9518,10220,24693,13393,34211
350610,202103,6908,18642,4962,14794,802,2662,2368,6591,3170,9253
350620,202103,417,1051,258,803,23,72,152,449,175,521
350630,202103,1446,3706,1067,3043,63,224,703,1869,766,2093
350635,202103,9457,22955,7090,19288,944,2837,4336,11280,5280,14117
350640,202103,905,2396,482,1479,68,207,138,369,206,576
350650,202103,8532,22524,5913,17430,1098,3513,2270,6199,3368,9712
350660,202103,4532,11681,3497,9980,554,1589,1870,5366,2424,6955
350670,202103,1769,4665,1442,4193,140,416,981,2863,1121,3279
350680,202103,1104,2934,755,2306,129,417,312,904,441,1321
350690,202103,1301,3320,924,2704,157,484,491,1402,648,1886
350700,202103,4872,12200,3530,10127,717,2358,1530,4195,2247,6553
350710,202103,2857,7741,2420,6975,419,1411,1308,3462,1727,4873
350715,202103,776,2206,646,1986,68,266,355,1016,423,1282
350720,202103,158,420,116,347,19,61,38,93,57,154
350730,202103,625,1666,528,1504,22,78,401,1083,423,1161
350740,202103,1710,4485,1194,3449,198,608,417,1113,615,1721
350745,202103,576,1435,333,996,33,124,140,381,173,505
350750,202103,10005,25696,7654,21691,1302,4315,3574,9059,4876,13374
350760,202103,14909,36608,10805,29593,2129,6472,4686,11560,6815,18032
350770,202103,1004,2502,641,1868,39,123,405,1147,444,1270
350775,202103,696,1594,481,1279,60,155,231,625,291,780
350780,202103,2334,5602,1659,4648,279,924,570,1846,849,2770
350790,202103,2011,5289,1291,3938,246,804,352,891,598,1695
350800,202103,3504,9928,3006,9072,239,817,2091,6129,2330,6946
350810,202103,2839,6829,2187,5872,349,866,1127,3109,1476,3975
350820,202103,949,2204,560,1517,69,215,264,641,333,856
350830,202103,880,2412,510,1600,76,249,157,396,233,645
350840,202103,3307,9539,2490,8021,559,2007,1107,3266,1666,5273
350850,202103,7710,21055,6063,18113,1133,3656,2952,8339,4085,11995
350860,202103,3608,9550,3101,8878,112,414,2384,6776,2496,7190
350870,202103,2592,7222,1937,6182,256,903,1099,3422,1355,4325
350880,202103,1318,3706,1039,3160,267,850,269,771,536,1621
350890,202103,549,1421,346,994,55,165,125,311,180,476
350900,202103,7327,19527,4747,14212,929,3031,1764,4866,2693,7897
350910,202103,927,2214,798,2022,95,248,578,1438,673,1686
350920,202103,12296,29924,10447,26973,398,1274,8629,21484,9027,22758
350925,202103,4153,11164,2973,9061,551,1815,1430,4032,1981,5847
350930,202103,1494,3837,1047,2977,73,220,660,1834,733,2054
350940,202103,2264,5863,1738,5020,170,562,1099,3019,1269,3581
350945,202103,852,2381,648,1984,98,334,323,912,421,1246
350950,202103,90750,229932,70337,192286,8640,25826,43812,114326,52452,140152
350960,202103,6515,17421,5064,14734,594,1982,3030,8365,3624,10347
350970,202103,3571,9863,2565,8016,732,2533,555,1479,1287,4012
350980,202103,644,1751,519,1515,130,393,236,692,366,1085
350990,202103,1767,4857,1312,4132,309,1088,467,1397,776,2485
350995,202103,779,2417,701,2263,55,211,490,1528,545,1739
351000,202103,2854,7378,1990,5868,358,1108,723,2072,1081,3180
351010,202103,333,816,224,632,29,94,113,303,142,397
351015,202103,819,2444,662,2110,104,362,296,842,400,1204
351020,202103,8726,23461,6670,19969,1457,4350,3049,8996,4506,13346
351030,202103,2819,8281,2270,7222,327,1170,1217,3732,1544,4902
351040,202103,5066,12446,4239,11223,205,646,3482,8967,3687,9613
351050,202103,16704,40423,12144,33441,2293,6692,5504,14984,7797,21676
351060,202103,49317,122686,38007,103577,3677,11076,25804,67891,29481,78967
351070,202103,1371,3343,746,2291,178,601,125,369,303,970
351080,202103,2805,6663,2019,5742,205,698,1367,3701,1572,4399
351090,202103,328,938,241,780,44,145,70,231,114,376
351100,202103,2589,6985,1700,5215,365,1184,491,1563,856,2747
351110,202103,6150,15505,4030,11649,642,2047,1804,4894,2446,6941
351120,202103,769,1947,526,1544,67,206,202,584,269,790
351130,202103,1205,3049,558,1700,95,296,155,429,250,725
351140,202103,2200,6100,1623,5020,305,1061,706,1961,1011,3022
351150,202103,2700,7625,1838,5761,289,1002,730,2065,1019,3067
351160,202103,1074,3298,780,2617,150,543,204,566,354,1109
351170,202103,1352,3695,1157,3351,83,270,834,2323,917,2593
351190,202103,1026,2812,690,2137,121,370,259,748,380,1118
351200,202103,1610,3804,1199,3205,90,277,846,2119,936,2396
351210,202103,1551,3782,978,2718,75,239,565,1456,640,1695
351220,202103,3351,9279,2865,8488,297,892,1912,5590,2209,6482
351230,202103,1761,4704,1313,3925,228,777,610,1677,838,2454
351240,202103,2409,6033,1476,4133,320,984,523,1310,843,2294
351250,202103,1079,2833,644,1963,81,268,236,702,317,970
351260,202103,901,2252,649,1796,132,373,244,635,376,1008
351270,202103,446,1188,359,1035,37,133,200,509,237,642
351280,202103,3785,9817,2927,8235,582,1662,1317,3569,1899,5231
351290,202103,1225,2998,860,2372,116,346,515,1356,631,1702
351300,202103,18517,49560,12853,38822,2178,7198,5639,16206,7817,23404
351310,202103,3460,8336,2633,7077,157,537,1951,4975,2108,5512
351320,202103,951,2713,706,2218,119,392,252,715,371,1107
351330,202103,498,1192,409,1028,22,72,291,657,313,729
351340,202103,6248,17521,5044,15396,1187,3800,2269,6880,3456,10680
351350,202103,11433,28286,9432,25167,933,2640,6909,17948,7842,20588
351360,202103,3774,9942,3095,8933,688,2139,1293,3452,1981,5591
351370,202103,2052,5628,1384,4256,315,1034,431,1201,746,2235
351380,202103,48322,115174,34204,90933,4102,11790,19906,50458,24008,62248
351385,202103,383,964,162,493,29,89,43,111,72,200
351390,202103,1354,3248,839,2499,110,388,484,1349,594,1737
351400,202103,901,2488,746,2181,110,321,466,1334,576,1655
351410,202103,2598,7143,1879,5743,318,995,748,2227,1066,3222
351420,202103,445,1053,254,720,25,65,151,402,176,467
351430,202103,944,2507,754,2199,62,184,522,1475,584,1659
351440,202103,3453,8949,2294,6626,414,1255,639,1579,1053,2834
351450,202103,1702,4468,1128,3417,220,734,198,467,418,1201
351460,202103,876,2250,692,1965,151,415,386,1096,537,1511
351470,202103,1192,3001,936,2580,83,289,615,1588,698,1877
351480,202103,2499,7267,1979,6388,370,1329,849,2558,1219,3887
351490,202103,2064,5717,1767,5189,65,264,1454,4126,1519,4390
351492,202103,348,938,285,807,7,21,217,599,224,620
351495,202103,178,451,135,370,16,39,75,204,91,243
351500,202103,38366,92902,29315,78080,4130,11698,17925,45703,22055,57401
351510,202103,12922,31582,9418,25678,1098,3431,5919,15385,7017,18816
351512,202103,484,1285,352,1003,62,186,118,307,180,493
351515,202103,3217,7144,2029,5319,359,1062,585,1631,944,2693
351518,202103,2344,5827,1518,4381,197,646,852,2226,1049,2872
351519,202103,697,1898,442,1399,86,273,71,201,157,474
351520,202103,1313,3231,571,1711,51,174,254,685,305,859
351530,202103,359,938,215,632,34,107,96,236,130,343
351535,202103,1844,4506,1345,3657,202,600,692,1759,894,2359
351540,202103,2607,6403,1728,4836,237,773,711,1753,948,2526
351550,202103,7217,17711,4876,13490,475,1505,2768,7086,3243,8591
351560,202103,437,1237,338,1047,79,268,100,285,179,553
351565,202103,240,660,192,572,41,135,52,130,93,265
351570,202103,21601,56788,16543,46854,1611,4930,10428,28304,12039,33234
351580,202103,233,595,133,408,13,41,56,180,69,221
351590,202103,528,1197,283,770,24,90,164,393,188,483
351600,202103,1362,3584,1045,2993,112,348,597,1607,709,1955
351610,202103,787,1859,496,1342,27,75,287,733,314,808
351620,202103,22847,59257,16555,48673,2562,8599,7651,20373,10213,28972
351630,202103,28713,74210,23119,64784,3040,9113,14655,39605,17695,48718
351640,202103,17819,46069,14011,39316,1333,4309,9481,25393,10814,29702
351650,202103,369,971,183,583,23,75,55,158,78,233
351660,202103,734,2022,471,1455,72,232,87,224,159,456
351670,202103,5997,15938,3939,11520,819,2394,1660,4518,2479,6912
351680,202103,428,1201,277,872,41,138,73,184,114,322
351685,202103,397,1124,316,993,84,267,99,294,183,561
351690,202103,1114,2773,619,1790,84,273,272,704,356,977
351700,202103,1298,3213,953,2636,184,522,487,1267,671,1789
351710,202103,760,2016,554,1633,49,170,304,809,353,979
351720,202103,1397,3572,927,2766,146,467,390,1087,536,1554
351730,202103,950,2488,790,2241,59,210,499,1342,558,1552
351740,202103,3458,8626,2755,7302,477,1371,1399,3397,1876,4768
351750,202103,1350,3463,850,2599,143,473,362,1054,505,1527
351760,202103,3257,9098,2400,7408,486,1703,907,2516,1393,4219
351770,202103,1786,5158,1446,4515,238,778,801,2427,1039,3205
351780,202103,1198,3010,727,2136,96,330,279,752,375,1082
351790,202103,1374,3275,1092,2899,168,462,634,1707,802,2169
351800,202103,522,1188,260,701,27,76,101,224,128,300
351810,202103,1058,2758,883,2507,54,143,619,1679,673,1822
351820,202103,2628,7295,1849,5794,475,1619,436,1252,911,2871
351830,202103,4537,12017,3504,10233,322,1121,2229,6175,2551,7296
351840,202103,8666,23468,6514,19559,878,2989,3507,9784,4385,12773
351850,202103,1526,4166,1010,3157,151,551,360,961,511,1512
351860,202103,2685,7617,2061,6468,333,1184,1118,3487,1451,4671
351870,202103,23841,60047,17705,50048,4180,12232,7397,21176,11577,33408
351880,202103,135835,343821,102315,287106,21187,65881,50284,133657,71471,199538
351885,202103,940,2472,736,2137,54,195,489,1357,543,1552
351890,202103,853,2179,542,1658,111,366,102,262,213,628
351900,202103,1131,2950,869,2563,115,333,517,1512,632,1845
351905,202103,433,1173,304,924,24,80,152,405,176,485
351907,202103,21220,54871,16566,46709,1824,5715,10711,28981,12535,34696
351910,202103,1645,4238,1150,3186,77,239,673,1688,750,1927
351920,202103,869,2297,655,1892,98,314,285,746,383,1060
351925,202103,918,2375,705,1995,89,296,366,947,455,1243
351930,202103,3270,9001,2934,8403,572,1646,1953,5502,2525,7148
351940,202103,1097,2795,791,2265,127,395,386,1087,513,1482
351950,202103,1704,3834,1285,3217,55,167,922,2215,977,2382
351960,202103,4994,12489,3630,10088,789,2362,1626,4188,2415,6550
351970,202103,7174,20866,5654,18233,845,3078,3139,9786,3984,12864
351980,202103,953,2200,612,1657,85,268,345,845,430,1113
351990,202103,1494,3509,1083,2902,50,186,536,1293,586,1479
352000,202103,2664,7500,2299,6744,245,818,1534,4225,1779,5043
352010,202103,2279,6008,1836,5284,490,1545,404,1186,894,2731
352020,202103,1360,3696,1048,3184,148,498,530,1527,678,2025
352030,202103,5797,15130,4512,13032,830,2588,2234,6250,3064,8838
352040,202103,2945,7699,2028,5892,292,942,763,1913,1055,2855
352042,202103,2946,7053,1960,5513,349,1140,896,2381,1245,3521
352044,202103,2116,5511,1250,3882,194,679,245,712,439,1391
352050,202103,12672,33205,8380,24869,1987,6761,1682,4208,3669,10969
352060,202103,710,1895,528,1554,83,271,224,590,307,861
352070,202103,936,1881,602,1441,59,158,307,656,366,814
352080,202103,486,1216,278,804,29,102,94,237,123,339
352090,202103,1516,4415,1261,3919,153,550,616,1731,769,2281
352100,202103,3403,9468,2749,8247,562,1842,1206,3489,1768,5331
352110,202103,604,1726,459,1447,95,304,183,541,278,845
352115,202103,542,1430,447,1282,58,191,272,765,330,956
352120,202103,890,2601,735,2291,79,224,436,1292,515,1516
352130,202103,2094,5768,1406,4115,204,627,600,1639,804,2266
352140,202103,1157,3142,829,2505,142,454,376,1093,518,1547
352150,202103,892,2331,695,2004,68,208,500,1412,568,1620
352160,202103,1013,2458,734,2017,67,231,425,1109,492,1340
352170,202103,3004,7918,2386,6733,297,938,1489,3931,1786,4869
352180,202103,2378,6352,1820,5358,403,1347,563,1459,966,2806
352190,202103,1275,3396,1015,2996,186,496,513,1589,699,2085
352200,202103,322,959,225,761,36,143,81,268,117,411
352210,202103,20074,46682,15838,41122,924,2710,12440,31607,13364,34317
352215,202103,677,1711,567,1551,78,239,350,918,428,1157
352220,202103,21121,51596,14712,40423,2637,7940,6787,17208,9424,25148
352230,202103,14667,41484,11401,35438,2693,9338,4115,11774,6808,21112
352240,202103,10211,26018,7822,22114,1654,5246,3457,9095,5111,14341
352250,202103,22722,62648,18208,55042,2806,9096,11035,32781,13841,41877
352260,202103,4742,11772,3173,8783,442,1411,1792,4443,2234,5854
352265,202103,932,2557,823,2407,56,187,622,1774,678,1961
352270,202103,1434,4213,1065,3435,220,756,376,1142,596,1898
352280,202103,2441,6080,1842,5223,184,631,1122,2956,1306,3587
352290,202103,1128,3196,920,2813,120,410,501,1382,621,1792
352300,202103,853,2298,584,1735,77,268,305,837,382,1105
352310,202103,43079,113691,32220,94954,7694,23284,14006,41543,21700,64827
352320,202103,6592,17029,5125,14289,736,2304,2787,7014,3523,9318
352330,202103,2193,5779,1667,5046,278,984,911,2583,1189,3567
352340,202103,6117,15967,4530,13090,677,2251,2308,6124,2985,8375
352350,202103,2210,6221,1707,5116,164,603,995,2723,1159,3326
352360,202103,1235,3264,1017,2886,79,272,769,2110,848,2382
352370,202103,1099,3052,952,2811,16,63,785,2277,801,2340
352380,202103,841,2255,632,1887,132,401,218,625,350,1026
352390,202103,14539,35523,9949,27537,1559,4704,5475,14331,7034,19035
352400,202103,3512,9598,2880,8436,600,2065,1419,3863,2019,5928
352410,202103,3292,8340,2506,7050,214,726,1567,4223,1781,4949
352420,202103,845,2039,602,1689,117,342,228,592,345,934
352430,202103,8241,20224,5952,16253,1088,3400,2963,7587,4051,10987
352440,202103,18151,48650,13673,40157,3274,9961,5031,14351,8305,24312
352450,202103,766,1835,383,1182,57,190,139,404,196,594
352460,202103,2986,8111,2102,6533,413,1423,864,2504,1277,3927
352470,202103,3352,8424,2544,7131,272,876,1600,4264,1872,5140
352480,202103,4037,9505,2715,7163,396,1216,1315,3058,1711,4274
352490,202103,766,2182,610,1905,98,347,286,843,384,1190
352500,202103,10267,26252,6953,20107,2762,8769,708,1163,3470,9932
352510,202103,3845,10357,2865,8643,559,1821,1352,3892,1911,5713
352520,202103,2925,7486,2275,6417,382,1236,1323,3385,1705,4621
352530,202103,10656,27086,7220,20648,1205,3971,2656,6541,3861,10512
352540,202103,594,1735,440,1394,66,223,157,454,223,677
352550,202103,1011,2769,706,2194,119,424,253,692,372,1116
352560,202103,565,1556,430,1294,74,241,212,588,286,829
352570,202103,2348,6613,1506,4796,353,1228,169,419,522,1647
352580,202103,651,1675,545,1483,44,136,377,977,421,1113
352585,202103,333,885,242,728,18,71,147,401,165,472
352590,202103,13106,34111,9207,26773,2207,7001,4160,11214,6367,18215
352600,202103,1901,5087,1497,4362,145,460,953,2643,1098,3103
352610,202103,2783,7713,2086,6503,406,1424,877,2577,1283,4001
352620,202103,5603,14094,4273,12216,1162,3366,1725,4987,2887,8353
352630,202103,834,2060,620,1756,112,361,288,744,400,1105
352640,202103,3000,7604,2175,6158,208,617,1258,3407,1466,4024
352650,202103,588,1655,407,1267,51,172,149,442,200,614
352660,202103,1083,3151,904,2792,97,312,551,1666,648,1978
352670,202103,9662,25716,6504,19513,1574,5123,1915,5268,3489,10391
352680,202103,3324,9690,2324,7433,351,1331,1094,3120,1445,4451
352690,202103,27378,67927,21465,58031,1302,4205,15384,39840,16686,44045
352700,202103,589,1467,447,1284,143,468,132,370,275,838
352710,202103,5215,13356,3743,10714,872,2760,1562,4120,2434,6880
352720,202103,7870,21058,6161,17951,2285,6863,1648,4462,3933,11325
352725,202103,584,1393,334,949,23,65,169,452,192,517
352730,202103,5316,15349,4821,14244,557,1785,2197,5676,2754,7461
352740,202103,2304,5470,1745,4652,173,544,1062,2661,1235,3205
352750,202103,423,1049,262,756,42,136,110,277,152,413
352760,202103,1655,4545,1301,3872,97,278,772,2290,869,2568
352770,202103,860,2315,593,1805,123,380,223,651,346,1031
352780,202103,620,1723,447,1385,98,277,116,378,214,655
352790,202103,458,1193,324,938,32,100,131,334,163,434
352800,202103,1253,3777,882,2905,240,808,112,325,352,1133
352810,202103,1177,2737,753,2001,127,357,445,1110,572,1467
352820,202103,470,1312,340,1075,68,204,73,226,141,430
352830,202103,585,1480,280,850,20,63,74,185,94,248
352840,202103,3974,11233,3255,9959,1025,3384,1105,3242,2130,6626
352850,202103,10867,26228,7540,20889,1963,5951,2502,6225,4465,12176
352860,202103,1032,2825,788,2394,139,460,294,847,433,1307
352870,202103,871,2150,611,1636,54,168,376,954,430,1122
352880,202103,1721,4066,1210,3188,209,575,611,1539,820,2114
352885,202103,310,849,233,718,24,80,139,413,163,493
352890,202103,699,1692,460,1195,41,126,272,622,313,748
352900,202103,18017,46502,12069,34887,1951,5993,5255,14262,7206,20255
352910,202103,415,1088,236,714,25,81,75,196,100,277
352920,202103,2624,6623,1918,5439,118,368,1337,3685,1455,4053
352930,202103,5736,15335,4297,12563,731,2378,2074,5644,2805,8022
352940,202103,22044,58728,16155,46729,3041,9603,7443,20220,10484,29823
352950,202103,547,1421,340,1047,92,287,68,186,160,473
352960,202103,734,1922,419,1267,72,233,113,279,185,512
352965,202103,220,615,141,460,41,132,35,103,76,235
352970,202103,2981,7094,2303,5974,230,647,1534,3895,1764,4542
352980,202103,1359,3575,1085,3173,259,846,557,1581,816,2427
352990,202103,4276,11623,3263,9951,630,2087,1612,4709,2242,6796
353000,202103,477,1292,275,826,36,121,65,159,101,280
353010,202103,2614,6445,1725,4826,333,1072,739,1860,1072,2932
353020,202103,3551,9111,2147,6253,296,962,748,2039,1044,3001
353030,202103,4477,11136,3094,8768,686,2110,911,2443,1597,4553
353040,202103,639,1438,444,1158,90,226,223,569,313,795
353050,202103,5204,14721,3694,11665,685,2332,1683,5077,2368,7409
353060,202103,48281,122228,39983,109099,2629,8544,30217,79633,32846,88177
353070,202103,9568,27067,7022,21642,1247,4231,3036,8590,4283,12821
353080,202103,4146,11217,2733,8497,480,1716,1081,2927,1561,4643
353090,202103,606,1780,487,1537,36,121,307,934,343,1055
353100,202103,292,783,141,448,25,83,39,101,64,184
353110,202103,7533,19662,6059,17581,1293,3854,3061,9237,4354,13091
353120,202103,403,983,305,827,38,122,155,373,193,495
353130,202103,2544,5903,1596,4294,379,1142,534,1280,913,2422
353140,202103,2725,6694,1979,5451,101,337,1412,3728,1513,4065
353150,202103,1605,3909,1150,3179,234,663,482,1266,716,1929
353160,202103,614,1566,449,1299,63,194,193,499,256,693
353170,202103,524,1385,392,1206,74,247,176,552,250,799
353180,202103,10022,24093,7938,20864,736,2150,5839,14877,6575,17027
353190,202103,3372,8959,2701,7641,351,1076,1573,4172,1924,5248
353200,202103,1803,4741,991,3101,161,562,264,746,425,1308
353205,202103,396,1184,338,1059,50,167,167,504,217,671
353210,202103,900,2058,586,1558,23,63,409,1067,432,1130
353215,202103,377,1032,296,888,44,147,140,385,184,532
353220,202103,731,1942,480,1429,98,278,81,237,179,515
353230,202103,842,2292,661,2012,180,599,250,693,430,1292
353240,202103,2310,6209,1907,5557,271,914,1146,3197,1417,4111
353250,202103,1317,2948,834,2172,105,308,467,1153,572,1461
353260,202103,1183,2686,654,1834,83,256,315,844,398,1100
353270,202103,693,1783,593,1608,46,138,419,1073,465,1211
353280,202103,671,1787,471,1430,136,415,107,322,243,737
353282,202103,1817,5059,1533,4541,177,579,942,2647,1119,3226
353284,202103,357,809,199,524,20,75,93,210,113,285
353286,202103,176,434,108,328,18,57,38,108,56,165
353290,202103,1480,3913,930,2813,168,506,277,779,445,1285
353300,202103,2044,5383,1507,4336,239,779,688,1769,927,2548
353310,202103,396,968,290,781,22,77,193,491,215,568
353320,202103,644,1578,551,1454,6,23,485,1269,491,1292
353325,202103,673,1930,470,1486,94,290,165,508,259,798
353330,202103,539,1383,378,1088,48,140,203,541,251,681
353340,202103,2836,7654,2064,6140,403,1337,992,2752,1395,4089
353350,202103,3626,9115,2537,7029,538,1536,802,2011,1340,3547
353360,202103,664,1834,512,1545,50,155,300,882,350,1037
353370,202103,557,1597,464,1454,38,122,333,1013,371,1135
353380,202103,290,859,244,768,25,80,132,385,157,465
353390,202103,6389,15586,4809,12985,446,1371,2949,7521,3395,8892
353400,202103,465,1221,353,1014,59,200,142,336,201,536
353410,202103,525,1405,395,1175,69,203,224,677,293,880
353420,202103,414,1077,259,763,58,164,19,50,77,214
353430,202103,2223,6066,1723,5150,320,1032,826,2363,1146,3395
353440,202103,65654,174668,48088,141350,7364,23675,26377,73127,33741,96802
353450,202103,361,894,240,687,33,109,117,305,150,414
353460,202103,3204,8631,2322,6974,180,586,1037,3014,1217,3600
353470,202103,7893,20399,5732,16468,906,3022,2582,6800,3488,9822
353475,202103,1552,3961,1093,3039,160,485,552,1426,712,1911
353480,202103,1609,4269,1289,3728,50,184,927,2597,977,2781
353490,202103,1098,2877,749,2224,102,341,344,951,446,1292
353500,202103,1088,2567,805,2136,172,469,440,1141,612,1610
353510,202103,783,2316,578,1829,141,466,154,420,295,886
353520,202103,1042,2694,665,2017,74,250,320,893,394,1143
353530,202103,2406,6275,1895,5365,253,809,1028,2688,1281,3497
353540,202103,2091,5550,1721,4964,273,829,1015,2837,1288,3666
353550,202103,5823,14822,4747,13116,741,2148,2742,7273,3483,9421
353560,202103,2308,6139,1750,5286,455,1486,534,1451,989,2937
353570,202103,589,1520,436,1267,50,155,245,675,295,830
353580,202103,2118,5542,1596,4530,352,1011,709,1969,1061,2980
353590,202103,688,1782,468,1377,79,245,215,637,294,882
353600,202103,1713,4215,1294,3487,153,412,709,1864,862,2276
353610,202103,562,1672,406,1360,83,342,118,357,201,699
353620,202103,2673,7005,1904,5697,372,1239,636,1752,1008,2991
353625,202103,507,1250,348,976,25,85,213,579,238,664
353630,202103,1332,4027,1123,3586,233,830,450,1316,683,2146
353640,202103,1379,3561,1109,3147,155,437,609,1718,764,2155
353650,202103,7566,19915,5759,16571,616,1979,3462,9398,4078,11377
353657,202103,391,1017,291,850,25,82,139,377,164,459
353660,202103,1306,2741,892,2194,394,977,233,552,627,1529
353670,202103,4123,11296,3200,9510,594,1982,1559,4259,2153,6241
353680,202103,690,1783,511,1529,64,223,302,838,366,1061
353690,202103,415,1085,203,620,24,79,40,102,64,181
353700,202103,2073,5343,1724,4777,116,377,1280,3397,1396,3774
353710,202103,5359,11933,3217,8161,357,937,1736,3923,2093,4860
353715,202103,424,1111,253,792,4,19,90,270,94,289
353720,202103,1972,5110,1519,4440,220,676,859,2461,1079,3137
353730,202103,4440,11457,3383,9631,460,1542,1834,4768,2294,6310
353740,202103,2000,5197,1404,4160,328,1067,471,1255,799,2322
353750,202103,871,2601,634,2143,138,527,132,423,270,950
353760,202103,12723,29130,9734,25170,1960,5174,5184,13219,7144,18393
353770,202103,744,2208,440,1462,73,268,55,160,128,428
353780,202103,5255,14311,4220,12387,865,2858,2146,5794,3011,8652
353790,202103,2716,8070,1986,6546,512,1867,410,1182,922,3049
353800,202103,18398,47484,14458,41197,2076,6224,8052,22880,10128,29104
353810,202103,1164,3093,750,2232,106,354,328,927,434,1281
353820,202103,1747,4640,1225,3615,255,815,402,1117,657,1932
353830,202103,635,1588,467,1309,80,238,206,551,286,789
353850,202103,1607,4414,1241,3737,257,761,457,1336,714,2097
353860,202103,2646,7174,2030,6140,473,1641,913,2488,1386,4129
353870,202103,29684,76875,21343,60985,2663,8524,11283,29412,13946,37936
353880,202103,3176,8667,2517,7439,209,711,1542,4372,1751,5083
353890,202103,2750,5885,1922,4731,135,367,1375,3169,1510,3536
353900,202103,738,2052,538,1662,79,273,219,622,298,895
353910,202103,2373,6520,1978,5911,194,684,1362,3990,1556,4674
353920,202103,1883,5142,1352,4110,316,1090,328,824,644,1914
353930,202103,4410,11574,3005,8934,486,1666,1298,3410,1784,5076
353940,202103,1059,2980,734,2349,127,428,265,774,392,1202
353950,202103,3327,8887,2561,7462,501,1570,1331,3629,1832,5199
353960,202103,717,1822,497,1415,90,269,218,592,308,861
353970,202103,644,1521,484,1281,41,122,332,854,373,976
353980,202103,16389,40802,12837,34724,789,2522,9345,24153,10134,26675
353990,202103,944,2279,577,1614,104,312,257,677,361,989
354000,202103,2475,5919,1404,3946,310,919,235,627,545,1546
354010,202103,347,900,244,732,49,158,125,358,174,516
354020,202103,3591,9648,2847,8157,620,1907,1210,3171,1830,5078
354025,202103,722,1999,488,1539,72,245,134,403,206,648
354030,202103,514,1114,279,729,61,166,131,318,192,484
354040,202103,792,1817,515,1370,22,72,382,977,404,1049
354050,202103,937,2624,663,2132,140,491,221,669,361,1160
354060,202103,3281,9210,2299,7157,484,1642,882,2500,1366,4142
354070,202103,3664,9485,2468,7151,413,1390,1113,2785,1526,4175
354075,202103,2686,7589,2123,6576,277,944,1232,3729,1509,4673
354080,202103,1348,3645,891,2764,182,579,246,698,428,1277
354085,202103,441,915,348,794,0,0,261,546,261,546
354090,202103,1667,4599,1438,4134,74,226,1125,3168,1199,3394
354100,202103,19528,52198,13471,41773,2902,9781,5099,15651,8001,25432
354105,202103,1403,3532,976,2764,123,353,448,1196,571,1549
354110,202103,441,1239,313,991,51,166,107,331,158,497
354120,202103,1345,3604,910,2683,180,581,312,807,492,1388
354130,202103,5371,14051,3595,10692,847,2659,197,394,1044,3053
354140,202103,19255,47071,13104,35841,2094,6407,5760,14444,7854,20851
354150,202103,2907,6849,2214,5767,463,1257,866,2237,1329,3494
354160,202103,2799,8059,2097,6672,580,2013,583,1680,1163,3693
354165,202103,674,1991,519,1683,82,308,264,793,346,1101
354170,202103,1842,5067,1547,4522,102,354,965,2692,1067,3046
354180,202103,376,1041,273,823,46,145,115,316,161,461
354190,202103,1486,4122,1055,3251,71,242,519,1524,590,1766
354200,202103,874,2102,671,1794,66,198,443,1116,509,1314
354210,202103,830,2142,671,1882,41,137,494,1313,535,1450
354220,202103,3153,8405,2395,6914,345,1065,1289,3513,1634,4578
354230,202103,787,1915,631,1731,35,124,476,1260,511,1384
354240,202103,1707,4679,1155,3582,193,652,365,1000,558,1652
354250,202103,529,1265,328,956,87,258,84,256,171,514
354260,202103,8080,21218,6165,17899,1185,3718,2708,7528,3893,11246
354270,202103,996,2993,814,2642,171,556,326,1032,497,1588
354280,202103,786,1948,664,1779,62,197,428,1061,490,1258
354290,202103,928,2928,783,2630,130,436,395,1369,525,1805
354300,202103,3540,10271,2994,9276,785,2445,1221,3743,2006,6188
354310,202103,718,2095,590,1843,133,447,229,665,362,1112
354320,202103,991,2401,658,1850,101,317,250,620,351,937
354323,202103,469,1115,311,830,42,96,138,355,180,451
354325,202103,1489,4415,1049,3406,171,545,341,1055,512,1600
354330,202103,9491,23802,6470,17752,759,2370,3847,9807,4606,12177
354340,202103,33075,82267,22510,63961,3252,10450,12136,32849,15388,43299
354350,202103,1206,3070,956,2653,119,339,603,1603,722,1942
354360,202103,588,1501,350,1116,64,199,77,246,141,445
354370,202103,1009,2846,812,2536,126,423,483,1464,609,1887
354380,202103,668,1754,483,1456,88,355,127,293,215,648
354390,202103,13714,32753,9057,24668,1564,4574,4132,10592,5696,15166
354400,202103,1547,4906,1189,4072,198,739,443,1493,641,2232
354410,202103,6086,16109,4650,13296,905,2785,2197,5929,3102,8714
354420,202103,1491,3836,1102,3152,149,458,663,1799,812,2257
354425,202103,2701,6492,1915,5145,441,1174,811,2193,1252,3367
354430,202103,1519,4023,1181,3497,109,360,729,2053,838,2413
354440,202103,562,1493,381,1130,60,201,165,452,225,653
354450,202103,427,1110,242,756,34,104,79,223,113,327
354460,202103,848,2129,564,1629,72,222,312,877,384,1099
354470,202103,469,1168,327,903,25,79,164,397,189,476
354480,202103,1262,2820,817,2123,68,173,541,1349,609,1522
354490,202103,816,2381,602,1915,107,355,269,788,376,1143
354500,202103,2118,5849,1722,5254,511,1628,385,1201,896,2829
354510,202103,724,1997,588,1741,46,146,332,891,378,1037
354515,202103,347,987,254,798,38,134,111,336,149,470
354520,202103,7005,18974,4962,14666,660,2253,2747,7514,3407,9767
354530,202103,4428,12454,3446,10557,861,2640,1189,3756,2050,6396
354540,202103,1325,3474,965,2845,206,627,355,1046,561,1673
354550,202103,590,1525,467,1296,69,211,265,696,334,907
354560,202103,2319,5556,1246,3503,149,425,622,1636,771,2061
354570,202103,1226,3053,494,1388,80,235,56,147,136,382
354580,202103,8443,21963,5516,16415,825,2646,2778,7964,3603,10610
354600,202103,1928,4997,1501,4235,141,459,997,2666,1138,3125
354610,202103,441,1121,254,747,22,67,131,365,153,432
354620,202103,466,1283,300,968,46,184,117,336,163,520
354625,202103,300,804,176,568,28,95,32,73,60,168
354630,202103,2057,6063,1654,5259,555,1873,291,854,846,2727
354640,202103,3269,9294,2447,7645,373,1260,990,2892,1363,4152
354650,202103,896,2306,723,2027,57,160,462,1274,519,1434
354660,202103,3639,8480,1928,5641,170,605,907,2416,1077,3021
354670,202103,1044,2883,732,2242,150,483,270,768,420,1251
354680,202103,5392,13843,4060,11700,886,2699,2050,6000,2936,8699
354690,202103,484,1526,348,1220,75,276,98,339,173,615
354700,202103,900,2407,651,1930,77,252,344,937,421,1189
354710,202103,480,1280,350,1021,53,167,148,372,201,539
354720,202103,282,675,128,376,52,157,26,78,78,235
354730,202103,9707,27174,7406,22766,983,3324,4236,12532,5219,15856
354740,202103,308,825,133,435,17,67,26,74,43,141
354750,202103,2625,6694,1741,5080,258,824,782,2047,1040,2871
354760,202103,2129,5595,1498,4416,333,1074,493,1269,826,2343
354765,202103,344,901,145,453,19,65,34,88,53,153
354770,202103,2425,5953,1798,4871,313,903,839,2137,1152,3040
354780,202103,54615,137114,41690,112081,3973,12071,26974,68132,30947,80203
354790,202103,988,2691,769,2329,74,247,475,1379,549,1626
354800,202103,2568,6536,2025,5711,495,1413,913,2436,1408,3849
354805,202103,1369,3116,950,2507,110,290,553,1366,663,1656
354810,202103,627,1851,365,1290,46,188,95,314,141,502
354820,202103,948,2659,670,2139,118,426,183,462,301,888
354830,202103,463,1126,296,832,52,161,96,249,148,410
354840,202103,924,2280,571,1573,55,161,310,795,365,956
354850,202103,20852,53548,14534,42417,1587,5299,8727,24189,10314,29488
354860,202103,1742,4814,1065,3400,165,587,310,886,475,1473
354870,202103,58523,147182,45277,122876,4571,13584,28705,73713,33276,87297
354880,202103,5822,14203,2886,8120,327,1065,1127,2605,1454,3670
354890,202103,15820,39455,12262,33506,1625,5001,7194,19053,8819,24054
354900,202103,400,1004,255,751,55,174,60,142,115,316
354910,202103,5642,14689,3450,10714,794,2600,622,1831,1416,4431
354920,202103,512,1385,264,880,29,104,61,181,90,285
354925,202103,308,869,188,597,25,83,47,127,72,210
354930,202103,366,879,239,661,19,60,119,297,138,357
354940,202103,2344,6877,1668,5398,570,1967,346,1016,916,2983
354950,202103,1519,3847,1213,3427,53,207,917,2453,970,2660
354960,202103,928,2472,706,2140,60,211,404,1147,464,1358
354970,202103,4163,11403,3252,9874,355,1235,2098,6142,2453,7377
354980,202103,33398,78543,22705,60267,2306,7276,14075,34884,16381,42160
354990,202103,67703,169321,51111,139097,3911,12426,33949,86811,37860,99237
354995,202103,2862,6335,2151,5413,140,414,1601,3880,1741,4294
355000,202103,1581,3885,1186,3312,196,635,576,1473,772,2108
355010,202103,3799,10197,2308,7062,748,2353,295,935,1043,3288
355020,202103,3656,10137,2710,8471,543,1883,1087,3216,1630,5099
355030,202103,1370666,3341184,999122,2633107,146106,423178,511836,1242840,657942,1666018
355040,202103,2978,7265,2311,6401,267,748,1668,4620,1935,5368
355050,202103,981,2259,715,1883,171,516,282,665,453,1181
355060,202103,6115,16333,4464,13312,708,2428,2216,6028,2924,8456
355070,202103,9010,22867,7317,20222,838,2652,4690,12235,5528,14887
355080,202103,924,2629,587,1998,111,409,84,229,195,638
355090,202103,1159,3261,899,2829,211,670,324,992,535,1662
355100,202103,21455,55626,16559,48448,2595,7987,9912,28807,12507,36794
355110,202103,783,2137,555,1781,163,603,96,274,259,877
355120,202103,708,1821,510,1538,42,142,232,662,274,804
355130,202103,838,1869,431,1131,28,90,268,657,296,747
355140,202103,1955,4376,1648,3955,83,218,1372,3210,1455,3428
355150,202103,4203,11012,3353,9523,361,1152,2174,5924,2535,7076
355160,202103,2055,5566,1484,4559,369,1239,386,1104,755,2343
355170,202103,10675,26617,8305,22679,1445,4271,4485,11856,5930,16127
355180,202103,2884,7575,2046,6182,392,1309,792,2188,1184,3497
355190,202103,1868,4862,1466,4225,387,1098,734,2235,1121,3333
355200,202103,800,2475,677,2275,184,682,279,896,463,1578
355210,202103,2973,8045,2307,6694,416,1354,1154,3129,1570,4483
355220,202103,45163,118478,35834,100740,7672,22896,15537,40603,23209,63499
355230,202103,1136,2854,626,1854,106,301,221,611,327,912
355240,202103,24778,64937,17373,50212,2153,6784,9572,25967,11725,32751
355250,202103,37263,98746,27765,80468,6864,20957,10565,29338,17429,50295
355255,202103,664,1653,366,1112,60,197,132,393,192,590
355260,202103,1496,3628,1089,2957,136,441,627,1573,763,2014
355270,202103,1133,3325,866,2790,207,690,301,888,508,1578
355280,202103,31394,79123,22493,62632,2901,8762,11556,30171,14457,38933
355290,202103,873,2350,672,1999,131,376,294,856,425,1232
355300,202103,1285,3757,1018,3238,173,595,350,1037,523,1632
355310,202103,951,2614,709,2214,99,294,393,1253,492,1547
355320,202103,531,1381,398,1141,74,244,160,374,234,618
355330,202103,2974,7434,2277,6261,121,429,1735,4539,1856,4968
355340,202103,4198,9230,3209,7916,384,864,2010,5059,2394,5923
355350,202103,1316,3725,978,3094,199,663,379,1165,578,1828
355360,202103,1212,3067,935,2650,116,363,553,1518,669,1881
355365,202103,350,932,192,649,42,136,27,96,69,232
355370,202103,5365,13657,4140,11715,984,2570,1780,5582,2764,8152
355380,202103,2875,7651,2182,6389,367,1180,818,2078,1185,3258
355385,202103,1463,3808,1205,3431,104,356,774,2006,878,2362
355390,202103,822,2233,593,1740,132,419,234,625,366,1044
355395,202103,1975,5376,1389,4211,227,740,494,1331,721,2071
355400,202103,8977,25363,7126,21754,1670,5817,2615,7124,4285,12941
355410,202103,22613,61712,14029,43997,2765,9476,3841,11760,6606,21236
355420,202103,620,1958,515,1761,134,487,132,441,266,928
355430,202103,3683,9272,2765,7617,610,1682,1299,3532,1909,5214
355440,202103,768,2071,471,1451,79,251,133,382,212,633
355450,202103,3027,7691,1980,5660,323,1003,859,2223,1182,3226
355460,202103,496,1197,311,895,42,151,153,396,195,547
355465,202103,410,1068,319,921,45,144,171,477,216,621
355470,202103,1070,2746,620,1857,164,547,187,486,351,1033
355475,202103,339,799,273,709,15,34,203,516,218,550
355480,202103,3929,10713,3187,9611,425,1493,2114,6198,2539,7691
355490,202103,931,2452,521,1599,39,129,274,775,313,904
355495,202103,815,2253,588,1865,66,254,215,598,281,852
355500,202103,6703,17095,4041,11984,597,1948,1436,3940,2033,5888
355510,202103,1338,3239,851,2411,103,334,373,948,476,1282
355520,202103,367,826,179,523,30,87,56,163,86,250
355530,202103,395,922,145,431,17,60,53,147,70,207
355535,202103,514,1386,391,1186,75,285,186,518,261,803
355540,202103,10864,26793,8898,24041,1211,3587,5945,15532,7156,19119
355550,202103,607,1771,501,1570,60,211,276,802,336,1013
355560,202103,1117,2844,629,1935,138,495,33,100,171,595
355570,202103,245,675,129,417,24,87,31,85,55,172
355580,202103,1201,2889,769,2162,139,453,297,750,436,1203
355590,202103,172,435,133,375,17,54,81,216,98,270
355600,202103,1542,3732,1015,2869,162,488,382,1081,544,1569
355610,202103,1783,4349,1184,3321,128,396,636,1687,764,2083
355620,202103,4757,12528,3556,10215,378,1297,2025,5373,2403,6670
355630,202103,2330,6346,1661,5110,251,816,829,2510,1080,3326
355635,202103,882,2555,652,2104,115,400,191,547,306,947
355640,202103,2998,8240,2000,6236,371,1243,589,1809,960,3052
355645,202103,4167,11616,3048,9663,446,1556,1630,5008,2076,6564
355650,202103,6260,16842,4828,14220,1295,3957,1436,3781,2731,7738
355660,202103,1317,3376,915,2652,140,420,293,841,433,1261
355670,202103,3690,9845,2475,7131,301,1021,1242,3143,1543,4164
355680,202103,2740,7462,1236,3951,308,1038,108,362,416,1400
355690,202103,798,2334,512,1769,118,447,13,25,131,472
355695,202103,252,710,156,493,14,66,26,57,40,123
355700,202103,7441,20987,6080,18004,961,3078,3383,9407,4344,12485
355710,202103,8993,21053,5934,15553,823,2441,2858,6620,3681,9061
355715,202103,470,1258,258,793,53,176,47,123,100,299
355720,202103,1457,4036,1148,3494,179,587,626,1782,805,2369
355730,202103,909,2513,747,2212,127,413,366,1009,493,1422
410010,202103,1286,3544,989,2928,196,628,240,675,436,1303
410020,202103,1031,3084,793,2543,278,841,164,553,442,1394
410030,202103,1552,4198,1328,3856,180,564,750,2200,930,2764
410040,202103,12526,34345,9197,28106,2015,6587,2872,8142,4887,14729
410045,202103,868,2290,607,1786,91,297,224,611,315,908
410050,202103,2281,5677,1583,4474,279,867,552,1441,831,2308
410060,202103,2086,5826,1629,4941,361,1153,503,1462,864,2615
410070,202103,1958,4951,1463,4057,234,713,564,1418,798,2131
410080,202103,1342,3578,967,2885,260,804,215,655,475,1459
410090,202103,1101,2805,934,2539,95,249,544,1556,639,1805
410100,202103,1828,5216,1215,3767,181,638,140,417,321,1055
410105,202103,492,1231,285,831,33,94,105,293,138,387
410110,202103,3310,8220,2324,6380,275,837,1104,2821,1379,3658
410115,202103,567,1454,414,1194,57,178,161,445,218,623
410120,202103,2665,7294,2301,6754,449,1434,1261,3579,1710,5013
410130,202103,1243,3329,1082,3028,200,645,567,1470,767,2115
410140,202103,16013,38598,10615,29035,1900,5709,2826,7041,4726,12750
410150,202103,16561,38599,8513,23055,1425,4291,2059,4988,3484,9279
410160,202103,2855,7803,2286,6812,507,1624,766,2305,1273,3929
410165,202103,742,1970,610,1707,59,194,354,921,413,1115
410170,202103,2855,7337,1892,5278,406,1239,117,335,523,1574
410180,202103,13862,38172,10647,31733,1428,4705,5580,15515,7008,20220
410185,202103,419,1223,305,934,59,191,87,237,146,428
410190,202103,2168,5375,1577,4344,317,901,407,1067,724,1968
410200,202103,5444,12393,3044,8310,484,1512,425,1117,909,2629
410210,202103,3106,7712,1971,5713,312,1007,676,1700,988,2707
410220,202103,514,1329,339,1005,59,182,82,240,141,422
410230,202103,1736,4577,1342,3806,195,600,613,1604,808,2204
410240,202103,5138,13363,3536,10304,773,2495,410,1064,1183,3559
410250,202103,2687,6300,1990,5202,149,478,967,2437,1116,2915
410260,202103,1766,4377,1106,3138,162,471,509,1407,671,1878
410270,202103,465,1238,334,1009,45,152,128,375,173,527
410275,202103,608,1704,447,1384,68,231,186,529,254,760
410280,202103,2250,5963,1491,4470,210,703,594,1628,804,2331
410290,202103,3389,9384,2337,7187,644,1920,595,1839,1239,3759
410300,202103,655,1660,526,1463,52,157,259,676,311,833
410302,202103,353,892,203,614,24,84,97,286,121,370
410304,202103,1248,3211,1034,2813,114,326,628,1649,742,1975
410305,202103,1723,4095,1203,3352,113,358,774,2081,887,2439
410310,202103,2518,7048,2026,6121,302,1006,1028,3056,1330,4062
410315,202103,622,1491,382,1105,135,393,94,284,229,677
410320,202103,1075,2978,741,2306,111,390,137,393,248,783
410322,202103,560,1459,329,953,32,108,165,424,197,532
410330,202103,1519,3648,1056,2796,172,486,295,770,467,1256
410335,202103,861,2266,658,1891,95,290,282,748,377,1038
410337,202103,840,2036,599,1580,71,191,231,577,302,768
410340,202103,519,1470,350,1056,18,62,178,463,196,525
410345,202103,2463,6350,1317,3863,257,788,344,868,601,1656
410347,202103,747,1891,553,1536,54,179,180,501,234,680
410350,202103,1562,3848,1124,3123,142,409,516,1356,658,1765
410360,202103,4324,10564,3321,8810,457,1287,1580,4056,2037,5343
410370,202103,13735,36696,8923,25371,1030,3178,3780,9457,4810,12635
410380,202103,1622,4058,1198,3307,163,456,401,1018,564,1474
410390,202103,2649,6625,1767,5071,379,1212,549,1416,928,2628
410395,202103,926,2623,759,2274,162,500,286,870,448,1370
410400,202103,6635,17128,5024,14069,681,2040,2617,6909,3298,8949
410405,202103,889,2061,638,1692,107,327,301,738,408,1065
410410,202103,1302,3424,1221,3297,155,494,776,2166,931,2660
410420,202103,10709,28984,8188,24046,1229,4064,3425,9040,4654,13104
410425,202103,3278,9075,2248,6978,348,1170,806,2273,1154,3443
410430,202103,13061,32489,9212,25553,1376,4172,3361,8672,4737,12844
410440,202103,2277,6738,1952,6146,277,982,1041,3209,1318,4191
410442,202103,2197,6642,1808,5810,438,1443,499,1510,937,2953
410445,202103,2249,6444,1651,5284,327,1175,299,1038,626,2213
410450,202103,1444,3524,1073,2949,197,598,409,1060,606,1658
410460,202103,2152,5295,1646,4480,174,516,823,2141,997,2657
410465,202103,2727,7826,2164,6770,380,1248,771,2259,1151,3507
410470,202103,2023,5549,1434,4488,380,1362,208,706,588,2068
410480,202103,36568,86928,19967,57714,3047,9861,4396,10921,7443,20782
410490,202103,11053,30448,8066,24375,1418,4626,3301,9346,4719,13972
410500,202103,1893,4872,1320,3799,278,914,373,929,651,1843
410510,202103,1807,4499,1209,3390,225,610,359,991,584,1601
410520,202103,3046,9490,2708,8812,959,3199,867,2907,1826,6106
410530,202103,1621,3903,782,2171,99,282,206,473,305,755
410540,202103,2783,7414,1932,5701,288,938,857,2408,1145,3346
410550,202103,7462,19720,4982,14383,817,2567,1394,3488,2211,6055
410560,202103,1474,3845,1108,3115,226,706,381,932,607,1638
410570,202103,2513,6812,1839,5628,490,1796,203,651,693,2447
410580,202103,25670,65967,18711,53415,3333,10229,8238,21983,11571,32212
410590,202103,1555,4391,1061,3247,147,475,298,769,445,1244
410600,202103,1788,4710,1391,3955,320,878,425,1276,745,2154
410610,202103,710,1816,539,1509,54,179,243,619,297,798
410620,202103,2496,7085,1686,5190,346,1181,267,746,613,1927
410630,202103,2438,6385,1604,4730,294,1014,321,784,615,1798
410640,202103,4772,11061,3246,8437,698,2099,401,1050,1099,3149
410645,202103,1052,2971,857,2722,274,888,355,1149,629,2037
410650,202103,2291,6165,1589,4776,306,988,556,1526,862,2514
410655,202103,910,2165,639,1678,27,83,335,832,362,915
410657,202103,624,1679,393,1184,50,171,135,342,185,513
410660,202103,3377,8566,1984,5561,357,1014,577,1508,934,2522
410670,202103,1031,2546,643,1823,125,350,216,561,341,911
410680,202103,2574,7667,1793,5722,414,1335,285,940,699,2275
410685,202103,526,1343,397,1128,95,310,154,392,249,702
410690,202103,131096,316360,88028,237938,13170,40740,34860,83176,48030,123916
410700,202103,2484,6241,2060,5583,347,960,998,2640,1345,3600
410710,202103,886,2218,583,1660,107,313,226,585,333,898
410712,202103,644,1812,531,1601,117,389,225,640,342,1029
410715,202103,807,2323,518,1698,68,239,194,610,262,849
410720,202103,3131,7882,2504,6716,348,1123,604,1566,952,2689
410725,202103,1119,2763,643,1871,122,392,84,211,206,603
410730,202103,692,1822,545,1553,118,389,119,338,237,727
410740,202103,916,2558,676,2095,81,281,275,838,356,1119
410750,202103,1756,4393,1403,3752,205,618,650,1658,855,2276
410752,202103,359,882,190,555,25,72,85,240,110,312
410753,202103,313,929,213,703,34,130,50,149,84,279
410754,202103,1079,2768,900,2504,58,125,622,1826,680,1951
410755,202103,536,1391,379,1083,54,168,166,426,220,594
410760,202103,3619,9283,2616,7495,657,2166,579,1534,1236,3700
410765,202103,13827,38161,10824,32333,1809,5825,2504,6644,4313,12469
410770,202103,1071,2498,754,1972,63,176,393,1032,456,1208
410773,202103,1282,3396,1126,3164,107,337,730,1986,837,2323
410775,202103,1518,3716,1327,3434,63,188,907,2276,970,2464
410780,202103,641,1573,432,1178,65,186,119,303,184,489
410785,202103,705,1826,545,1556,92,289,177,514,269,803
410790,202103,821,2293,679,2025,168,546,63,132,231,678
410800,202103,3454,7627,2808,6716,50,153,1837,4265,1887,4418
410810,202103,416,1088,326,916,26,75,162,411,188,486
410820,202103,918,2569,490,1486,100,308,82,209,182,517
410830,202103,39265,94066,27268,74270,5104,15791,10475,26679,15579,42470
410832,202103,1031,2690,831,2347,92,295,495,1307,587,1602
410840,202103,8579,21508,5147,15030,965,3039,1323,3621,2288,6660
410845,202103,1151,2851,899,2476,178,516,368,1006,546,1522
410850,202103,2221,6322,1951,5834,315,997,954,2789,1269,3786
410855,202103,772,1926,504,1409,50,133,242,630,292,763
410860,202103,4261,10350,3353,8915,298,941,1990,4999,2288,5940
410865,202103,1429,4118,1238,3752,138,462,729,2236,867,2698
410870,202103,1230,3289,1011,2919,92,285,665,1892,757,2177
410880,202103,4617,12147,3268,9715,532,1638,496,1573,1028,3211
410890,202103,978,2743,738,2272,156,542,201,589,357,1131
410895,202103,995,3125,845,2800,258,945,198,620,456,1565
410900,202103,858,2274,605,1781,94,292,135,331,229,623
410910,202103,407,962,251,668,10,35,140,341,150,376
410920,202103,857,2039,617,1647,76,221,311,810,387,1031
410930,202103,1681,4269,1159,3366,273,924,221,619,494,1543
410940,202103,22571,60747,16419,49893,3324,11105,5160,15322,8484,26427
410950,202103,1920,5576,1724,5287,47,163,1431,4343,1478,4506
410960,202103,7568,18594,5257,14748,1181,3687,2099,5781,3280,9468
410965,202103,1138,2885,797,2244,84,258,455,1260,539,1518
410970,202103,4043,10748,2877,8539,638,2259,400,975,1038,3234
410975,202103,1318,3239,1007,2753,111,327,494,1332,605,1659
410980,202103,7617,18831,4944,14045,556,1745,2139,5512,2695,7257
410990,202103,1379,3336,947,2654,205,675,347,933,552,1608
411000,202103,650,1706,448,1339,66,223,121,296,187,519
411005,202103,466,1179,283,789,50,161,88,208,138,369
411007,202103,2248,6217,1824,5497,434,1386,627,1877,1061,3263
411010,202103,4143,12399,3278,10662,806,2872,349,1034,1155,3906
411020,202103,2332,6541,1894,5758,516,1645,501,1501,1017,3146
411030,202103,789,1914,558,1457,40,133,303,693,343,826
411040,202103,978,2460,532,1493,73,233,164,380,237,613
411050,202103,1950,6025,1595,5246,398,1425,225,629,623,2054
411060,202103,1958,5143,1260,3708,274,923,220,592,494,1515
411065,202103,398,1018,269,768,39,105,116,318,155,423
411070,202103,7388,18595,5848,16063,697,2121,3012,8014,3709,10135
411080,202103,2095,5465,1657,4727,408,1344,336,925,744,2269
411090,202103,818,2149,543,1614,44,151,160,453,204,604
411095,202103,2800,6487,1540,4186,175,508,400,1005,575,1513
411100,202103,1218,3105,854,2467,81,259,305,900,386,1159
411110,202103,626,1620,304,942,39,122,21,46,60,168
411120,202103,1316,3582,1089,3163,316,1060,230,609,546,1669
411125,202103,5181,15001,4636,14025,1018,3032,2247,7145,3265,10177
411130,202103,726,1935,517,1543,111,300,177,586,288,886
411140,202103,2238,6855,1907,6158,564,1932,496,1592,1060,3524
411150,202103,3844,9616,2632,7234,521,1679,247,491,768,2170
411155,202103,964,2468,582,1754,84,241,244,698,328,939
411160,202103,355,820,246,661,29,87,60,165,89,252
411170,202103,730,2129,575,1778,133,428,201,592,334,1020
411180,202103,5524,14475,4350,12467,612,1943,2129,5692,2741,7635
411190,202103,1743,4420,1291,3615,199,590,507,1289,706,1879
411200,202103,4831,13027,3483,10521,821,2782,738,1923,1559,4705
411210,202103,3224,7146,2155,5419,371,1025,741,1751,1112,2776
411220,202103,862,2199,612,1718,153,478,159,403,312,881
411230,202103,838,2229,610,1794,119,376,225,640,344,1016
411240,202103,1592,3779,1087,2883,109,337,549,1331,658,1668
411250,202103,2245,5911,1645,4833,305,1059,514,1433,819,2492
411260,202103,326,836,224,634,22,60,90,222,112,282
411270,202103,2029,5358,1522,4355,205,609,752,1989,957,2598
411275,202103,1447,3314,1012,2612,141,439,471,1118,612,1557
411280,202103,1308,3532,888,2727,239,752,118,346,357,1098
411290,202103,835,2180,539,1609,65,187,276,827,341,1014
411295,202103,1268,3179,903,2467,108,307,408,1051,516,1358
411300,202103,1028,2549,667,1849,63,184,311,752,374,936
411310,202103,879,2004,674,1723,61,154,294,749,355,903
411320,202103,5489,14006,4014,11404,604,1836,1762,4512,2366,6348
411325,202103,1415,4007,1205,3638,205,588,672,2096,877,2684
411330,202103,3312,8890,2416,7273,522,1705,745,2277,1267,3982
411340,202103,830,2244,495,1519,76,243,146,422,222,665
411342,202103,1057,2531,610,1654,108,313,215,539,323,852
411345,202103,1086,2779,820,2340,63,188,584,1680,647,1868
411350,202103,2810,7472,1812,5445,435,1413,302,829,737,2242
411360,202103,705,1693,498,1368,80,232,158,413,238,645
411370,202103,58582,142599,42659,115789,3022,9781,25535,64527,28557,74308
411373,202103,1392,3513,1126,3116,106,342,608,1689,714,2031
411375,202103,1108,2774,807,2216,128,363,314,845,442,1208
411380,202103,1147,2616,785,1953,42,118,482,1117,524,1235
411390,202103,1495,4097,1180,3404,187,585,497,1259,684,1844
411400,202103,2328,5666,1748,4581,156,482,941,2325,1097,2807
411410,202103,2640,7210,1957,5771,412,1320,433,1205,845,2525
411420,202103,4341,10461,2342,6660,295,949,442,954,737,1903
411430,202103,3447,9257,2646,7765,543,1721,935,2545,1478,4266
411435,202103,398,1103,251,794,50,160,75,197,125,357
411440,202103,2489,6893,2020,6020,429,1380,698,2010,1127,3390
411450,202103,2447,6594,1855,5596,241,725,992,3051,1233,3776
411460,202103,4173,10652,2660,7801,397,1370,482,1267,879,2637
411470,202103,774,1973,582,1603,109,334,224,550,333,884
411480,202103,4966,13042,3671,10666,701,2452,1368,3523,2069,5975
411490,202103,1647,4254,1265,3623,161,534,530,1363,691,1897
411500,202103,1287,3424,872,2547,143,452,168,388,311,840
411510,202103,2321,5866,1870,5106,368,1171,500,1378,868,2549
411520,202103,31395,76101,18243,50740,2074,6663,7172,17836,9246,24499
411530,202103,952,2483,571,1753,92,303,94,266,186,569
411535,202103,504,1451,315,1006,34,127,85,220,119,347
411540,202103,2631,6408,1809,4929,142,455,947,2515,1089,2970
411545,202103,904,2605,763,2362,69,226,487,1502,556,1728
411550,202103,721,1810,535,1481,81,239,93,277,174,516
411560,202103,1938,5206,1119,3480,161,575,61,157,222,732
411570,202103,7201,16574,4851,13063,1084,3197,852,2309,1936,5506
411573,202103,766,2056,646,1857,97,282,312,882,409,1164
411575,202103,2025,5472,1509,4423,270,845,364,1036,634,1881
411580,202103,4810,10981,2927,8115,424,1433,533,1318,957,2751
411585,202103,614,1839,290,952,64,219,51,153,115,372
411590,202103,391,1051,279,827,42,128,135,373,177,501
411600,202103,327,809,201,606,38,118,59,163,97,281
411605,202103,1564,3602,1015,2748,137,473,515,1364,652,1837
411610,202103,2572,5992,1830,4726,65,222,1263,3048,1328,3270
411620,202103,2723,7241,2326,6621,398,1194,1248,3558,1646,4752
411630,202103,764,1973,512,1495,71,261,189,483,260,744
411640,202103,472,1217,333,925,45,137,110,272,155,409
411650,202103,208,600,133,440,24,87,26,61,50,148
411660,202103,926,2348,673,1887,57,164,275,734,332,898
411670,202103,1365,3276,934,2467,99,275,468,1148,567,1423
411680,202103,1406,3750,1050,3042,145,477,458,1282,603,1759
411690,202103,3925,9849,2982,8255,647,1807,821,2435,1468,4242
411695,202103,635,1894,430,1362,48,165,177,515,225,680
411700,202103,1702,4353,1147,3301,242,726,197,538,439,1264
411705,202103,1909,5790,1618,5300,280,867,981,3409,1261,4276
411710,202103,1952,4902,1346,3795,295,833,282,783,577,1616
411720,202103,1041,2375,746,1879,146,379,285,689,431,1068
411721,202103,984,2441,741,1996,141,373,211,554,352,927
411722,202103,881,2300,511,1478,88,278,180,427,268,705
411725,202103,1162,3218,795,2517,190,648,181,564,371,1212
411727,202103,1485,4070,956,2937,216,694,146,408,362,1102
411729,202103,687,1646,439,1186,56,199,170,403,226,602
411730,202103,5312,13918,4179,11750,813,2447,1879,5154,2692,7601
411740,202103,524,1341,271,798,58,161,59,156,117,317
411745,202103,792,2247,551,1704,74,247,123,298,197,545
411750,202103,5500,14348,4041,11532,545,1662,1955,5262,2500,6924
411760,202103,6602,17541,5121,15010,1601,4909,993,3271,2594,8180
411770,202103,3023,8699,2219,6956,502,1688,358,1019,860,2707
411780,202103,2684,7485,2331,6839,664,2037,784,2340,1448,4377
411790,202103,2786,6687,1591,4565,308,1019,348,864,656,1883
411800,202103,1006,2840,760,2290,127,409,150,412,277,821
411810,202103,1589,4060,1184,3255,193,542,518,1337,711,1879
411820,202103,11234,31889,9161,28327,2170,7233,4012,12065,6182,19298
411830,202103,558,1390,429,1190,84,257,95,275,179,532
411840,202103,12174,32152,8359,24331,1397,4377,2284,6010,3681,10387
411845,202103,587,1642,347,1087,47,170,79,211,126,381
411850,202103,7204,18265,4945,14363,1211,3928,833,2229,2044,6157
411860,202103,681,1881,492,1483,79,246,121,327,200,573
411870,202103,583,1692,410,1305,92,322,98,284,190,606
411880,202103,2300,5630,1682,4664,226,700,637,1658,863,2358
411885,202103,1094,2834,787,2281,117,396,241,633,358,1029
411890,202103,1372,3633,984,2920,163,542,107,314,270,856
411900,202103,763,2102,488,1521,104,343,82,240,186,583
411910,202103,985,2911,732,2380,164,633,291,866,455,1499
411915,202103,14909,36526,10267,28153,1445,4428,4276,10518,5721,14946
411920,202103,1117,3247,938,2860,194,683,345,970,539,1653
411925,202103,467,1225,332,982,71,233,131,360,202,593
411930,202103,4904,14764,4136,13342,1838,6447,247,957,2085,7404
411940,202103,3282,9561,2568,8055,623,2015,832,2344,1455,4359
411950,202103,14279,38212,11823,34196,1520,5023,7094,19614,8614,24637
411960,202103,5967,15820,4742,13356,833,2546,1936,5169,2769,7715
411965,202103,473,1300,348,1049,47,157,149,424,196,581
411970,202103,1142,2612,894,2284,181,440,398,1148,579,1588
411980,202103,1477,3604,1066,2937,265,726,393,1074,658,1800
411990,202103,37605,97726,24210,73435,4363,14580,8402,24225,12765,38805
411995,202103,3536,8565,2692,7285,779,2321,717,1903,1496,4224
412000,202103,1848,4271,1296,3344,33,109,908,2189,941,2298
412010,202103,602,1861,458,1547,77,275,127,379,204,654
412015,202103,538,1520,445,1357,64,213,264,791,328,1004
412020,202103,442,1224,284,892,42,155,115,324,157,479
412030,202103,613,1703,454,1411,74,235,149,443,223,678
412033,202103,952,2514,685,1970,88,271,261,650,349,921
412035,202103,738,2000,474,1517,45,173,262,805,307,978
412040,202103,604,1611,378,1157,58,178,58,172,116,350
412050,202103,1605,3995,1106,3076,243,752,258,714,501,1466
412060,202103,7265,20963,6092,18632,1594,5508,1715,5036,3309,10544
412065,202103,610,1670,462,1383,104,335,105,310,209,645
412070,202103,1197,3084,946,2600,121,370,374,933,495,1303
412080,202103,2193,6053,1498,4671,228,749,392,1106,620,1855
412085,202103,302,724,106,325,10,31,25,67,35,98
412090,202103,5887,15154,4382,12383,1026,3045,1686,4784,2712,7829
412100,202103,1634,4425,1234,3667,387,1275,256,836,643,2111
412110,202103,824,2188,575,1685,86,272,181,500,267,772
412120,202103,2010,5689,1529,4753,319,1081,389,1028,708,2109
412125,202103,614,1731,431,1351,82,275,113,340,195,615
412130,202103,819,2040,569,1578,94,266,144,411,238,677
412135,202103,624,1648,295,883,51,164,85,219,136,383
412140,202103,1680,4021,1133,3083,179,619,247,625,426,1244
412150,202103,2788,7213,2375,6488,339,1062,1451,3755,1790,4817
412160,202103,889,2740,510,1721,67,246,74,208,141,454
412170,202103,4304,11716,3617,10635,711,2333,1489,4005,2200,6338
412175,202103,1303,3680,1095,3327,222,689,488,1488,710,2177
412180,202103,1626,4449,1193,3649,144,503,543,1547,687,2050
412190,202103,3345,8343,2472,6825,307,918,1076,2949,1383,3867
412200,202103,1698,4968,1222,3902,313,1102,183,532,496,1634
412210,202103,635,1498,395,1086,51,155,156,386,207,541
412215,202103,3355,9048,2624,7603,619,1762,1120,3543,1739,5305
412217,202103,1001,2579,846,2302,50,146,587,1535,637,1681
412220,202103,5501,15327,4497,13512,1296,3777,1397,4538,2693,8315
412230,202103,2669,7775,2122,6722,350,1275,530,1437,880,2712
412240,202103,7375,18822,4690,13525,788,2447,1405,3648,2193,6095
412250,202103,2025,5188,1512,4213,371,1060,314,807,685,1867
412260,202103,1217,3249,896,2581,137,410,272,740,409,1150
412265,202103,906,2463,720,2143,156,487,283,803,439,1290
412270,202103,1008,2732,642,1957,82,276,250,679,332,955
412280,202103,397,1092,314,952,80,246,89,259,169,505
412290,202103,1030,2601,716,2038,103,311,239,628,342,939
412300,202103,1664,4276,1153,3384,253,777,252,780,505,1557
412310,202103,749,2105,592,1788,99,346,195,550,294,896
412320,202103,815,2092,525,1502,49,167,155,450,204,617
412330,202103,1612,4251,1109,3311,226,727,369,1129,595,1856
412340,202103,1157,3145,744,2251,97,354,120,326,217,680
412350,202103,2925,7584,1896,5579,360,1131,316,843,676,1974
412360,202103,254,694,182,544,6,27,113,316,119,343
412370,202103,852,2419,584,1853,116,411,63,201,179,612
412380,202103,1502,4062,1075,3231,280,875,115,405,395,1280
412382,202103,487,1178,324,918,39,141,146,340,185,481
412385,202103,2176,5919,1787,5171,557,1523,554,1780,1111,3303
412390,202103,2479,5906,1989,5157,333,885,720,1857,1053,2742
412395,202103,676,1925,488,1502,61,171,210,656,271,827
412400,202103,916,2393,653,1895,117,374,185,515,302,889
412402,202103,2144,5253,1499,4205,381,1080,187,553,568,1633
412405,202103,3037,7956,2001,6038,505,1775,101,276,606,2051
412410,202103,6157,15742,4561,13164,748,2508,1567,4245,2315,6753
412420,202103,544,1370,360,995,29,95,171,409,200,504
412430,202103,593,1488,311,901,33,104,126,339,159,443
412440,202103,2721,7287,1801,5523,424,1420,294,938,718,2358
412450,202103,479,1377,330,1018,48,146,30,72,78,218
412460,202103,1075,2767,839,2375,162,490,376,1044,538,1534
412470,202103,1517,4803,1254,4222,312,1121,268,892,580,2013
412480,202103,1012,2662,688,1968,114,360,224,553,338,913
412490,202103,1309,3209,1060,2758,139,359,512,1261,651,1620
412500,202103,1941,4842,1474,3982,316,883,403,983,719,1866
412510,202103,1872,5654,1296,4220,288,1003,146,406,434,1409
412520,202103,1146,2983,649,1916,148,406,58,189,206,595
412530,202103,703,1848,515,1465,74,236,112,317,186,553
412535,202103,801,2059,540,1561,94,296,118,289,212,585
412540,202103,1188,3003,863,2415,94,320,291,854,385,1174
412545,202103,683,1755,469,1334,76,227,149,413,225,640
412550,202103,33057,87464,23666,68784,3697,11710,9646,25529,13343,37239
412555,202103,290,749,198,555,21,62,58,130,79,192
412560,202103,4603,13129,3496,10611,635,2106,978,2971,1613,5077
412570,202103,4432,11092,2570,7519,493,1627,305,974,798,2601
412575,202103,1047,2622,838,2265,111,337,452,1137,563,1474
412580,202103,1422,3684,1018,2924,74,255,556,1531,630,1786
412590,202103,407,1064,229,704,35,115,23,62,58,177
412600,202103,1655,4403,1263,3621,179,579,582,1538,761,2117
412610,202103,819,2142,583,1643,76,229,270,661,346,890
412620,202103,1261,3276,963,2827,190,630,289,793,479,1423
412625,202103,8514,22285,5236,15811,713,2450,335,916,1048,3366
412627,202103,1152,3218,754,2390,138,480,203,642,341,1122
412630,202103,2866,8288,2091,6651,381,1254,615,1777,996,3031
412635,202103,389,1053,259,779,31,114,83,198,114,312
412640,202103,1045,2731,598,1802,69,209,186,506,255,715
412650,202103,1682,4536,1346,3875,215,685,534,1335,749,2020
412660,202103,2427,6218,1742,4916,270,816,549,1383,819,2199
412665,202103,386,982,308,849,56,158,144,386,200,544
412667,202103,1798,4715,1346,3842,191,588,572,1561,763,2149
412670,202103,879,2042,566,1528,111,343,153,378,264,721
412680,202103,2038,5376,1424,4205,179,619,522,1353,701,1972
412690,202103,1126,2956,814,2358,129,406,299,814,428,1220
412700,202103,1961,5135,1634,4628,200,625,893,2470,1093,3095
412710,202103,5780,16663,4342,13616,812,2888,1197,3294,2009,6182
412720,202103,1117,3306,857,2740,136,464,180,492,316,956
412730,202103,2517,6572,1758,5064,313,1010,650,1743,963,2753
412740,202103,1876,5178,1288,4001,217,790,186,564,403,1354
412750,202103,3940,10239,3226,9223,269,897,2161,5890,2430,6787
412760,202103,2893,7768,2415,6970,449,1455,1278,3438,1727,4893
412770,202103,10145,25658,5557,16681,733,2373,1286,3269,2019,5642
412780,202103,1174,3098,886,2575,197,621,331,932,528,1553
412785,202103,2090,4917,1493,3927,128,346,1027,2637,1155,2983
412788,202103,1363,3780,1117,3354,304,923,431,1260,735,2183
412790,202103,1333,3502,768,2352,108,385,240,637,348,1022
412795,202103,1227,3122,661,1987,93,306,132,352,225,658
412796,202103,2150,6133,1776,5438,354,1154,606,1710,960,2864
412800,202103,3675,8850,2549,6788,278,859,1205,2832,1483,3691
412810,202103,11852,29967,7713,21689,908,2965,3034,7562,3942,10527
412820,202103,6280,17105,4466,13452,1072,3437,1272,3788,2344,7225
412830,202103,341,965,245,756,35,102,67,197,102,299
412840,202103,1866,4610,1338,3598,154,467,607,1472,761,1939
412850,202103,2735,7147,1977,5837,311,978,831,2423,1142,3401
412853,202103,1484,3739,1243,3324,180,529,641,1523,821,2052
412855,202103,1281,3325,805,2339,111,360,228,607,339,967
412860,202103,752,1846,510,1463,68,223,278,739,346,962
412862,202103,671,1624,460,1275,81,228,191,498,272,726
412863,202103,1262,3765,1126,3522,258,832,550,1708,808,2540
412865,202103,701,1905,517,1531,140,409,131,428,271,837
412870,202103,845,2183,615,1801,170,542,135,445,305,987
412880,202103,857,2294,571,1712,93,316,102,274,195,590
420005,202103,403,1182,245,824,30,98,115,394,145,492
420010,202103,3246,7913,2185,6129,127,387,1609,4543,1736,4930
420020,202103,407,1272,273,926,43,177,60,150,103,327
420030,202103,63,206,44,168,12,53,18,60,30,113
420040,202103,494,1475,303,1047,59,227,23,61,82,288
420050,202103,710,1611,478,1207,67,200,300,675,367,875
420055,202103,151,454,81,286,14,66,24,70,38,136
420060,202103,96,254,55,158,7,22,16,33,23,55
420070,202103,681,2041,514,1703,109,376,206,655,315,1031
420075,202103,76,184,38,108,7,26,14,22,21,48
420080,202103,352,1001,277,831,72,242,107,313,179,555
420090,202103,409,1265,261,914,56,214,44,128,100,342
420100,202103,1252,3227,1049,2918,53,172,854,2338,907,2510
420110,202103,242,776,219,729,41,155,110,348,151,503
420120,202103,574,1523,390,1125,64,213,187,460,251,673
420125,202103,342,1043,241,819,58,214,89,288,147,502
420127,202103,287,748,109,335,15,51,33,93,48,144
420130,202103,3354,9181,2537,7815,362,1323,1206,3403,1568,4726
420140,202103,3445,9218,2473,7540,681,2344,381,1198,1062,3542
420150,202103,674,1690,467,1336,44,145,281,768,325,913
420160,202103,191,461,69,222,8,28,20,62,28,90
420165,202103,147,415,86,283,20,68,26,75,46,143
420170,202103,269,861,185,638,25,90,59,170,84,260
420180,202103,163,524,100,362,16,60,29,92,45,152
420190,202103,194,596,117,402,32,121,36,112,68,233
420195,202103,1354,3422,995,2858,277,953,165,385,442,1338
420200,202103,4628,11076,2833,7776,373,1265,1186,2787,1559,4052
420205,202103,1743,4671,1163,3490,167,535,636,1886,803,2421
420207,202103,1693,4396,1059,3183,197,694,430,1205,627,1899
420208,202103,309,875,181,632,54,202,44,136,98,338
420209,202103,152,484,98,316,17,58,40,110,57,168
420210,202103,2977,7549,2021,6004,328,1123,1012,2895,1340,4018
420213,202103,765,2324,647,2098,141,484,325,1039,466,1523
420215,202103,192,574,137,451,38,148,34,105,72,253
420220,202103,267,765,165,541,24,93,78,237,102,330
420230,202103,5067,13594,3873,11383,559,1795,2091,5891,2650,7686
420240,202103,13460,36940,8649,25991,1052,3625,4211,11070,5263,14695
420243,202103,374,1046,302,906,54,186,181,515,235,701
420245,202103,1254,3258,914,2681,67,238,577,1612,644,1850
420250,202103,422,1176,354,1065,52,178,206,581,258,759
420253,202103,464,1128,330,934,33,103,189,530,222,633
420257,202103,157,409,99,305,15,57,51,155,66,212
420260,202103,1061,2747,771,2351,116,410,504,1506,620,1916
420270,202103,525,1369,274,798,35,110,124,344,159,454
420280,202103,1111,3312,869,2807,152,546,325,1015,477,1561
420285,202103,125,264,57,164,10,44,22,49,32,93
420287,202103,424,970,305,811,90,244,105,283,195,527
420290,202103,4632,13062,3568,10682,494,1684,2073,5770,2567,7454
420300,202103,7196,20242,4231,13223,727,2536,1361,3695,2088,6231
420310,202103,748,1714,375,1042,33,102,209,541,242,643
420315,202103,759,2088,519,1677,95,327,225,719,320,1046
420320,202103,5053,13547,3639,11201,973,3302,969,2762,1942,6064
420325,202103,312,858,226,688,33,97,103,291,136,388
420330,202103,954,2761,605,2031,97,380,183,559,280,939
420340,202103,914,2535,691,2141,152,477,127,360,279,837
420350,202103,1138,2955,841,2435,65,219,595,1686,660,1905
420360,202103,2789,7588,1510,4842,280,982,117,369,397,1351
420370,202103,1114,2964,916,2643,78,263,645,1803,723,2066
420380,202103,4218,11015,2846,8550,605,1943,1081,3086,1686,5029
420390,202103,1046,2532,727,1888,127,388,297,533,424,921
420395,202103,1106,3119,763,2438,118,423,114,267,232,690
420400,202103,955,2653,664,2045,111,394,277,800,388,1194
420410,202103,550,1464,428,1214,36,108,298,830,334,938
420415,202103,271,791,205,652,51,178,83,271,134,449
420417,202103,573,1696,465,1470,126,418,175,563,301,981
420419,202103,135,480,109,422,39,160,9,37,48,197
420420,202103,10882,27969,7317,21535,1967,6625,2059,5500,4026,12125
420425,202103,599,1590,402,1184,35,118,207,593,242,711
420430,202103,3039,8093,1807,5427,412,1284,582,1626,994,2910
420435,202103,245,629,125,400,15,52,63,193,78,245
420440,202103,695,1868,430,1316,126,413,130,375,256,788
420445,202103,250,604,164,452,30,81,75,193,105,274
420450,202103,698,2046,513,1644,91,356,181,506,272,862
420455,202103,1942,4722,1412,3924,189,593,692,1820,881,2413
420460,202103,8857,23479,6662,19477,913,3016,3470,9724,4383,12740
420470,202103,565,1464,306,957,54,207,58,153,112,360
420475,202103,64,166,24,79,6,21,2,7,8,28
420480,202103,5162,12658,3186,9415,597,1942,1147,3355,1744,5297
420490,202103,344,958,250,770,56,197,95,282,151,479
420500,202103,1342,3669,863,2772,139,496,394,1246,533,1742
420510,202103,151,427,85,274,9,37,24,68,33,105
420515,202103,59,155,36,103,3,18,15,36,18,54
420517,202103,732,2011,628,1819,51,154,441,1277,492,1431
420519,202103,279,687,203,575,23,72,118,343,141,415
420520,202103,271,728,144,480,23,79,10,31,33,110
420530,202103,775,2273,539,1762,86,337,208,582,294,919
420535,202103,233,679,100,337,14,54,43,142,57,196
420540,202103,36132,85776,23791,65361,3362,10519,8605,20465,11967,30984
420543,202103,200,590,154,484,18,55,85,250,103,305
420545,202103,1169,3495,889,2881,152,559,334,955,486,1514
420550,202103,3393,8956,2198,6937,342,1268,922,2979,1264,4247
420555,202103,279,806,195,627,24,90,116,351,140,441
420560,202103,378,937,252,745,46,147,149,438,195,585
420570,202103,2227,5986,1761,5103,287,972,819,2267,1106,3239
420580,202103,1773,4530,1275,3776,289,923,437,1337,726,2260
420590,202103,2634,7004,1551,4673,275,984,432,1000,707,1984
420600,202103,990,2837,763,2418,91,347,448,1351,539,1698
420610,202103,311,911,183,615,44,153,64,225,108,378
420620,202103,758,1860,508,1457,109,331,199,564,308,895
420630,202103,891,2677,654,2097,77,269,391,1198,468,1467
420640,202103,478,1292,242,811,76,253,26,89,102,342
420650,202103,3483,9128,2168,6418,297,943,851,2189,1148,3132
420660,202103,414,1065,268,757,50,149,74,190,124,339
420665,202103,603,1543,389,1179,69,240,164,431,233,671
420670,202103,1204,3335,770,2429,125,477,286,782,411,1259
420675,202103,175,483,103,339,19,87,56,165,75,252
420680,202103,306,703,157,495,30,101,77,235,107,336
420690,202103,832,2449,526,1740,68,274,138,391,206,665
420700,202103,2443,6378,1832,5364,207,656,1092,3102,1299,3758
420710,202103,961,2672,748,2216,71,283,474,1261,545,1544
420720,202103,1132,3159,826,2626,138,466,436,1328,574,1794
420730,202103,2986,7740,2226,6493,356,1156,1199,3362,1555,4518
420740,202103,481,1421,268,947,56,225,21,89,77,314
420750,202103,1870,5390,1212,3867,206,770,501,1455,707,2225
420757,202103,83,199,37,112,4,6,17,54,21,60
420760,202103,303,885,162,508,32,112,46,127,78,239
420765,202103,435,1271,208,710,26,101,94,307,120,408
420768,202103,1326,3696,1153,3413,138,406,860,2529,998,2935
420770,202103,439,1189,218,746,38,152,87,279,125,431
420775,202103,260,764,178,579,37,131,61,160,98,291
420780,202103,886,2461,540,1691,109,376,92,255,201,631
420785,202103,194,502,137,380,11,39,71,162,82,201
420790,202103,996,2994,742,2487,125,485,413,1305,538,1790
420800,202103,627,1581,318,963,74,257,112,325,186,582
420810,202103,1385,4237,1124,3725,311,1188,423,1199,734,2387
420820,202103,12013,29770,8694,24432,1567,4943,4081,10595,5648,15538
420830,202103,4012,10467,3008,8675,531,1635,1310,3678,1841,5313
420840,202103,461,1350,224,810,63,242,25,79,88,321
420845,202103,2335,5919,1441,4321,260,944,592,1684,852,2628
420850,202103,1036,3301,651,2297,115,438,134,426,249,864
420860,202103,297,746,167,521,30,105,49,130,79,235
420870,202103,746,2073,557,1724,150,523,218,613,368,1136
420880,202103,1005,3021,771,2543,155,609,293,879,448,1488
420890,202103,7908,21383,4947,15332,669,2270,1744,4818,2413,7088
420895,202103,171,496,108,334,29,88,32,104,61,192
420900,202103,1479,3646,896,2633,117,417,414,1068,531,1485
420910,202103,29519,77319,18730,56624,2702,9324,7581,20278,10283,29602
420915,202103,488,1750,361,1387,52,194,199,779,251,973
420917,202103,343,819,191,519,31,90,98,262,129,352
420920,202103,70,195,30,108,1,2,5,20,6,22
420930,202103,15690,40812,11177,32935,1959,6371,4973,13988,6932,20359
420940,202103,2939,7119,1736,5048,388,1278,363,866,751,2144
420945,202103,126,360,99,302,23,80,39,110,62,190
420950,202103,329,953,184,609,29,113,45,136,74,249
420960,202103,991,2410,720,1956,117,366,323,795,440,1161
420970,202103,2280,6203,1603,4963,450,1445,468,1438,918,2883
420980,202103,272,890,236,814,106,377,62,224,168,601
420985,202103,288,828,147,520,37,150,41,125,78,275
420990,202103,280,877,164,583,27,97,36,124,63,221
421000,202103,530,1583,387,1277,81,287,94,280,175,567
421003,202103,460,1080,158,453,3,7,18,41,21,48
421005,202103,57,155,42,133,9,27,19,64,28,91
421010,202103,3141,8592,2257,6954,428,1496,634,1709,1062,3205
421020,202103,359,1102,283,966,43,179,143,459,186,638
421030,202103,725,2159,558,1822,169,624,181,542,350,1166
421040,202103,618,1468,389,1119,26,91,247,694,273,785
421050,202103,998,2650,659,1915,124,398,261,669,385,1067
421055,202103,166,455,93,286,15,50,57,157,72,207
421060,202103,625,1796,447,1411,86,315,218,613,304,928
421070,202103,634,1902,395,1293,68,249,137,417,205,666
421080,202103,499,1429,414,1272,38,141,249,758,287,899
421085,202103,363,1023,141,487,14,46,24,65,38,111
421090,202103,263,678,147,421,13,50,44,107,57,157
421100,202103,752,1685,325,976,83,284,85,204,168,488
421105,202103,1490,4048,1027,3129,166,539,485,1400,651,1939
421110,202103,1079,2758,884,2509,18,52,651,1956,669,2008
421120,202103,976,2911,718,2340,103,365,218,612,321,977
421125,202103,286,742,204,593,74,239,73,180,147,419
421130,202103,4641,13464,3836,11918,862,3064,1969,5722,2831,8786
421140,202103,331,900,199,610,34,102,71,207,105,309
421145,202103,429,1173,276,839,74,240,94,265,168,505
421150,202103,566,1528,367,1139,61,222,193,558,254,780
421160,202103,499,1365,371,1118,50,171,233,664,283,835
421165,202103,217,632,132,430,26,84,55,174,81,258
421170,202103,963,2661,824,2435,133,378,502,1536,635,1914
421175,202103,954,2367,587,1801,112,389,267,789,379,1178
421180,202103,368,953,206,630,35,137,91,238,126,375
421185,202103,311,817,212,612,21,65,128,360,149,425
421187,202103,270,828,170,575,24,77,62,205,86,282
421189,202103,327,954,259,824,45,153,105,313,150,466
421190,202103,10834,29158,7474,22832,1341,4393,2800,7913,4141,12306
421200,202103,647,1833,534,1636,73,267,330,959,403,1226
421205,202103,182,481,132,402,24,89,60,163,84,252
421210,202103,1034,2583,596,1853,113,361,233,720,346,1081
421220,202103,1323,3917,1024,3289,227,809,324,944,551,1753
421223,202103,310,851,194,639,44,141,94,308,138,449
421225,202103,811,2363,687,2155,109,402,424,1300,533,1702
421227,202103,616,1761,397,1297,73,262,172,573,245,835
421230,202103,556,1442,358,1074,62,219,143,420,205,639
421240,202103,276,802,133,460,12,56,27,79,39,135
421250,202103,1956,4906,1377,3971,134,452,845,2332,979,2784
421260,202103,191,581,49,179,12,53,10,32,22,85
421265,202103,642,1714,568,1607,13,40,496,1382,509,1422
421270,202103,327,853,137,472,21,67,46,157,67,224
421280,202103,1846,4840,1401,4111,194,694,815,2265,1009,2959
421290,202103,938,2502,492,1483,97,307,112,314,209,621
421300,202103,267,681,134,426,11,48,20,56,31,104
421310,202103,172,484,116,375,23,78,62,198,85,276
421315,202103,218,572,145,421,45,121,32,102,77,223
421320,202103,614,1934,333,1116,35,100,32,62,67,162
421330,202103,570,1677,413,1354,83,311,118,360,201,671
421335,202103,328,990,269,890,60,217,115,379,175,596
421340,202103,1349,3714,977,3037,162,570,467,1339,629,1909
421350,202103,1438,3706,966,2875,184,616,383,1074,567,1690
421360,202103,2189,5832,1286,3961,222,800,490,1324,712,2124
421370,202103,687,2222,425,1519,75,280,125,391,200,671
421380,202103,804,2098,691,1924,83,262,415,1107,498,1369
421390,202103,159,425,59,205,15,44,21,64,36,108
421400,202103,297,926,213,737,35,138,108,354,143,492
421410,202103,176,495,83,299,21,83,24,74,45,157
421415,202103,170,507,108,345,24,83,24,64,48,147
421420,202103,551,1497,452,1311,49,163,283,798,332,961
421430,202103,94,301,71,241,8,28,17,57,25,85
421440,202103,587,1576,357,1153,67,214,154,484,221,698
421450,202103,444,1295,257,879,32,113,40,142,72,255
421460,202103,356,1068,197,731,22,91,26,84,48,175
421470,202103,273,773,165,541,29,96,64,225,93,321
421480,202103,2654,7064,1773,5298,342,1211,705,1900,1047,3111
421490,202103,115,397,70,263,11,44,15,46,26,90
421500,202103,1998,5805,1391,4550,352,1353,338,966,690,2319
421505,202103,282,783,236,718,31,118,157,453,188,571
421507,202103,412,1152,226,756,51,187,80,247,131,434
421510,202103,330,917,213,632,32,103,111,303,143,406
421520,202103,473,1245,315,901,24,77,186,483,210,560
421530,202103,269,780,157,530,24,102,40,113,64,215
421535,202103,364,954,230,718,38,135,124,375,162,510
421540,202103,295,696,161,477,24,78,55,141,79,219
421545,202103,617,1803,466,1541,100,402,229,702,329,1104
421550,202103,1962,5183,1589,4632,294,873,906,2639,1200,3512
421555,202103,160,488,73,259,7,31,10,23,17,54
421560,202103,82,274,54,203,10,38,17,59,27,97
421565,202103,879,2263,581,1796,150,518,157,476,307,994
421567,202103,401,1264,261,886,84,304,72,219,156,523
421568,202103,320,947,241,769,32,115,111,348,143,463
421569,202103,149,417,73,230,10,32,39,123,49,155
421570,202103,1157,3109,828,2478,179,601,246,668,425,1269
421575,202103,279,798,212,622,30,96,104,284,134,380
421580,202103,4068,11013,2644,8068,373,1325,1029,2695,1402,4020
421590,202103,134,417,109,359,27,99,38,116,65,215
421600,202103,543,1465,375,1112,74,247,118,298,192,545
421605,202103,725,1877,523,1545,90,232,281,892,371,1124
421610,202103,1005,2741,687,2130,106,368,227,671,333,1039
421620,202103,3660,9638,2219,7024,430,1593,676,2009,1106,3602
421625,202103,124,346,61,190,12,32,15,46,27,78
421630,202103,2412,6256,1565,4643,269,967,588,1449,857,2416
421635,202103,255,684,184,539,14,45,119,323,133,368
421640,202103,661,1766,478,1492,98,346,209,639,307,985
421650,202103,2302,6273,1557,4901,342,1255,503,1366,845,2621
421660,202103,9800,27102,6921,21602,1027,3571,3126,8938,4153,12509
421670,202103,736,2085,526,1584,94,320,244,703,338,1023
421680,202103,1010,2722,770,2305,168,540,423,1171,591,1711
421690,202103,1270,3575,862,2727,152,533,306,959,458,1492
421700,202103,490,1429,338,1095,68,250,114,348,182,598
421710,202103,195,626,98,340,20,70,23,78,43,148
421715,202103,104,282,83,236,19,52,44,125,63,177
421720,202103,1858,4988,1124,3442,293,926,276,737,569,1663
421725,202103,244,580,125,374,21,70,55,135,76,205
421730,202103,376,1052,213,624,28,88,112,306,140,394
421740,202103,718,2037,492,1549,107,367,148,417,255,784
421750,202103,838,1959,397,1150,94,293,139,366,233,659
421755,202103,147,410,91,277,15,59,47,126,62,185
421760,202103,945,2455,644,1906,105,344,239,598,344,942
421770,202103,2270,5973,1641,4888,429,1257,578,1848,1007,3105
421775,202103,209,538,125,377,16,50,52,148,68,198
421780,202103,771,2252,501,1688,101,384,215,665,316,1049
421790,202103,843,2287,504,1654,112,383,225,712,337,1095
421795,202103,170,462,123,351,22,74,45,118,67,192
421800,202103,2453,6585,1791,5364,213,738,1050,2994,1263,3732
421810,202103,615,1669,419,1307,44,164,246,748,290,912
421820,202103,881,2541,523,1669,103,382,171,442,274,824
421825,202103,1293,3591,1150,3376,111,353,826,2368,937,2721
421830,202103,1918,5608,1563,4961,313,1063,647,2015,960,3078
421835,202103,212,516,138,393,26,88,52,135,78,223
421840,202103,206,663,145,525,30,116,35,120,65,236
421850,202103,355,993,205,690,50,200,54,135,104,335
421860,202103,297,806,162,531,17,65,64,186,81,251
421870,202103,4184,10381,3093,8399,459,1485,1633,3942,2092,5427
421875,202103,273,801,117,361,17,57,33,85,50,142
421880,202103,647,1801,438,1338,90,310,122,357,212,667
421885,202103,209,594,135,422,32,101,38,102,70,203
421890,202103,805,2419,606,2023,101,404,333,1042,434,1446
421895,202103,386,983,329,909,41,118,221,640,262,758
421900,202103,1004,2642,765,2153,93,306,377,959,470,1265
421910,202103,304,885,189,618,30,129,42,103,72,232
421915,202103,362,1015,210,662,46,138,40,121,86,259
421917,202103,555,1296,320,997,110,354,79,267,189,621
421920,202103,355,1076,258,889,97,350,74,251,171,601
421930,202103,2463,6170,1308,3996,268,944,468,1245,736,2189
421935,202103,388,1193,307,1020,61,213,172,557,233,770
421940,202103,354,1026,171,549,25,85,34,84,59,169
421950,202103,2840,7065,1655,4853,332,1058,425,1107,757,2165
421960,202103,178,445,93,284,14,62,30,70,44,132
421970,202103,1794,4583,1112,3191,212,709,437,1080,649,1789
421985,202103,287,777,178,554,20,72,70,200,90,272
422000,202103,1870,4792,1526,4263,143,478,1055,2902,1198,3380
430003,202103,570,1525,375,1176,64,216,167,526,231,742
430005,202103,261,687,166,517,26,94,83,243,109,337
430010,202103,1665,3998,1326,3483,175,485,897,2300,1072,2785
430020,202103,578,1311,439,1131,41,125,294,728,335,853
430030,202103,929,2194,508,1439,119,383,163,429,282,812
430040,202103,10218,24007,6165,17004,1606,4739,831,2415,2437,7154
430045,202103,463,1164,329,917,26,84,221,603,247,687
430047,202103,231,498,93,251,23,60,26,74,49,134
430050,202103,853,2169,506,1472,107,330,126,347,233,677
430055,202103,263,657,135,390,19,72,74,186,93,258
430057,202103,79,166,31,81,7,22,11,23,18,45
430060,202103,16938,44533,13143,38639,2604,8129,6234,18111,8838,26240
430063,202103,801,2219,651,1916,129,382,350,1033,479,1415
430064,202103,1011,2733,754,2214,211,646,303,869,514,1515
430066,202103,94,197,66,155,6,14,49,107,55,121
430070,202103,719,1827,108,357,11,42,14,32,25,74
430080,202103,845,2073,521,1447,79,253,283,673,362,926
430085,202103,860,1902,522,1363,107,288,215,551,322,839
430087,202103,787,1884,659,1717,61,166,466,1204,527,1370
430090,202103,499,1303,197,622,11,45,61,188,72,233
430100,202103,793,1874,487,1311,88,270,164,377,252,647
430105,202103,1176,3090,788,2429,115,416,387,1145,502,1561
430107,202103,170,498,103,327,21,71,28,75,49,146
430110,202103,2214,5450,1656,4635,297,874,835,2304,1132,3178
430120,202103,1139,3337,768,2414,134,438,337,1058,471,1496
430130,202103,3411,7718,2497,6431,837,2190,452,1431,1289,3621
430140,202103,959,2461,693,1977,167,431,358,1010,525,1441
430150,202103,538,1375,293,880,65,216,93,265,158,481
430155,202103,239,604,113,339,19,53,23,62,42,115
430160,202103,19772,45346,15483,39424,1738,4786,9330,23431,11068,28217
430163,202103,3064,7160,2160,5734,83,296,1593,4116,1676,4412
430165,202103,288,704,90,280,12,27,13,38,25,65
430170,202103,948,2483,333,1124,47,163,49,151,96,314
430175,202103,650,1892,551,1679,138,421,256,786,394,1207
430180,202103,621,1490,491,1277,59,141,334,883,393,1024
430185,202103,634,1582,327,942,90,231,51,142,141,373
430187,202103,726,1555,520,1302,71,188,290,742,361,930
430190,202103,1397,3575,1109,3130,239,723,507,1379,746,2102
430192,202103,121,323,39,117,5,15,8,19,13,34
430195,202103,405,1182,58,206,4,17,6,12,10,29
430200,202103,1029,3031,824,2663,287,954,221,745,508,1699
430205,202103,451,1189,406,1107,14,49,357,947,371,996
430210,202103,5722,14601,3871,10686,606,1801,1281,2850,1887,4651
430215,202103,300,770,191,556,38,114,71,210,109,324
430220,202103,642,1587,199,651,21,75,41,104,62,179
430222,202103,184,510,137,414,15,53,48,136,63,189
430223,202103,244,629,194,544,14,35,121,331,135,366
430225,202103,16,32,10,23,0,0,7,16,7,16
430230,202103,1945,5218,1607,4695,135,442,1170,3346,1305,3788
430235,202103,357,991,234,735,45,161,62,167,107,328
430237,202103,510,1183,380,976,17,47,289,727,306,774
430240,202103,1304,3019,745,2033,80,263,396,985,476,1248
430245,202103,695,1937,544,1656,147,464,254,796,401,1260
430250,202103,927,2239,670,1840,239,702,37,91,276,793
430258,202103,139,373,99,291,6,15,53,152,59,167
430260,202103,649,1696,453,1322,57,189,256,751,313,940
430265,202103,210,605,139,460,30,93,44,150,74,243
430270,202103,2913,7120,2306,6176,384,1117,1408,3653,1792,4770
430280,202103,5073,11742,3555,9193,671,1748,1571,3999,2242,5747
430290,202103,2232,5048,1826,4580,44,142,1586,3879,1630,4021
430300,202103,10083,25010,7585,20727,1153,3464,4062,10735,5215,14199
430310,202103,11771,28739,8020,21916,1010,3039,3968,10118,4978,13157
430320,202103,1010,2532,568,1673,54,160,326,956,380,1116
430330,202103,694,1664,415,1110,77,215,159,381,236,596
430340,202103,588,1373,392,1055,64,163,234,621,298,784
430350,202103,7781,19294,5900,16029,710,2081,3589,9272,4299,11353
430355,202103,302,801,112,361,17,57,13,33,30,90
430360,202103,818,1939,540,1451,100,305,231,580,331,885
430367,202103,304,683,178,470,30,95,103,255,133,350
430370,202103,451,1238,218,658,34,108,60,151,94,259
430380,202103,704,1724,341,1053,76,268,99,290,175,558
430390,202103,3173,7533,1927,5287,393,1224,301,603,694,1827
430400,202103,1007,2148,776,1837,64,166,456,1051,520,1217
430410,202103,535,1261,375,1007,58,158,233,619,291,777
430420,202103,2556,6832,1965,5591,447,1332,938,2549,1385,3881
430430,202103,563,1418,260,796,61,176,57,185,118,361
430435,202103,1461,3667,1138,3155,195,591,605,1669,800,2260
430440,202103,3731,10030,2935,8688,283,950,1840,5400,2123,6350
430450,202103,6629,16342,5282,13983,952,2731,2600,6599,3552,9330
430460,202103,32658,81477,24421,68180,3985,12219,12712,33968,16697,46187
430461,202103,233,614,78,242,12,42,33,87,45,129
430462,202103,260,698,151,477,27,96,49,152,76,248
430463,202103,5998,15397,4434,12646,858,2744,2062,5577,2920,8321
430465,202103,441,1109,354,948,58,174,222,571,280,745
430466,202103,4105,10238,3209,8808,745,2111,1483,3871,2228,5982
430467,202103,503,1178,356,957,48,158,199,484,247,642
430468,202103,1263,3063,999,2675,76,236,694,1803,770,2039
430469,202103,520,1374,73,235,8,25,16,34,24,59
430470,202103,5448,13872,3623,10637,1057,3359,902,2459,1959,5818
430471,202103,537,1489,439,1312,64,207,260,746,324,953
430480,202103,679,1888,439,1361,55,186,103,281,158,467
430485,202103,171,442,66,199,20,55,5,18,25,73
430490,202103,338,876,194,579,24,89,99,266,123,355
430495,202103,393,1046,260,795,34,109,117,332,151,441
430500,202103,976,2488,673,1980,225,713,182,490,407,1203
430510,202103,26358,67073,18958,53070,3003,9493,9021,23247,12024,32740
430511,202103,319,914,141,453,19,64,20,61,39,125
430512,202103,959,2124,745,1808,165,405,275,686,440,1091
430513,202103,794,1948,368,1049,62,187,175,464,237,651
430515,202103,367,1030,268,827,32,95,147,451,179,546
430517,202103,1178,3483,885,2819,163,513,432,1400,595,1913
430520,202103,1256,3154,678,1912,124,374,157,406,281,780
430530,202103,970,2392,400,1188,68,201,116,333,184,534
430535,202103,3445,8771,2504,7059,342,1007,1269,3424,1611,4431
430537,202103,335,1111,308,1041,17,49,252,852,269,901
430540,202103,602,1423,337,964,58,166,159,454,217,620
430543,202103,836,1433,479,1036,57,116,198,500,255,616
430544,202103,745,2068,518,1561,121,377,175,513,296,890
430545,202103,2281,5769,1685,4868,311,903,884,2609,1195,3512
430550,202103,342,937,251,746,46,146,98,271,144,417
430558,202103,113,260,53,144,8,17,18,49,26,66
430560,202103,275,645,133,397,21,71,49,129,70,200
430570,202103,842,2035,599,1596,99,303,302,736,401,1039
430580,202103,824,2039,587,1676,149,459,249,712,398,1171
430583,202103,201,497,40,121,4,12,12,30,16,42
430585,202103,227,548,120,328,18,56,53,122,71,178
430587,202103,194,523,146,437,22,70,58,166,80,236
430590,202103,1369,3280,1130,2923,56,167,929,2353,985,2520
430593,202103,17,50,13,39,2,4,5,15,7,19
430595,202103,430,1067,125,401,12,50,22,47,34,97
430597,202103,463,1166,249,735,24,74,82,192,106,266
430600,202103,1975,5030,902,2556,147,438,241,625,388,1063
430605,202103,1282,3338,929,2693,109,359,459,1266,568,1625
430607,202103,515,1207,433,1082,26,67,318,783,344,850
430610,202103,5843,13430,3923,10572,1078,3354,865,2240,1943,5594
430613,202103,267,617,75,215,10,27,19,40,29,67
430620,202103,626,1502,464,1205,64,192,280,649,344,841
430630,202103,391,1060,116,373,21,68,26,70,47,138
430632,202103,450,1166,202,605,30,87,85,244,115,331
430635,202103,530,1233,398,1016,46,120,291,746,337,866
430637,202103,459,1097,355,941,36,108,239,606,275,714
430640,202103,1059,2778,701,2055,111,345,273,730,384,1075
430642,202103,351,963,263,765,45,132,136,374,181,506
430645,202103,154,360,60,160,8,24,22,52,30,76
430650,202103,1639,4587,1307,4026,382,1165,557,1857,939,3022
430655,202103,280,694,170,479,29,95,82,197,111,292
430660,202103,5221,13154,4002,11170,850,2480,1773,4888,2623,7368
430670,202103,643,1563,489,1298,33,93,285,770,318,863
430673,202103,525,1190,222,622,38,104,87,227,125,331
430675,202103,238,686,53,190,5,17,19,68,24,85
430676,202103,5068,12363,4026,10766,497,1429,2533,6648,3030,8077
430680,202103,1047,2751,609,1847,161,501,140,404,301,905
430690,202103,2776,7430,2201,6400,750,2293,589,1654,1339,3947
430692,202103,214,659,167,580,14,48,122,434,136,482
430693,202103,930,2415,575,1731,107,382,150,413,257,795
430695,202103,401,1011,248,708,30,81,132,361,162,442
430697,202103,393,985,305,849,76,198,148,444,224,642
430700,202103,7297,17727,4478,12549,837,2546,1120,2833,1957,5379
430705,202103,403,950,201,577,19,53,86,222,105,275
430710,202103,1669,3527,1169,2860,148,403,712,1708,860,2111
430720,202103,667,1587,352,1049,42,116,182,547,224,663
430730,202103,988,2666,690,2104,98,297,366,1096,464,1393
430740,202103,645,1714,337,1078,57,181,87,280,144,461
430745,202103,338,909,223,671,49,168,71,184,120,352
430750,202103,1365,3397,953,2703,227,671,434,1207,661,1878
430755,202103,444,1079,286,761,21,65,159,394,180,459
430760,202103,2004,4863,1534,4147,310,927,741,1898,1051,2825
430770,202103,6231,15444,4823,13317,574,1808,3108,8289,3682,10097
430780,202103,1810,4424,1083,3186,196,659,433,1219,629,1878
430781,202103,457,1264,264,821,35,105,79,213,114,318
430783,202103,350,796,211,580,21,63,136,353,157,416
430786,202103,31,110,21,78,3,13,2,9,5,22
430790,202103,4356,10486,3073,8310,324,1037,1911,4820,2235,5857
430800,202103,763,1730,578,1463,46,117,382,961,428,1078
430805,202103,329,849,217,618,14,50,140,382,154,432
430807,202103,479,1187,255,757,35,113,96,255,131,368
430810,202103,671,1584,292,857,32,119,134,359,166,478
430820,202103,1126,3010,690,2178,125,413,218,658,343,1071
430825,202103,255,625,83,229,9,22,31,79,40,101
430830,202103,1686,4723,1369,4123,107,317,951,2831,1058,3148
430840,202103,1067,2555,729,1991,104,271,470,1309,574,1580
430843,202103,171,398,79,209,5,16,33,78,38,94
430845,202103,457,1068,303,823,50,144,137,354,187,498
430850,202103,2235,5719,1517,4365,224,700,583,1709,807,2409
430860,202103,850,1977,397,1119,51,175,180,423,231,598
430865,202103,502,1247,370,1022,85,235,135,372,220,607
430870,202103,580,1534,264,833,37,135,80,217,117,352
430880,202103,1492,3343,1019,2626,168,438,550,1377,718,1815
430885,202103,170,448,90,293,5,16,57,180,62,196
430890,202103,971,2355,651,1828,54,225,140,364,194,589
430900,202103,3107,6723,2176,5412,173,530,1462,3404,1635,3934
430905,202103,822,2034,529,1482,89,274,218,583,307,857
430910,202103,1844,4926,1368,3957,202,672,648,1647,850,2319
430912,202103,508,1419,353,1105,29,89,225,713,254,802
430915,202103,479,1425,366,1215,134,424,92,327,226,751
430920,202103,22089,55606,16829,46996,2158,6625,10155,27715,12313,34340
430925,202103,88,201,36,112,4,12,19,56,23,68
430930,202103,10137,23767,6514,18232,1235,3479,2654,7829,3889,11308
430940,202103,926,2376,567,1633,118,355,199,511,317,866
430950,202103,783,1765,505,1292,35,122,330,767,365,889
430955,202103,378,971,91,252,20,57,27,57,47,114
430957,202103,163,546,149,518,19,70,100,344,119,414
430960,202103,1284,3033,726,2020,152,448,313,820,465,1268
430965,202103,1599,3769,1239,3206,69,182,942,2491,1011,2673
430970,202103,335,793,173,481,22,72,87,212,109,284
430975,202103,497,1454,382,1190,76,254,211,620,287,874
430980,202103,378,854,223,593,26,84,104,247,130,331
430990,202103,512,1445,340,1051,51,164,161,485,212,649
430995,202103,545,1368,416,1161,49,145,243,656,292,801
431000,202103,1323,3111,566,1641,110,336,45,118,155,454
431010,202103,2145,5642,1415,4367,281,953,355,967,636,1920
431020,202103,7552,16310,4489,11754,977,2927,1573,3583,2550,6510
431030,202103,359,967,170,568,31,118,22,65,53,183
431033,202103,3721,8536,2425,6530,503,1392,896,2404,1399,3796
431036,202103,333,728,69,208,7,24,22,52,29,76
431040,202103,870,2197,565,1674,77,255,264,723,341,978
431041,202103,435,1005,320,828,25,56,195,506,220,562
431043,202103,309,789,180,553,42,144,85,252,127,396
431046,202103,103,273,41,128,4,9,8,24,12,33
431050,202103,1338,3221,955,2601,179,530,429,1209,608,1739
431053,202103,645,1707,382,1145,72,252,124,319,196,571
431055,202103,578,1387,487,1244,56,131,350,889,406,1020
431057,202103,212,604,119,384,26,84,32,95,58,179
431060,202103,5481,13626,3691,10619,841,2646,1077,2988,1918,5634
431065,202103,401,988,290,803,42,125,149,405,191,530
431070,202103,413,1121,247,749,54,178,73,215,127,393
431075,202103,217,622,134,432,33,114,39,123,72,237
431080,202103,569,1537,396,1171,59,206,149,415,208,621
431085,202103,775,1994,499,1372,56,154,260,697,316,851
431087,202103,385,1084,313,939,20,58,221,682,241,740
431090,202103,401,936,160,487,29,97,45,137,74,234
431100,202103,3315,7156,2289,5835,301,789,1228,3178,1529,3967
431110,202103,1402,3196,958,2434,245,658,396,903,641,1561
431112,202103,595,1622,502,1457,58,197,330,918,388,1115
431113,202103,365,982,310,875,46,150,192,520,238,670
431115,202103,948,2649,744,2275,89,334,454,1293,543,1627
431120,202103,2578,6728,1785,5233,493,1607,396,1065,889,2672
431123,202103,397,1057,260,766,55,142,139,430,194,572
431125,202103,966,2717,779,2354,283,842,266,857,549,1699
431127,202103,201,534,65,217,8,28,14,43,22,71
431130,202103,2904,7306,2159,6099,327,1037,1204,3317,1531,4354
431140,202103,5557,12921,3434,8991,419,1213,1565,3556,1984,4769
431142,202103,491,1281,368,1070,44,135,229,671,273,806
431150,202103,1033,2719,747,2200,133,430,338,961,471,1391
431160,202103,629,1795,416,1311,79,263,121,369,200,632
431162,202103,477,1128,279,779,29,88,157,408,186,496
431164,202103,165,372,40,123,9,30,4,10,13,40
431170,202103,439,1202,310,938,89,280,90,264,179,544
431171,202103,651,1520,531,1360,118,265,304,810,422,1075
431173,202103,368,975,281,851,78,267,117,336,195,603
431175,202103,1277,2930,809,2144,133,362,307,768,440,1130
431177,202103,781,2077,616,1815,119,416,391,1095,510,1511
431179,202103,332,726,101,295,20,56,27,75,47,131
431180,202103,2103,5291,1315,3747,302,889,403,1100,705,1989
431190,202103,577,1457,268,774,29,86,92,224,121,310
431198,202103,369,1052,291,907,94,308,87,292,181,600
431200,202103,360,887,87,234,18,54,11,29,29,83
431205,202103,198,541,103,330,29,92,35,115,64,207
431210,202103,599,1451,484,1294,124,335,216,610,340,945
431213,202103,261,680,196,565,13,46,102,293,115,339
431215,202103,596,1425,282,826,22,65,144,395,166,460
431217,202103,152,389,105,303,14,47,57,150,71,197
431220,202103,512,1319,318,939,30,101,180,498,210,599
431225,202103,1481,3456,1140,2900,117,309,769,1953,886,2262
431230,202103,657,1861,530,1594,76,238,327,947,403,1185
431235,202103,150,384,22,80,2,6,4,20,6,26
431237,202103,297,926,238,788,45,161,122,388,167,549
431238,202103,30,80,24,67,5,16,11,23,16,39
431240,202103,4413,10732,3511,9327,420,1310,2196,5484,2616,6794
431242,202103,241,625,210,574,37,106,120,314,157,420
431244,202103,303,729,160,449,21,78,59,134,80,212
431245,202103,1266,2902,810,2126,67,191,451,1135,518,1326
431247,202103,272,681,165,464,30,91,72,178,102,269
431250,202103,1674,4119,1241,3541,275,785,641,1962,916,2747
431260,202103,249,685,164,520,23,86,53,163,76,249
431261,202103,235,700,190,628,13,45,107,339,120,384
431262,202103,333,933,168,550,10,28,113,376,123,404
431265,202103,1580,3700,648,1883,79,257,207,530,286,787
431267,202103,256,635,169,456,8,33,124,306,132,339
431270,202103,2781,6184,1502,4051,319,865,503,1384,822,2249
431275,202103,112,322,62,206,22,67,11,41,33,108
431280,202103,236,634,76,239,5,14,9,21,14,35
431290,202103,326,936,209,648,40,122,36,87,76,209
431295,202103,68,167,20,60,3,8,5,13,8,21
431300,202103,277,720,57,181,7,20,18,47,25,67
431301,202103,302,850,70,216,7,19,8,24,15,43
431303,202103,562,1452,348,1009,22,81,162,428,184,509
431306,202103,2293,5393,1426,3956,179,544,622,1532,801,2076
431308,202103,25,76,23,72,10,34,10,31,20,65
431310,202103,537,1464,378,1112,47,137,169,470,216,607
431320,202103,596,1621,320,1028,47,142,66,177,113,319
431330,202103,1692,3964,856,2439,145,463,347,902,492,1365
431333,202103,211,546,115,338,21,60,38,95,59,155
431335,202103,35,100,21,70,4,8,1,2,5,10
431337,202103,2502,6520,1867,5481,306,1034,1059,2980,1365,4014
431339,202103,415,1070,309,879,85,251,118,327,203,578
431340,202103,18168,43727,12772,34793,1982,5944,5974,15269,7956,21213
431342,202103,425,933,313,757,27,51,255,617,282,668
431344,202103,385,972,231,682,9,30,123,352,132,382
431346,202103,232,570,92,292,16,54,26,77,42,131
431349,202103,608,1588,349,1013,80,220,130,377,210,597
431350,202103,4026,10161,3005,8442,387,1251,1650,4429,2037,5680
431360,202103,543,1293,266,751,83,239,68,194,151,433
431365,202103,2044,4723,1623,4156,124,360,1233,3117,1357,3477
431370,202103,4381,10452,3168,8509,608,1727,1611,4393,2219,6120
431380,202103,795,2108,640,1859,48,146,445,1293,493,1439
431390,202103,2658,6438,1664,4697,159,540,846,2088,1005,2628
431395,202103,1274,3108,902,2545,186,550,413,1204,599,1754
431400,202103,311,868,172,547,37,111,38,118,75,229
431402,202103,873,1930,641,1578,73,187,442,1067,515,1254
431403,202103,199,544,156,458,22,61,71,200,93,261
431405,202103,4569,11910,3541,10198,578,1838,1765,4836,2343,6674
431406,202103,519,1465,378,1167,74,222,203,643,277,865
431407,202103,448,1227,316,951,68,230,161,461,229,691
431410,202103,16731,41326,11368,32072,1557,5087,6023,15775,7580,20862
431413,202103,198,518,55,178,5,15,11,37,16,52
431415,202103,643,1551,402,1140,71,238,202,515,273,753
431417,202103,555,1222,374,942,61,178,199,489,260,667
431420,202103,1622,3575,1216,3018,157,399,710,1716,867,2115
431430,202103,554,1415,274,842,44,148,89,246,133,394
431440,202103,29248,67522,20308,53697,3295,9522,8262,20375,11557,29897
431442,202103,122,344,56,193,10,39,8,24,18,63
431445,202103,388,1073,116,366,15,40,11,28,26,68
431446,202103,247,719,186,597,33,124,95,291,128,415
431447,202103,731,1900,423,1239,85,263,143,418,228,681
431449,202103,773,1987,472,1367,94,252,177,530,271,782
431450,202103,2290,4645,1787,3943,68,160,1414,3045,1482,3205
431454,202103,33,105,28,91,8,23,8,24,16,47
431455,202103,585,1369,289,767,35,100,148,351,183,451
431460,202103,2844,6792,1989,5288,511,1425,511,1371,1022,2796
431470,202103,1389,3851,1024,3075,183,567,446,1345,629,1912
431475,202103,238,639,58,198,5,18,7,14,12,32
431477,202103,374,972,232,683,35,97,98,263,133,360
431478,202103,218,575,50,154,11,30,6,13,17,43
431480,202103,3294,8015,2636,7020,608,1624,1358,3639,1966,5263
431490,202103,105155,244821,79710,206512,5461,16820,58095,144638,63556,161458
431500,202103,477,1201,356,973,60,171,187,490,247,661
431505,202103,251,601,170,475,11,37,123,341,134,378
431507,202103,332,778,137,399,45,143,35,91,80,234
431510,202103,1569,3986,1066,3012,259,787,348,991,607,1778
431513,202103,208,459,118,312,9,19,79,210,88,229
431514,202103,110,278,78,220,4,12,54,143,58,155
431515,202103,448,1119,332,912,80,218,185,478,265,696
431517,202103,54,164,45,140,6,17,21,61,27,78
431520,202103,389,975,158,491,15,55,66,175,81,230
431530,202103,4249,8852,2445,6194,558,1403,652,1698,1210,3101
431531,202103,209,500,132,357,19,48,52,132,71,180
431532,202103,541,1249,335,882,69,204,144,367,213,571
431535,202103,237,621,109,337,22,70,24,64,46,134
431540,202103,1757,5601,1630,5424,55,210,1325,4436,1380,4646
431545,202103,339,879,61,203,5,17,12,37,17,54
431550,202103,2097,5252,1516,4177,236,685,762,2021,998,2706
431555,202103,665,1483,390,1024,30,87,229,597,259,684
431560,202103,22529,53880,15495,42973,3184,9127,5302,15473,8486,24600
431570,202103,4209,10232,3528,9232,447,1275,2478,6237,2925,7512
431575,202103,236,576,185,489,68,161,47,133,115,294
431580,202103,564,1452,359,1044,36,121,202,560,238,681
431590,202103,577,1605,434,1311,91,283,170,530,261,813
431595,202103,360,968,241,719,44,127,94,256,138,383
431600,202103,1334,3086,931,2504,214,623,373,994,587,1617
431610,202103,1371,3466,932,2664,138,376,476,1395,614,1771
431620,202103,478,1222,221,641,36,107,87,233,123,340
431630,202103,1299,3170,625,1813,97,299,235,632,332,931
431640,202103,6216,14487,5260,13292,457,1199,4025,10201,4482,11400
431642,202103,557,1342,348,926,36,94,152,376,188,470
431643,202103,381,920,181,510,17,44,54,156,71,200
431645,202103,1841,4039,1448,3520,53,169,1190,2842,1243,3011
431647,202103,296,719,96,280,11,29,25,61,36,90
431650,202103,120,328,82,268,9,31,44,129,53,160
431660,202103,836,2194,414,1310,65,245,114,303,179,548
431670,202103,1149,2712,702,1905,103,281,344,884,447,1165
431673,202103,238,604,90,305,6,24,20,57,26,81
431675,202103,414,1075,114,379,8,33,23,63,31,96
431680,202103,7719,19433,5666,15682,1316,3760,2387,6461,3703,10221
431690,202103,23890,57763,16119,44008,3083,8964,6768,18265,9851,27229
431695,202103,169,406,104,304,22,77,51,126,73,203
431697,202103,459,1071,358,918,52,124,211,555,263,679
431700,202103,1316,3347,1091,2944,181,441,644,1757,825,2198
431710,202103,13159,30857,9247,25293,1438,4232,4847,13320,6285,17552
431720,202103,6487,15789,3917,10939,931,2717,813,2056,1744,4773
431725,202103,28,81,22,71,3,10,10,30,13,40
431730,202103,3924,9174,2457,6902,551,1625,781,2364,1332,3989
431740,202103,5126,11943,3400,9087,873,2718,891,2059,1764,4777
431750,202103,7339,18726,5557,15907,1246,3777,2203,6255,3449,10032
431755,202103,314,845,76,254,13,41,9,29,22,70
431760,202103,5338,11860,3656,9217,403,1148,2247,5376,2650,6524
431770,202103,1921,4411,1489,3838,119,313,1101,2784,1220,3097
431775,202103,201,508,102,314,19,59,13,34,32,93
431780,202103,2101,5103,1361,3769,209,626,578,1551,787,2177
431790,202103,766,2050,541,1619,99,285,248,748,347,1033
431795,202103,230,584,117,355,27,74,28,81,55,155
431800,202103,8112,19061,5049,14271,1238,4168,477,1416,1715,5584
431805,202103,291,671,87,277,12,42,20,61,32,103
431810,202103,3238,7558,2039,5399,385,1051,867,2200,1252,3251
431820,202103,2073,5502,1623,4789,477,1471,537,1682,1014,3153
431830,202103,8904,19056,6518,15903,1634,4737,1679,4047,3313,8784
431840,202103,2570,6571,2062,5764,300,849,1326,3696,1626,4545
431842,202103,514,1283,175,538,24,81,72,197,96,278
431843,202103,333,871,249,707,33,97,121,327,154,424
431844,202103,200,529,69,225,14,49,23,80,37,129
431845,202103,499,1313,354,1027,36,104,207,598,243,702
431846,202103,267,689,229,632,12,35,201,556,213,591
431848,202103,116,299,70,205,11,33,17,39,28,72
431849,202103,406,976,78,221,8,19,13,26,21,45
431850,202103,4096,10914,3162,9093,716,2221,1071,3018,1787,5239
431860,202103,642,1499,350,943,54,157,202,523,256,680
431861,202103,91,252,55,172,10,34,20,57,30,91
431862,202103,448,1393,368,1254,68,253,185,603,253,856
431870,202103,20327,50654,16395,44589,1767,5509,10374,27053,12141,32562
431880,202103,3888,9859,2773,7916,408,1346,1341,3624,1749,4970
431890,202103,4468,11150,2796,7987,773,2402,493,1578,1266,3980
431900,202103,942,2326,615,1747,89,275,315,846,404,1121
431910,202103,744,1768,280,776,40,117,89,204,129,321
431912,202103,476,1268,375,1091,76,229,211,616,287,845
431915,202103,1051,2510,837,2168,21,64,663,1685,684,1749
431920,202103,1236,2815,1020,2535,33,71,866,2153,899,2224
431930,202103,657,1717,448,1324,164,454,158,486,322,940
431935,202103,85,225,61,178,16,49,13,37,29,86
431936,202103,305,864,171,532,35,112,75,216,110,328
431937,202103,142,347,92,248,12,33,43,98,55,131
431940,202103,3044,7087,1766,4789,184,531,909,2366,1093,2897
431950,202103,1819,4716,1444,4097,392,1173,574,1571,966,2744
431960,202103,2922,7015,2182,5704,583,1627,595,1543,1178,3170
431970,202103,400,996,171,497,34,108,49,117,83,225
431971,202103,83,204,36,111,4,16,6,11,10,27
431973,202103,467,1497,388,1342,38,130,279,968,317,1098
431975,202103,106,214,20,62,2,7,2,6,4,13
431980,202103,942,2437,727,2088,144,435,349,967,493,1402
431990,202103,5491,13035,3811,10631,423,1425,2030,5464,2453,6889
432000,202103,11179,26305,8176,21729,1945,5200,3475,9396,5420,14596
432010,202103,2286,5425,1650,4377,282,811,911,2277,1193,3088
432020,202103,1743,4508,1075,3082,224,660,386,1072,610,1732
432023,202103,497,1178,262,729,33,103,130,325,163,428
432026,202103,940,2580,694,2106,179,528,208,646,387,1174
432030,202103,354,865,204,562,14,43,120,319,134,362
432032,202103,332,847,231,644,23,71,133,339,156,410
432035,202103,652,1827,566,1681,172,483,248,782,420,1265
432040,202103,1043,2434,394,1204,52,172,145,395,197,567
432045,202103,155,442,102,331,21,65,38,127,59,192
432050,202103,509,1252,379,1033,79,212,159,457,238,669
432055,202103,566,1513,375,1163,127,401,69,202,196,603
432057,202103,185,506,147,404,11,28,70,178,81,206
432060,202103,426,1015,129,400,30,101,37,106,67,207
432065,202103,197,542,141,424,31,99,54,160,85,259
432067,202103,721,2050,612,1808,58,191,460,1310,518,1501
432070,202103,1633,4199,1088,3159,219,719,382,993,601,1712
432080,202103,4747,10966,3614,9223,576,1722,1722,4165,2298,5887
432085,202103,366,974,263,815,59,187,120,382,179,569
432090,202103,1897,4674,1130,3201,190,583,532,1375,722,1958
432100,202103,965,2385,477,1428,106,335,81,198,187,533
432110,202103,1986,5174,1370,4087,322,1072,154,412,476,1484
432120,202103,2686,7190,2099,6213,371,1230,897,2503,1268,3733
432130,202103,2551,6373,2122,5743,623,1731,903,2485,1526,4216
432132,202103,177,510,110,362,20,68,54,153,74,221
432135,202103,977,2281,653,1736,40,124,475,1247,515,1371
432140,202103,1593,4707,1214,3946,177,605,744,2407,921,3012
432143,202103,1357,3501,1038,3022,63,203,686,1973,749,2176
432145,202103,1658,4339,1058,3103,153,473,348,885,501,1358
432146,202103,102,285,71,234,24,87,24,70,48,157
432147,202103,457,1265,277,894,90,312,70,199,160,511
432149,202103,435,1041,224,624,21,62,105,262,126,324
432150,202103,3076,7625,2266,6226,449,1326,957,2561,1406,3887
432160,202103,4921,12714,3588,10620,822,2731,1289,3649,2111,6380
432162,202103,228,493,33,92,7,25,8,16,15,41
432163,202103,101,250,21,53,0,0,4,5,4,5
432166,202103,624,1718,496,1458,100,325,180,468,280,793
432170,202103,1469,3896,993,3013,177,593,411,1181,588,1774
432180,202103,3070,7179,1675,4602,296,853,637,1538,933,2391
432183,202103,345,1003,241,768,54,194,72,208,126,402
432185,202103,802,2056,464,1392,37,123,228,641,265,764
432190,202103,1924,4562,1317,3616,168,522,762,1946,930,2468
432195,202103,798,2040,541,1572,151,398,191,595,342,993
432200,202103,3278,8135,2382,6740,360,1042,1380,3937,1740,4979
432210,202103,380,990,237,709,43,155,111,286,154,441
432215,202103,606,1781,552,1699,50,126,417,1311,467,1437
432218,202103,247,604,117,332,13,42,53,131,66,173
432220,202103,3485,8111,2586,6690,484,1278,1310,3370,1794,4648
432225,202103,86,238,66,200,9,24,37,118,46,142
432230,202103,712,1646,385,1043,43,119,174,417,217,536
432232,202103,468,1147,292,847,59,180,104,273,163,453
432234,202103,254,640,116,344,17,47,16,44,33,91
432235,202103,44,125,18,57,5,17,4,13,9,30
432237,202103,305,789,273,738,11,20,229,612,240,632
432240,202103,15801,38408,11503,32689,856,2455,7390,22002,8246,24457
432250,202103,5353,15055,3995,12370,1015,3274,1667,5131,2682,8405
432252,202103,413,984,266,720,32,90,141,362,173,452
432253,202103,854,2572,567,1843,137,474,56,170,193,644
432254,202103,691,1608,201,586,36,96,40,109,76,205
432255,202103,98,251,57,172,3,9,28,78,31,87
432260,202103,4791,12116,3576,9837,991,2789,1244,3293,2235,6082
432270,202103,1846,5026,1495,4362,455,1437,374,1024,829,2461
432280,202103,1393,3435,746,2190,99,302,274,682,373,984
432285,202103,142,427,22,67,2,6,3,7,5,13
432290,202103,328,897,182,559,58,182,32,73,90,255
432300,202103,25336,63028,18947,52848,2589,8170,11175,30026,13764,38196
432310,202103,822,2178,593,1763,65,199,405,1202,470,1401
432320,202103,197,456,77,235,7,24,29,83,36,107
432330,202103,240,535,74,238,9,22,13,43,22,65
432335,202103,158,452,59,210,5,21,17,58,22,79
432340,202103,301,723,133,416,8,26,47,136,55,162
432345,202103,720,1588,626,1476,14,35,522,1208,536,1243
432350,202103,338,854,182,558,27,89,71,221,98,310
432360,202103,230,676,44,146,4,7,15,50,19,57
432370,202103,289,706,196,550,14,50,135,367,149,417
432375,202103,461,1149,348,928,68,176,173,461,241,637
432377,202103,168,542,33,123,5,22,3,5,8,27
432380,202103,1677,4437,1122,3432,173,603,589,1765,762,2368
500020,202103,2573,6606,1918,5525,201,656,1166,3265,1367,3921
500025,202103,1181,2880,755,2090,77,210,405,1087,482,1297
500060,202103,7949,22212,5465,17061,658,2135,3214,10258,3872,12393
500070,202103,4180,10695,2957,8610,552,1649,1280,3802,1832,5451
500080,202103,1624,3942,1000,2804,182,563,391,962,573,1525
500085,202103,1965,4878,1372,3868,339,992,623,1692,962,2684
500090,202103,2156,5637,1460,4428,230,738,496,1615,726,2353
500100,202103,3558,8989,2708,7612,419,1334,1369,3627,1788,4961
500110,202103,7927,20021,5143,15716,1036,3498,1550,5592,2586,9090
500124,202103,2032,5870,1615,5172,278,815,842,2854,1120,3669
500150,202103,1325,2962,834,2255,129,365,342,910,471,1275
500190,202103,4856,12564,3115,9178,631,1862,762,2141,1393,4003
500200,202103,2455,5739,1751,4568,161,439,1074,2700,1235,3139
500210,202103,4602,10841,3268,9101,899,2409,1425,4129,2324,6538
500215,202103,1399,3801,1019,3123,98,335,578,1758,676,2093
500220,202103,2752,7595,1820,5826,286,967,533,1633,819,2600
500230,202103,1985,4595,1513,3941,184,445,1018,2641,1202,3086
500240,202103,3960,11487,2816,9121,424,1493,1170,3861,1594,5354
500260,202103,3305,6942,2129,5371,289,734,1163,2809,1452,3543
500270,202103,136217,317588,83582,229954,12994,39393,32310,82849,45304,122242
500280,202103,1322,3291,904,2664,148,445,446,1315,594,1760
500290,202103,3600,8618,2143,6084,321,1064,707,1753,1028,2817
500295,202103,3553,8483,2268,6224,369,1122,903,2149,1272,3271
500310,202103,983,2015,670,1628,92,198,354,885,446,1083
500315,202103,3778,10251,3022,9131,238,734,2196,6764,2434,7498
500320,202103,19294,51282,13403,41599,3408,10952,4471,14977,7879,25929
500325,202103,4511,10008,3131,8173,283,740,2050,5427,2333,6167
500330,202103,6575,14812,4363,11655,341,992,2342,6476,2683,7468
500345,202103,2063,5025,1384,3966,308,927,478,1352,786,2279
500348,202103,2365,6096,1778,5088,234,712,1026,2964,1260,3676
500350,202103,1302,3531,732,2293,82,243,293,881,375,1124
500370,202103,26776,67704,19257,55616,2328,7753,10433,29591,12761,37344
500375,202103,2425,6366,1622,4733,264,831,550,1475,814,2306
500380,202103,3321,8260,2313,6550,659,2018,463,1331,1122,3349
500390,202103,626,1312,380,1008,48,153,235,594,283,747
500400,202103,1546,3899,1029,2908,175,550,352,894,527,1444
500410,202103,2384,5790,1678,4739,170,450,955,2825,1125,3275
500430,202103,2573,6303,1780,5125,239,798,759,2309,998,3107
500440,202103,1192,2869,755,2207,117,371,269,836,386,1207
500450,202103,1486,3619,858,2498,140,438,231,611,371,1049
500460,202103,3493,9316,2140,6669,334,1183,664,2027,998,3210
500470,202103,2348,6258,1443,4410,394,1343,306,816,700,2159
500480,202103,2045,6254,1742,5792,160,547,1301,4382,1461,4929
500490,202103,1058,2420,630,1779,118,400,169,486,287,886
500500,202103,4190,11013,2697,8598,826,3071,324,1056,1150,4127
500510,202103,684,1716,455,1292,33,98,285,792,318,890
500515,202103,1667,4295,1283,3680,163,504,761,2081,924,2585
500520,202103,3228,9620,2528,8383,652,2126,1038,3780,1690,5906
500525,202103,933,2660,739,2377,63,222,478,1521,541,1743
500540,202103,4351,11275,2661,8312,657,2622,238,667,895,3289
500560,202103,5474,14704,4408,13374,295,874,3557,11003,3852,11877
500568,202103,4311,9375,2661,6975,692,1814,887,2423,1579,4237
500570,202103,7615,17574,4825,12946,811,2382,1920,4810,2731,7192
500580,202103,3030,7982,2221,6559,521,1574,974,2891,1495,4465
500600,202103,3393,8427,2445,6922,550,1616,998,2889,1548,4505
500620,202103,7905,20445,5370,15682,1044,3215,2098,5885,3142,9100
500625,202103,536,1460,350,1074,71,225,88,252,159,477
500627,202103,759,1957,469,1443,89,292,139,397,228,689
500630,202103,7028,15817,4003,10911,795,2344,1129,3049,1924,5393
500635,202103,2958,9102,2266,8205,162,606,1561,6230,1723,6836
500640,202103,1688,3670,1123,2924,36,108,776,1996,812,2104
500660,202103,17906,45055,12398,37219,3746,12863,3192,9815,6938,22678
500690,202103,2373,6429,1526,4984,513,1953,108,284,621,2237
500710,202103,2716,7199,2103,6183,569,1799,678,1850,1247,3649
500720,202103,4792,11975,3158,9272,728,2284,960,2896,1688,5180
500730,202103,1094,2671,600,1771,119,329,131,413,250,742
500740,202103,4577,10888,3132,8627,418,1195,1532,4144,1950,5339
500750,202103,987,2479,684,1957,83,209,265,718,348,927
500755,202103,906,2305,508,1559,94,317,108,305,202,622
500769,202103,5116,12444,2895,8304,528,1658,421,1057,949,2715
500770,202103,1407,3785,935,2963,166,599,307,953,473,1552
500780,202103,1166,2797,756,2129,151,491,202,511,353,1002
500790,202103,6694,17821,5191,15303,1050,3328,2489,7380,3539,10708
500793,202103,2024,5122,1460,4163,349,1066,488,1279,837,2345
500795,202103,2706,6638,2172,5969,117,291,1718,4983,1835,5274
500797,202103,729,1842,465,1370,136,414,129,388,265,802
500800,202103,3279,7312,2018,5463,623,2008,221,655,844,2663
500830,202103,17925,44362,12411,34373,2569,7581,4448,11634,7017,19215
500840,202103,1366,3312,871,2384,116,321,351,902,467,1223
510010,202103,1791,4014,1219,3301,113,249,862,2376,975,2625
510020,202103,3796,9414,1977,5861,358,1168,466,1203,824,2371
510025,202103,6493,15550,4009,11634,574,1819,1747,4934,2321,6753
510030,202103,2689,5963,1793,4652,343,869,762,1940,1105,2809
510035,202103,1231,3192,785,2495,98,332,445,1517,543,1849
510040,202103,2373,5237,1761,4446,189,454,1087,2893,1276,3347
510050,202103,2110,4360,1413,3485,176,450,959,2343,1135,2793
510060,202103,1377,3426,869,2518,173,559,214,572,387,1131
510080,202103,1263,3269,820,2560,213,697,317,926,530,1623
510100,202103,658,1517,470,1221,57,148,265,662,322,810
510120,202103,271,487,149,343,10,20,110,258,120,278
510125,202103,1967,4890,1543,4280,147,536,855,2227,1002,2763
510130,202103,1476,3666,1019,2937,216,670,321,953,537,1623
510140,202103,3055,7707,2069,6475,743,2643,733,2259,1476,4902
510160,202103,1704,4371,1262,3803,151,432,920,2845,1071,3277
510170,202103,4437,11614,3310,9811,789,2426,1312,3986,2101,6412
510180,202103,14638,32500,9524,25204,1996,5779,2994,8904,4990,14683
510185,202103,1741,4451,1117,3568,446,1459,245,1050,691,2509
510190,202103,2005,5663,1280,4461,344,1333,229,884,573,2217
510250,202103,17328,43083,12848,36383,2456,7252,6242,18407,8698,25659
510260,202103,1823,7731,1517,7202,249,1283,944,4862,1193,6145
510263,202103,3140,8725,1948,6286,309,1094,372,1052,681,2146
510267,202103,5023,14130,2902,9452,492,1740,419,1215,911,2955
510268,202103,1193,2925,925,2524,101,258,617,1684,718,1942
510269,202103,999,2688,618,1965,141,492,191,574,332,1066
510270,202103,2998,8380,2054,6712,321,1211,849,2733,1170,3944
510279,202103,1736,4445,1052,3263,178,619,423,1236,601,1855
510285,202103,1113,2899,749,2280,236,807,169,459,405,1266
510300,202103,3646,9130,2699,7868,388,1152,1576,4850,1964,6002
510305,202103,1407,3871,876,2848,173,596,200,745,373,1341
510310,202103,885,2153,605,1697,172,489,182,531,354,1020
510320,202103,3540,8668,2444,6846,521,1656,554,1516,1075,3172
510325,202103,4139,12111,3038,10088,848,2983,843,2898,1691,5881
510330,202103,2573,7727,1730,6251,308,1123,628,2692,936,3815
510335,202103,4878,13872,3694,11983,560,1945,2056,6812,2616,8757
510336,202103,438,1221,318,1038,50,161,165,601,215,762
510337,202103,1442,4127,922,3196,352,1347,190,666,542,2013
510340,202103,91875,203141,59826,157481,14197,43558,18092,45321,32289,88879
510343,202103,1026,2759,690,2145,113,399,308,909,421,1308
510345,202103,1246,3532,940,2933,144,444,426,1298,570,1742
510350,202103,2832,7173,1906,5638,383,1217,832,2426,1215,3643
510360,202103,1978,3985,1230,3117,73,131,857,2362,930,2493
510370,202103,1695,4766,1260,4068,175,632,736,2481,911,3113
510380,202103,546,1334,313,944,46,162,133,399,179,561
510385,202103,1205,4008,906,3457,87,392,601,2364,688,2756
510390,202103,1277,3281,859,2770,261,845,276,1063,537,1908
510395,202103,717,1596,490,1262,24,62,312,851,336,913
510410,202103,4717,12872,3466,10726,653,2093,1754,5695,2407,7788
510420,202103,2509,5156,1687,4067,108,257,1130,2738,1238,2995
510450,202103,397,997,237,692,65,197,28,97,93,294
510452,202103,805,2233,597,1859,79,263,352,1063,431,1326
510454,202103,923,2530,722,2192,79,234,449,1440,528,1674
510455,202103,946,2559,684,2051,107,343,292,820,399,1163
510460,202103,1716,4245,1242,3545,100,329,800,2215,900,2544
510480,202103,4681,11111,3165,8421,579,1688,1219,3142,1798,4830
510490,202103,1683,4305,1252,3766,231,686,757,2311,988,2997
510500,202103,1531,3746,938,2812,177,574,310,936,487,1510
510510,202103,3469,9888,2522,8237,604,2235,811,2796,1415,5031
510515,202103,5165,13007,3429,9975,749,2458,1008,2591,1757,5049
510517,202103,1025,2929,771,2498,235,857,144,424,379,1281
510520,202103,2162,4333,1219,3164,94,242,604,1693,698,1935
510523,202103,1152,2742,854,2298,159,420,518,1429,677,1849
510525,202103,7310,19756,5454,16188,797,2557,2619,7372,3416,9929
510530,202103,546,1397,400,1182,29,93,259,758,288,851
510550,202103,2247,6616,1641,5573,348,1244,770,2631,1118,3875
510558,202103,2340,6205,1706,5226,219,617,800,2715,1019,3332
510560,202103,1480,4195,906,3070,182,692,207,775,389,1467
510562,202103,5594,14137,4129,11621,947,2869,1413,4236,2360,7105
510590,202103,3002,7457,2211,6418,151,437,1615,4825,1766,5262
510600,202103,1322,2981,892,2364,161,429,419,1110,580,1539
510610,202103,2529,6057,1720,5021,173,571,1097,3196,1270,3767
510615,202103,2606,6398,1826,5169,276,827,1023,2944,1299,3771
510617,202103,993,2978,775,2635,82,334,529,1836,611,2170
510618,202103,1192,3138,851,2574,188,617,388,1134,576,1751
510619,202103,760,1912,488,1452,67,195,136,389,203,584
510620,202103,1441,3242,675,1994,160,574,33,68,193,642
510621,202103,1543,4124,933,2943,194,682,299,869,493,1551
510622,202103,4653,12832,3187,9787,997,3347,435,1233,1432,4580
510623,202103,2645,6521,1918,5377,458,1461,643,1771,1101,3232
510624,202103,1580,4009,776,2532,96,353,185,543,281,896
510625,202103,2932,7039,1582,4669,255,883,351,1052,606,1935
510626,202103,1410,3418,890,2600,229,779,200,597,429,1376
510627,202103,624,1592,346,1064,83,286,87,280,170,566
510628,202103,1412,3245,943,2635,198,598,354,978,552,1576
510629,202103,1580,4432,1144,3646,219,755,398,1271,617,2026
510630,202103,3374,9205,2006,6636,453,1598,364,1321,817,2919
510631,202103,575,1358,424,1133,13,30,325,895,338,925
510637,202103,3658,8573,2579,7008,634,1930,743,2049,1377,3979
510642,202103,5320,15000,4044,13087,931,3318,1834,5980,2765,9298
510645,202103,989,1881,597,1399,182,382,240,605,422,987
510650,202103,7017,17786,5563,16186,645,1680,3754,12199,4399,13879
510665,202103,1821,3913,1160,2877,252,586,415,1124,667,1710
510670,202103,429,915,248,656,28,75,133,356,161,431
510675,202103,6215,16916,4311,13421,1171,4035,860,2549,2031,6584
510677,202103,2129,5371,1468,4403,198,691,808,2368,1006,3059
510680,202103,687,1735,391,1188,69,240,94,238,163,478
510682,202103,1455,4202,1064,3570,365,1378,264,839,629,2217
510685,202103,468,1349,340,1099,51,169,177,568,228,737
510700,202103,4011,9477,2807,7837,248,747,2109,5890,2357,6637
510704,202103,10645,24908,7144,19030,1656,4698,1779,4623,3435,9321
510706,202103,2050,6018,1425,4980,277,996,731,2772,1008,3768
510710,202103,2596,6396,1713,4751,365,1077,558,1474,923,2551
510715,202103,558,1196,403,987,29,91,207,496,236,587
510718,202103,2333,5254,1383,3980,342,983,533,1844,875,2827
510719,202103,452,954,267,711,24,68,155,389,179,457
510720,202103,819,1915,553,1515,96,301,265,686,361,987
510724,202103,817,2203,564,1722,71,227,309,914,380,1141
510726,202103,1040,1896,549,1302,64,168,265,638,329,806
510729,202103,593,1366,277,782,30,100,69,216,99,316
510730,202103,2915,6952,1986,5553,240,776,1041,2806,1281,3582
510735,202103,1063,2963,807,2612,72,283,608,1952,680,2235
510740,202103,951,2343,618,1730,106,300,298,813,404,1113
510757,202103,473,1502,373,1349,110,441,150,518,260,959
510760,202103,43385,94309,26300,68612,5321,15954,8339,20030,13660,35984
510770,202103,4210,9459,2878,7776,196,505,2012,5656,2208,6161
510774,202103,336,831,233,673,33,98,124,366,157,464
510775,202103,612,1606,387,1243,84,300,80,236,164,536
510776,202103,496,1237,348,980,74,213,132,373,206,586
510777,202103,1490,3944,1072,3413,136,467,714,2278,850,2745
510779,202103,693,1848,538,1606,55,159,314,1015,369,1174
510780,202103,3666,9342,2723,8009,653,1866,1182,3960,1835,5826
510785,202103,1947,5037,1148,3625,313,1068,187,683,500,1751
510787,202103,2648,7478,1799,5759,511,1714,219,734,730,2448
510788,202103,589,1375,410,1103,62,171,195,602,257,773
510790,202103,17757,44949,11341,33547,2550,8415,1897,5046,4447,13461
510792,202103,8992,24600,5656,18149,1159,4172,940,2745,2099,6917
510794,202103,1148,3076,803,2494,266,902,150,411,416,1313
510795,202103,8317,21451,5535,16533,1214,4000,1511,4409,2725,8409
510800,202103,1626,4124,1067,3209,316,974,137,392,453,1366
510805,202103,1453,4009,1043,3281,216,738,395,1162,611,1900
510810,202103,586,1180,366,889,100,242,140,368,240,610
510820,202103,746,1405,411,992,31,92,208,512,239,604
510830,202103,804,1940,583,1662,38,101,433,1319,471,1420
510835,202103,549,1318,365,1059,45,148,223,630,268,778
510840,202103,56954,119044,38838,97094,7540,17707,18941,52351,26481,70058
510850,202103,1735,4130,1019,3019,316,1090,143,374,459,1464
510860,202103,2261,5885,1408,4462,422,1593,112,355,534,1948
510880,202103,726,2017,546,1680,133,431,195,601,328,1032
510885,202103,647,1526,429,1217,83,241,135,390,218,631
510890,202103,669,1928,499,1634,120,416,216,711,336,1127
510895,202103,1265,3184,826,2467,148,536,370,1035,518,1571
520005,202103,2752,6902,2128,6142,631,1831,842,2864,1473,4695
520010,202103,2337,6547,1700,5326,393,1375,562,1580,955,2955
520013,202103,2923,7281,1925,5501,456,1331,533,1682,989,3013
520015,202103,498,1232,360,1034,82,228,147,447,229,675
520017,202103,1204,2996,899,2536,208,617,432,1199,640,1816
520020,202103,419,928,324,816,25,79,260,636,285,715
520025,202103,32979,91175,28241,84623,2771,8902,20324,60731,23095,69633
520030,202103,5532,13866,4445,12369,299,906,3179,8812,3478,9718
520050,202103,393,921,243,659,17,45,153,428,170,473
520055,202103,1833,4348,1204,3161,144,320,662,1739,806,2059
520060,202103,1443,3817,1074,3170,245,847,300,855,545,1702
520080,202103,1775,4612,1356,4038,242,730,664,2159,906,2889
520082,202103,933,2329,719,1980,76,207,381,1092,457,1299
520085,202103,836,2167,652,1882,114,348,322,927,436,1275
520090,202103,845,1661,588,1383,67,110,435,1088,502,1198
520110,202103,36765,97920,25533,79426,7441,26467,2354,6681,9795,33148
520120,202103,198,476,112,333,11,34,45,138,56,172
520130,202103,3753,9023,2943,7790,600,1621,1265,3423,1865,5044
520140,202103,39353,103649,27282,83364,9528,31736,3455,11025,12983,42761
520145,202103,596,1323,410,1076,63,182,246,601,309,783
520150,202103,625,1437,461,1239,77,218,239,641,316,859
520160,202103,731,1690,525,1371,104,261,217,622,321,883
520170,202103,4751,9586,3155,7772,166,479,2440,5967,2606,6446
520180,202103,2318,6198,1896,5592,324,1037,1026,2991,1350,4028
520215,202103,1706,4064,1220,3328,286,812,419,1106,705,1918
520235,202103,644,1459,393,1081,39,128,180,475,219,603
520250,202103,1495,3763,1068,3064,317,969,269,866,586,1835
520260,202103,797,1834,519,1405,97,265,206,567,303,832
520280,202103,748,1780,594,1551,112,292,287,816,399,1108
520310,202103,1003,2157,658,1651,140,396,255,676,395,1072
520320,202103,1552,4155,1164,3512,151,496,641,1880,792,2376
520330,202103,4145,10860,3052,9103,414,1426,1636,4781,2050,6207
520340,202103,2504,5454,1565,4165,187,470,913,2543,1100,3013
520350,202103,2741,6485,1968,5356,554,1594,794,2198,1348,3792
520355,202103,1867,5043,1334,4013,451,1441,222,571,673,2012
520357,202103,712,1686,511,1397,28,66,377,1075,405,1141
520360,202103,688,1782,531,1526,140,423,162,483,302,906
520380,202103,1399,3463,844,2457,91,278,404,1099,495,1377
520390,202103,1015,2206,597,1685,171,522,201,613,372,1135
520393,202103,476,1131,321,892,40,127,142,371,182,498
520396,202103,861,2168,720,1958,38,117,538,1437,576,1554
520400,202103,1581,3841,1223,3360,142,436,848,2313,990,2749
520410,202103,1898,4243,1193,3169,183,529,520,1295,703,1824
520420,202103,368,844,289,726,21,58,228,546,249,604
520425,202103,1475,3583,813,2333,215,650,151,437,366,1087
520430,202103,2295,5180,1320,3688,235,782,49,135,284,917
520440,202103,2832,6790,1713,4842,404,1259,442,1180,846,2439
520450,202103,11589,27096,7824,21569,2383,7261,1658,4753,4041,12014
520455,202103,685,1871,500,1591,139,456,133,453,272,909
520460,202103,1013,2326,791,2049,79,173,618,1645,697,1818
520465,202103,720,1818,583,1635,72,240,421,1136,493,1376
520470,202103,2055,5201,1566,4552,463,1416,589,1852,1052,3268
520480,202103,874,2374,609,1938,190,632,148,480,338,1112
520485,202103,1512,4304,1261,3967,148,475,903,2838,1051,3313
520490,202103,3929,10710,2965,9175,951,3086,1133,3601,2084,6687
520495,202103,1577,3445,1202,2939,59,149,967,2368,1026,2517
520500,202103,1202,3185,834,2486,188,597,337,1024,525,1621
520505,202103,760,1654,523,1360,58,161,341,878,399,1039
520510,202103,7237,17797,4873,14225,1046,3432,1494,4599,2540,8031
520520,202103,1161,2864,867,2412,200,604,323,897,523,1501
520530,202103,2094,5770,1615,4981,380,1265,743,2337,1123,3602
520540,202103,2878,7433,1882,5536,338,1081,525,1438,863,2519
520545,202103,952,2439,725,2068,154,417,317,930,471,1347
520547,202103,813,2198,664,1955,149,453,333,964,482,1417
520549,202103,13826,36175,11561,33018,1450,4373,7954,22532,9404,26905
520551,202103,4537,12025,3774,10904,387,1286,2698,7645,3085,8931
520552,202103,816,2072,673,1890,145,386,380,1151,525,1537
520570,202103,496,1106,337,879,82,179,125,377,207,556
520580,202103,2166,4891,1642,4286,126,387,1192,3062,1318,3449
520590,202103,1228,3003,851,2400,278,787,222,651,500,1438
520620,202103,7787,20932,6174,18560,1469,4613,2882,8928,4351,13541
520630,202103,719,1852,525,1511,91,284,186,503,277,787
520640,202103,2345,5684,1787,4735,406,1065,771,2122,1177,3187
520650,202103,959,2125,689,1750,109,278,374,1007,483,1285
520660,202103,530,1276,288,854,40,132,86,264,126,396
520670,202103,930,2494,787,2291,62,190,534,1533,596,1723
520680,202103,658,1658,502,1414,72,201,268,770,340,971
520690,202103,298,690,203,549,63,161,60,181,123,342
520710,202103,392,956,286,784,14,33,200,540,214,573
520725,202103,1453,3413,1005,2692,106,331,644,1670,750,2001
520735,202103,753,1843,496,1416,103,274,196,602,299,876
520740,202103,2213,4835,1692,4241,324,737,947,2624,1271,3361
520750,202103,662,1573,460,1254,80,219,212,575,292,794
520753,202103,1203,3252,917,2717,164,521,367,1013,531,1534
520760,202103,1195,2675,1052,2502,30,55,964,2328,994,2383
520780,202103,1447,3374,1053,2825,119,307,549,1468,668,1775
520790,202103,3454,8138,2443,6515,358,980,1277,3547,1635,4527
520800,202103,16161,41452,12677,36346,1782,5322,7631,22421,9413,27743
520810,202103,1267,2660,956,2307,158,389,614,1569,772,1958
520815,202103,528,1623,405,1370,74,271,118,403,192,674
520830,202103,1881,3917,1334,3295,59,116,1096,2702,1155,2818
520840,202103,2615,6952,2127,6310,853,2779,586,1847,1439,4626
520850,202103,624,1556,463,1325,146,487,134,385,280,872
520860,202103,6643,17596,4909,14803,1282,4185,1841,5425,3123,9610
520870,202103,107315,246673,73039,195981,15274,44351,26832,70710,42106,115061
520880,202103,6694,19038,5193,16374,1123,3706,1952,6187,3075,9893
520890,202103,3978,9365,2748,7458,477,1441,1279,3395,1756,4836
520910,202103,4613,11463,2973,8664,685,2163,724,2052,1409,4215
520915,202103,690,1926,402,1276,71,242,134,407,205,649
520920,202103,4415,9798,3128,8213,416,1126,1635,4526,2051,5652
520929,202103,673,1585,512,1354,52,113,294,826,346,939
520940,202103,937,2458,734,2174,51,108,545,1622,596,1730
520945,202103,509,1083,382,915,14,33,274,647,288,680
520960,202103,1073,2507,842,2170,242,561,384,1067,626,1628
520970,202103,2472,6652,1937,5808,439,1502,507,1630,946,3132
520980,202103,759,1838,558,1571,97,283,230,631,327,914
520990,202103,2998,7821,2404,7069,339,943,1604,4808,1943,5751
520993,202103,1140,2648,788,2109,132,391,421,1083,553,1474
520995,202103,2316,5808,1740,5005,253,737,713,2146,966,2883
521000,202103,8590,22245,5661,16948,1065,3295,1656,4889,2721,8184
521010,202103,3531,9109,2656,7608,249,711,1562,4447,1811,5158
521015,202103,773,1902,539,1489,39,125,340,895,379,1020
521020,202103,3228,8139,1915,5631,544,1801,141,451,685,2252
521030,202103,499,1084,336,836,71,154,136,370,207,524
521040,202103,7344,17846,5428,14864,1146,3275,2244,6328,3390,9603
521056,202103,910,2356,708,2062,227,646,197,649,424,1295
521060,202103,956,2558,708,2090,117,364,277,814,394,1178
521080,202103,1086,2322,562,1513,79,231,237,559,316,790
521090,202103,3123,8305,2102,6274,534,1730,260,813,794,2543
521100,202103,1688,3907,1248,3283,200,504,769,2067,969,2571
521120,202103,4492,10648,3325,9207,184,472,1639,5297,1823,5769
521130,202103,977,2152,558,1454,19,52,286,793,305,845
521140,202103,1292,3288,965,2724,98,293,510,1439,608,1732
521150,202103,12193,26465,7653,20041,1293,3869,3604,9698,4897,13567
521160,202103,611,1265,437,1019,63,129,282,646,345,775
521170,202103,1020,2374,752,1982,56,159,491,1254,547,1413
521180,202103,7195,19592,5929,17455,958,3033,3091,8869,4049,11902
521190,202103,10683,26154,6309,18964,1556,5016,1276,4088,2832,9104
521200,202103,695,1657,493,1341,41,121,307,830,348,951
521205,202103,634,1542,485,1305,17,50,377,975,394,1025
521210,202103,649,1653,384,1139,71,224,79,184,150,408
521220,202103,3456,8310,2264,6489,359,1144,910,2623,1269,3767
521225,202103,383,800,277,683,53,122,156,399,209,521
521230,202103,1330,3341,1170,3148,351,937,589,1727,940,2664
521250,202103,30487,79853,23853,70228,8561,26164,7049,22405,15610,48569
521260,202103,527,1224,389,1008,60,158,226,570,286,728
521270,202103,1779,4424,1552,4160,77,178,1209,3265,1286,3443
521280,202103,1750,4645,1307,3905,305,996,556,1673,861,2669
521290,202103,479,1104,337,927,41,132,217,581,258,713
521295,202103,1078,2346,838,2087,64,110,699,1796,763,1906
521300,202103,1899,4600,1495,4030,277,693,917,2582,1194,3275
521305,202103,710,1662,511,1378,78,195,290,798,368,993
521308,202103,4722,12471,3290,9801,292,857,1940,5676,2232,6533
521310,202103,8216,20835,5849,16910,1161,3679,2609,7224,3770,10903
521340,202103,400,926,292,772,23,62,194,510,217,572
521350,202103,1996,5017,1520,4319,125,433,1087,2958,1212,3391
521370,202103,1215,3054,732,2232,209,734,93,321,302,1055
521375,202103,1184,2857,804,2317,181,524,244,789,425,1313
521377,202103,1507,3167,1118,2697,107,175,890,2268,997,2443
521380,202103,6163,16115,4011,12221,448,1485,1038,3394,1486,4879
521385,202103,661,1569,519,1390,50,128,300,868,350,996
521390,202103,695,1685,486,1383,145,464,170,507,315,971
521400,202103,2549,5882,1988,5210,214,535,1371,3708,1585,4243
521405,202103,1307,3317,947,2688,156,464,486,1359,642,1823
521410,202103,776,2072,577,1727,93,268,288,916,381,1184
521440,202103,1099,2716,792,2264,267,847,212,621,479,1468
521450,202103,3904,11427,2861,9429,767,2512,659,2394,1426,4906
521460,202103,5486,14175,3860,11323,1209,3719,984,2959,2193,6678
521470,202103,622,1643,392,1199,61,176,135,413,196,589
521480,202103,358,898,218,636,52,146,69,201,121,347
521483,202103,2342,5509,1637,4463,328,945,700,1900,1028,2845
521486,202103,1771,4215,1342,3615,90,222,944,2563,1034,2785
521487,202103,397,941,279,782,39,102,153,446,192,548
521490,202103,896,2353,673,1988,31,112,468,1342,499,1454
521500,202103,2198,5263,1650,4451,102,327,1202,3160,1304,3487
521520,202103,702,1624,500,1335,73,200,204,558,277,758
521523,202103,11659,34972,9556,31661,2646,9551,2531,8712,5177,18263
521525,202103,1056,2374,808,2040,74,190,583,1466,657,1656
521530,202103,2245,5702,1380,4001,286,827,387,1130,673,1957
521540,202103,815,2032,564,1638,75,242,278,838,353,1080
521550,202103,1599,4032,889,2606,168,554,211,635,379,1189
521560,202103,4351,11254,2969,9399,441,1607,1497,5080,1938,6687
521565,202103,634,1502,484,1295,70,172,295,780,365,952
521570,202103,3207,8799,2209,6879,431,1589,169,563,600,2152
521580,202103,469,1118,270,786,36,111,85,227,121,338
521590,202103,612,1429,451,1209,77,226,265,693,342,919
521600,202103,397,1050,258,780,29,69,121,369,150,438
521630,202103,1664,3587,1035,2698,212,595,347,879,559,1474
521640,202103,1866,4282,1231,3364,255,728,450,1214,705,1942
521645,202103,546,1390,355,1049,80,225,109,319,189,544
521680,202103,1059,3192,812,2717,232,845,134,497,366,1342
521690,202103,539,1278,449,1166,59,167,286,725,345,892
521710,202103,3181,7775,2071,6004,361,1196,573,1525,934,2721
521720,202103,2105,4823,1359,3710,132,407,762,2095,894,2502
521730,202103,3475,9508,2674,8159,702,2548,808,2071,1510,4619
521740,202103,3806,9768,2887,8461,656,2082,1078,3322,1734,5404
521760,202103,14567,39142,11257,34168,2640,8806,4243,13748,6883,22554
521770,202103,3065,7160,2007,5511,572,1706,521,1464,1093,3170
521800,202103,6427,16896,4679,14035,1005,3060,1963,6385,2968,9445
521805,202103,508,1189,387,1026,120,291,154,444,274,735
521810,202103,593,1390,422,1162,54,154,257,711,311,865
521830,202103,5468,14944,4348,13237,268,987,3170,9464,3438,10451
521839,202103,715,1675,509,1349,78,240,282,667,360,907
521850,202103,5464,12533,3488,9669,684,2070,654,1788,1338,3858
521860,202103,1486,3927,1032,3122,183,602,332,967,515,1569
521870,202103,681,1892,495,1534,102,365,125,335,227,700
521878,202103,674,1709,472,1317,55,181,267,678,322,859
521880,202103,18253,44212,12515,35398,3263,9704,4318,12378,7581,22082
521890,202103,3052,7871,2052,6130,564,1838,417,1122,981,2960
521900,202103,1468,3390,821,2396,240,675,75,223,315,898
521910,202103,1256,2665,838,2174,79,200,471,1336,550,1536
521920,202103,477,1283,348,1066,58,204,155,452,213,656
521925,202103,751,1922,547,1617,82,260,307,910,389,1170
521930,202103,5385,12740,3561,10032,928,2469,1322,4195,2250,6664
521935,202103,1059,2489,714,1899,66,191,410,1036,476,1227
521940,202103,1289,2763,824,2149,186,544,340,867,526,1411
521945,202103,642,1668,515,1462,107,307,273,801,380,1108
521950,202103,736,1763,515,1422,124,347,209,562,333,909
521960,202103,719,1848,477,1393,46,150,254,700,300,850
521970,202103,2469,6038,1972,5450,162,435,1491,4178,1653,4613
521971,202103,736,1729,522,1410,150,394,146,402,296,796
521973,202103,1426,3648,1166,3299,44,112,943,2663,987,2775
521975,202103,11860,30964,9751,28059,1656,4844,6017,17451,7673,22295
521980,202103,2519,5850,1943,5092,148,389,1469,3935,1617,4324
521990,202103,1021,2883,818,2517,182,593,295,903,477,1496
522000,202103,2634,6809,2103,6161,361,1062,1229,3795,1590,4857
522005,202103,317,759,235,635,48,135,111,300,159,435
522010,202103,4021,9691,2872,7857,566,1697,1141,3033,1707,4730
522015,202103,1017,2613,746,2197,236,666,275,854,511,1520
522020,202103,5537,12902,3607,9889,748,2185,1376,3945,2124,6130
522026,202103,751,1976,506,1551,87,295,182,516,269,811
522028,202103,405,983,301,819,69,192,128,355,197,547
522040,202103,3124,6955,2243,5784,261,742,1547,3912,1808,4654
522045,202103,17135,46906,12748,39260,2955,9795,3566,10716,6521,20511
522050,202103,1118,2881,775,2294,182,589,283,753,465,1342
522060,202103,2954,7635,2075,6197,195,587,1189,3669,1384,4256
522068,202103,1762,4455,1404,4032,110,281,1117,3258,1227,3539
522070,202103,657,1567,534,1388,17,47,455,1169,472,1216
522100,202103,710,1788,483,1445,65,221,252,720,317,941
522108,202103,1046,2545,817,2222,50,137,662,1768,712,1905
522119,202103,1639,3911,1271,3438,197,536,674,1952,871,2488
522130,202103,419,1055,297,888,23,65,215,662,238,727
522140,202103,19211,49453,13495,39425,3327,10391,3778,10600,7105,20991
522145,202103,759,1868,516,1503,142,404,184,544,326,948
522150,202103,1081,2614,775,2117,199,553,225,653,424,1206
522155,202103,1085,2696,845,2327,161,380,477,1381,638,1761
522157,202103,615,1405,505,1269,23,66,409,1037,432,1103
522160,202103,5783,14795,3768,11141,1013,3227,309,1024,1322,4251
522170,202103,2533,6438,1913,5536,282,824,1091,3224,1373,4048
522180,202103,549,1270,349,909,57,157,85,235,142,392
522185,202103,19984,48528,14219,40635,5407,16991,2968,9170,8375,26161
522190,202103,744,1754,504,1347,96,255,199,526,295,781
522200,202103,1592,4465,1077,3518,215,768,212,650,427,1418
522205,202103,1714,3982,1290,3396,157,438,783,2058,940,2496
522220,202103,1291,3109,953,2611,112,307,574,1602,686,1909
522230,202103,1127,2800,896,2474,194,647,447,1165,641,1812
530010,202103,167682,445386,135666,399147,19706,63505,81654,236393,101360,299898
110001,202102,3961,10939,2673,8557,601,2085,1011,3299,1612,5384
110002,202102,12919,33151,9407,27247,2536,7824,2530,7460,5066,15284
110003,202102,580,1713,431,1403,114,389,120,369,234,758
110004,202102,11650,29865,7858,23273,1601,5166,2278,6841,3879,12007
110005,202102,2483,6368,1726,5151,347,1122,460,1495,807,2617
110006,202102,1729,4805,1077,3427,183,660,219,678,402,1338
110007,202102,1220,3093,783,2370,244,807,186,691,430,1498
110008,202102,3312,8962,2457,7691,275,833,1608,5419,1883,6252
110009,202102,4324,11994,2816,9280,574,2013,1129,3771,1703,5784
110010,202102,7849,24548,5758,20498,1120,4069,2819,10891,3939,14960
110011,202102,7051,18550,4765,14426,1580,5056,621,1990,2201,7046
110012,202102,15549,38653,9310,27781,2010,6629,783,2524,2793,9153
110013,202102,5261,15071,3690,11906,1446,4953,433,1570,1879,6523
110014,202102,3888,10118,2711,7909,565,1749,1156,3277,1721,5026
110015,202102,5679,14481,3421,10150,729,2390,820,2222,1549,4612
110018,202102,3746,9370,2171,6610,397,1402,572,1765,969,3167
110020,202102,73847,175225,53515,147707,11839,33815,21697,66420,33536,100235
110025,202102,5231,12517,3544,9667,674,1972,1601,4354,2275,6326
110026,202102,531,1324,384,1112,88,294,152,466,240,760
110028,202102,6893,17275,4186,12479,1000,3274,607,1830,1607,5104
110029,202102,1520,3692,883,2576,197,593,309,945,506,1538
110030,202102,12538,28601,7743,21535,1582,5119,1331,4138,2913,9257
110032,202102,3194,8908,1929,6229,607,1954,365,1308,972,3262
110033,202102,3493,10741,2646,9221,941,3314,674,2642,1615,5956
110034,202102,3297,7662,2192,6148,668,2118,705,2161,1373,4279
110037,202102,1652,4827,1233,4086,278,904,588,2022,866,2926
110040,202102,2907,8012,2109,6561,579,1950,674,2048,1253,3998
110045,202102,4850,13839,3567,11494,917,3182,1198,3985,2115,7167
110050,202102,1820,4892,1287,3972,490,1689,196,613,686,2302
110060,202102,871,2568,597,1917,195,685,78,246,273,931
110070,202102,1505,4703,1105,3824,339,1252,224,710,563,1962
110080,202102,6298,14603,4741,12757,669,1674,3083,8877,3752,10551
110090,202102,580,1549,398,1226,87,293,174,531,261,824
110092,202102,1185,3399,847,2773,150,502,418,1482,568,1984
110094,202102,2754,8172,2054,6815,836,2977,241,829,1077,3806
110100,202102,1674,4922,1338,4265,359,1214,557,1815,916,3029
110110,202102,1739,4700,1241,3897,419,1361,254,906,673,2267
110120,202102,1306,3738,1000,3141,234,816,343,1041,577,1857
110130,202102,2791,6958,1689,4871,175,526,246,640,421,1166
110140,202102,2046,5978,1402,4668,324,1138,406,1399,730,2537
110143,202102,1330,3633,940,2862,274,838,155,485,429,1323
110145,202102,874,2267,533,1636,113,360,206,650,319,1010
110146,202102,470,1212,333,1001,73,200,156,512,229,712
110147,202102,758,1964,485,1441,60,204,187,484,247,688
110148,202102,733,2009,440,1430,121,460,52,162,173,622
110149,202102,3049,8235,2099,6715,718,2426,441,1518,1159,3944
110150,202102,2791,6786,1811,5377,526,1724,437,1566,963,3290
110155,202102,734,2141,518,1629,116,391,170,499,286,890
110160,202102,1461,4498,1072,3637,307,1067,257,907,564,1974
110170,202102,2117,5395,1327,3925,234,739,691,1968,925,2707
110175,202102,1798,5069,1236,3956,184,616,511,1726,695,2342
110180,202102,1449,3905,1025,3055,138,448,541,1579,679,2027
120001,202102,3302,9636,2702,8751,449,1537,1677,5550,2126,7087
120005,202102,1965,7361,1791,7119,147,643,1442,5821,1589,6464
120010,202102,5372,15860,4551,14652,435,1338,3332,11094,3767,12432
120013,202102,2119,7361,1863,7055,400,1437,1182,4794,1582,6231
120017,202102,2529,8000,2214,7525,370,1267,1370,4958,1740,6225
120020,202102,15234,57691,14048,55434,1027,4514,11245,44696,12272,49210
120025,202102,3163,8802,2538,8058,363,1128,1777,5849,2140,6977
120030,202102,6334,25081,5876,24233,435,2232,4555,18972,4990,21204
120032,202102,1749,7623,1668,7479,98,619,1408,6193,1506,6812
120033,202102,4144,15156,3904,14728,110,652,3439,12800,3549,13452
120034,202102,2725,9746,2340,9084,103,602,1953,7471,2056,8073
120035,202102,3743,14566,3555,14242,283,1355,2937,11741,3220,13096
120038,202102,2678,8505,2272,7841,503,1790,1229,4336,1732,6126
120039,202102,2029,8695,1902,8452,111,698,1546,6822,1657,7520
120040,202102,43699,135837,37215,125458,5052,18026,23344,79894,28396,97920
120042,202102,3404,12378,3170,11957,128,675,2701,10093,2829,10768
120043,202102,1431,5780,1305,5586,35,217,1200,5140,1235,5357
120045,202102,6125,15654,5302,14735,127,512,4816,13231,4943,13743
120050,202102,9332,33543,8561,32381,369,1928,7214,27372,7583,29300
120060,202102,9517,37083,8710,35906,360,2222,7609,31101,7969,33323
120070,202102,3216,10140,2785,9567,260,882,2016,7173,2276,8055
120080,202102,4355,13677,3886,12986,451,1559,2879,9826,3330,11385
130002,202102,3176,12048,2843,11573,192,740,2438,10127,2630,10867
130006,202102,2493,9061,2076,8323,160,635,1597,6453,1757,7088
130008,202102,2710,9417,2412,8983,65,333,2107,7845,2172,8178
130010,202102,4001,11522,3375,10818,78,206,3088,10079,3166,10285
130014,202102,3303,9520,2556,8335,429,1415,1580,5269,2009,6684
130020,202102,2927,11120,2608,10635,117,679,2157,8740,2274,9419
130030,202102,10346,32844,9448,31809,375,1063,8399,28868,8774,29931
130040,202102,4204,12085,3471,11117,219,638,2844,9263,3063,9901
130050,202102,7579,27711,6340,26096,177,847,5730,23876,5907,24723
130060,202102,7704,29940,6610,28538,419,2189,5517,23828,5936,26017
130063,202102,6492,20909,5807,20160,196,833,5296,18488,5492,19321
130068,202102,3946,13379,3354,12557,193,1075,2568,9503,2761,10578
130070,202102,7597,21124,6234,19642,273,799,5165,16845,5438,17644
130080,202102,7398,25949,6505,24927,247,1282,5595,21816,5842,23098
130083,202102,2764,8941,2456,8563,142,560,2095,7364,2237,7924
130090,202102,3574,10963,3178,10479,48,211,2841,9560,2889,9771
130100,202102,8151,24246,6921,22969,76,146,6523,22227,6599,22373
130110,202102,8575,24277,7040,22391,1058,2700,5030,17384,6088,20084
130115,202102,5204,16206,4485,15408,98,337,3986,13899,4084,14236
130120,202102,14102,49631,12408,47396,1061,4442,10085,38964,11146,43406
130130,202102,5597,17194,4325,15537,378,1385,3298,12062,3676,13447
130140,202102,7365,25441,6460,24408,177,1022,5672,21536,5849,22558
130150,202102,3633,13605,3413,13361,67,427,3153,12378,3220,12805
130160,202102,5189,18290,4471,17386,280,1072,3788,15141,4068,16213
130165,202102,3234,12145,3042,11910,124,519,2747,10865,2871,11384
130170,202102,11779,33910,9533,31306,699,2467,7700,25826,8399,28293
130180,202102,4477,14381,4252,14129,44,222,4105,13611,4149,13833
130185,202102,18353,45113,14992,41538,988,1775,12575,37059,13563,38834
130190,202102,18867,61893,15184,56469,1670,6276,10799,41656,12469,47932
130195,202102,2490,8935,2006,8288,75,436,1695,6985,1770,7421
130200,202102,2641,7287,2164,6674,93,361,1825,5597,1918,5958
130210,202102,1364,5097,1236,4947,97,566,1014,3938,1111,4504
130220,202102,2258,7722,1923,7297,44,249,1717,6533,1761,6782
130230,202102,4849,19306,4224,18426,215,1327,3681,15996,3896,17323
130240,202102,12417,36925,10103,33890,166,967,9118,30609,9284,31576
130250,202102,26456,78086,22712,73891,1607,4731,18385,62187,19992,66918
130255,202102,4598,14933,4021,13941,139,601,3300,11456,3439,12057
130260,202102,259962,714530,211676,646460,57357,185121,96378,307229,153735,492350
130270,202102,9911,34403,8232,31804,1383,5227,5274,21415,6657,26642
130280,202102,3594,14290,3310,13977,75,388,3106,13254,3181,13642
130290,202102,13397,43753,11644,41532,649,2363,9847,35937,10496,38300
130300,202102,4829,16438,4395,15851,140,767,3853,13857,3993,14624
130310,202102,6434,21116,5587,20034,272,1194,4796,17205,5068,18399
130320,202102,3391,11033,2818,10278,376,1321,2057,7802,2433,9123
130330,202102,4662,14837,3765,13758,205,915,3220,11779,3425,12694
130340,202102,24253,73249,20907,69473,1470,4025,17577,60494,19047,64519
130350,202102,4016,14377,3619,13881,147,771,3199,12220,3346,12991
130353,202102,7505,20060,6016,18200,765,2194,4315,13610,5080,15804
130356,202102,5297,16628,4395,15251,795,2657,2631,9780,3426,12437
130360,202102,2900,9618,2522,9096,86,381,2221,7961,2307,8342
130370,202102,5706,22613,4983,21584,314,1706,3986,17284,4300,18990
130380,202102,7380,30499,6865,29763,395,2174,5862,25240,6257,27414
130390,202102,5796,24395,5145,23320,557,2778,3910,17890,4467,20668
130395,202102,2357,7410,2039,6908,186,647,1590,5427,1776,6074
130400,202102,2847,8645,2445,8113,104,311,2191,7404,2295,7715
130406,202102,10953,37648,9155,35495,1726,6664,6071,24651,7797,31315
130410,202102,4356,15227,3729,14182,1075,4305,1703,6678,2778,10983
130420,202102,13886,47779,11568,44884,986,4584,8963,35152,9949,39736
130423,202102,4389,13589,3840,12969,191,806,3372,11322,3563,12128
130426,202102,2765,10988,2574,10765,61,339,2385,10047,2446,10386
130430,202102,4325,12003,3734,11226,232,835,3188,9477,3420,10312
130440,202102,4961,15297,4209,14400,76,342,3913,13461,3989,13803
140002,202102,2220,6507,1937,6167,88,339,1642,5307,1730,5646
140005,202102,3269,9082,2844,8591,139,375,2410,7516,2549,7891
140010,202102,55163,145831,44323,129938,10900,33802,18907,56829,29807,90631
140015,202102,3886,11398,3321,10713,231,703,2882,9498,3113,10201
140017,202102,4418,12149,3830,11404,255,670,3155,9707,3410,10377
140020,202102,5325,15291,4603,14358,237,949,3806,11795,4043,12744
140023,202102,2507,7417,2057,6772,203,666,1562,5284,1765,5950
140028,202102,2008,5157,1704,4777,80,254,1380,3873,1460,4127
140030,202102,5390,13564,4788,12874,338,643,4197,11672,4535,12315
140040,202102,2660,10181,2462,9922,85,524,2256,8952,2341,9476
140045,202102,2576,9477,2143,8878,340,1223,1422,6402,1762,7625
140047,202102,6340,17811,5331,16376,558,1751,3877,12089,4435,13840
140050,202102,1458,4235,1238,3925,115,336,940,3100,1055,3436
140060,202102,1715,4420,1491,4106,109,270,1222,3445,1331,3715
140070,202102,1871,9715,1811,9600,112,794,1535,8048,1647,8842
150010,202102,45331,113343,40969,107770,981,2234,36731,96730,37712,98964
150013,202102,1990,5017,1674,4682,148,274,1317,3939,1465,4213
150020,202102,14582,43309,13479,41890,1835,4729,10511,34201,12346,38930
150030,202102,8853,33080,8049,32094,482,1991,6965,28115,7447,30106
150034,202102,4272,10315,3508,9381,239,556,2914,7997,3153,8553
150040,202102,16329,42341,14390,40195,1299,1984,12030,36586,13329,38570
150050,202102,6981,24156,6379,23371,131,561,5869,21728,6000,22289
150060,202102,22111,59401,17796,53018,2767,8400,11407,34781,14174,43181
150070,202102,6914,25387,6072,24372,243,1100,5412,21972,5655,23072
150080,202102,92717,206821,76814,185157,19434,51396,20267,60317,39701,111713
150085,202102,7987,22627,7271,21783,115,363,6821,20604,6936,20967
150090,202102,10017,36234,9458,35154,822,2887,7543,28463,8365,31350
150095,202102,5716,16385,5004,15506,276,587,4276,13814,4552,14401
150100,202102,2839,9857,2505,9309,211,662,1977,7580,2188,8242
150110,202102,4415,17940,4102,17588,178,811,3783,16342,3961,17153
150120,202102,8238,25353,7815,24864,271,674,6970,22829,7241,23503
150125,202102,778,2007,575,1730,99,363,344,1020,443,1383
150130,202102,22401,64135,19371,59571,3594,9902,12116,40035,15710,49937
150140,202102,265410,601454,224114,545237,33795,78881,128701,325776,162496,404657
150145,202102,4270,13268,3607,12219,1015,3217,1733,6659,2748,9876
150150,202102,16299,41193,14201,38566,534,1608,11883,32205,12417,33813
150157,202102,3587,9627,2882,8723,304,882,2029,6444,2333,7326
150160,202102,3016,8769,2807,8470,518,1454,1768,5579,2286,7033
150170,202102,24613,79651,21585,74595,3994,12993,13064,48353,17058,61346
150172,202102,5051,13568,4059,12183,284,739,3055,9531,3339,10270
150175,202102,1669,5170,1402,4674,251,872,808,2733,1059,3605
150178,202102,10360,27781,8647,25804,196,456,7772,23552,7968,24008
150180,202102,22696,79175,20503,76685,1243,3664,17953,69176,19196,72840
150190,202102,6794,22212,6318,21635,212,915,5688,19406,5900,20321
150195,202102,5095,16133,4800,15679,106,490,4369,14133,4475,14623
150200,202102,5891,17147,5385,16590,61,158,5090,15798,5151,15956
150210,202102,26616,90743,24902,88527,1755,5886,20547,75695,22302,81581
150215,202102,7831,21961,6779,20441,1142,3370,4093,12844,5235,16214
150220,202102,12797,35344,11191,33071,1131,3100,7737,23487,8868,26587
150230,202102,12572,35321,11152,33430,1277,3418,7574,23803,8851,27221
150240,202102,32649,89263,27206,80205,6981,21135,9785,29168,16766,50303
150250,202102,4309,16092,4007,15756,586,2228,3136,12653,3722,14881
150260,202102,2787,8862,2517,8460,141,445,2049,6985,2190,7430
150270,202102,9024,25407,6354,20641,1978,6768,1513,5307,3491,12075
150275,202102,7037,21967,6418,21103,240,856,5540,18214,5780,19070
150276,202102,2382,6194,2059,5809,265,671,1367,4337,1632,5008
150277,202102,5202,13484,4165,12272,319,852,3155,9931,3474,10783
150280,202102,7011,27703,6763,27312,468,1840,5812,23734,6280,25574
150285,202102,3271,11412,2876,10798,271,1003,2091,8046,2362,9049
150290,202102,10361,27965,9362,26906,303,599,8469,24981,8772,25580
150293,202102,9191,22573,7107,19862,886,2477,4450,13089,5336,15566
150295,202102,7489,20228,5497,17506,1794,6075,1880,6887,3674,12962
150300,202102,2373,7075,2148,6796,34,120,1978,6291,2012,6411
150304,202102,4149,12122,3432,11029,600,1788,2108,7184,2708,8972
150307,202102,6106,19460,5629,18676,315,1071,4573,15319,4888,16390
150309,202102,6384,18727,5144,16613,874,2790,2927,9904,3801,12694
150310,202102,7473,29324,7149,28944,210,1103,6410,26215,6620,27318
150320,202102,9274,25241,8476,24080,382,1175,6640,18840,7022,20015
150330,202102,13816,43956,12799,42389,1185,3578,9671,33170,10856,36748
150340,202102,2552,7410,2265,6983,340,984,1544,4950,1884,5934
150345,202102,8100,23588,7275,22502,419,1363,6171,19161,6590,20524
150350,202102,8950,22351,8277,21490,669,1253,6843,18313,7512,19566
150360,202102,24211,65686,19401,59644,2076,4885,13719,45371,15795,50256
150370,202102,11001,32808,9077,30227,1056,2907,6561,23679,7617,26586
150375,202102,3664,14621,3318,14136,222,1073,2850,12225,3072,13298
150380,202102,11273,28481,9290,25898,108,423,8247,22973,8355,23396
150390,202102,7825,31114,7029,29903,1066,3927,5045,22831,6111,26758
150400,202102,6681,23615,6412,23118,264,929,5649,20482,5913,21411
150405,202102,9262,24191,8095,22805,506,1083,6561,19146,7067,20229
150410,202102,1941,6037,1653,5549,246,716,1022,3575,1268,4291
150420,202102,39822,108539,30654,95230,8420,27398,10740,38993,19160,66391
150430,202102,8593,24596,7828,23617,944,2032,6042,19275,6986,21307
150440,202102,5775,18047,5233,17308,1035,2989,3298,11801,4333,14790
150442,202102,26549,62059,21909,56351,2326,5794,15198,39994,17524,45788
150445,202102,6302,19289,5543,18147,205,682,4745,15592,4950,16274
150450,202102,5200,21881,4798,21349,384,1876,4050,18094,4434,19970
150460,202102,8428,27439,7707,26523,231,843,6660,23761,6891,24604
150470,202102,21420,55521,19117,52907,335,955,18031,49906,18366,50861
150475,202102,4909,15257,4218,14235,166,589,3539,12101,3705,12690
150480,202102,13815,43743,12407,41686,2321,6780,8184,29647,10505,36427
150490,202102,8465,29082,7765,28221,319,1243,6811,24964,7130,26207
150495,202102,5275,17757,5044,17438,109,530,4600,15811,4709,16341
150497,202102,2795,8837,2247,7902,483,1741,1198,4516,1681,6257
150500,202102,3322,8377,2952,7867,283,690,2229,5980,2512,6670
150503,202102,4693,11973,3232,10084,946,3210,1035,3714,1981,6924
150506,202102,10351,30306,8649,28002,1841,5213,5336,19358,7177,24571
150510,202102,9853,35542,8567,33205,1380,4910,5453,22570,6833,27480
150520,202102,6901,27197,6606,26831,220,1326,5947,24075,6167,25401
150530,202102,12179,41420,10537,39130,1460,4370,7613,30224,9073,34594
150540,202102,4950,13393,4246,12347,253,691,3535,10318,3788,11009
150543,202102,7163,19152,5905,17590,468,1395,4575,14241,5043,15636
150548,202102,10194,31738,9172,30339,237,962,8171,27103,8408,28065
150549,202102,1992,5825,1704,5420,45,155,1435,4603,1480,4758
150550,202102,20781,60254,17273,54549,4414,14128,7170,24272,11584,38400
150553,202102,30932,86788,24414,75458,7018,21945,8873,29201,15891,51146
150555,202102,1982,5165,1544,4472,178,394,1038,3208,1216,3602
150560,202102,1884,5632,1679,5235,295,860,961,3166,1256,4026
150563,202102,2594,7659,2165,6940,421,1397,1216,3965,1637,5362
150565,202102,4431,13946,3946,13200,95,413,3314,11193,3409,11606
150570,202102,6199,19609,5785,19044,267,970,5046,16604,5313,17574
150580,202102,10504,40810,8995,39135,615,3094,7223,32794,7838,35888
150590,202102,8325,28252,7138,26835,156,900,6543,24535,6699,25435
150600,202102,9738,31917,9075,31129,212,813,8434,29101,8646,29914
150610,202102,2924,8423,2618,7951,79,317,2238,6726,2317,7043
150611,202102,3255,8904,2899,8420,86,301,2574,7441,2660,7742
150613,202102,13736,37109,10412,31534,1882,6056,5200,15683,7082,21739
150616,202102,3533,9557,2584,7988,595,1922,1111,3418,1706,5340
150618,202102,6839,19625,5540,17654,483,1508,3576,12058,4059,13566
150619,202102,6675,18233,5536,16665,219,609,4678,14302,4897,14911
150620,202102,6835,22404,5894,20846,682,2295,3960,14474,4642,16769
150630,202102,6309,16726,5766,16070,341,884,4919,13797,5260,14681
150635,202102,4847,13172,4067,11933,560,1499,2624,7984,3184,9483
150640,202102,2282,6671,2087,6428,40,109,1942,6054,1982,6163
150650,202102,11385,31226,9889,28876,2881,7951,4310,13835,7191,21786
150655,202102,5738,16377,5199,15594,195,604,4513,13541,4708,14145
150658,202102,4534,12711,3524,11136,580,1904,1995,6665,2575,8569
150660,202102,5703,16197,5058,15313,476,1374,3536,10984,4012,12358
150670,202102,8432,19210,6654,17224,712,1414,5209,14344,5921,15758
150680,202102,69271,200517,53607,175954,12885,41269,23530,88005,36415,129274
150690,202102,2756,6796,2370,6354,71,162,2124,5807,2195,5969
150700,202102,6113,17907,5458,17068,352,846,4351,14036,4703,14882
150710,202102,3808,12558,3465,12018,295,971,2610,9271,2905,10242
150715,202102,4944,14061,4037,12687,301,881,3168,10171,3469,11052
150720,202102,6944,24197,6474,23508,440,1627,5376,19859,5816,21486
150730,202102,12264,36598,10547,34158,1184,3950,7858,26157,9042,30107
150740,202102,4052,11062,3557,10285,329,781,2665,7937,2994,8718
150745,202102,5022,14118,4042,12694,790,2586,2566,8223,3356,10809
150746,202102,1710,5048,1555,4834,68,186,1312,4113,1380,4299
150747,202102,4975,15427,4406,14529,710,1993,2987,10432,3697,12425
150750,202102,3687,11406,3089,10496,226,820,2343,8252,2569,9072
150760,202102,11767,34602,10685,33114,1474,4134,7538,24208,9012,28342
150770,202102,6583,23037,6203,22615,188,521,5655,21281,5843,21802
150775,202102,967,2625,758,2353,132,440,420,1323,552,1763
150780,202102,4484,13518,3977,12920,158,430,3561,11900,3719,12330
150790,202102,5849,16190,5040,15317,269,672,3809,13180,4078,13852
150795,202102,14208,43082,12370,40302,3021,9262,6938,24257,9959,33519
150796,202102,3916,9348,3423,8788,225,484,2875,7557,3100,8041
150797,202102,4095,12331,3555,11601,140,342,3050,10178,3190,10520
150800,202102,13322,41401,12005,39668,1477,4549,8972,30754,10449,35303
150803,202102,7180,22499,6717,21782,410,1128,5676,18712,6086,19840
150805,202102,3546,10701,3017,9943,250,782,2300,7790,2550,8572
150808,202102,5951,16794,4388,14253,1707,6118,607,2295,2314,8413
150810,202102,20836,54071,15885,48138,3375,10417,7907,26814,11282,37231
150812,202102,5526,15149,4875,14098,427,1298,3631,10319,4058,11617
150815,202102,9765,28070,8149,26182,642,1993,6742,22074,7384,24067
150820,202102,11712,32084,9901,29844,1067,2750,7517,23788,8584,26538
150830,202102,12063,43044,11153,41942,464,1775,9582,37370,10046,39145
150835,202102,2319,7567,1974,7000,327,1139,1146,4133,1473,5272
150840,202102,7614,21090,6141,18782,973,3231,3506,10634,4479,13865
160005,202102,1231,3333,1090,3158,67,222,917,2677,984,2899
160010,202102,2432,6372,2263,6188,18,102,2198,5934,2216,6036
160015,202102,2842,8126,2521,7738,70,233,2324,7163,2394,7396
160020,202102,2098,6591,1831,6261,156,491,1425,5091,1581,5582
160021,202102,1210,4418,1120,4303,53,282,902,3500,955,3782
160023,202102,1304,4492,1154,4240,133,434,785,3095,918,3529
160025,202102,1847,5561,1748,5449,12,38,1698,5309,1710,5347
160027,202102,8922,24809,7963,23582,654,1838,6389,19336,7043,21174
160030,202102,75996,211916,61613,192492,12984,38113,32548,112595,45532,150708
160040,202102,5892,19511,5374,18861,68,303,5058,17856,5126,18159
160050,202102,4727,14097,3705,12725,1392,4583,1274,5560,2666,10143
160053,202102,3859,11710,3482,11241,287,778,2801,9454,3088,10232
160055,202102,936,2680,902,2642,30,96,827,2437,857,2533
160060,202102,25034,65199,20306,59880,936,2842,16073,49915,17009,52757
160070,202102,2635,10007,2359,9582,188,749,1866,7846,2054,8595
160080,202102,3368,10553,2989,10128,26,132,2810,9588,2836,9720
170025,202102,627,1609,465,1366,72,208,250,771,322,979
170030,202102,1238,3712,956,3227,150,503,459,1604,609,2107
170035,202102,1456,3759,1081,3170,85,270,684,2001,769,2271
170040,202102,1913,5288,1523,4736,108,373,960,3067,1068,3440
170070,202102,1885,4370,1346,3685,84,259,795,2277,879,2536
170100,202102,2441,6932,2037,6269,225,612,1271,4063,1496,4675
170105,202102,735,2116,513,1646,137,394,165,556,302,950
170110,202102,968,2889,746,2479,114,390,372,1211,486,1601
170130,202102,1284,3783,924,3100,180,645,444,1522,624,2167
170190,202102,1403,3900,1024,3294,346,1195,189,744,535,1939
170200,202102,2052,4831,1342,3674,197,559,569,1569,766,2128
170210,202102,24667,66395,18856,56799,6174,20389,2683,8911,8857,29300
170215,202102,1319,3505,1054,3136,39,161,831,2460,870,2621
170220,202102,5878,18001,4916,16263,1357,4312,1849,6870,3206,11182
170230,202102,1210,3582,901,2983,260,876,145,536,405,1412
170240,202102,2529,7070,1996,6209,127,466,1440,4389,1567,4855
170255,202102,3947,11303,2847,9341,509,1698,1290,4360,1799,6058
170270,202102,941,2289,637,1856,38,102,382,1107,420,1209
170290,202102,2819,8323,2444,7826,121,391,1911,6295,2032,6686
170300,202102,1993,5312,1621,4761,193,545,1081,3251,1274,3796
170305,202102,633,1721,531,1555,75,234,264,781,339,1015
170307,202102,959,3205,784,2870,107,414,436,1606,543,2020
170310,202102,1569,3892,1111,3176,164,520,524,1508,688,2028
170320,202102,1027,2652,772,2249,72,219,487,1457,559,1676
170330,202102,919,2803,836,2681,43,192,694,2169,737,2361
170360,202102,523,1403,364,1150,20,68,238,717,258,785
170370,202102,1247,3343,904,2763,280,807,229,830,509,1637
170380,202102,1790,5112,1351,4440,94,365,791,2663,885,3028
170382,202102,543,1579,454,1433,29,125,341,1030,370,1155
170384,202102,1574,5510,1299,4991,266,1052,660,2603,926,3655
170386,202102,988,2645,619,1946,80,282,221,668,301,950
170388,202102,613,1748,433,1431,58,211,203,673,261,884
170389,202102,1034,3167,852,2873,47,188,622,2147,669,2335
170390,202102,1755,3973,1327,3460,35,85,1104,2952,1139,3037
170410,202102,569,1637,416,1358,30,117,247,776,277,893
170460,202102,352,941,293,849,34,95,203,598,237,693
170510,202102,912,2562,683,2148,44,176,442,1315,486,1491
170550,202102,6420,17015,4732,14307,1216,3951,1072,3534,2288,7485
170555,202102,1416,3768,1116,3304,77,230,547,1708,624,1938
170560,202102,1038,2860,791,2520,65,193,506,1729,571,1922
170600,202102,1232,3335,998,3006,222,538,541,1794,763,2332
170610,202102,1598,4188,1157,3534,83,275,720,2181,803,2456
170625,202102,413,1124,263,827,43,131,84,256,127,387
170650,202102,1226,3603,972,3186,125,431,576,1940,701,2371
170700,202102,3322,9795,2528,8255,505,1651,1124,3761,1629,5412
170710,202102,1450,3799,1133,3307,159,492,688,2036,847,2528
170720,202102,1710,4313,1293,3635,332,995,528,1510,860,2505
170730,202102,1086,2895,816,2455,137,351,422,1362,559,1713
170740,202102,2098,6808,1810,6286,174,663,1281,4440,1455,5103
170755,202102,889,2421,629,1990,67,212,301,962,368,1174
170765,202102,1147,2968,816,2436,148,439,349,1099,497,1538
170770,202102,1835,5271,1491,4734,169,521,978,3204,1147,3725
170820,202102,3271,9806,2571,8532,539,1831,1153,3971,1692,5802
170825,202102,1010,2306,822,2055,95,214,594,1503,689,1717
170830,202102,1403,3698,1152,3313,163,433,761,2268,924,2701
170900,202102,2770,8522,2329,7892,216,655,1816,6305,2032,6960
170930,202102,3660,10066,2803,8466,652,2087,892,2713,1544,4800
170950,202102,11115,30535,7762,24500,2110,7646,861,2982,2971,10628
170980,202102,462,1206,369,1061,27,89,244,679,271,768
171050,202102,1636,5066,1433,4727,51,221,1192,3908,1243,4129
171070,202102,1344,3798,1152,3516,306,902,498,1803,804,2705
171090,202102,1059,2611,838,2303,82,233,547,1475,629,1708
171110,202102,560,1498,389,1184,66,192,178,506,244,698
171150,202102,1068,2637,672,1973,61,204,415,1210,476,1414
171180,202102,773,2095,521,1631,95,270,217,686,312,956
171190,202102,1808,5933,1574,5537,245,911,959,3503,1204,4414
171195,202102,777,2463,629,2188,80,321,381,1312,461,1633
171200,202102,603,1654,453,1402,96,314,164,502,260,816
171215,202102,376,1035,312,927,31,101,213,618,244,719
171240,202102,773,2509,619,2216,30,177,419,1463,449,1640
171245,202102,692,2018,538,1709,46,153,340,1043,386,1196
171250,202102,1006,2658,739,2265,127,404,348,1093,475,1497
171270,202102,473,1651,373,1440,78,311,162,684,240,995
171280,202102,873,2600,696,2281,62,226,419,1423,481,1649
171320,202102,3999,11084,3100,9518,639,1893,1132,3722,1771,5615
171330,202102,2777,7581,2154,6481,483,1445,920,2891,1403,4336
171360,202102,1423,4055,1140,3640,86,273,832,2733,918,3006
171370,202102,694,1743,529,1515,45,121,360,1044,405,1165
171380,202102,1450,3888,1222,3573,147,414,839,2559,986,2973
171395,202102,970,2636,680,2103,60,216,424,1275,484,1491
171420,202102,1983,5731,1438,4659,251,856,633,2061,884,2917
171430,202102,1030,3006,868,2704,54,170,606,1835,660,2005
171488,202102,2319,6818,1839,6025,271,874,947,3248,1218,4122
171500,202102,982,2414,749,2063,50,129,550,1528,600,1657
171510,202102,829,2664,722,2462,42,172,521,1761,563,1933
171515,202102,469,1177,354,1011,34,99,218,591,252,690
171525,202102,730,2012,555,1735,30,111,331,991,361,1102
171550,202102,345,987,266,859,40,150,140,435,180,585
171570,202102,1115,3352,941,3046,123,401,554,1852,677,2253
171575,202102,1779,4772,1160,3661,133,436,510,1627,643,2063
171610,202102,5627,15582,4221,13192,871,3065,1126,3828,1997,6893
171620,202102,2565,7289,2183,6737,107,431,1782,5477,1889,5908
171630,202102,1009,2581,794,2290,94,271,553,1642,647,1913
171650,202102,2016,5682,1553,4910,379,1309,462,1613,841,2922
171660,202102,2330,5841,1616,4661,224,575,842,2479,1066,3054
171665,202102,1243,3472,978,3038,171,603,459,1431,630,2034
171670,202102,1915,5062,1478,4342,216,675,776,2321,992,2996
171700,202102,1210,3388,887,2797,112,347,474,1520,586,1867
171720,202102,798,2033,635,1782,56,168,463,1282,519,1450
171750,202102,1320,3662,914,2908,227,749,119,474,346,1223
171780,202102,1186,3039,874,2584,90,289,584,1702,674,1991
171790,202102,1408,4502,1164,4007,187,660,572,1989,759,2649
171800,202102,716,1949,545,1700,68,254,311,950,379,1204
171820,202102,11333,31491,8477,26614,2047,6706,2395,8210,4442,14916
171830,202102,1559,4914,1336,4528,127,512,866,2924,993,3436
171840,202102,757,2020,584,1750,21,63,385,1157,406,1220
171845,202102,653,1567,501,1350,46,162,330,849,376,1011
171850,202102,898,2946,769,2656,69,304,542,1827,611,2131
171855,202102,1039,3143,889,2870,69,225,565,1807,634,2032
171865,202102,373,1155,314,1057,54,193,157,514,211,707
171870,202102,828,2257,586,1821,71,220,298,942,369,1162
171875,202102,1295,3678,1039,3271,41,177,789,2472,830,2649
171880,202102,1192,3524,1049,3339,42,126,828,2703,870,2829
171884,202102,853,2442,641,2079,130,474,229,769,359,1243
171886,202102,1346,3643,971,3057,276,1003,202,647,478,1650
171888,202102,723,2004,503,1602,28,101,309,970,337,1071
171889,202102,374,1151,299,1003,60,222,123,410,183,632
171890,202102,1182,3276,854,2748,169,499,472,1583,641,2082
171900,202102,533,1839,397,1504,80,298,162,642,242,940
172000,202102,575,1697,484,1536,55,169,274,852,329,1021
172010,202102,957,3302,820,3032,67,280,505,1864,572,2144
172015,202102,371,1275,282,1098,70,271,102,430,172,701
172020,202102,2724,7612,2402,7193,166,506,1775,5554,1941,6060
172025,202102,697,1912,518,1622,38,142,377,1175,415,1317
172030,202102,1236,3603,1057,3323,62,217,813,2557,875,2774
172049,202102,1308,3102,882,2522,193,507,426,1355,619,1862
172065,202102,1435,3613,1133,3235,100,214,898,2763,998,2977
172080,202102,2372,6940,1929,6172,115,391,1289,4115,1404,4506
172085,202102,470,1272,309,932,57,170,103,294,160,464
172090,202102,4013,9944,3132,8781,132,377,2381,6766,2513,7143
172093,202102,461,1366,333,1137,17,88,200,644,217,732
172097,202102,674,1749,474,1409,62,192,209,622,271,814
172100,202102,48785,119467,35141,98353,5919,18199,12983,37230,18902,55429
172110,202102,1580,5729,1363,5393,127,536,1012,4158,1139,4694
172120,202102,4994,14569,3913,12813,497,1684,2186,7405,2683,9089
172125,202102,386,1036,295,885,21,72,182,522,203,594
172130,202102,620,1505,490,1299,25,89,343,830,368,919
172208,202102,2609,6250,2101,5596,222,446,1501,4165,1723,4611
172210,202102,2663,6682,2041,5893,306,964,1184,3586,1490,4550
210005,202102,18771,53188,14172,45620,4102,13769,5308,17928,9410,31697
210010,202102,1928,5908,1745,5688,69,292,1528,4992,1597,5284
210015,202102,3292,9802,2922,9316,155,481,2418,7750,2573,8231
210020,202102,7319,17236,6245,15990,90,285,5738,14729,5828,15014
210030,202102,4612,15246,4254,14707,257,1031,3583,12443,3840,13474
210040,202102,1803,4291,1594,4038,32,86,1364,3379,1396,3465
210043,202102,5965,17258,5129,16088,409,1235,3989,12733,4398,13968
210047,202102,6449,20033,5278,18483,131,682,4568,15992,4699,16674
210050,202102,2179,7320,1736,6506,159,666,1204,4517,1363,5183
210055,202102,1874,6010,1703,5746,64,237,1450,4920,1514,5157
210060,202102,7237,26339,6450,24970,652,2601,4479,17817,5131,20418
210070,202102,7003,19948,6564,19377,45,207,6198,18236,6243,18443
210080,202102,4333,14317,4117,14086,44,256,3801,13083,3845,13339
210083,202102,5505,15725,4583,14744,37,164,4359,14083,4396,14247
210087,202102,2966,8084,2542,7520,84,247,2158,6444,2242,6691
210090,202102,9104,28413,8512,27387,488,1259,7241,23580,7729,24839
210095,202102,6458,20589,5900,19886,259,1028,4936,17023,5195,18051
210100,202102,6714,20392,5990,19230,409,1419,4617,14905,5026,16324
210110,202102,2883,9275,2662,9015,54,318,2397,8071,2451,8389
210120,202102,22907,61852,18968,56753,1927,4586,12800,41076,14727,45662
210125,202102,4396,11764,3819,11088,760,1756,2635,8233,3395,9989
210130,202102,4302,11145,3567,10231,162,338,3007,8763,3169,9101
210135,202102,1445,4272,1254,3968,58,150,1024,3334,1082,3484
210140,202102,19274,49881,14844,44188,2956,8249,8094,25828,11050,34077
210150,202102,4308,10427,3856,9807,142,392,3271,8188,3413,8580
210160,202102,16397,47350,14121,44517,1214,4019,9984,32793,11198,36812
210170,202102,15242,46669,14175,45315,795,2098,12400,40227,13195,42325
210173,202102,2260,8646,2119,8400,101,572,1808,7130,1909,7702
210177,202102,3472,9507,3019,8952,175,396,2573,7935,2748,8331
210180,202102,1438,3815,1257,3600,26,70,1145,3293,1171,3363
210190,202102,5364,14261,4554,13191,78,323,3923,11251,4001,11574
210193,202102,1328,3843,1170,3593,33,129,873,2735,906,2864
210197,202102,2101,6433,1941,6217,156,467,1576,5160,1732,5627
210200,202102,7652,24408,6791,22982,402,1514,5373,18162,5775,19676
210203,202102,6985,20581,5954,19196,380,1288,4744,15604,5124,16892
210207,202102,3971,9551,3036,8556,166,344,2526,7338,2692,7682
210210,202102,7957,25717,7267,24741,163,930,6230,21006,6393,21936
210215,202102,2493,7801,2136,7271,121,607,1593,5348,1714,5955
210220,202102,6106,21038,5803,20598,170,1123,5111,17779,5281,18902
210230,202102,5077,15327,4628,14657,472,1182,3772,12367,4244,13549
210232,202102,10944,34334,9005,31373,1615,5511,5499,20546,7114,26057
210235,202102,3314,10013,2939,9494,164,653,2467,7968,2631,8621
210237,202102,2781,8981,2396,8534,31,183,2215,7893,2246,8076
210240,202102,2597,8076,2393,7722,71,247,1987,6305,2058,6552
210250,202102,5653,17085,5145,16445,75,429,4680,14894,4755,15323
210255,202102,2486,7579,2114,6936,283,935,1355,4450,1638,5385
210260,202102,5450,16163,4820,15257,253,934,4050,12748,4303,13682
210270,202102,4947,13501,4418,12839,95,422,3957,11399,4052,11821
210275,202102,3432,8721,3006,8194,76,210,2498,6802,2574,7012
210280,202102,5589,15753,4500,14097,243,933,3356,10363,3599,11296
210290,202102,7261,19226,6503,18281,100,325,6083,17079,6183,17404
210300,202102,32351,88077,26449,79610,2047,6442,18449,57742,20496,64184
210310,202102,3076,7802,2728,7299,132,289,2369,6403,2501,6692
210312,202102,2689,6779,2386,6455,26,113,2251,6032,2277,6145
210315,202102,2979,8228,2572,7775,78,224,2274,7022,2352,7246
210317,202102,4078,12776,3691,12320,135,671,3277,10849,3412,11520
210320,202102,19037,56820,17413,54692,380,1690,15470,48439,15850,50129
210325,202102,3672,10275,3157,9607,111,322,2731,8531,2842,8853
210330,202102,23902,67191,19130,61124,5736,16470,9087,33801,14823,50271
210340,202102,10074,29317,8964,27840,782,2311,6762,21739,7544,24050
210350,202102,8997,25958,7942,24686,140,490,7117,22234,7257,22724
210355,202102,4273,14009,3786,13248,97,471,3227,11347,3324,11818
210360,202102,13727,42514,12251,40374,597,2716,9279,30037,9876,32753
210370,202102,10877,24363,8442,21803,244,403,7726,20439,7970,20842
210375,202102,3184,8463,2445,7449,666,2105,996,3373,1662,5478
210380,202102,5377,13739,4657,12904,195,476,4000,11186,4195,11662
210390,202102,2563,8923,2373,8598,123,564,2013,7260,2136,7824
210400,202102,4492,13552,3994,12964,123,372,3581,11824,3704,12196
210405,202102,6764,18173,5486,16376,1053,2920,3060,9814,4113,12734
210407,202102,1952,6411,1666,5907,78,338,1341,4707,1419,5045
210408,202102,2580,9443,2417,9204,148,687,1927,7374,2075,8061
210409,202102,3765,12921,3447,12487,108,577,2866,10466,2974,11043
210410,202102,3368,10167,2871,9348,150,574,2208,7129,2358,7703
210420,202102,3762,11971,3414,11362,193,594,2876,9687,3069,10281
210430,202102,2244,6516,1988,6184,91,258,1693,5350,1784,5608
210440,202102,4321,11600,3759,10897,75,263,3413,9821,3488,10084
210450,202102,2357,7009,2031,6541,82,292,1683,5394,1765,5686
210455,202102,4388,11410,3341,10093,953,2927,1496,4820,2449,7747
210460,202102,3695,10489,3137,9770,57,236,2751,8530,2808,8766
210462,202102,1650,4965,1415,4586,37,147,1155,3779,1192,3926
210465,202102,2726,7852,2377,7370,79,348,1898,5753,1977,6101
210467,202102,5825,18461,5096,17509,294,1115,4203,14672,4497,15787
210470,202102,1974,5260,1468,4538,106,238,1114,3612,1220,3850
210480,202102,16116,47268,13369,43892,1143,3397,9779,34745,10922,38142
210490,202102,3628,9146,2945,8211,91,260,2487,6923,2578,7183
210500,202102,6390,24070,5875,23198,394,1853,4792,18838,5186,20691
210510,202102,5879,19415,5150,18636,118,521,4641,17054,4759,17575
210515,202102,3720,10922,3241,10378,204,729,2635,8607,2839,9336
210520,202102,2521,7251,2261,6908,69,247,1927,5835,1996,6082
210530,202102,50619,124647,39121,107729,6867,22570,11178,37995,18045,60565
210535,202102,3139,10399,2914,10064,161,577,2414,8413,2575,8990
210540,202102,14588,41770,12109,38304,1506,4346,8348,27821,9854,32167
210542,202102,6596,15109,5276,13674,396,688,4230,11782,4626,12470
210545,202102,2205,6804,2082,6605,40,166,1853,5816,1893,5982
210547,202102,3549,12592,3159,11856,293,1058,2409,9245,2702,10303
210550,202102,6063,18161,4792,16162,337,1297,3400,11788,3737,13085
210560,202102,3574,10747,3195,10148,117,347,2704,8550,2821,8897
210565,202102,1480,4759,1236,4412,69,352,932,3340,1001,3692
210570,202102,10366,28054,9237,26679,337,914,7953,23495,8290,24409
210580,202102,2968,7893,2388,7124,126,282,1664,5172,1790,5454
210590,202102,4217,12542,3662,11842,67,368,3264,10480,3331,10848
210592,202102,2628,7690,2410,7337,22,106,2057,6182,2079,6288
210594,202102,2470,6647,1897,5764,91,272,1394,4406,1485,4678
210596,202102,2527,8859,2291,8401,103,420,1893,6960,1996,7380
210598,202102,1797,5229,1662,5025,57,228,1454,4334,1511,4562
210600,202102,2990,7939,2461,7196,112,283,1891,5589,2003,5872
210610,202102,2706,7475,2330,7028,61,264,1995,6017,2056,6281
210620,202102,2803,7362,2332,6797,52,151,2103,6164,2155,6315
210630,202102,2990,9976,2735,9551,123,574,2248,7762,2371,8336
210632,202102,4368,13928,3892,13241,223,934,3076,10406,3299,11340
210635,202102,1719,6114,1628,5958,98,351,1344,5015,1442,5366
210637,202102,2433,7996,2119,7554,151,645,1561,5654,1712,6299
210640,202102,4481,16012,4209,15694,68,338,3826,14313,3894,14651
210650,202102,7417,21064,6747,20212,112,385,6066,18191,6178,18576
210660,202102,7983,23732,7159,22406,273,1114,6059,18646,6332,19760
210663,202102,2577,7430,2369,7189,156,358,1995,6270,2151,6628
210667,202102,1963,6323,1762,6026,58,236,1569,5424,1627,5660
210670,202102,4498,14975,4107,14360,106,507,3615,12561,3721,13068
210675,202102,5041,13558,4309,12623,286,703,3473,10547,3759,11250
210680,202102,4595,11037,3887,10205,106,182,3499,9314,3605,9496
210690,202102,7566,23058,6310,21671,232,991,5589,19369,5821,20360
210700,202102,2761,7706,2190,6878,152,453,1580,5181,1732,5634
210710,202102,4751,14930,4188,14140,97,553,3702,12330,3799,12883
210720,202102,2973,9666,2640,9252,60,353,2321,8073,2381,8426
210725,202102,1278,4293,1123,4064,50,188,787,2976,837,3164
210730,202102,1160,3050,975,2789,47,127,836,2387,883,2514
210735,202102,4694,13510,4016,12626,196,529,3436,11124,3632,11653
210740,202102,5234,13758,4562,13003,80,245,3939,11247,4019,11492
210745,202102,4385,11878,4077,11493,104,311,3709,10424,3813,10735
210750,202102,23183,59205,20114,55337,2071,5055,13725,40177,15796,45232
210760,202102,5867,15440,4978,14507,36,76,4719,13908,4755,13984
210770,202102,6032,15518,5225,14587,57,253,4914,13625,4971,13878
210780,202102,7388,22946,6466,21418,625,1785,4931,16741,5556,18526
210790,202102,4235,13316,3839,12807,187,446,3169,11091,3356,11537
210800,202102,4844,12900,4171,12014,103,397,3686,10510,3789,10907
210805,202102,3971,14246,3787,13982,113,585,3352,12323,3465,12908
210810,202102,4766,13841,4359,13318,318,724,3570,11276,3888,12000
210820,202102,6761,19250,5651,17476,686,2167,3260,10454,3946,12621
210825,202102,6658,20598,6014,19747,272,868,5134,17163,5406,18031
210830,202102,7691,21404,7006,20599,313,726,6150,18474,6463,19200
210840,202102,3118,8331,2825,7958,57,193,2501,6981,2558,7174
210845,202102,6476,17315,5799,16581,36,114,5527,15950,5563,16064
210850,202102,5765,19459,4825,18057,205,1054,3832,14354,4037,15408
210860,202102,21311,53577,17764,49189,1063,2476,13938,40913,15001,43389
210870,202102,7279,18820,5777,17127,253,636,5012,15055,5265,15691
210880,202102,4217,12878,3784,12355,186,732,3028,9870,3214,10602
210890,202102,3762,11045,3388,10588,257,664,2678,8688,2935,9352
210900,202102,4384,12711,3395,10865,1323,4566,484,1792,1807,6358
210905,202102,1992,5441,1668,5027,46,82,1521,4697,1567,4779
210910,202102,7042,21291,5852,19359,758,2530,3805,12746,4563,15276
210920,202102,3161,10387,2738,9834,73,415,2449,8701,2522,9116
210923,202102,1563,4608,1324,4228,84,299,939,3017,1023,3316
210927,202102,5123,16269,4512,15539,386,1280,3479,12398,3865,13678
210930,202102,2410,8349,2123,7796,152,627,1600,5871,1752,6498
210940,202102,4065,11361,3781,11033,107,446,3464,9971,3571,10417
210945,202102,6579,18684,5895,17875,244,683,4944,15419,5188,16102
210950,202102,5141,14255,3965,12625,613,1491,2590,9071,3203,10562
210955,202102,1493,4750,1288,4407,148,503,865,3072,1013,3575
210960,202102,8820,26172,7658,24424,1315,3876,4932,16514,6247,20390
210970,202102,1321,4043,1057,3589,92,291,754,2550,846,2841
210975,202102,1720,5345,1548,5074,72,265,1242,4086,1314,4351
210980,202102,9954,23191,8719,21918,96,230,8230,20803,8326,21033
210990,202102,16282,45197,12790,40606,678,2281,9445,31092,10123,33373
211000,202102,14478,41947,12109,39011,846,2722,9210,31077,10056,33799
211003,202102,5597,16542,4714,15473,137,529,4082,13678,4219,14207
211010,202102,6363,22450,5710,21657,150,681,5069,19562,5219,20243
211020,202102,8054,23216,6980,21996,261,950,5886,19139,6147,20089
211023,202102,1922,6251,1795,6089,91,319,1522,5171,1613,5490
211027,202102,3042,9686,2896,9465,199,510,2476,8235,2675,8745
211030,202102,3770,10380,3375,9894,244,592,2724,8221,2968,8813
211040,202102,4627,16502,4288,15924,116,675,3837,14131,3953,14806
211050,202102,8891,23144,8093,22078,77,278,7409,20183,7486,20461
211060,202102,6877,20725,6272,19913,163,663,5536,17572,5699,18235
211065,202102,2209,6110,1849,5657,95,273,1478,4660,1573,4933
211070,202102,7745,24260,6593,22536,560,1817,5065,17595,5625,19412
211080,202102,1294,3549,1041,3152,33,181,815,2331,848,2512
211085,202102,2045,5703,1757,5330,108,245,1495,4743,1603,4988
211090,202102,3153,8671,2853,8328,31,153,2656,7712,2687,7865
211100,202102,6762,16935,6246,16321,41,131,5799,15230,5840,15361
211102,202102,3091,10406,2832,10027,149,675,2434,8512,2583,9187
211105,202102,2344,7311,1957,6622,174,602,1393,4691,1567,5293
211107,202102,4747,14683,4078,13723,153,624,3200,11232,3353,11856
211110,202102,5919,15926,4622,13968,371,1038,3400,10504,3771,11542
211120,202102,44348,107678,36308,98305,5374,13158,23072,67005,28446,80163
211125,202102,2084,6169,1765,5683,48,173,1495,4837,1543,5010
211130,202102,181600,428499,156080,395788,23917,56886,75695,218155,99612,275041
211140,202102,4936,14475,4336,13729,226,610,3622,11633,3848,12243
211150,202102,9201,25017,7788,23188,344,924,6539,19674,6883,20598
211153,202102,2399,7012,1914,6408,253,877,1261,4401,1514,5278
211157,202102,1128,3553,942,3213,30,140,682,2328,712,2468
211160,202102,4005,11251,3148,10019,143,496,2382,7514,2525,8010
211163,202102,1596,5141,1459,4948,54,231,1280,4365,1334,4596
211167,202102,1537,4802,1445,4661,30,122,1304,4180,1334,4302
211170,202102,6371,15677,5924,15174,68,154,5608,14354,5676,14508
211172,202102,2509,6726,2176,6247,109,343,1676,4689,1785,5032
211174,202102,2841,8179,2569,7875,34,178,2410,7348,2444,7526
211176,202102,4195,11879,3264,10507,149,629,2620,8406,2769,9035
211178,202102,4630,10706,4067,10101,28,120,3885,9571,3913,9691
211180,202102,4030,13200,3750,12797,215,782,3102,10643,3317,11425
211190,202102,3047,8894,2587,8219,31,176,2310,7278,2341,7454
211195,202102,1389,3892,1191,3589,83,157,988,3091,1071,3248
211200,202102,2138,6071,1719,5477,205,607,1192,3882,1397,4489
211210,202102,6240,18942,5681,18214,291,1100,4759,15177,5050,16277
211220,202102,36900,92302,30394,84370,3055,7768,22413,63967,25468,71735
211223,202102,5271,13707,4337,12480,394,1118,3138,9096,3532,10214
211227,202102,1744,5669,1567,5416,66,302,1205,4203,1271,4505
211230,202102,7607,21682,6667,20267,416,1046,5373,16773,5789,17819
211240,202102,7961,25068,7577,24580,134,704,7046,22634,7180,23338
211245,202102,6974,17308,6193,16499,76,191,5983,15943,6059,16134
211250,202102,13008,40909,11786,39198,753,2767,9493,31545,10246,34312
211260,202102,8046,25866,7172,24716,245,1012,6363,22121,6608,23133
211270,202102,10361,32771,8863,30759,368,1680,7186,25154,7554,26834
211280,202102,12363,33951,11120,32392,827,1922,9152,27714,9979,29636
211285,202102,1782,5757,1583,5479,138,527,1177,4167,1315,4694
211290,202102,7358,22017,6657,21112,174,701,5754,18225,5928,18926
211300,202102,7619,21951,6733,20561,226,762,5597,16895,5823,17657
211400,202102,11476,32171,9409,29366,1063,3315,6249,20558,7312,23873
220005,202102,1821,4663,1662,4453,34,112,1414,3736,1448,3848
220010,202102,1482,4200,1219,3736,23,96,954,2890,977,2986
220020,202102,3711,10060,3213,9368,132,446,2657,7703,2789,8149
220025,202102,2208,5028,1897,4573,26,72,1587,3712,1613,3784
220027,202102,1295,3203,1110,2961,20,67,954,2500,974,2567
220030,202102,3338,8415,3131,8146,83,224,2759,7124,2842,7348
220040,202102,7090,21252,6242,19654,1512,4286,3161,10609,4673,14895
220045,202102,1445,4411,1193,4000,27,147,979,3231,1006,3378
220050,202102,4745,12735,4048,11842,57,269,3724,10767,3781,11036
220060,202102,2349,4923,2007,4532,25,60,1894,4266,1919,4326
220070,202102,2408,6045,2066,5541,71,137,1721,4646,1792,4783
220080,202102,739,2067,639,1924,21,68,548,1644,569,1712
220090,202102,1740,4162,1461,3766,16,46,1219,3268,1235,3314
220095,202102,643,1593,604,1554,26,42,540,1418,566,1460
220100,202102,1376,3746,1110,3329,49,158,887,2599,936,2757
220105,202102,2022,6221,1775,5746,111,414,1350,4359,1461,4773
220110,202102,3346,9214,3085,8759,34,167,2774,7777,2808,7944
220115,202102,2704,7755,2509,7500,68,202,2281,6799,2349,7001
220117,202102,1416,3331,1129,2939,4,18,962,2457,966,2475
220120,202102,12883,34150,11826,32867,82,285,11092,30806,11174,31091
220130,202102,1111,2962,953,2746,13,74,870,2469,883,2543
220140,202102,2140,4372,1811,3988,103,252,1577,3431,1680,3683
220150,202102,6334,18582,5797,17665,103,486,4944,14821,5047,15307
220155,202102,1192,3363,961,2954,38,116,696,2110,734,2226
220157,202102,1063,2569,898,2319,23,80,712,1780,735,1860
220160,202102,2888,7895,2498,7193,32,135,2050,5794,2082,5929
220170,202102,1619,4156,1391,3816,15,68,1241,3360,1256,3428
220173,202102,2186,5975,1790,5288,43,182,1414,4082,1457,4264
220177,202102,1999,5627,1897,5514,9,33,1876,5444,1885,5477
220180,202102,1109,2660,915,2358,4,21,719,1748,723,1769
220190,202102,7002,17258,5973,15859,368,1003,4511,12237,4879,13240
220191,202102,1595,4701,1452,4468,86,283,1032,3130,1118,3413
220192,202102,2083,5409,1536,4447,28,88,1238,3534,1266,3622
220194,202102,1717,4848,1533,4555,54,190,1265,3729,1319,3919
220196,202102,2045,5218,1861,4946,29,109,1610,4211,1639,4320
220198,202102,1283,3483,1091,3235,5,21,1011,3025,1016,3046
220200,202102,5097,14585,4454,13757,73,326,3858,11902,3931,12228
220202,202102,2179,6077,1884,5598,26,133,1615,4717,1641,4850
220205,202102,2462,7045,2213,6596,51,194,1879,5514,1930,5708
220207,202102,774,2318,643,2095,60,198,420,1393,480,1591
220208,202102,1666,5055,1392,4534,176,615,806,2600,982,3215
220209,202102,1577,4458,1382,4113,22,94,1151,3378,1173,3472
220210,202102,1761,4199,1529,3844,10,42,1327,3251,1337,3293
220211,202102,1641,4078,1513,3905,15,60,1326,3430,1341,3490
220213,202102,1797,4690,1559,4295,22,74,1265,3390,1287,3464
220217,202102,2241,6482,2103,6321,40,84,1954,5980,1994,6064
220220,202102,10561,27174,8822,24554,611,1472,5953,17498,6564,18970
220225,202102,1000,2622,820,2388,5,33,773,2227,778,2260
220230,202102,5629,14021,4852,12948,159,372,4180,11236,4339,11608
220240,202102,3025,8652,2761,8221,112,359,2260,6725,2372,7084
220245,202102,1806,4083,1391,3577,12,47,1270,3296,1282,3343
220250,202102,2976,8227,2635,7801,14,80,2480,7308,2494,7388
220253,202102,1596,4296,1435,4033,58,188,1213,3331,1271,3519
220255,202102,1923,4454,1656,4087,29,128,1440,3436,1469,3564
220260,202102,4361,13213,3834,12257,167,594,3019,9638,3186,10232
220265,202102,1290,4098,1158,3929,31,167,962,3212,993,3379
220270,202102,6019,19237,5705,18669,203,978,4778,15154,4981,16132
220271,202102,1481,3762,1295,3504,26,88,1136,3057,1162,3145
220272,202102,1742,5012,1550,4667,48,146,1173,3448,1221,3594
220273,202102,1245,3505,1044,3137,38,148,803,2369,841,2517
220275,202102,2303,5359,1854,4753,40,88,1627,4203,1667,4291
220277,202102,2126,5312,1828,4890,27,70,1534,4047,1561,4117
220280,202102,1670,3842,1394,3492,22,68,1186,2961,1208,3029
220285,202102,1432,3577,1243,3361,10,38,1151,3087,1161,3125
220290,202102,6653,18237,5307,16354,367,1150,3869,12272,4236,13422
220300,202102,1957,5592,1609,5140,33,170,1356,4306,1389,4476
220310,202102,3019,7997,2380,7260,43,209,1996,6052,2039,6261
220320,202102,3078,8853,2386,7569,68,319,1877,5792,1945,6111
220323,202102,1622,4690,1284,4143,49,187,1065,3377,1114,3564
220325,202102,1250,3681,1079,3399,22,108,899,2776,921,2884
220327,202102,1567,4308,1374,4003,34,132,1144,3247,1178,3379
220330,202102,4498,10593,3821,9782,58,191,3444,8770,3502,8961
220335,202102,1662,4975,1506,4774,30,94,1341,4278,1371,4372
220340,202102,1881,4888,1457,4193,59,183,997,2780,1056,2963
220342,202102,1168,3350,1042,3159,52,176,824,2498,876,2674
220345,202102,3115,6955,2408,5956,17,49,2181,5376,2198,5425
220350,202102,3330,8388,2676,7433,131,371,1904,5338,2035,5709
220360,202102,1232,3125,982,2714,16,43,785,2161,801,2204
220370,202102,8600,24772,7871,23612,151,602,6840,20295,6991,20897
220375,202102,1589,4486,1411,4270,3,14,1341,4084,1344,4098
220380,202102,1459,3446,1197,3086,13,36,1045,2677,1058,2713
220385,202102,831,1966,682,1701,6,15,596,1471,602,1486
220390,202102,10404,26630,8021,22986,2063,5810,2772,8939,4835,14749
220400,202102,1491,3509,1156,2995,30,89,883,2210,913,2299
220410,202102,1145,3148,945,2805,49,143,760,2228,809,2371
220415,202102,815,2052,688,1856,22,53,558,1493,580,1546
220420,202102,2020,5569,1633,4839,59,176,1250,3663,1309,3839
220430,202102,2469,6580,2313,6351,67,222,1993,5405,2060,5627
220435,202102,1750,4473,1517,4132,51,171,1258,3348,1309,3519
220440,202102,2379,7326,2037,6798,80,356,1738,5696,1818,6052
220450,202102,2497,6444,2034,5868,58,192,1738,5031,1796,5223
220455,202102,1253,3875,1196,3797,9,52,1067,3386,1076,3438
220460,202102,990,2410,924,2330,37,86,790,1981,827,2067
220465,202102,2312,7113,2052,6699,185,591,1499,5028,1684,5619
220470,202102,3533,9650,3201,9129,96,239,2611,7368,2707,7607
220480,202102,2830,7188,2284,6324,226,511,1458,4114,1684,4625
220490,202102,2484,6117,2149,5701,23,112,1872,4886,1895,4998
220500,202102,2943,7294,2590,6752,82,207,2046,5249,2128,5456
220510,202102,2540,7106,2031,6198,75,204,1586,4896,1661,5100
220515,202102,1656,3965,1533,3793,44,61,1330,3306,1374,3367
220520,202102,4928,12708,4476,12076,101,274,3879,10427,3980,10701
220525,202102,1353,3356,1172,3128,7,37,1081,2846,1088,2883
220527,202102,1310,3591,1131,3332,14,57,968,2899,982,2956
220530,202102,1417,3503,1233,3265,29,89,1130,2970,1159,3059
220535,202102,807,2176,757,2109,28,73,613,1709,641,1782
220540,202102,3218,10181,3019,9793,128,425,2556,8276,2684,8701
220545,202102,1442,4257,1341,4099,63,231,1125,3411,1188,3642
220550,202102,8507,26007,7605,24449,479,1634,5792,18508,6271,20142
220551,202102,1415,3940,1266,3704,26,109,1038,2984,1064,3093
220552,202102,1607,4598,1317,4086,25,120,1064,3199,1089,3319
220553,202102,1765,4484,1466,4091,56,101,1182,3430,1238,3531
220554,202102,914,2351,668,1955,54,130,427,1243,481,1373
220555,202102,2378,6855,2121,6518,41,166,1772,5563,1813,5729
220556,202102,1201,3437,1048,3146,47,187,768,2219,815,2406
220557,202102,1645,4980,1390,4440,65,242,1029,3184,1094,3426
220558,202102,1399,3611,1102,3203,17,72,950,2736,967,2808
220559,202102,1807,4398,1540,3992,14,31,1260,3301,1274,3332
220560,202102,1746,3913,1440,3527,42,77,1302,3228,1344,3305
220570,202102,7163,21166,6543,20294,489,1470,5173,16239,5662,17709
220580,202102,6942,18653,6347,17701,96,290,5733,15927,5829,16217
220585,202102,2066,6422,1704,5758,47,143,1394,4770,1441,4913
220590,202102,1364,3625,1126,3274,79,215,806,2389,885,2604
220595,202102,2567,6930,2347,6633,21,103,2091,5850,2112,5953
220600,202102,1381,3070,1170,2817,86,105,973,2436,1059,2541
220605,202102,1579,4627,1359,4232,17,103,1111,3355,1128,3458
220610,202102,2793,8040,2623,7782,27,114,2458,7277,2485,7391
220620,202102,7765,23854,7168,23056,166,845,6540,20807,6706,21652
220630,202102,372,1083,288,928,24,81,193,619,217,700
220635,202102,1674,5157,1495,4772,49,242,1148,3547,1197,3789
220640,202102,2446,6771,2086,6257,72,290,1698,5050,1770,5340
220650,202102,2045,5618,1790,5240,37,136,1439,4213,1476,4349
220660,202102,2556,7947,2182,7314,73,356,1829,6010,1902,6366
220665,202102,1219,3661,1029,3343,31,172,862,2720,893,2892
220667,202102,1630,4991,1468,4695,59,215,1190,3791,1249,4006
220669,202102,1621,4860,1556,4760,45,201,1394,4167,1439,4368
220670,202102,2208,5640,1778,5035,17,75,1552,4388,1569,4463
220672,202102,3227,7844,2618,7106,91,306,2329,6236,2420,6542
220675,202102,1281,3481,1145,3230,30,93,946,2650,976,2743
220680,202102,2729,7276,2606,7108,107,210,2376,6578,2483,6788
220690,202102,1567,4114,1390,3848,56,166,1106,3055,1162,3221
220695,202102,907,2481,842,2366,22,67,737,2064,759,2131
220700,202102,10136,24418,8226,21834,333,890,6348,16776,6681,17666
220710,202102,915,2460,679,2023,34,94,508,1486,542,1580
220720,202102,2128,4996,1916,4715,18,73,1682,4089,1700,4162
220730,202102,1309,3623,1120,3311,12,65,945,2733,957,2798
220735,202102,989,2241,785,1935,21,62,653,1560,674,1622
220740,202102,1354,3476,1097,3145,29,73,922,2688,951,2761
220750,202102,3794,9572,3339,8928,212,491,2881,7780,3093,8271
220755,202102,1354,3246,1129,2912,19,69,933,2347,952,2416
220760,202102,3083,8374,2719,7882,61,177,2467,7209,2528,7386
220770,202102,23512,68592,19925,62540,5953,19728,6871,22629,12824,42357
220775,202102,1153,2895,1026,2735,12,40,984,2611,996,2651
220777,202102,1583,3979,1205,3402,31,79,927,2636,958,2715
220779,202102,1265,3245,1096,3001,18,63,970,2630,988,2693
220780,202102,5684,14013,4945,12908,225,657,4016,10279,4241,10936
220785,202102,1485,3267,1307,3041,10,30,1250,2888,1260,2918
220790,202102,10193,28680,9202,27248,193,849,7752,22759,7945,23608
220793,202102,934,2436,751,2116,8,17,632,1801,640,1818
220795,202102,1380,3526,1233,3329,22,73,1086,2930,1108,3003
220800,202102,18161,39750,15508,36314,614,1369,12114,28358,12728,29727
220810,202102,3044,8335,2587,7539,52,153,2135,6168,2187,6321
220820,202102,4819,12622,4216,11736,261,641,3186,8867,3447,9508
220830,202102,7201,18927,6474,17930,252,786,5364,14649,5616,15435
220840,202102,12010,36635,10065,32682,2230,6906,4679,15860,6909,22766
220850,202102,3130,9533,2828,9155,53,273,2523,8171,2576,8444
220855,202102,705,1758,616,1639,17,53,559,1477,576,1530
220860,202102,1063,2618,930,2414,16,66,842,2152,858,2218
220865,202102,2448,6405,1905,5439,79,293,1387,3837,1466,4130
220870,202102,3069,8299,2572,7646,26,128,2376,7047,2402,7175
220880,202102,5298,12385,4566,11479,79,287,4175,10388,4254,10675
220885,202102,1411,4160,1176,3768,58,185,926,3026,984,3211
220887,202102,1584,3351,1335,3036,15,32,1232,2790,1247,2822
220890,202102,1403,4224,1235,3984,44,153,1030,3369,1074,3522
220900,202102,2016,4739,1690,4324,32,71,1485,3797,1517,3868
220910,202102,1523,4121,1288,3775,60,168,1055,3134,1115,3302
220915,202102,965,2569,799,2272,8,29,609,1683,617,1712
220920,202102,1432,4387,1243,4142,53,221,1026,3443,1079,3664
220930,202102,1752,4653,1472,4251,17,52,1373,3957,1390,4009
220935,202102,1090,3114,887,2685,24,98,582,1672,606,1770
220937,202102,1498,3885,1293,3569,25,91,1036,2811,1061,2902
220940,202102,1562,4277,1254,3732,31,97,979,2883,1010,2980
220945,202102,439,1513,382,1392,19,112,285,1002,304,1114
220950,202102,1421,3260,947,2532,20,62,753,1942,773,2004
220955,202102,1617,4053,1344,3586,23,64,1152,3034,1175,3098
220960,202102,790,1991,598,1669,18,53,421,1122,439,1175
220965,202102,1797,4846,1569,4513,21,130,1361,3831,1382,3961
220970,202102,2002,4671,1478,3905,29,72,1234,3225,1263,3297
220975,202102,692,1931,599,1817,13,73,532,1564,545,1637
220980,202102,1131,3186,1003,3013,38,140,831,2475,869,2615
220985,202102,1261,3238,1099,2998,42,117,902,2388,944,2505
220987,202102,1414,4201,1242,3899,55,202,999,3127,1054,3329
220990,202102,1723,4680,1521,4382,15,84,1301,3696,1316,3780
220995,202102,1102,3266,917,2926,39,125,671,2156,710,2281
220997,202102,2341,7072,2166,6792,45,199,1932,6001,1977,6200
221000,202102,4474,12104,3961,11345,83,368,3391,9598,3474,9966
221005,202102,1479,3816,1358,3622,17,82,1179,3057,1196,3139
221010,202102,1255,2782,1004,2477,19,53,876,2122,895,2175
221020,202102,1528,4650,1423,4458,19,70,1089,3379,1108,3449
221030,202102,1660,4002,1429,3724,22,57,1240,3276,1262,3333
221035,202102,1493,3844,1317,3611,19,25,1167,3287,1186,3312
221037,202102,687,1862,574,1673,8,25,412,1149,420,1174
221038,202102,522,1459,411,1266,13,52,284,865,297,917
221039,202102,864,2349,750,2158,24,106,614,1699,638,1805
221040,202102,3993,11754,3497,10879,148,500,2774,8656,2922,9156
221050,202102,3890,10147,3448,9588,65,221,3107,8631,3172,8852
221060,202102,8644,23869,7189,21488,313,788,5771,17445,6084,18233
221062,202102,1133,3636,984,3393,39,175,795,2712,834,2887
221063,202102,1067,2890,924,2683,55,171,727,2073,782,2244
221065,202102,2645,6705,2338,6163,18,61,2055,5338,2073,5399
221070,202102,3413,10454,2775,9129,298,931,1680,5673,1978,6604
221080,202102,3501,8539,2882,7627,59,204,2372,6169,2431,6373
221090,202102,1404,3559,1167,3178,8,28,998,2665,1006,2693
221093,202102,1355,3798,1236,3563,141,387,820,2339,961,2726
221095,202102,867,2247,740,2053,11,35,625,1707,636,1742
221097,202102,857,2173,660,1823,21,52,493,1297,514,1349
221100,202102,117255,309613,97849,276745,10048,30450,63217,173949,73265,204399
221110,202102,9854,29202,9060,28176,138,699,8134,25063,8272,25762
221120,202102,4793,13078,4276,12256,154,449,3724,10700,3878,11149
221130,202102,5366,13791,4042,11246,836,2172,1874,5325,2710,7497
221135,202102,1643,4266,1481,4053,48,141,1308,3589,1356,3730
221140,202102,1312,3063,1110,2811,11,37,1000,2486,1011,2523
221150,202102,1096,2711,862,2312,21,96,665,1671,686,1767
221160,202102,721,1778,638,1673,16,20,523,1381,539,1401
221170,202102,995,2830,914,2679,11,42,802,2318,813,2360
230010,202102,2986,7748,2469,6883,31,112,2053,5601,2084,5713
230015,202102,3058,9705,2709,9003,162,587,1907,6342,2069,6929
230020,202102,12832,40068,12022,38839,341,1349,10276,33075,10617,34424
230030,202102,13071,32059,10987,29363,207,562,9641,25785,9848,26347
230040,202102,4507,11461,3737,10210,44,197,3136,8440,3180,8637
230050,202102,2742,8409,2101,6935,333,1047,932,3014,1265,4061
230060,202102,2351,6410,1897,5600,34,145,1503,4355,1537,4500
230070,202102,4001,10372,3223,8904,176,514,2287,6238,2463,6752
230075,202102,8766,28500,8055,27262,481,1976,6395,21382,6876,23358
230080,202102,3023,6347,2305,5477,6,18,2108,5026,2114,5044
230090,202102,4334,10535,3681,9522,182,437,2944,7584,3126,8021
230100,202102,18291,46596,16070,43625,1314,3420,11493,31562,12807,34982
230110,202102,12678,37181,10658,33274,1741,5364,5557,17562,7298,22926
230120,202102,7699,20207,6798,18768,569,1343,4964,13942,5533,15285
230125,202102,3174,8306,2580,7363,85,281,1994,5605,2079,5886
230130,202102,5634,17231,4584,14945,401,1374,2946,9503,3347,10877
230140,202102,3394,10084,2911,9103,90,375,2233,6810,2323,7185
230150,202102,1602,4770,1318,4149,205,569,758,2464,963,3033
230160,202102,6468,16586,5598,15255,162,542,4631,12416,4793,12958
230170,202102,6334,17773,5220,15527,308,871,3722,10958,4030,11829
230180,202102,1647,4510,1401,4042,19,82,1149,3212,1168,3294
230185,202102,4465,12436,3790,11316,281,887,2809,8390,3090,9277
230190,202102,13490,38776,11342,34807,1436,4492,6586,20085,8022,24577
230195,202102,5313,15450,4865,14603,416,1199,3582,10781,3998,11980
230200,202102,4975,13631,4183,12156,151,478,3213,9171,3364,9649
230205,202102,4157,12098,3656,11348,210,656,2763,8571,2973,9227
230210,202102,10094,24193,8532,22117,330,1064,6731,17130,7061,18194
230220,202102,13719,34341,12055,31969,583,1535,9943,26166,10526,27701
230230,202102,6818,20177,6095,18712,416,1237,4491,13805,4907,15042
230240,202102,12891,34316,11161,31351,260,1115,9249,25381,9509,26496
230250,202102,8989,24814,8347,23816,239,805,6778,18817,7017,19622
230260,202102,14861,43319,12874,39847,2092,6105,7003,22365,9095,28470
230270,202102,7700,20472,5900,17110,532,1473,3816,11158,4348,12631
230280,202102,20378,53946,16737,47852,448,1816,13165,36271,13613,38087
230290,202102,5005,13562,4140,11953,239,613,3162,9105,3401,9718
230300,202102,4870,12744,4410,12124,94,258,3878,10639,3972,10897
230310,202102,4632,13070,3929,11819,129,522,2851,8393,2980,8915
230320,202102,7859,22404,6626,20162,215,892,5117,15220,5332,16112
230330,202102,4665,12594,3712,10789,131,411,2804,7957,2935,8368
230340,202102,3686,11265,3156,10180,261,886,2155,6869,2416,7755
230350,202102,18168,49006,15893,45674,798,2608,10860,31371,11658,33979
230360,202102,2957,7692,2337,6612,126,351,1624,4538,1750,4889
230365,202102,3067,7503,2529,6710,54,237,2159,5636,2213,5873
230370,202102,59083,161238,50409,148586,7146,21192,30586,91197,37732,112389
230380,202102,6231,17155,4944,14818,118,471,3689,10798,3807,11269
230390,202102,3384,9861,2935,9143,88,352,2301,7072,2389,7424
230393,202102,3355,9686,2687,8308,79,398,2089,6206,2168,6604
230395,202102,5722,15540,4989,14322,340,931,3516,10124,3856,11055
230400,202102,5351,14668,4787,13745,91,463,3858,10767,3949,11230
230410,202102,13764,40435,11444,36183,879,2998,7871,24894,8750,27892
230420,202102,29330,79171,23970,70073,2895,8723,13531,39274,16426,47997
230423,202102,4794,13961,4201,12790,88,381,3459,10355,3547,10736
230425,202102,5669,17143,5180,16155,428,1379,3689,11442,4117,12821
230426,202102,2824,7290,2063,5806,29,112,1562,4287,1591,4399
230427,202102,1839,5116,1358,4118,64,193,889,2615,953,2808
230428,202102,9618,25358,8237,23321,1186,3264,4742,13449,5928,16713
230430,202102,5036,13888,3979,12064,162,529,2944,8806,3106,9335
230435,202102,6089,15626,5082,13863,701,1740,2988,8301,3689,10041
230440,202102,420977,1025740,351283,924884,32913,91558,231350,600562,264263,692120
230445,202102,4257,11216,3469,9863,186,510,2353,6539,2539,7049
230450,202102,3588,10162,3136,9514,250,915,2279,6715,2529,7630
230460,202102,2143,5871,1869,5442,50,205,1579,4562,1629,4767
230465,202102,4056,11241,3454,10091,94,363,2631,7408,2725,7771
230470,202102,11277,36852,10114,34729,896,3406,7084,24027,7980,27433
230480,202102,1463,4210,1233,3800,63,258,921,2724,984,2982
230490,202102,2580,7119,2188,6385,168,573,1388,3810,1556,4383
230495,202102,5695,16730,5039,15578,413,1459,3331,10201,3744,11660
230500,202102,9422,29751,8413,27916,239,974,6901,22907,7140,23881
230510,202102,1614,4758,1273,4026,170,572,662,2059,832,2631
230520,202102,4606,12743,3987,11663,343,916,2756,8129,3099,9045
230523,202102,15439,44883,12373,38451,2716,8420,3151,10457,5867,18877
230526,202102,3691,10418,3169,9547,190,531,2290,6989,2480,7520
230530,202102,5393,16693,4546,15035,276,1034,3313,10778,3589,11812
230533,202102,4611,10706,3801,9434,104,271,3172,7742,3276,8013
230535,202102,5254,14516,4458,13181,307,911,2985,8921,3292,9832
230540,202102,16027,43259,13785,39978,273,1026,11412,32864,11685,33890
230550,202102,21242,55213,17135,48323,1517,4377,11042,30969,12559,35346
230560,202102,8075,19558,6585,17216,58,231,5667,14685,5725,14916
230565,202102,3058,8393,2581,7524,103,408,1978,5644,2081,6052
230570,202102,3364,8597,2888,7938,84,225,2374,6522,2458,6747
230580,202102,11125,28284,9556,26063,377,1007,7878,21427,8255,22434
230590,202102,8942,24967,7460,22284,422,1433,5537,16004,5959,17437
230600,202102,3724,9452,2959,8125,92,235,2033,5625,2125,5860
230610,202102,6747,18333,5999,17088,444,1207,4747,13444,5191,14651
230620,202102,2094,5586,1628,4703,113,345,1005,2811,1118,3156
230625,202102,8073,22408,6800,20144,2012,6177,1853,5928,3865,12105
230630,202102,10737,31625,9343,28902,1399,4104,5476,17319,6875,21423
230640,202102,27438,82095,24876,78070,1156,4467,20000,61900,21156,66367
230650,202102,5289,13943,4478,12547,130,474,3644,9958,3774,10432
230655,202102,9361,31072,8816,30149,696,2313,6992,24271,7688,26584
230660,202102,6052,17772,4962,15875,142,753,4035,12642,4177,13395
230670,202102,6214,14576,4573,11981,130,422,3674,9393,3804,9815
230680,202102,2705,7282,2291,6552,124,332,1646,4725,1770,5057
230690,202102,7191,20932,6193,18993,393,1374,3953,11910,4346,13284
230700,202102,10304,26012,8388,22529,365,873,6165,16336,6530,17209
230710,202102,6859,21435,6028,19671,645,1992,3992,13012,4637,15004
230720,202102,1830,5374,1502,4725,113,323,1030,3186,1143,3509
230725,202102,4068,11783,3650,11068,366,1244,2180,6498,2546,7742
230730,202102,56655,150889,44635,132870,9768,31256,14992,47289,24760,78545
230740,202102,6103,16727,5181,15243,132,436,4144,12184,4276,12620
230750,202102,8429,22130,7049,19879,163,525,5635,15527,5798,16052
230760,202102,11036,28688,9619,26592,481,1558,7325,19795,7806,21353
230763,202102,5020,13284,4212,11852,113,514,3425,9317,3538,9831
230765,202102,41139,109903,34184,98777,5130,15341,17648,50452,22778,65793
230770,202102,25119,61516,21002,56119,2121,5667,14014,37570,16135,43237
230780,202102,6455,22331,5884,20977,868,3003,3407,12540,4275,15543
230790,202102,3056,8604,2756,8130,105,425,2117,6047,2222,6472
230800,202102,8156,25634,7165,23627,923,3204,4138,13493,5061,16697
230810,202102,11078,33096,9954,31305,368,1357,7769,24052,8137,25409
230820,202102,3394,10984,2786,9638,268,1052,1639,5425,1907,6477
230830,202102,7508,20252,6444,18487,123,509,5338,14945,5461,15454
230835,202102,4245,10042,3293,8562,91,272,2604,6664,2695,6936
230837,202102,3074,9287,2752,8744,109,450,2201,6878,2310,7328
230840,202102,9260,26642,7991,24504,924,2596,5560,17330,6484,19926
230850,202102,9677,27646,8120,24604,348,1191,5890,17589,6238,18780
230860,202102,5396,13322,4489,12038,59,192,3971,10591,4030,10783
230870,202102,16492,39614,14219,35867,394,1083,11681,28924,12075,30007
230880,202102,2121,6307,1947,6033,48,245,1547,4663,1595,4908
230890,202102,4503,14243,4114,13479,330,1153,2999,9708,3329,10861
230900,202102,2935,8373,2535,7626,183,625,1709,5028,1892,5653
230910,202102,3154,8360,2562,7452,62,282,2066,5991,2128,6273
230920,202102,4674,12990,3953,11848,117,478,3159,9269,3276,9747
230930,202102,6522,17983,5478,16142,296,824,3816,11287,4112,12111
230940,202102,8265,20489,7179,18855,214,509,5993,15656,6207,16165
230945,202102,6588,18566,5649,16804,281,973,4044,11769,4325,12742
230950,202102,6205,15477,5501,14519,103,243,4745,12569,4848,12812
230960,202102,13434,38286,11793,35211,2013,5844,5734,17386,7747,23230
230970,202102,13600,35573,11369,32157,1665,4550,6612,18968,8277,23518
230980,202102,2661,7644,2360,7126,341,965,1479,4628,1820,5593
230990,202102,1676,4629,1384,4058,66,261,990,2763,1056,3024
231000,202102,2519,6680,2058,5780,80,198,1523,4179,1603,4377
231010,202102,3658,8436,2874,7107,34,129,2502,6007,2536,6136
231020,202102,7917,24373,7084,22792,1272,3702,4069,13651,5341,17353
231025,202102,7561,20399,6580,18805,721,2003,4624,13338,5345,15341
231030,202102,7361,21580,5816,18353,995,2975,2910,9305,3905,12280
231040,202102,2939,8290,2554,7584,121,366,2001,5847,2122,6213
231050,202102,11645,29532,9558,25894,626,1622,7120,18946,7746,20568
231060,202102,2909,8061,2566,7521,57,172,2151,6304,2208,6476
231070,202102,7819,22430,6732,20539,672,2114,4480,13567,5152,15681
231080,202102,3970,11082,3378,10118,135,517,2576,7569,2711,8086
231085,202102,6889,16326,5473,14678,225,533,4276,11525,4501,12058
231090,202102,4571,11745,3381,9484,100,378,2285,6168,2385,6546
231095,202102,2257,6634,1791,5649,145,448,1198,3778,1343,4226
231100,202102,3209,9113,2642,8042,114,410,1981,5963,2095,6373
231110,202102,3702,10601,3374,9995,140,483,2553,7457,2693,7940
231120,202102,2302,6563,1903,5875,81,287,1374,4205,1455,4492
231123,202102,1915,4880,1622,4381,81,167,1188,3241,1269,3408
231126,202102,5459,14840,4504,13040,305,833,3199,9203,3504,10036
231130,202102,21718,54254,18053,49695,1064,3470,13422,36359,14486,39829
231135,202102,4153,11586,3461,10242,176,560,2454,7181,2630,7741
231140,202102,16469,45766,13275,40271,677,2480,9343,27729,10020,30209
231150,202102,5881,15738,4495,13147,646,1882,1964,5925,2610,7807
231160,202102,6235,18836,5572,17643,775,2354,3157,10332,3932,12686
231170,202102,4157,12073,3490,10847,164,588,2477,7456,2641,8044
231180,202102,14234,39762,11654,34444,3049,8760,4086,12554,7135,21314
231190,202102,3863,10793,3179,9552,68,278,2434,7168,2502,7446
231195,202102,4985,14745,4175,13101,271,933,3011,9414,3282,10347
231200,202102,7798,23902,6854,22012,180,890,5430,16906,5610,17796
231210,202102,4839,14001,4146,12867,151,548,3202,9770,3353,10318
231220,202102,12193,31161,9609,26368,433,1236,6976,18600,7409,19836
231230,202102,9190,29068,8121,27094,542,2032,5932,19879,6474,21911
231240,202102,11537,33165,10175,30625,1584,4588,6119,18712,7703,23300
231250,202102,2161,5479,1432,3895,114,320,847,2242,961,2562
231260,202102,3274,9078,2845,8403,267,736,1937,5858,2204,6594
231270,202102,6313,16375,5105,14404,153,562,3863,10643,4016,11205
231280,202102,1702,5260,1561,5004,85,271,1190,3792,1275,4063
231290,202102,38068,111935,31721,99304,5312,16385,14708,45837,20020,62222
231300,202102,4112,11189,3254,9489,175,563,2219,6315,2394,6878
231310,202102,7479,18944,5982,16217,522,1432,4057,10768,4579,12200
231320,202102,7783,21101,6109,18154,86,383,4790,14034,4876,14417
231325,202102,2450,6254,2019,5619,159,333,1418,4065,1577,4398
231330,202102,9532,27937,7936,24788,1468,4318,4192,13781,5660,18099
231335,202102,5628,14725,4815,13446,71,316,4250,11731,4321,12047
231340,202102,17972,53926,16228,50852,1277,3962,12044,38117,13321,42079
231350,202102,15758,42839,14433,40936,245,870,12987,36496,13232,37366
231355,202102,4392,12882,3973,12093,225,726,3109,9355,3334,10081
231360,202102,7438,22168,6440,20443,271,943,5125,16220,5396,17163
231370,202102,2163,5924,1739,5164,34,99,1327,3938,1361,4037
231375,202102,4270,13244,3906,12653,124,557,3275,10481,3399,11038
231380,202102,6040,16278,5470,15491,195,502,4446,12766,4641,13268
231390,202102,3305,9569,2967,8999,120,452,2198,6489,2318,6941
231395,202102,4036,11656,3357,10589,406,1284,2014,6415,2420,7699
231400,202102,9801,27795,8234,24952,252,1063,6263,18556,6515,19619
231410,202102,14792,45093,13544,43049,625,2102,10962,34679,11587,36781
240010,202102,2624,6781,2062,5777,209,585,1226,3386,1435,3971
240020,202102,12691,34987,10654,31389,635,2270,7084,20539,7719,22809
240030,202102,2948,7008,2649,6566,100,268,2295,5646,2395,5914
240040,202102,818,2336,696,2110,30,115,474,1388,504,1503
240050,202102,3312,8775,2685,7648,50,152,2061,5766,2111,5918
240060,202102,1387,3684,1143,3244,24,87,937,2605,961,2692
240070,202102,2136,6094,1933,5669,200,600,1387,3973,1587,4573
240080,202102,2921,7797,2374,6832,67,244,1804,5109,1871,5353
240090,202102,2241,5478,1837,4806,19,53,1545,4004,1564,4057
240100,202102,10191,24683,8141,21066,192,563,6424,16080,6616,16643
240110,202102,4525,12722,3812,11439,176,643,2788,8189,2964,8832
240120,202102,3260,8981,2635,8216,180,595,1890,6034,2070,6629
240130,202102,3702,7593,3079,6788,30,86,2820,6140,2850,6226
240140,202102,1712,5138,1474,4667,151,524,1013,3186,1164,3710
240145,202102,6449,17791,5279,15809,804,2466,3013,9127,3817,11593
240150,202102,933,2694,820,2459,45,156,639,1866,684,2022
240160,202102,1457,4317,1223,3882,39,162,933,2977,972,3139
240165,202102,971,2629,806,2317,25,92,667,1877,692,1969
240170,202102,2621,6953,2212,6221,202,612,1507,4127,1709,4739
240180,202102,2990,8755,2400,7567,567,1692,1046,3519,1613,5211
240185,202102,1204,3737,1107,3564,57,221,913,2909,970,3130
240190,202102,1077,3127,927,2880,18,87,796,2481,814,2568
240200,202102,10712,27053,8540,23415,852,2530,4926,13225,5778,15755
240210,202102,3305,8047,2678,7051,23,117,2264,5779,2287,5896
240220,202102,7219,21487,6494,20363,329,1409,5158,15910,5487,17319
240230,202102,5812,14609,4659,12709,227,562,3662,10067,3889,10629
240240,202102,1797,5154,1164,3701,104,344,384,1087,488,1431
240250,202102,3014,7719,2640,7213,82,244,2262,6136,2344,6380
240260,202102,13727,40356,11911,37324,1695,4976,7355,24198,9050,29174
240270,202102,2302,6759,2019,6290,106,317,1457,4709,1563,5026
240280,202102,1709,4302,1443,3872,56,143,1156,3064,1212,3207
240290,202102,1167,3379,954,2911,31,137,688,1986,719,2123
240300,202102,2304,5831,1659,4656,70,206,1033,2848,1103,3054
240310,202102,8394,22065,6611,18900,860,2605,3392,9541,4252,12146
240320,202102,2100,5617,1528,4506,33,140,1148,3230,1181,3370
240325,202102,31430,82790,25146,71956,4213,12342,11509,33011,15722,45353
240330,202102,1771,4795,1368,4035,59,206,940,2658,999,2864
240340,202102,1914,4402,1576,3900,58,140,1302,3176,1360,3316
240350,202102,2225,5563,1994,5304,36,97,1802,4815,1838,4912
240360,202102,9233,24913,8216,23353,795,2260,5832,16760,6627,19020
240370,202102,1954,4995,1531,4160,59,160,1085,2874,1144,3034
240375,202102,916,2291,766,2029,26,87,613,1567,639,1654
240380,202102,2215,6262,1663,5051,149,419,949,2849,1098,3268
240390,202102,1054,2515,756,1957,27,62,477,1151,504,1213
240400,202102,1499,3607,1167,3040,31,99,834,2050,865,2149
240410,202102,582,1679,477,1476,37,133,311,912,348,1045
240420,202102,4483,15641,3951,14460,442,1913,2352,8434,2794,10347
240430,202102,3422,8661,2848,7683,166,512,2136,5579,2302,6091
240440,202102,2488,5376,2115,4870,140,262,1720,3999,1860,4261
240450,202102,4536,12181,3570,10413,346,1035,2090,5885,2436,6920
240460,202102,2907,8214,2577,7679,215,697,2022,6000,2237,6697
240470,202102,3626,10807,2761,9024,509,1564,1366,4688,1875,6252
240480,202102,585,1589,393,1173,29,92,187,532,216,624
240485,202102,2212,6074,1794,5331,128,377,1228,3657,1356,4034
240490,202102,1608,4091,1277,3482,85,193,946,2613,1031,2806
240500,202102,2175,5800,1895,5323,107,285,1512,4279,1619,4564
240510,202102,1689,4407,1474,4089,69,232,1203,3278,1272,3510
240520,202102,1504,3571,1176,3124,69,172,862,2337,931,2509
240530,202102,2175,6057,1966,5728,94,289,1640,4742,1734,5031
240540,202102,2295,5684,2012,5246,61,104,1732,4549,1793,4653
240550,202102,693,1941,629,1813,17,70,530,1482,547,1552
240560,202102,3250,8402,2751,7738,273,673,1992,5744,2265,6417
240570,202102,2814,7295,1909,5328,288,797,699,1862,987,2659
240580,202102,7966,23206,7061,21544,575,1632,5596,17282,6171,18914
240590,202102,730,1886,644,1745,13,43,476,1263,489,1306
240600,202102,1808,4850,1342,3883,48,152,906,2525,954,2677
240610,202102,4062,10873,3472,9812,123,412,2686,7460,2809,7872
240615,202102,1259,3205,1013,2776,110,282,682,1846,792,2128
240620,202102,1821,5059,1574,4644,105,268,1245,3690,1350,3958
240630,202102,2067,5730,1864,5387,134,276,1333,4015,1467,4291
240640,202102,965,2551,774,2239,27,100,575,1627,602,1727
240650,202102,4071,11255,3509,10106,243,689,2648,7526,2891,8215
240660,202102,3053,7756,2714,7326,46,146,2471,6671,2517,6817
240670,202102,2453,6877,1982,5921,150,470,1268,3697,1418,4167
240680,202102,1613,4236,1313,3728,50,146,997,2764,1047,2910
240690,202102,1022,2521,805,2163,16,69,644,1665,660,1734
240700,202102,2468,7055,2021,6225,66,216,1564,4757,1630,4973
240710,202102,16044,41075,13485,36764,1689,4514,8497,23110,10186,27624
240720,202102,5051,12316,4367,11375,384,1027,3223,8312,3607,9339
240725,202102,1126,3165,869,2663,37,111,582,1731,619,1842
240730,202102,2296,6305,1847,5421,48,158,1412,4089,1460,4247
240740,202102,1869,4971,1509,4267,46,175,1113,2988,1159,3163
240750,202102,2105,6869,1792,6218,253,947,964,3373,1217,4320
240760,202102,1654,3787,1197,3099,68,98,906,2433,974,2531
240770,202102,3216,8807,2715,8082,125,436,2206,6505,2331,6941
240780,202102,4647,12823,3837,11483,525,1542,2354,7247,2879,8789
240790,202102,871,2436,736,2173,18,78,562,1614,580,1692
240800,202102,48592,114680,37805,98550,5150,13598,19641,51203,24791,64801
240810,202102,90663,231003,77022,208776,8653,24204,50198,133776,58851,157980
240820,202102,5957,17464,5175,16069,716,2186,3190,10094,3906,12280
240830,202102,8782,24652,7813,23225,252,996,6460,18991,6712,19987
240840,202102,1110,2727,889,2378,30,75,633,1634,663,1709
240850,202102,1368,3677,986,2883,52,156,556,1577,608,1733
240860,202102,1328,3508,1001,2920,16,77,759,2113,775,2190
240870,202102,1087,2725,828,2290,135,383,446,1265,581,1648
240880,202102,1259,3965,1109,3672,77,331,856,2762,933,3093
240890,202102,4390,11893,3375,9988,445,1433,1728,4937,2173,6370
240895,202102,2859,8645,2639,8300,166,487,2232,7143,2398,7630
240910,202102,3493,9235,2965,8296,53,169,2437,6698,2490,6867
240920,202102,922,2459,762,2197,68,166,434,1317,502,1483
240930,202102,3655,8242,3023,7479,205,299,2245,5896,2450,6195
240933,202102,1684,4099,1415,3720,36,145,1248,3230,1284,3375
240940,202102,5889,14509,4622,12347,532,1437,2758,7205,3290,8642
240950,202102,1052,3086,923,2851,30,126,747,2250,777,2376
240960,202102,682,2091,612,1951,27,97,471,1474,498,1571
240970,202102,1856,4764,1495,4155,60,215,1213,3272,1273,3487
240980,202102,3350,9836,2956,9132,103,461,2409,7309,2512,7770
240990,202102,2580,7193,2281,6618,256,815,1613,4517,1869,5332
241000,202102,937,2449,743,2104,27,67,551,1537,578,1604
241010,202102,2796,8803,2556,8284,164,613,1873,5998,2037,6611
241020,202102,2145,5630,1618,4591,145,402,1053,2928,1198,3330
241025,202102,1806,5099,1443,4435,44,178,1051,3172,1095,3350
241030,202102,2488,7702,2017,6709,235,787,1281,4293,1516,5080
241040,202102,2265,7080,2000,6615,87,387,1590,5210,1677,5597
241050,202102,1377,3796,1137,3364,34,120,833,2400,867,2520
241060,202102,762,2121,673,1937,29,88,478,1330,507,1418
241070,202102,672,1804,577,1642,10,24,451,1247,461,1271
241080,202102,1121,3160,867,2651,8,35,653,1966,661,2001
241090,202102,1974,5728,1613,5112,48,224,1268,3961,1316,4185
241100,202102,1195,3286,921,2741,68,210,599,1732,667,1942
241105,202102,946,2855,777,2543,239,763,255,867,494,1630
241110,202102,979,2726,740,2230,37,106,498,1450,535,1556
241120,202102,7619,21358,6449,19303,931,2706,3833,11822,4764,14528
241140,202102,3303,8671,2591,7261,135,394,1879,5154,2014,5548
241142,202102,793,2107,586,1718,30,100,348,972,378,1072
241150,202102,5948,15260,5291,14205,158,469,4337,11482,4495,11951
241160,202102,1168,3125,933,2696,138,404,594,1679,732,2083
241170,202102,1349,3378,1145,3031,34,118,950,2423,984,2541
241180,202102,1046,2636,778,2122,94,265,386,1043,480,1308
241190,202102,1139,2970,958,2616,15,63,706,1854,721,1917
241200,202102,19872,51103,17211,46760,2700,7309,10008,27206,12708,34515
241210,202102,1427,3732,1041,2972,110,334,594,1664,704,1998
241220,202102,9026,25901,7893,24012,1727,5230,3844,12137,5571,17367
241230,202102,2968,7712,2634,7197,113,319,2168,5877,2281,6196
241240,202102,1230,3397,797,2452,70,218,342,1055,412,1273
241250,202102,5627,15922,4514,13845,153,671,3322,9804,3475,10475
241255,202102,2249,6921,2000,6402,114,449,1527,4796,1641,5245
241260,202102,4904,12618,3893,10953,77,309,3089,8502,3166,8811
241270,202102,1663,4786,1396,4280,106,355,1002,3084,1108,3439
241280,202102,2236,5480,1924,4922,67,161,1634,4127,1701,4288
241290,202102,3379,8226,2504,6828,75,236,1962,5218,2037,5454
241300,202102,1507,3970,1216,3466,40,138,825,2288,865,2426
241310,202102,2134,5235,1839,4817,16,55,1589,4204,1605,4259
241320,202102,935,3006,806,2765,84,347,531,1803,615,2150
241330,202102,1765,4483,1384,3977,18,98,1214,3445,1232,3543
241335,202102,3328,9148,2932,8428,113,355,2380,6763,2493,7118
241340,202102,1562,4328,1225,3643,248,795,508,1444,756,2239
241350,202102,2144,5909,1876,5432,106,324,1464,4195,1570,4519
241355,202102,1311,3507,1082,3067,15,44,839,2353,854,2397
241360,202102,2042,5261,1549,4269,43,117,1141,3064,1184,3181
241370,202102,1364,3722,1065,3101,47,143,753,2128,800,2271
241380,202102,648,1789,494,1490,74,192,247,770,321,962
241390,202102,2735,7931,2441,7496,193,517,1881,5905,2074,6422
241400,202102,3544,9736,3158,9140,139,464,2575,7388,2714,7852
241410,202102,2435,7157,1991,6250,338,1086,1016,3207,1354,4293
241415,202102,1677,4871,1390,4316,55,193,1013,3115,1068,3308
241420,202102,2318,7181,1994,6638,464,1709,974,3255,1438,4964
241430,202102,604,1640,429,1266,19,62,273,767,292,829
241440,202102,7781,23301,6973,21887,370,1251,5519,17344,5889,18595
241445,202102,1124,2808,996,2642,23,57,882,2410,905,2467
241450,202102,2664,6481,2278,5869,389,855,1470,3959,1859,4814
241460,202102,3844,10263,3139,8801,201,559,2173,5967,2374,6526
241470,202102,1393,3677,1144,3304,28,100,951,2747,979,2847
241475,202102,1225,3369,974,2884,22,105,715,2018,737,2123
241480,202102,2959,9117,2438,7981,738,2375,797,2915,1535,5290
241490,202102,629,1478,517,1330,26,62,372,942,398,1004
241500,202102,787,2184,704,2080,3,10,656,1958,659,1968
250010,202102,2586,7626,2174,6781,55,202,1596,4862,1651,5064
250020,202102,1679,4381,1224,3505,52,89,860,2494,912,2583
250030,202102,7006,18932,6223,17704,559,1559,4630,13090,5189,14649
250040,202102,3984,12089,3449,11115,234,826,2516,7988,2750,8814
250050,202102,3603,9539,3260,9090,106,387,2719,7556,2825,7943
250053,202102,1178,3269,1078,3112,81,223,769,2246,850,2469
250057,202102,647,2293,606,2231,9,38,547,2043,556,2081
250060,202102,5425,14002,4875,13331,262,700,4065,11196,4327,11896
250070,202102,4053,11104,3415,10001,32,125,2761,7905,2793,8030
250073,202102,778,2033,636,1817,10,20,515,1442,525,1462
250077,202102,2232,5897,1690,5015,57,195,1292,3801,1349,3996
250080,202102,4953,12188,4188,11225,62,270,3678,9724,3740,9994
250090,202102,3420,8169,2987,7601,58,167,2572,6424,2630,6591
250100,202102,3638,10905,3282,10259,155,541,2582,7931,2737,8472
250110,202102,4876,13603,4417,12952,241,882,3458,9951,3699,10833
250115,202102,725,1822,532,1529,13,51,397,1122,410,1173
250120,202102,1889,5407,1587,4915,27,127,1260,3876,1287,4003
250130,202102,5629,15193,4768,13973,67,357,4073,11779,4140,12136
250135,202102,1213,3306,1063,3051,17,63,928,2660,945,2723
250140,202102,2268,6537,2115,6351,108,415,1827,5454,1935,5869
250150,202102,4719,14527,4235,13710,144,602,3390,10815,3534,11417
250153,202102,1384,3631,1158,3297,31,83,920,2600,951,2683
250157,202102,1830,5231,1660,4919,61,230,1341,3912,1402,4142
250160,202102,3887,9600,3096,8542,42,145,2710,7493,2752,7638
250170,202102,1813,4653,1629,4394,23,88,1425,3800,1448,3888
250180,202102,20375,48343,17432,44632,718,2161,13792,34465,14510,36626
250190,202102,3999,10600,3347,9640,308,913,2333,6591,2641,7504
250200,202102,1970,5168,1707,4810,63,184,1438,4069,1501,4253
250205,202102,865,2627,747,2447,6,28,616,1996,622,2024
250210,202102,1555,4634,1405,4402,65,278,1119,3451,1184,3729
250215,202102,1587,4283,1333,3932,78,247,783,2336,861,2583
250220,202102,663,1815,530,1614,24,90,355,1069,379,1159
250230,202102,1675,3731,1175,2994,15,49,945,2343,960,2392
250240,202102,2307,6929,2032,6427,34,170,1731,5394,1765,5564
250250,202102,4588,12631,4017,11804,87,276,3434,10130,3521,10406
250260,202102,1688,4655,1432,4216,50,121,1134,3321,1184,3442
250270,202102,1199,3585,1090,3449,52,190,833,2708,885,2898
250280,202102,3429,9248,3081,8741,128,325,2449,6981,2577,7306
250290,202102,1536,4044,1328,3749,17,51,1060,2982,1077,3033
250300,202102,5507,14561,4958,13923,174,760,4173,11317,4347,12077
250310,202102,1164,3210,973,2893,38,128,740,2177,778,2305
250320,202102,12265,27092,10565,25154,248,670,9499,22342,9747,23012
250330,202102,2365,6468,1987,5947,113,329,1597,4797,1710,5126
250340,202102,1136,2850,1018,2702,14,39,941,2493,955,2532
250350,202102,4176,11595,3703,10798,200,453,2908,8767,3108,9220
250355,202102,2019,6028,1815,5752,28,151,1630,5147,1658,5298
250360,202102,1778,4833,1602,4595,36,126,1358,3862,1394,3988
250370,202102,13719,34640,11400,31153,234,829,9648,25985,9882,26814
250375,202102,1191,3051,965,2779,4,16,917,2654,921,2670
250380,202102,1633,4134,1499,3967,30,107,1321,3407,1351,3514
250390,202102,1837,4665,1558,4226,78,213,1246,3356,1324,3569
250400,202102,69314,168733,51365,141266,14286,42378,13852,40580,28138,82958
250403,202102,1771,4853,1578,4629,70,350,1236,3442,1306,3792
250407,202102,1324,3151,1049,2748,98,197,681,1922,779,2119
250410,202102,644,1725,556,1576,4,9,463,1285,467,1294
250415,202102,1888,5196,1659,4833,31,144,1431,4145,1462,4289
250420,202102,1173,3252,1068,3103,31,103,956,2761,987,2864
250430,202102,6184,15169,5254,13953,158,455,4324,11268,4482,11723
250435,202102,1525,4245,1230,3742,14,73,941,2808,955,2881
250440,202102,4637,12116,4018,11338,70,190,3582,10105,3652,10295
250450,202102,1819,4748,1506,4320,29,98,1243,3586,1272,3684
250460,202102,7157,19345,6369,18198,339,1016,5090,14519,5429,15535
250470,202102,1538,3943,1280,3548,50,155,1020,2777,1070,2932
250480,202102,3927,10603,3340,9904,39,136,2946,8801,2985,8937
250485,202102,735,1634,554,1381,46,72,392,962,438,1034
250490,202102,5175,12183,4600,11530,174,500,4081,10061,4255,10561
250500,202102,1987,5439,1777,5072,75,233,1438,4108,1513,4341
250510,202102,5408,13510,4662,12522,74,186,4077,11037,4151,11223
250520,202102,1808,4819,1539,4439,121,353,1103,3182,1224,3535
250523,202102,2204,5431,1952,5110,72,284,1621,4089,1693,4373
250527,202102,1679,4247,1510,4060,22,62,1339,3621,1361,3683
250530,202102,624,1589,538,1466,5,11,477,1302,482,1313
250535,202102,1378,3989,1245,3741,24,102,1013,2953,1037,3055
250540,202102,3080,6879,2573,6315,78,137,2259,5662,2337,5799
250550,202102,782,2467,692,2290,18,65,519,1700,537,1765
250560,202102,1751,4776,1550,4494,37,137,1304,3702,1341,3839
250570,202102,2657,7843,2283,7168,78,289,1785,5527,1863,5816
250580,202102,1066,2750,938,2572,46,171,789,2117,835,2288
250590,202102,805,2251,722,2131,19,65,595,1765,614,1830
250600,202102,8151,20864,6790,19094,238,734,5528,15439,5766,16173
250610,202102,2976,8346,2669,7895,117,437,2214,6472,2331,6909
250620,202102,826,2112,712,1920,11,23,516,1373,527,1396
250625,202102,2452,7005,2190,6573,42,209,1868,5451,1910,5660
250630,202102,10294,27979,8407,24758,882,2616,5366,15504,6248,18120
250640,202102,3501,9438,3137,8960,95,356,2698,7609,2793,7965
250650,202102,961,2292,815,2091,13,36,713,1806,726,1842
250660,202102,1628,4016,1301,3566,43,114,1063,2848,1106,2962
250670,202102,2287,7117,2080,6755,42,183,1812,5788,1854,5971
250680,202102,5866,13518,5245,12824,51,192,4878,11776,4929,11968
250690,202102,6767,15157,5707,13847,107,243,5047,12193,5154,12436
250700,202102,4220,11823,3690,11025,480,1410,2487,7462,2967,8872
250710,202102,4393,12520,3852,11765,282,883,2816,8605,3098,9488
250720,202102,2776,7335,2495,6936,29,140,2222,6121,2251,6261
250730,202102,4122,10881,3613,10207,101,420,3039,8342,3140,8762
250740,202102,1902,4689,1597,4294,94,213,1254,3402,1348,3615
250750,202102,105615,255975,89856,234118,7173,19986,65653,168007,72826,187993
250760,202102,2339,6007,2046,5534,79,228,1634,4308,1713,4536
250770,202102,3984,11971,3568,11420,391,1202,2559,8337,2950,9539
250780,202102,1753,4667,1472,4161,55,188,1133,3120,1188,3308
250790,202102,2476,7215,2139,6717,122,481,1505,4610,1627,5091
250800,202102,2408,6351,2111,5869,90,182,1722,4838,1812,5020
250810,202102,1289,3349,1078,3052,32,64,907,2614,939,2678
250820,202102,1976,5408,1818,5236,30,127,1651,4726,1681,4853
250830,202102,5881,17455,4854,15384,276,1027,3293,10160,3569,11187
250840,202102,748,2360,644,2156,14,56,490,1651,504,1707
250850,202102,1796,5263,1614,4934,31,139,1338,3996,1369,4135
250855,202102,978,2838,837,2605,53,206,616,1892,669,2098
250860,202102,3133,9247,2622,8398,424,1442,1525,4911,1949,6353
250870,202102,1019,2796,878,2567,35,127,719,2073,754,2200
250880,202102,1605,4090,1330,3687,79,219,1028,2854,1107,3073
250890,202102,10312,26193,9112,24595,476,1663,7238,18750,7714,20413
250900,202102,2905,7832,2522,7167,98,258,2104,5920,2202,6178
250905,202102,2505,6866,2317,6608,41,147,2118,6040,2159,6187
250910,202102,6070,14760,5009,13553,74,251,4398,11931,4472,12182
250915,202102,2159,4951,1500,4241,26,56,1311,3795,1337,3851
250920,202102,3578,8949,3146,8297,329,755,2338,6196,2667,6951
250930,202102,2294,6125,2075,5839,50,208,1807,4981,1857,5189
250933,202102,1177,3440,1042,3196,19,86,826,2480,845,2566
250937,202102,680,1827,561,1634,21,70,431,1275,452,1345
250939,202102,1831,4760,1601,4469,64,194,1253,3476,1317,3670
250940,202102,4032,10598,3553,9969,15,58,3182,8936,3197,8994
250950,202102,1751,4435,1417,4011,25,92,1145,3183,1170,3275
250960,202102,1115,3256,982,3046,24,126,811,2431,835,2557
250970,202102,8278,21099,7308,19554,210,641,6081,15975,6291,16616
250980,202102,2387,6309,2158,5977,26,117,1889,5109,1915,5226
250990,202102,2035,6109,1707,5551,55,251,1266,4061,1321,4312
251000,202102,2016,5673,1635,5014,35,155,1341,4083,1376,4238
251010,202102,2708,7420,2462,7048,23,86,2223,6365,2246,6451
251020,202102,1613,4385,1445,4118,34,149,1246,3484,1280,3633
251030,202102,1033,2711,852,2395,40,105,583,1635,623,1740
251040,202102,1810,5062,1521,4573,33,162,1252,3741,1285,3903
251050,202102,1031,2814,869,2506,46,156,620,1714,666,1870
251060,202102,1065,2262,812,1952,8,26,622,1477,630,1503
251065,202102,485,1309,373,1098,10,31,259,742,269,773
251070,202102,736,1865,621,1695,8,32,534,1420,542,1452
251080,202102,18666,47093,15142,41803,2142,6089,9254,25803,11396,31892
251090,202102,2880,8161,2439,7393,61,192,1926,5819,1987,6011
251100,202102,796,2522,707,2349,22,84,553,1775,575,1859
251110,202102,1722,4510,1470,4074,67,155,1116,3104,1183,3259
251120,202102,7450,20440,6296,19051,274,957,4977,15102,5251,16059
251130,202102,3900,8590,3445,8080,55,152,3137,7319,3192,7471
251140,202102,4248,11772,3797,11149,70,285,3181,9238,3251,9523
251150,202102,2634,7593,2403,7212,84,359,2031,5954,2115,6313
251160,202102,2136,6223,1853,5816,37,174,1601,4937,1638,5111
251170,202102,1613,4287,1410,4027,26,88,1253,3547,1279,3635
251180,202102,2590,6891,2121,6232,152,454,1465,4289,1617,4743
251190,202102,4402,11422,4002,10971,45,246,3636,9764,3681,10010
251200,202102,4363,12638,3855,12005,68,295,3410,10637,3478,10932
251203,202102,922,3020,850,2859,21,111,639,2089,660,2200
251207,202102,1104,2958,846,2544,17,85,599,1760,616,1845
251210,202102,7710,19208,6330,17343,291,637,4837,13562,5128,14199
251220,202102,1242,2930,935,2529,57,124,704,1955,761,2079
251230,202102,4620,12768,4000,11689,107,388,3174,9045,3281,9433
251240,202102,3640,9906,3073,8964,162,420,2305,6664,2467,7084
251250,202102,10484,27866,9210,25720,759,2137,6768,18434,7527,20571
251260,202102,489,1375,445,1305,16,74,354,1005,370,1079
251270,202102,4238,13140,3816,12575,108,437,3115,10482,3223,10919
251272,202102,1320,3576,1203,3420,47,176,1004,2790,1051,2966
251274,202102,888,2470,710,2147,56,193,471,1364,527,1557
251275,202102,1191,3359,1017,3073,26,121,809,2379,835,2500
251276,202102,1314,3558,1144,3334,28,149,930,2614,958,2763
251278,202102,589,1619,532,1539,43,107,397,1173,440,1280
251280,202102,2219,5984,2023,5703,50,146,1705,4766,1755,4912
251290,202102,5929,13783,5377,13119,161,493,4714,11174,4875,11667
251300,202102,876,2545,796,2424,7,38,677,2049,684,2087
251310,202102,2687,7665,2336,7131,42,238,1918,5709,1960,5947
251315,202102,1724,5318,1572,5028,103,287,1177,3744,1280,4031
251320,202102,1611,4266,1182,3519,30,106,885,2587,915,2693
251330,202102,2082,4830,1721,4407,20,68,1545,3991,1565,4059
251335,202102,1103,3119,988,2934,23,104,872,2533,895,2637
251340,202102,3748,8870,3015,7910,123,343,2335,6124,2458,6467
251350,202102,1038,2970,945,2817,29,102,776,2284,805,2386
251360,202102,1834,5104,1492,4615,12,64,1247,3864,1259,3928
251365,202102,730,1965,575,1663,6,20,455,1298,461,1318
251370,202102,24387,63503,20879,58520,2884,8068,12514,36071,15398,44139
251380,202102,1204,3349,1044,3074,14,88,882,2530,896,2618
251385,202102,741,1903,574,1601,25,70,417,1132,442,1202
251390,202102,6369,18294,5644,17184,490,1511,3786,11616,4276,13127
251392,202102,993,2661,844,2434,28,116,659,1855,687,1971
251394,202102,599,1719,490,1533,18,77,366,1131,384,1208
251396,202102,642,1731,556,1583,13,39,398,1110,411,1149
251398,202102,991,2456,694,1944,22,73,518,1419,540,1492
251400,202102,1265,2979,1004,2633,21,85,812,2052,833,2137
251410,202102,1553,3609,1264,3205,20,79,1073,2618,1093,2697
251420,202102,1938,5043,1597,4646,39,130,1280,3684,1319,3814
251430,202102,1572,4708,1417,4436,30,146,1226,3821,1256,3967
251440,202102,1097,3034,892,2647,39,91,701,2117,740,2208
251445,202102,1542,4256,1425,4094,30,101,1225,3475,1255,3576
251450,202102,4404,12864,3943,12159,80,299,3293,10074,3373,10373
251455,202102,860,2585,788,2456,20,86,629,1912,649,1998
251460,202102,923,2627,798,2438,12,40,656,2010,668,2050
251465,202102,449,1305,387,1192,6,26,294,879,300,905
251470,202102,1185,3234,897,2645,75,240,517,1459,592,1699
251480,202102,1019,2650,835,2329,16,63,651,1746,667,1809
251490,202102,1907,4977,1516,4426,66,200,1135,3339,1201,3539
251500,202102,1966,5454,1804,5251,32,118,1636,4762,1668,4880
251510,202102,2617,7817,2189,6977,112,397,1498,4688,1610,5085
251520,202102,997,2572,772,2158,71,184,486,1338,557,1522
251530,202102,14730,35013,11853,31439,95,517,10511,27407,10606,27924
251540,202102,2999,8435,2727,7933,65,230,2306,6625,2371,6855
251550,202102,3843,8955,3118,8074,126,220,2576,6755,2702,6975
251560,202102,544,1657,486,1569,54,184,339,1061,393,1245
251570,202102,958,2665,788,2332,18,79,629,1810,647,1889
251580,202102,1918,4566,1716,4279,34,138,1484,3566,1518,3704
251590,202102,1571,3861,1326,3577,51,138,1109,2939,1160,3077
251593,202102,910,2663,817,2510,89,280,521,1592,610,1872
251597,202102,2118,5900,1906,5620,18,93,1703,4954,1721,5047
251600,202102,6338,17015,5537,15801,192,560,4552,12859,4744,13419
251610,202102,3141,8968,2729,8204,241,657,1856,5711,2097,6368
251615,202102,1300,3187,1049,2811,20,60,849,2205,869,2265
251620,202102,19291,43685,14862,38271,86,299,12869,33447,12955,33746
251630,202102,4747,11032,3852,9794,207,506,2893,7315,3100,7821
251640,202102,2180,5859,1945,5494,27,120,1723,4767,1750,4887
251650,202102,3944,10528,3454,9890,133,403,2904,8338,3037,8741
251660,202102,3521,10429,3122,9739,63,285,2613,8028,2676,8313
251670,202102,3997,11199,3564,10571,46,231,3179,9368,3225,9599
251675,202102,657,1822,591,1742,82,229,401,1205,483,1434
251680,202102,2553,6622,2143,6091,39,121,1760,5051,1799,5172
251690,202102,3006,8430,2554,7659,81,251,1936,5766,2017,6017
251700,202102,2167,5989,1806,5539,43,185,1534,4617,1577,4802
251710,202102,783,2021,553,1557,39,126,318,845,357,971
251720,202102,1316,3697,1068,3273,20,89,829,2468,849,2557
251740,202102,605,1679,487,1454,41,153,328,934,369,1087
260005,202102,29912,62957,24682,56261,1786,3943,18802,42100,20588,46043
260010,202102,10231,26572,8474,23756,476,1373,5024,14201,5500,15574
260020,202102,6859,15883,5825,14412,84,373,4968,12067,5052,12440
260030,202102,6889,17401,5811,15833,133,396,4731,12833,4864,13229
260040,202102,7505,19025,6309,17309,423,1155,4543,12658,4966,13813
260050,202102,13975,36004,11664,33459,172,675,10755,30906,10927,31581
260060,202102,4125,10064,3568,9183,236,505,2753,7195,2989,7700
260070,202102,10768,26595,9244,24425,307,1069,7553,19400,7860,20469
260080,202102,6495,14753,5672,13670,108,346,4768,11306,4876,11652
260090,202102,4551,11757,4071,11107,433,1211,2981,8135,3414,9346
260100,202102,2929,7923,2472,7239,46,230,2059,5930,2105,6160
260105,202102,4961,13527,4446,12835,122,426,3753,10695,3875,11121
260110,202102,22288,61178,19897,57715,899,3007,16527,47329,17426,50336
260120,202102,14542,38179,12323,34905,1432,3920,7913,22832,9345,26752
260130,202102,3180,8014,2825,7503,262,656,2048,5397,2310,6053
260140,202102,12795,28638,11065,26620,524,1408,9340,22141,9864,23549
260150,202102,3535,8170,3055,7584,86,243,2692,6622,2778,6865
260160,202102,6491,16737,5524,15574,91,315,4999,14219,5090,14534
260170,202102,20659,48005,17586,43882,944,2309,14010,34605,14954,36914
260180,202102,3518,9245,3051,8609,66,246,2643,7344,2709,7590
260190,202102,18042,36120,15227,32812,177,450,13567,28714,13744,29164
260200,202102,10904,26229,9402,24316,435,989,7861,20654,8296,21643
260210,202102,11661,32676,9931,29847,302,1112,7930,23696,8232,24808
260220,202102,10515,24758,9756,23797,162,481,8663,20835,8825,21316
260230,202102,10810,26099,9437,24287,181,566,8019,20322,8200,20888
260240,202102,2737,8112,2411,7486,96,322,1857,5717,1953,6039
260250,202102,2194,5705,1922,5276,125,276,1454,4011,1579,4287
260260,202102,12791,32862,11399,30760,350,1157,9121,24132,9471,25289
260270,202102,4326,10328,3828,9737,103,374,3248,8122,3351,8496
260280,202102,12889,38167,11642,36400,414,1721,9976,30728,10390,32449
260290,202102,40757,101726,35071,93644,3723,10129,23913,63663,27636,73792
260300,202102,9534,25532,8343,23921,184,789,7105,20276,7289,21065
260310,202102,5360,13386,4743,12613,345,809,3666,9898,4011,10707
260320,202102,7740,22102,6574,20132,247,782,5360,16449,5607,17231
260330,202102,2568,7833,2249,7180,73,262,1781,5560,1854,5822
260340,202102,2039,5432,1769,5037,25,114,1537,4279,1562,4393
260345,202102,25601,65102,21388,59076,3272,9571,11247,30542,14519,40113
260350,202102,5680,13077,4920,12215,57,164,4409,10888,4466,11052
260360,202102,2470,6451,2239,6026,47,204,1579,4139,1626,4343
260370,202102,5522,15678,4768,14431,221,725,3701,11158,3922,11883
260380,202102,5084,14640,4369,13475,169,509,3326,10173,3495,10682
260390,202102,4564,13496,3795,11941,238,688,2538,7889,2776,8577
260392,202102,3341,10636,3025,10243,108,640,2464,8331,2572,8971
260400,202102,18620,42373,16059,39051,446,1204,12789,29970,13235,31174
260410,202102,73057,175280,56818,152896,10163,28628,25270,70395,35433,99023
260415,202102,4360,11519,3778,10576,54,225,3121,8572,3175,8797
260420,202102,12501,25968,10637,23898,94,264,9880,22007,9974,22271
260430,202102,2714,8389,2351,7665,103,422,1684,5406,1787,5828
260440,202102,3717,9496,3306,8896,66,227,2816,7453,2882,7680
260450,202102,5761,14311,5160,13546,291,575,4277,11450,4568,12025
260460,202102,5189,15247,4428,13927,474,1647,2656,8229,3130,9876
260470,202102,4902,12832,4158,11973,84,198,3815,11131,3899,11329
260480,202102,3922,10404,3302,9528,217,756,2297,6635,2514,7391
260490,202102,5366,12244,4776,11393,33,143,4359,10222,4392,10365
260500,202102,6000,14930,5116,13712,446,1118,3603,9816,4049,10934
260510,202102,9815,24005,8248,21820,110,430,7286,19105,7396,19535
260515,202102,4405,11653,3451,9898,158,407,2339,6551,2497,6958
260520,202102,16764,38597,14602,35863,692,1654,11971,29036,12663,30690
260530,202102,9806,27861,8387,25691,133,626,7246,21907,7379,22533
260540,202102,7247,15679,6419,14640,141,340,5786,13104,5927,13444
260545,202102,69,211,44,150,3,12,19,62,22,74
260550,202102,3068,8298,2522,7431,111,411,1752,5046,1863,5457
260560,202102,5997,15198,5056,13845,120,439,4263,11457,4383,11896
260570,202102,7652,20690,6755,19488,358,1127,5356,15511,5714,16638
260580,202102,4483,10527,4029,9924,26,88,3688,9032,3714,9120
260590,202102,6700,15413,5620,14214,240,561,4661,11962,4901,12523
260600,202102,30797,78683,25165,70231,1074,3269,19198,52634,20272,55903
260610,202102,7424,18916,6637,17899,407,1124,4985,13430,5392,14554
260620,202102,16862,42686,14778,39739,1272,3784,10799,28486,12071,32270
260630,202102,2395,6413,1968,5749,39,151,1603,4593,1642,4744
260640,202102,22352,49445,18699,45266,831,1981,15231,36668,16062,38649
260650,202102,6253,15945,5018,14449,444,868,4040,12060,4484,12928
260660,202102,6921,18054,5990,16834,166,650,5142,14150,5308,14800
260670,202102,2254,5826,1894,5274,81,207,1365,3728,1446,3935
260680,202102,29135,68657,24617,62333,1756,4638,17396,43251,19152,47889
260690,202102,3524,9047,2964,8183,73,276,2345,6417,2418,6693
260700,202102,6259,17243,5832,16758,19,71,5657,16333,5676,16404
260710,202102,1363,3534,1176,3263,32,122,926,2572,958,2694
260720,202102,23944,58350,20641,54080,1903,4996,15225,39845,17128,44841
260730,202102,7896,22157,6934,20836,243,829,5832,17315,6075,18144
260740,202102,1309,3691,1112,3372,14,73,868,2690,882,2763
260750,202102,7130,19392,5977,17958,252,498,5209,16173,5461,16671
260760,202102,5755,13386,4946,12444,194,504,4086,10333,4280,10837
260765,202102,8175,23072,7103,21606,385,1485,5049,15085,5434,16570
260770,202102,3883,9775,3238,8722,121,369,2542,6751,2663,7120
260775,202102,5225,13771,4601,12848,184,665,3611,9745,3795,10410
260780,202102,3650,10748,3269,10150,308,1095,2050,6164,2358,7259
260790,202102,120834,266748,100086,240222,15205,35243,61815,149030,77020,184273
260795,202102,2952,7475,2534,6943,76,261,2001,5527,2077,5788
260800,202102,5340,12326,4827,11649,127,400,4214,9853,4341,10253
260805,202102,3657,10170,3105,9214,174,559,2320,6787,2494,7346
260810,202102,6423,17363,5639,15861,470,1231,4039,11188,4509,12419
260820,202102,4571,10425,4048,9810,93,312,3403,8083,3496,8395
260825,202102,2976,8676,2620,8055,113,376,1971,6006,2084,6382
260830,202102,4229,12181,3538,10959,484,1286,2214,7123,2698,8409
260840,202102,4189,10793,3758,10204,209,527,3136,8540,3345,9067
260845,202102,4463,11577,3957,10725,232,645,2969,7924,3201,8569
260850,202102,5167,13916,4332,12373,349,1067,2772,7652,3121,8719
260860,202102,3339,9478,2884,8711,96,335,2315,6841,2411,7176
260870,202102,4538,10830,3891,10048,67,254,3484,8877,3551,9131
260875,202102,7306,17492,6001,15606,552,1409,4132,10834,4684,12243
260880,202102,9687,26918,8445,24798,490,1438,6597,19368,7087,20806
260890,202102,13018,32874,11311,30322,579,1623,8285,21717,8864,23340
260900,202102,5356,14663,4412,13358,312,973,2948,8938,3260,9911
260910,202102,3266,8706,2838,8070,108,313,2237,6339,2345,6652
260915,202102,5093,14898,4483,14197,55,252,4094,12988,4149,13240
260920,202102,3453,8182,2934,7627,111,218,2518,6653,2629,6871
260930,202102,3725,11603,3223,10725,184,724,2399,7817,2583,8541
260940,202102,14923,35000,13027,32407,1105,2656,9695,23846,10800,26502
260950,202102,7190,18835,5825,16508,366,1229,3806,10261,4172,11490
260960,202102,71609,156949,57767,139476,6156,15109,37206,88773,43362,103882
260970,202102,5852,14896,5210,14041,259,560,3877,10714,4136,11274
260980,202102,4632,13216,4075,12519,53,177,3731,11557,3784,11734
260990,202102,18350,49117,15589,45371,846,2586,12250,35268,13096,37854
261000,202102,16463,38162,13858,34903,374,1237,11209,27574,11583,28811
261010,202102,2347,6110,2060,5732,73,187,1797,5020,1870,5207
261020,202102,5998,16141,5223,14868,177,658,4317,11843,4494,12501
261030,202102,4044,11624,3567,10790,124,484,2843,8383,2967,8867
261040,202102,5382,15327,4402,13477,156,597,3334,9912,3490,10509
261050,202102,7807,20006,7109,18934,446,839,5501,14825,5947,15664
261060,202102,14293,35203,12468,33028,260,808,10501,27524,10761,28332
261070,202102,65377,140460,54436,126238,2930,6498,41654,94575,44584,101073
261080,202102,6775,15947,6179,15220,131,310,5736,14106,5867,14416
261090,202102,19736,45604,17590,42840,331,1014,15437,36977,15768,37991
261100,202102,8312,22691,7264,21161,504,1539,5324,15560,5828,17099
261110,202102,68158,186681,57405,167420,7826,23952,33935,97702,41761,121654
261120,202102,3586,9021,3142,8414,81,203,2710,7270,2791,7473
261130,202102,7345,17707,6501,16597,121,354,5739,14534,5860,14888
261140,202102,3763,8515,3350,7973,188,465,2662,6245,2850,6710
261150,202102,5179,13486,4609,12634,68,261,4009,10871,4077,11132
261153,202102,1918,5728,1621,5148,58,189,1090,3496,1148,3685
261160,202102,215275,490761,174861,435961,42360,108779,72581,184433,114941,293212
261170,202102,6099,14954,5441,14011,311,690,4358,11188,4669,11878
261180,202102,9630,23630,8399,22027,495,1194,6102,16197,6597,17391
261190,202102,4637,13271,4148,12476,159,678,3307,9640,3466,10318
261200,202102,3357,7691,2985,7192,114,306,2532,5997,2646,6303
261210,202102,1920,4613,1649,4231,63,170,1379,3479,1442,3649
261220,202102,13678,38220,11459,34198,1443,4625,6536,19245,7979,23870
261230,202102,4011,11349,3355,10457,45,174,2812,8857,2857,9031
261240,202102,5419,13346,4787,12353,296,727,3894,9977,4190,10704
261245,202102,3774,10379,3163,9308,79,361,2530,7165,2609,7526
261247,202102,2943,8713,2452,7842,166,558,1669,5312,1835,5870
261250,202102,22350,50467,19431,47102,1983,4355,14339,35819,16322,40174
261255,202102,4078,11827,3325,10375,138,584,2450,7422,2588,8006
261260,202102,12768,34166,11135,32051,331,1281,9610,27329,9941,28610
261270,202102,4553,10908,3982,10197,205,521,3260,8314,3465,8835
261280,202102,2530,7009,2234,6506,59,210,1796,5089,1855,5299
261290,202102,2966,7620,2484,7077,68,260,2015,5789,2083,6049
261300,202102,12504,34324,10676,31270,576,2021,7833,22397,8409,24418
261310,202102,8944,22290,7661,20573,607,1780,5678,14928,6285,16708
261320,202102,5966,16603,5232,15413,74,303,4460,12962,4534,13265
261330,202102,5752,14054,5194,13337,126,445,4513,11386,4639,11831
261340,202102,4291,11766,3730,11054,140,505,3117,9142,3257,9647
261350,202102,8787,25555,7773,23837,120,509,6322,19172,6442,19681
261360,202102,8170,19390,6933,17660,230,618,5572,13838,5802,14456
261370,202102,24096,59154,20210,53864,2125,5453,13062,35179,15187,40632
261380,202102,4095,12180,3631,11382,451,1480,2384,7382,2835,8862
261390,202102,16952,47381,14374,43259,1199,3913,9622,28673,10821,32586
261400,202102,4616,14459,4047,13210,172,736,3043,9663,3215,10399
261410,202102,9760,23914,8043,21304,427,1240,6426,16593,6853,17833
261420,202102,7310,21454,6584,20573,733,2593,4683,14578,5416,17171
261430,202102,3457,9665,2940,8853,59,262,2471,7341,2530,7603
261440,202102,1491,4378,1248,3921,41,190,899,2702,940,2892
261450,202102,14871,39783,13158,37157,165,592,10897,30869,11062,31461
261460,202102,7620,20614,6725,19222,309,927,5372,15321,5681,16248
261470,202102,4174,10253,3643,9537,21,107,3181,8303,3202,8410
261480,202102,5069,15362,4385,14221,198,792,3403,10814,3601,11606
261485,202102,4860,13680,4216,12704,327,1073,3065,9113,3392,10186
261500,202102,6069,15213,5299,14165,388,890,3719,10332,4107,11222
261510,202102,1898,5557,1654,5160,61,224,1261,3960,1322,4184
261520,202102,2356,7147,2122,6670,68,240,1568,4893,1636,5133
261530,202102,12108,34894,9815,30784,879,3270,5027,15157,5906,18427
261540,202102,8245,23244,7432,22084,1114,3189,4201,13234,5315,16423
261550,202102,3696,9709,3191,8933,237,701,2284,6266,2521,6967
261560,202102,7653,22657,6643,21150,271,1042,5143,16369,5414,17411
261570,202102,3521,9396,2816,8261,181,608,1956,5647,2137,6255
261580,202102,6912,17832,5975,16564,101,451,5377,14705,5478,15156
261590,202102,2714,6926,2206,6203,73,245,1668,4674,1741,4919
261600,202102,5317,13041,4534,11915,307,673,3218,8661,3525,9334
261610,202102,2148,6097,1725,5322,99,367,1157,3532,1256,3899
261618,202102,2558,6244,2236,5771,91,212,1790,4605,1881,4817
261620,202102,4221,11691,3842,11136,737,1867,2521,7654,3258,9521
261630,202102,6169,17237,5276,15580,364,1269,3556,10102,3920,11371
261640,202102,37329,82860,31772,76053,1901,3538,23907,59131,25808,62669
261650,202102,4161,10245,3547,9444,161,470,2668,7059,2829,7529
270010,202102,4354,14351,3787,13388,146,824,3047,10444,3193,11268
270020,202102,3881,9596,3400,8985,125,412,2917,7534,3042,7946
270030,202102,34033,91058,28349,81955,3384,9631,19166,55296,22550,64927
270040,202102,10767,28447,9254,26663,369,1274,7703,22084,8072,23358
270050,202102,5440,12604,4643,11701,241,549,4034,10249,4275,10798
270060,202102,2220,5531,1863,5126,154,369,1476,4128,1630,4497
270070,202102,4697,13046,4087,12205,126,459,3408,10014,3534,10473
270080,202102,1445,3883,1222,3500,48,145,935,2574,983,2719
270090,202102,1759,5328,1588,4995,65,260,1310,4022,1375,4282
270100,202102,5555,14293,4807,13208,196,623,3994,10802,4190,11425
270110,202102,3240,7430,2620,6720,151,310,2077,5600,2228,5910
270120,202102,2671,7319,2327,6863,71,304,1965,5695,2036,5999
270130,202102,5099,12873,4442,12086,128,381,3862,10526,3990,10907
270135,202102,2032,4840,1728,4501,36,123,1585,4089,1621,4212
270140,202102,9551,22154,7666,19557,344,1084,5992,14594,6336,15678
270150,202102,2699,8053,2463,7706,3,19,2326,7265,2329,7284
270160,202102,6234,16615,5298,15564,97,355,4885,14402,4982,14757
270170,202102,3347,9715,2825,8995,169,783,2157,6587,2326,7370
270180,202102,2223,6845,2044,6617,36,173,1856,5952,1892,6125
270190,202102,1669,4879,1489,4656,30,149,1321,4095,1351,4244
270200,202102,2379,7177,2077,6762,99,366,1540,5018,1639,5384
270210,202102,5803,13414,4949,12453,62,217,4575,11350,4637,11567
270220,202102,1608,4115,1283,3649,182,529,771,2176,953,2705
270230,202102,9176,25082,7619,22705,645,2049,5440,16158,6085,18207
270235,202102,5637,17284,4857,16048,116,522,4041,13215,4157,13737
270240,202102,10669,29058,8705,26327,984,3135,6005,18317,6989,21452
270250,202102,2779,6914,2441,6431,185,474,1942,5114,2127,5588
270255,202102,4389,12514,3460,10835,110,447,2675,8242,2785,8689
270260,202102,5515,16221,5000,15370,99,499,4383,13179,4482,13678
270270,202102,1047,2718,872,2505,100,289,643,1839,743,2128
270280,202102,3844,9161,3089,8218,482,749,2190,6294,2672,7043
270290,202102,7380,23332,6646,22123,155,741,5846,19240,6001,19981
270300,202102,4258,10912,3324,9900,184,463,2580,7895,2764,8358
270310,202102,6960,19258,5986,17738,83,449,5151,14895,5234,15344
270320,202102,5517,16072,4781,14660,378,1195,3430,10246,3808,11441
270330,202102,3964,12640,3529,11970,255,958,2739,9280,2994,10238
270340,202102,1565,4197,1350,3920,49,153,1149,3291,1198,3444
270350,202102,1894,4401,1550,4003,144,401,1111,2895,1255,3296
270360,202102,2622,6479,2341,6166,90,183,2148,5716,2238,5899
270370,202102,1393,4241,1277,4032,33,155,1090,3384,1123,3539
270375,202102,3124,7238,2589,6650,22,66,2427,6252,2449,6318
270380,202102,5478,15137,4612,14023,574,1648,3125,9861,3699,11509
270390,202102,1190,2967,966,2713,24,96,802,2249,826,2345
270400,202102,6377,16515,5370,15008,283,719,4216,11759,4499,12478
270410,202102,4566,12997,3961,12095,141,497,3317,10087,3458,10584
270420,202102,5507,16134,4944,15315,120,546,4303,13091,4423,13637
270430,202102,133578,313546,105195,277458,20444,55861,50149,134596,70593,190457
270440,202102,4681,12588,4051,11823,82,344,3564,10280,3646,10624
270450,202102,7077,18729,6209,17686,266,831,5204,15036,5470,15867
270460,202102,3749,8256,3220,7627,159,301,2891,6887,3050,7188
270470,202102,10982,30275,9563,28294,621,2024,7460,22048,8081,24072
270480,202102,2969,7736,2504,7069,90,327,2061,5692,2151,6019
270490,202102,950,2580,832,2437,52,155,671,1962,723,2117
270500,202102,4921,14851,4372,13943,280,1013,3440,10837,3720,11850
270510,202102,5452,14379,4590,13301,325,1268,3436,9501,3761,10769
270520,202102,3980,11184,3164,9813,647,2064,1294,4211,1941,6275
270530,202102,1308,3660,1106,3347,60,163,788,2428,848,2591
270540,202102,2254,6280,1942,5872,58,242,1701,5071,1759,5313
270550,202102,6726,17183,5350,15671,620,1457,3947,12079,4567,13536
270560,202102,2940,7539,2538,7008,119,381,2093,5724,2212,6105
270570,202102,4062,11320,3447,10410,122,382,2814,8454,2936,8836
270580,202102,2272,6332,2060,6031,107,323,1762,5130,1869,5453
270590,202102,1577,4736,1454,4571,16,82,1370,4283,1386,4365
270600,202102,2747,8419,2492,8037,48,237,2225,7105,2273,7342
270610,202102,3686,9438,3199,8803,99,266,2853,7833,2952,8099
270620,202102,1251,3713,1153,3531,28,118,1010,3014,1038,3132
270630,202102,17348,42100,14907,38748,609,1860,12445,31689,13054,33549
270640,202102,5284,15134,4606,14044,168,668,3792,11357,3960,12025
270642,202102,2497,7958,2218,7515,148,629,1702,5651,1850,6280
270644,202102,3602,8916,2972,8107,324,774,2183,6162,2507,6936
270650,202102,3109,9058,2736,8545,354,1160,1975,6172,2329,7332
270660,202102,2012,5071,1719,4650,76,258,1319,3510,1395,3768
270670,202102,16290,36978,13571,33656,361,1050,11654,28225,12015,29275
270680,202102,5609,13119,5017,12477,121,179,4691,11817,4812,11996
270690,202102,9256,22466,7767,20600,406,1087,6211,16352,6617,17439
270700,202102,519,1546,457,1443,35,126,337,1044,372,1170
270710,202102,5384,16149,4790,15237,224,914,3863,12094,4087,13008
270720,202102,3627,10427,3232,9769,55,309,2883,8535,2938,8844
270730,202102,8149,17845,7166,16802,253,475,5627,14643,5880,15118
270740,202102,2374,6176,2093,5852,92,304,1745,4816,1837,5120
270750,202102,5726,14856,5018,13958,76,359,4504,12427,4580,12786
270760,202102,3218,9012,2785,8438,42,213,2370,7098,2412,7311
270770,202102,21075,51008,16912,45923,2709,6536,10364,29800,13073,36336
270780,202102,1838,4901,1699,4708,70,232,1491,4084,1561,4316
270790,202102,1634,4375,1367,4013,113,344,1011,2945,1124,3289
270800,202102,11039,29530,9968,28017,330,1122,8600,23868,8930,24990
270810,202102,3357,9436,2658,8277,175,633,1863,5701,2038,6334
270820,202102,1568,4699,1334,4326,48,237,1056,3360,1104,3597
270830,202102,5031,12023,4071,10843,153,519,3324,8696,3477,9215
270840,202102,8235,24364,7353,23116,154,825,6457,19823,6611,20648
270850,202102,8985,21095,7931,19852,703,1918,6533,16135,7236,18053
270860,202102,14444,31541,11457,28196,586,1288,9297,22888,9883,24176
270870,202102,2167,6032,1791,5446,234,657,1158,3656,1392,4313
270880,202102,8070,23960,7210,22662,215,910,6028,18621,6243,19531
270890,202102,2911,7774,2436,7103,184,542,1676,4888,1860,5430
270895,202102,3128,9395,2844,9028,67,362,2530,7876,2597,8238
270900,202102,1776,4572,1349,3890,36,107,1057,3016,1093,3123
270910,202102,3838,10981,3307,10154,87,288,2727,8267,2814,8555
270915,202102,9475,26640,7656,23702,645,2260,5213,15798,5858,18058
270920,202102,5171,15772,4715,15000,132,594,3965,12277,4097,12871
270930,202102,17193,39375,13281,34843,1768,4215,8932,24693,10700,28908
270940,202102,6689,17114,5672,15905,200,783,4681,12809,4881,13592
280010,202102,695,1875,556,1591,16,67,393,1024,409,1091
280020,202102,4872,12207,4137,11055,447,1135,2814,7581,3261,8716
280030,202102,76368,177224,60784,155468,12345,31813,27832,73865,40177,105678
280040,202102,2892,8006,2532,7467,259,766,1720,5088,1979,5854
280050,202102,3886,10977,3343,10154,590,1839,1926,5835,2516,7674
280060,202102,5814,15052,4655,13275,889,2668,2178,6487,3067,9155
280067,202102,6985,16947,5955,15388,301,780,4393,11215,4694,11995
280070,202102,1888,5556,1757,5353,120,375,1455,4402,1575,4777
280100,202102,3994,10453,3370,9480,335,966,2298,6464,2633,7430
280110,202102,1411,3755,1245,3506,16,79,1106,3033,1122,3112
280120,202102,7621,21692,6799,20383,790,2149,4907,15174,5697,17323
280130,202102,8988,20965,7902,19448,406,1080,6410,15619,6816,16699
280140,202102,5453,12859,4828,12043,224,636,4079,10076,4303,10712
280150,202102,4164,10407,3617,9669,383,908,2733,7393,3116,8301
280160,202102,1198,3386,1013,3084,95,322,694,2070,789,2392
280170,202102,5119,13431,4599,12778,240,623,3721,10386,3961,11009
280190,202102,1289,2805,1152,2625,52,128,960,2140,1012,2268
280200,202102,1241,3213,1033,2927,63,220,783,2182,846,2402
280210,202102,16888,41457,14690,38340,1563,4152,9402,24625,10965,28777
280220,202102,1745,4613,1495,4287,47,210,1237,3508,1284,3718
280230,202102,4431,10932,3724,9901,330,711,2586,7028,2916,7739
280240,202102,3318,8784,2969,8250,43,224,2584,7001,2627,7225
280250,202102,918,2178,762,1942,82,219,522,1294,604,1513
280260,202102,2245,5320,1980,4989,40,94,1790,4554,1830,4648
280270,202102,2450,6483,2180,6076,159,415,1757,4902,1916,5317
280280,202102,4198,12254,3739,11566,511,1340,2591,8420,3102,9760
280290,202102,18293,47388,15723,43811,1308,3830,10639,29836,11947,33666
280300,202102,12395,28890,10858,27238,323,818,8020,22147,8343,22965
280310,202102,1396,3543,1166,3161,42,137,883,2322,925,2459
280320,202102,8618,23026,7484,21343,921,2545,4976,14172,5897,16717
280330,202102,4691,11494,4003,10552,249,702,2950,7754,3199,8456
280340,202102,5504,11554,4568,10543,233,406,3943,9274,4176,9680
280350,202102,26162,60629,23051,56556,1078,2774,18331,44180,19409,46954
280360,202102,5602,15366,4923,14248,730,2130,2898,8548,3628,10678
280370,202102,2107,5187,1783,4663,59,155,1422,3660,1481,3815
280380,202102,1012,2629,862,2427,76,205,590,1684,666,1889
280390,202102,3693,8889,3138,8041,171,365,2480,6398,2651,6763
280400,202102,3839,9594,3336,8912,527,1226,2051,5774,2578,7000
280410,202102,2295,6229,1867,5568,187,579,1092,3185,1279,3764
280420,202102,4324,11341,3993,10929,68,249,3679,10007,3747,10256
280430,202102,2070,4944,1824,4626,64,214,1495,3679,1559,3893
280440,202102,4283,11212,3785,10486,146,466,3204,8670,3350,9136
280445,202102,2340,5922,2098,5508,47,145,1587,4009,1634,4154
280450,202102,10226,23663,8893,21885,1045,2199,5811,14992,6856,17191
280460,202102,6882,16093,6224,15197,372,830,5296,12821,5668,13651
280470,202102,1696,4718,1452,4278,68,224,1083,3121,1151,3345
280480,202102,43901,104610,37944,96321,3146,8366,26967,67134,30113,75500
280490,202102,3780,10675,3252,9779,93,379,2511,7319,2604,7698
280500,202102,1014,2378,875,2194,27,87,745,1831,772,1918
280510,202102,2572,6378,2234,5909,115,340,1694,4422,1809,4762
280520,202102,1602,4063,1409,3798,59,164,1131,3001,1190,3165
280530,202102,2431,6051,2113,5610,289,647,1458,4017,1747,4664
280540,202102,8849,23515,8083,22424,249,821,7080,19415,7329,20236
280550,202102,6597,15172,5487,13631,159,573,4583,10978,4742,11551
280560,202102,7371,19922,6940,19281,125,456,6175,16926,6300,17382
280570,202102,6444,15526,5252,14021,230,689,3918,10480,4148,11169
280580,202102,5698,14790,4986,13763,586,1424,3536,9937,4122,11361
280590,202102,2857,6453,2449,5979,111,411,1943,4551,2054,4962
280600,202102,3548,9317,3144,8754,193,555,2250,6302,2443,6857
280610,202102,2445,5982,2203,5617,142,352,1798,4557,1940,4909
280620,202102,5498,13202,4741,12222,416,899,3327,8983,3743,9882
280630,202102,3853,10581,3549,10166,156,544,2931,8308,3087,8852
280640,202102,2317,6202,2047,5897,50,159,1827,5277,1877,5436
280650,202102,1200,3113,978,2784,84,280,714,1940,798,2220
280660,202102,3710,8037,3194,7437,236,411,2635,6273,2871,6684
280670,202102,19761,44446,17042,40963,1325,3100,13064,31445,14389,34545
280680,202102,2746,6533,2370,6004,224,423,1718,4436,1942,4859
280690,202102,978,2325,827,2129,52,118,657,1673,709,1791
280700,202102,1168,2909,1013,2678,23,86,810,2107,833,2193
280710,202102,15399,34186,13082,31553,559,1023,10996,27296,11555,28319
280720,202102,2679,6091,2233,5562,52,160,1659,4255,1711,4415
280730,202102,1084,2739,966,2556,50,149,730,1870,780,2019
280740,202102,14028,33896,12038,30903,739,2005,8756,21900,9495,23905
280750,202102,3639,10037,3173,9250,185,582,2296,6585,2481,7167
280760,202102,6487,16884,5652,15616,593,1492,3719,10623,4312,12115
290010,202102,3202,6659,2097,4957,5,16,1733,3929,1738,3945
290020,202102,5392,14110,4916,13514,343,623,4129,11776,4472,12399
290030,202102,4703,10499,3793,9506,180,399,3207,8156,3387,8555
290035,202102,5230,11150,4353,10030,347,515,3469,8316,3816,8831
290040,202102,4163,10122,3558,9400,107,279,2810,7847,2917,8126
290050,202102,2003,6433,1679,5733,115,477,1115,3706,1230,4183
290060,202102,1346,3134,998,2606,122,313,628,1648,750,1961
290070,202102,37364,80730,32209,74415,1821,4373,25189,57531,27010,61904
290080,202102,5246,15258,4544,14204,470,1539,3145,9957,3615,11496
290090,202102,2171,4144,1529,3461,16,46,1393,3137,1409,3183
290100,202102,9852,25337,8010,22636,1369,3617,4268,12747,5637,16364
290110,202102,5114,13421,4554,12571,317,890,3293,8996,3610,9886
290115,202102,3978,11409,3357,10313,249,783,2496,7667,2745,8450
290120,202102,6578,15993,5552,14571,129,416,4788,12367,4917,12783
290130,202102,4705,11378,3665,10019,158,440,2849,7801,3007,8241
290135,202102,4262,9925,3523,8750,158,425,2796,6708,2954,7133
290140,202102,4443,11517,3432,10184,91,330,2893,8555,2984,8885
290150,202102,2514,6342,2161,5909,133,351,1688,4654,1821,5005
290160,202102,3446,7694,3059,7168,254,526,2457,5767,2711,6293
290170,202102,3380,8466,2996,8052,112,271,2671,7284,2783,7555
290180,202102,2980,8071,2467,7237,74,269,2028,5890,2102,6159
290190,202102,4249,11699,3743,11010,138,512,3087,8959,3225,9471
290195,202102,2270,5643,1819,5053,26,135,1549,4265,1575,4400
290200,202102,4084,11270,3331,10019,166,553,2533,7551,2699,8104
290205,202102,3427,8755,3038,8191,134,459,2382,6222,2516,6681
290210,202102,12706,35329,11291,33196,836,2260,8785,26248,9621,28508
290220,202102,2920,7045,2563,6597,114,296,2115,5421,2229,5717
290225,202102,3192,6805,2481,6053,135,233,2118,5269,2253,5502
290230,202102,2443,6435,2230,6181,31,91,2009,5564,2040,5655
290240,202102,3730,9276,2975,8339,69,240,2512,7039,2581,7279
290250,202102,3966,11434,3321,10467,100,328,2741,8782,2841,9110
290260,202102,5492,13183,4639,11967,162,520,3908,9840,4070,10360
290265,202102,3557,10198,2902,8965,229,654,2025,6294,2254,6948
290270,202102,10806,36624,10100,35431,520,2232,8159,28417,8679,30649
290280,202102,6100,18025,5282,16416,290,999,3823,11762,4113,12761
290290,202102,9916,28457,8106,25195,789,2659,5364,16418,6153,19077
290300,202102,4172,11277,3098,9252,149,480,2234,6650,2383,7130
290310,202102,1620,3908,1294,3517,45,192,1036,2730,1081,2922
290320,202102,24200,62405,19268,55000,4237,11818,9167,27736,13404,39554
290323,202102,3722,10066,3252,9344,103,314,2567,7395,2670,7709
290327,202102,4081,11719,3515,10650,259,721,2538,7658,2797,8379
290330,202102,2261,4648,1765,4117,40,60,1579,3740,1619,3800
290340,202102,5713,13972,4338,12303,400,1138,3151,9071,3551,10209
290350,202102,4754,13078,3975,11762,281,827,2821,8411,3102,9238
290360,202102,5080,13112,4463,12316,140,343,3831,10675,3971,11018
290370,202102,5261,12654,3860,10821,201,474,2715,7792,2916,8266
290380,202102,5590,14749,4668,13492,118,283,3992,11756,4110,12039
290390,202102,14518,41156,12101,37320,1341,4044,7799,24497,9140,28541
290395,202102,2895,8210,2334,7261,56,269,1799,5515,1855,5784
290400,202102,3806,10084,3103,8925,96,354,2407,6781,2503,7135
290405,202102,4684,13469,4019,12340,299,941,2762,8664,3061,9605
290410,202102,5725,15337,4403,13237,118,508,3333,9771,3451,10279
290420,202102,3002,8180,2493,7395,68,229,1957,5767,2025,5996
290430,202102,3202,8606,2635,7730,232,697,1795,5183,2027,5880
290440,202102,2865,6977,2056,5716,51,123,1446,4108,1497,4231
290450,202102,3493,8762,2747,7632,150,377,1993,5620,2143,5997
290460,202102,11784,32953,9944,29505,2001,6041,4343,12923,6344,18964
290470,202102,4533,10986,3337,9342,401,1231,1902,5401,2303,6632
290475,202102,6528,18768,5551,17064,80,440,4592,13841,4672,14281
290480,202102,1773,4431,1449,3977,74,252,1031,2701,1105,2953
290485,202102,4531,13057,4010,12326,92,467,3461,10475,3553,10942
290490,202102,9032,21131,8114,19881,474,1026,6385,15903,6859,16929
290500,202102,4007,11898,3131,10051,535,1799,1358,4261,1893,6060
290510,202102,3499,8578,2932,7848,69,218,2556,6805,2625,7023
290515,202102,3663,10098,3186,9440,41,135,2879,8667,2920,8802
290520,202102,11561,32533,9009,27665,603,1959,5502,16731,6105,18690
290530,202102,4998,14169,4223,12915,125,501,3581,10874,3706,11375
290540,202102,3360,8730,3010,8347,45,140,2795,7746,2840,7886
290550,202102,4276,11163,3757,10549,11,61,3467,9839,3478,9900
290560,202102,6299,16197,4802,14023,386,1396,3171,8940,3557,10336
290570,202102,44398,108279,39399,101986,2445,6450,31728,81678,34173,88128
290580,202102,7909,22737,6830,21193,618,1823,5006,15980,5624,17803
290590,202102,7084,21542,5992,19604,148,557,4818,15857,4966,16414
290600,202102,19189,52272,16918,48609,714,2088,13659,39151,14373,41239
290610,202102,2590,7884,2040,6766,91,350,1437,4713,1528,5063
290620,202102,6201,17390,5373,16034,192,550,4530,13515,4722,14065
290630,202102,9328,22166,7465,19797,629,1587,5664,15237,6293,16824
290640,202102,2793,7086,2179,6213,103,287,1550,4547,1653,4834
290650,202102,12930,31662,11416,29972,2464,6173,7180,19727,9644,25900
290660,202102,3629,9288,3051,8455,53,150,2310,6599,2363,6749
290670,202102,6596,18093,5609,16485,363,1018,4270,12759,4633,13777
290680,202102,10956,29980,9184,27370,188,979,7646,22350,7834,23329
290682,202102,4767,12167,4135,11328,127,289,3490,9663,3617,9952
290685,202102,3493,7800,2525,6424,214,481,1527,4182,1741,4663
290687,202102,6436,17322,5260,15423,670,1877,3408,10270,4078,12147
290689,202102,2883,7850,2202,6607,189,607,1490,4473,1679,5080
290690,202102,5306,13759,4317,12385,283,885,3158,8915,3441,9800
290700,202102,2700,7146,2385,6743,52,191,2067,5832,2119,6023
290710,202102,8235,23017,7084,21429,182,652,5967,18114,6149,18766
290720,202102,18450,50070,16798,47558,894,2809,13571,37951,14465,40760
290730,202102,7046,16619,6009,15423,294,580,4709,12338,5003,12918
290740,202102,1005,2715,790,2367,38,119,648,1950,686,2069
290750,202102,10906,26914,9466,24676,619,1725,7048,17870,7667,19595
290755,202102,2008,5660,1635,4988,88,263,1156,3577,1244,3840
290760,202102,3680,10708,3004,9434,169,490,2054,6660,2223,7150
290770,202102,2691,8340,2466,8058,48,230,2087,6895,2135,7125
290780,202102,8201,20197,7108,18770,261,575,5550,15031,5811,15606
290790,202102,4625,12743,4029,11882,167,470,3298,9879,3465,10349
290800,202102,7045,14445,4986,12043,282,634,3737,9099,4019,9733
290810,202102,5285,13739,4283,12290,112,347,3280,9608,3392,9955
290820,202102,4779,12862,4322,12231,177,513,3275,9399,3452,9912
290830,202102,4510,10203,3992,9547,24,73,3511,8278,3535,8351
290840,202102,17297,44943,14786,41066,1997,4574,9375,27828,11372,32402
290850,202102,6642,15802,5933,15047,224,527,5083,13040,5307,13567
290860,202102,6177,17389,5382,16483,212,657,4556,14244,4768,14901
290870,202102,4724,12935,3596,10793,147,451,2521,7528,2668,7979
290880,202102,1385,3401,1113,3047,73,185,753,2166,826,2351
290890,202102,9392,18743,8491,17747,165,351,7954,16542,8119,16893
290900,202102,2431,6245,1888,5300,114,253,1177,3309,1291,3562
290910,202102,5172,12218,3968,10395,45,133,3392,8806,3437,8939
290920,202102,5149,12821,4674,12274,86,131,4375,11678,4461,11809
290930,202102,7538,20879,6124,18429,209,844,4772,13992,4981,14836
290940,202102,3590,10091,3023,9270,166,549,2433,7451,2599,8000
290950,202102,1449,3627,1182,3226,69,188,828,2271,897,2459
290960,202102,5662,14357,5090,13652,192,458,4321,11641,4513,12099
290970,202102,3238,9528,2661,8484,101,376,2059,6571,2160,6947
290980,202102,12173,28735,10246,25866,775,2127,6474,15872,7249,17999
290990,202102,9665,25375,8603,23683,261,1011,7252,19337,7513,20348
291000,202102,3366,8576,2612,7624,112,337,2146,6330,2258,6667
291005,202102,15384,37590,13604,35304,1407,3243,10377,27306,11784,30549
291010,202102,3068,9168,2512,7981,121,421,1654,5119,1775,5540
291020,202102,1250,3031,1009,2613,26,87,738,1802,764,1889
291030,202102,2528,6094,1784,4824,117,278,1098,2921,1215,3199
291040,202102,5367,14544,4495,13328,151,554,3573,10556,3724,11110
291050,202102,7579,19428,6463,17919,615,1871,4721,12917,5336,14788
291060,202102,6079,18196,5151,16954,307,1298,3915,12815,4222,14113
291070,202102,16165,42893,13567,38749,410,1366,11109,31551,11519,32917
291072,202102,24428,61340,17761,50285,3190,9335,7743,22068,10933,31403
291075,202102,5406,13215,4881,12433,106,268,4116,10327,4222,10595
291077,202102,1647,4236,1285,3607,59,117,914,2583,973,2700
291080,202102,111714,269634,88028,237044,25421,69963,24779,72602,50200,142565
291085,202102,5580,14015,4702,12662,169,504,3935,10575,4104,11079
291090,202102,1989,3757,1435,3135,43,92,1163,2495,1206,2587
291100,202102,3225,6971,2239,5802,102,269,1717,4406,1819,4675
291110,202102,5941,17522,5072,16074,293,1169,3911,11966,4204,13135
291120,202102,7609,18387,6417,16892,303,822,4966,13062,5269,13884
291125,202102,2223,3854,1690,3269,90,128,1376,2704,1466,2832
291130,202102,3307,9275,2451,7611,61,284,1835,5500,1896,5784
291140,202102,4900,13029,3574,10656,467,1260,2175,6521,2642,7781
291150,202102,2478,5355,1904,4709,4,12,1798,4443,1802,4455
291160,202102,5050,13722,4201,12510,362,1143,2841,8417,3203,9560
291165,202102,2152,5813,1618,4761,25,109,1203,3440,1228,3549
291170,202102,20906,52398,17478,46701,931,2724,11642,30521,12573,33245
291180,202102,6371,14444,4672,12226,242,611,3659,9584,3901,10195
291185,202102,3025,8075,2664,7509,95,279,2060,5836,2155,6115
291190,202102,7696,18579,6359,16880,275,816,5067,13433,5342,14249
291200,202102,2819,7618,2092,6252,81,254,1314,3768,1395,4022
291210,202102,7042,14954,5257,12908,134,436,3876,9582,4010,10018
291220,202102,4141,11553,3744,10969,195,649,2989,8685,3184,9334
291230,202102,4466,9486,3373,8295,36,87,3057,7583,3093,7670
291240,202102,4149,10581,3537,9554,58,201,3043,8114,3101,8315
291250,202102,3348,9768,2621,8441,141,423,1702,5524,1843,5947
291260,202102,1456,3386,1194,3043,28,87,982,2522,1010,2609
291270,202102,5400,13784,4197,12066,585,1673,2681,7871,3266,9544
291280,202102,2633,6256,1940,5258,152,421,1251,3357,1403,3778
291290,202102,5775,15030,4458,13006,336,1040,3053,8862,3389,9902
291300,202102,3776,10192,2983,8887,113,396,2291,6736,2404,7132
291310,202102,5040,13318,4326,12039,117,364,3660,10075,3777,10439
291320,202102,6033,16593,4714,14173,1041,2927,2338,7472,3379,10399
291330,202102,1799,4546,1504,4067,74,185,1145,3052,1219,3237
291340,202102,4312,10964,3486,9546,81,259,2670,7203,2751,7462
291345,202102,2923,8646,2657,8235,97,331,2247,6977,2344,7308
291350,202102,6855,16701,5342,14896,46,148,4660,13214,4706,13362
291360,202102,36705,83267,28886,73960,2711,6819,19107,50179,21818,56998
291370,202102,8124,21795,7172,20343,537,1591,5336,14881,5873,16472
291380,202102,3390,9175,2986,8630,100,406,2505,7173,2605,7579
291390,202102,13252,28099,10213,24747,432,988,8457,20528,8889,21516
291400,202102,13734,34766,11346,31231,1511,3641,6778,20120,8289,23761
291410,202102,2998,7768,2355,6670,36,146,1734,4821,1770,4967
291420,202102,1986,4745,1558,4222,22,90,1383,3725,1405,3815
291430,202102,2733,7657,2369,7060,65,282,1912,5521,1977,5803
291440,202102,6421,18175,5577,16791,326,1021,4340,13115,4666,14136
291450,202102,9875,22882,8154,20916,73,129,7225,19008,7298,19137
291460,202102,15728,41138,13800,38289,675,2062,10460,28810,11135,30872
291465,202102,9300,22528,7321,20274,123,546,6376,17526,6499,18072
291470,202102,17325,37956,14446,34694,831,1731,10684,26475,11515,28206
291480,202102,42081,92247,31291,77766,3658,9326,16690,41531,20348,50857
291490,202102,5506,13601,4739,12737,133,433,4283,11445,4416,11878
291500,202102,5035,12180,4235,11115,59,256,3891,10158,3950,10414
291510,202102,4342,10571,3234,9188,46,266,2721,7650,2767,7916
291520,202102,4529,10156,3412,8689,188,505,2643,6673,2831,7178
291530,202102,2356,5259,1679,4390,312,731,916,2667,1228,3398
291535,202102,3387,9846,2984,9141,160,444,2299,7271,2459,7715
291540,202102,2261,4981,1559,4154,70,218,1282,3389,1352,3607
291550,202102,5650,12809,4399,11245,412,853,2985,7863,3397,8716
291560,202102,18425,43268,13421,36681,1475,3831,7828,22401,9303,26232
291570,202102,2391,5647,1885,5028,53,153,1563,4311,1616,4464
291580,202102,6351,16163,4992,14359,242,744,3674,10511,3916,11255
291590,202102,2206,5259,1923,4938,69,230,1715,4315,1784,4545
291600,202102,5411,12421,4176,10555,359,961,2881,7056,3240,8017
291610,202102,5596,14452,5016,13817,67,258,4620,12690,4687,12948
291620,202102,3132,6965,2361,6127,109,264,1834,4878,1943,5142
291630,202102,3401,7424,2552,6330,297,800,1840,4496,2137,5296
291640,202102,16422,39268,12416,33559,1763,4423,5847,16325,7610,20748
291650,202102,9423,23243,8365,22000,561,1025,7023,19021,7584,20046
291660,202102,2050,4965,1512,4153,140,416,977,2557,1117,2973
291670,202102,2037,5353,1721,4902,97,244,1306,3778,1403,4022
291680,202102,4059,9818,3296,8744,308,833,2344,6212,2652,7045
291685,202102,4823,11388,3863,10141,215,447,2946,7975,3161,8422
291690,202102,4147,9059,2900,7269,273,550,2168,5522,2441,6072
291700,202102,8712,24783,7689,23016,334,1135,6267,18459,6601,19594
291710,202102,5221,12259,3895,10431,215,652,2831,7469,3046,8121
291720,202102,4468,13341,3757,11923,578,1883,2248,7030,2826,8913
291730,202102,6311,15871,5449,14752,256,762,4538,12215,4794,12977
291733,202102,2790,7106,2388,6585,55,154,1754,5091,1809,5245
291735,202102,2955,7726,2374,6703,73,172,1813,5084,1886,5256
291740,202102,3967,10151,2947,8262,94,227,2048,5714,2142,5941
291750,202102,19798,46431,16217,41256,1635,4011,10848,28074,12483,32085
291760,202102,10283,29192,8069,25703,2426,8731,2240,7118,4666,15849
291770,202102,7167,18975,6029,17041,320,995,4598,12669,4918,13664
291780,202102,5188,13595,4675,12888,87,308,4102,11208,4189,11516
291790,202102,2750,7457,2497,7136,232,547,1884,5573,2116,6120
291800,202102,29203,72375,21837,61581,3571,9721,10488,30956,14059,40677
291810,202102,10551,24799,8883,22780,310,746,7454,19375,7764,20121
291820,202102,3901,10020,3406,9381,91,278,2770,7637,2861,7915
291830,202102,4538,10486,3721,9400,203,404,2946,7485,3149,7889
291835,202102,6552,19414,5180,16816,511,1755,3332,10971,3843,12726
291840,202102,47440,128942,41365,119620,4195,12964,29249,83996,33444,96960
291845,202102,2524,6474,1985,5814,120,358,1595,4737,1715,5095
291850,202102,3814,10858,3152,9771,235,706,2286,7264,2521,7970
291855,202102,2239,4303,1734,3745,37,87,1568,3396,1605,3483
291860,202102,2273,5869,1584,4546,47,129,1076,2975,1123,3104
291870,202102,1286,3211,865,2477,39,112,596,1684,635,1796
291875,202102,2978,8782,2573,7946,61,250,1913,5726,1974,5976
291880,202102,5682,15917,4828,14494,223,642,3594,10889,3817,11531
291890,202102,1623,3287,1054,2632,135,297,697,1766,832,2063
291900,202102,1309,3021,1013,2575,19,67,801,1979,820,2046
291905,202102,2399,6107,1983,5458,76,274,1531,4064,1607,4338
291910,202102,3025,7411,2565,6852,57,200,2195,6015,2252,6215
291915,202102,7276,20496,5941,18263,213,748,4492,13968,4705,14716
291920,202102,26224,67201,22225,61753,2009,6107,15651,42643,17660,48750
291930,202102,2492,6614,2141,6142,225,651,1465,4248,1690,4899
291940,202102,3960,9912,2667,7743,202,569,1574,4552,1776,5121
291950,202102,9065,27231,7703,24623,271,1013,5398,17080,5669,18093
291955,202102,15191,38138,13490,35953,1096,3079,10621,28356,11717,31435
291960,202102,3000,7907,2523,7270,124,362,1969,5817,2093,6179
291970,202102,4584,11368,3846,10473,130,430,2964,8086,3094,8516
291980,202102,9523,27024,7614,23702,1058,3048,4608,14776,5666,17824
291990,202102,2331,5945,1915,5445,29,117,1770,5038,1799,5155
291992,202102,3841,9247,3102,8303,237,530,2458,6733,2695,7263
291995,202102,2123,5787,1757,5191,50,212,1350,3910,1400,4122
292000,202102,2637,6075,2154,5504,83,287,1716,4350,1799,4637
292010,202102,5717,13208,4691,11773,149,402,3948,9730,4097,10132
292020,202102,4594,13067,3823,11719,186,667,2834,8415,3020,9082
292030,202102,1794,5452,1630,5147,81,288,1065,3301,1146,3589
292040,202102,4475,11244,3504,9793,221,565,2672,7622,2893,8187
292045,202102,4099,10473,3046,8931,32,89,2696,8061,2728,8150
292050,202102,6493,17935,5286,15859,240,825,3421,10132,3661,10957
292060,202102,11141,25662,10290,24611,449,1015,9033,21405,9482,22420
292070,202102,5701,14752,4977,13897,287,818,4285,11883,4572,12701
292080,202102,3037,7676,2538,7032,76,265,2254,6183,2330,6448
292090,202102,4545,9810,3203,8196,227,605,2409,6192,2636,6797
292100,202102,11024,26465,9478,24557,981,2598,6536,16991,7517,19589
292105,202102,3664,8820,3199,8195,85,188,2684,6885,2769,7073
292110,202102,6028,14375,4284,11667,906,2521,2094,5694,3000,8215
292120,202102,6942,17534,5772,15621,349,964,4375,11668,4724,12632
292130,202102,3441,8137,2849,7410,106,316,2221,5712,2327,6028
292140,202102,4973,11687,4218,10570,310,776,3365,8404,3675,9180
292145,202102,2360,6730,1999,6119,77,197,1544,4782,1621,4979
292150,202102,14671,38873,12749,35791,288,1073,10461,28851,10749,29924
292160,202102,2998,7170,2258,6220,36,97,1835,5316,1871,5413
292170,202102,8485,22264,7114,20070,339,1084,5417,14995,5756,16079
292180,202102,2857,7755,2119,6389,156,469,1318,3911,1474,4380
292190,202102,2900,7593,2479,6956,87,301,1958,5442,2045,5743
292200,202102,8763,21252,6546,18173,1126,3222,3207,9293,4333,12515
292205,202102,3820,10488,3321,9754,56,251,2897,8480,2953,8731
292210,202102,6602,15078,5344,13499,77,317,4833,12093,4910,12410
292220,202102,2205,5097,1939,4699,54,131,1542,3616,1596,3747
292225,202102,3151,9135,2784,8578,67,312,2393,7233,2460,7545
292230,202102,8688,20519,7801,19409,157,502,6750,16533,6907,17035
292240,202102,4689,13501,4139,12528,306,901,2924,8881,3230,9782
292250,202102,5982,15031,5386,14169,399,1028,4100,10723,4499,11751
292260,202102,3390,8742,3022,8265,91,243,2635,7218,2726,7461
292265,202102,3425,9147,2882,8325,63,270,2324,6589,2387,6859
292270,202102,4329,9888,3447,8840,111,271,2875,7396,2986,7667
292273,202102,2805,5905,2247,5233,52,86,1645,4116,1697,4202
292275,202102,1613,4176,1271,3726,56,161,966,2881,1022,3042
292280,202102,2662,6171,2144,5578,83,158,1809,4841,1892,4999
292285,202102,2560,6134,2059,5461,77,160,1687,4515,1764,4675
292290,202102,7585,19525,6005,17339,162,572,4949,14235,5111,14807
292300,202102,10565,25870,8348,22936,803,2316,5758,15892,6561,18208
292303,202102,2938,8294,2557,7686,80,191,2136,6489,2216,6680
292305,202102,2269,6039,2100,5812,43,189,1904,5186,1947,5375
292310,202102,6821,16764,5920,15683,135,411,5220,13694,5355,14105
292320,202102,6090,16498,4853,14221,271,876,3522,10052,3793,10928
292330,202102,2748,5964,2235,5386,106,185,1730,4374,1836,4559
292335,202102,4740,12245,4208,11469,209,498,3557,9788,3766,10286
292340,202102,5469,15286,4552,13554,212,601,3369,9980,3581,10581
292350,202102,2500,6737,2097,6184,76,281,1711,5063,1787,5344
292360,202102,4912,12955,4105,11601,238,735,2887,8059,3125,8794
292370,202102,10252,23940,8861,22148,112,385,8254,20390,8366,20775
292380,202102,6712,18670,6030,17463,379,1120,4648,13340,5027,14460
292390,202102,4611,8655,3414,7264,130,238,2991,6372,3121,6610
292400,202102,22233,62331,19239,57636,1878,5671,13233,39947,15111,45618
292405,202102,4543,10833,3838,9729,79,190,3213,8038,3292,8228
292410,202102,2231,5258,1851,4777,67,147,1628,4234,1695,4381
292420,202102,3346,10066,3075,9666,99,491,2690,8240,2789,8731
292430,202102,4820,14260,3656,12142,270,907,2383,7966,2653,8873
292440,202102,8572,26750,7954,25819,123,608,7157,23100,7280,23708
292450,202102,4059,11425,3186,9756,89,327,2503,7609,2592,7936
292460,202102,4970,13325,4088,11874,297,814,3047,8867,3344,9681
292465,202102,2690,6796,2307,6313,97,203,1546,4669,1643,4872
292467,202102,1917,5305,1684,4988,256,655,1163,3607,1419,4262
292470,202102,2907,7328,2266,6349,55,113,1777,4990,1832,5103
292480,202102,6287,14695,5130,13296,74,278,4661,11976,4735,12254
292490,202102,2082,5297,1769,4840,120,268,1348,3780,1468,4048
292500,202102,6588,17738,5277,15462,475,1470,3452,9998,3927,11468
292510,202102,13436,35417,10517,30853,532,1722,7414,21704,7946,23426
292520,202102,7115,17448,6306,16307,425,1139,4976,12730,5401,13869
292525,202102,5998,14045,4922,12846,122,262,4291,11382,4413,11644
292530,202102,28471,74072,22088,63563,5070,14759,9043,26613,14113,41372
292540,202102,4355,7951,3414,6949,120,205,3083,6299,3203,6504
292550,202102,8361,21360,6444,19080,505,1403,4500,14329,5005,15732
292560,202102,4454,10954,3871,10188,101,264,3197,8499,3298,8763
292570,202102,3604,9404,3041,8358,67,246,2584,6937,2651,7183
292575,202102,6871,19426,6318,18704,400,1133,5068,15195,5468,16328
292580,202102,7599,18905,6294,16991,128,414,5329,14234,5457,14648
292590,202102,7379,19484,6277,17580,283,877,5133,14173,5416,15050
292593,202102,2839,7008,2367,6237,67,171,2000,5220,2067,5391
292595,202102,5405,14206,4616,13243,140,475,3908,11149,4048,11624
292600,202102,10762,29098,9331,26924,338,948,7487,21689,7825,22637
292610,202102,4185,10751,3571,9684,183,407,2716,7457,2899,7864
292620,202102,6395,17311,5315,16011,128,280,4823,14850,4951,15130
292630,202102,8556,20676,6899,18067,738,1907,4383,11615,5121,13522
292640,202102,8345,23968,7245,22149,190,692,5226,16137,5416,16829
292650,202102,4452,10946,4011,10377,106,288,3659,9369,3765,9657
292660,202102,11393,30330,9684,27856,460,1421,7387,21332,7847,22753
292665,202102,2194,6390,1897,5997,63,180,1590,5111,1653,5291
292670,202102,3551,9507,2757,8041,121,366,1871,5356,1992,5722
292680,202102,3944,10278,3133,8872,173,449,2315,6439,2488,6888
292690,202102,2624,6677,1821,5376,198,535,1085,3358,1283,3893
292700,202102,9994,26789,8747,24887,763,1867,6034,17818,6797,19685
292710,202102,2618,7726,2440,7489,36,108,2240,6896,2276,7004
292720,202102,9097,21290,7682,19658,209,542,6137,16011,6346,16553
292730,202102,4795,10808,4445,10312,324,537,3719,8855,4043,9392
292740,202102,315807,752634,272046,691311,36940,93510,171106,433639,208046,527149
292750,202102,6070,16148,5352,15127,220,633,4175,12003,4395,12636
292760,202102,3868,11022,3379,10166,208,682,2494,7443,2702,8125
292770,202102,6346,16160,5137,14498,739,2130,3345,9684,4084,11814
292780,202102,2106,4083,1566,3438,69,166,1257,2639,1326,2805
292790,202102,4086,8521,3109,7462,171,368,2560,6220,2731,6588
292800,202102,11317,28103,9697,25661,305,846,8132,21265,8437,22111
292805,202102,3703,8659,2919,7656,115,324,2324,6040,2439,6364
292810,202102,10661,27407,8511,24041,273,953,6424,17633,6697,18586
292820,202102,7357,20177,5413,16898,410,1357,3783,11647,4193,13004
292830,202102,2933,6812,2509,6292,87,225,2135,5394,2222,5619
292840,202102,8618,22475,7315,20728,141,517,6409,17909,6550,18426
292850,202102,2474,6520,2085,5962,149,442,1460,4153,1609,4595
292860,202102,16917,37008,15216,35027,383,969,13245,30109,13628,31078
292870,202102,18355,44553,15858,41143,990,2541,10988,28180,11978,30721
292880,202102,10845,29393,9258,27016,249,1020,7332,20706,7581,21726
292890,202102,7181,19453,6356,18289,169,673,5605,16010,5774,16683
292895,202102,3131,6481,2334,5318,110,232,1893,4276,2003,4508
292900,202102,2628,6947,2385,6578,53,205,1984,5325,2037,5530
292905,202102,4286,10889,3425,9626,108,347,2593,7219,2701,7566
292910,202102,4789,12916,4380,12345,208,575,3399,9527,3607,10102
292920,202102,9674,26391,8974,25428,262,955,7713,21527,7975,22482
292925,202102,5406,15179,4541,13640,223,637,3262,9775,3485,10412
292930,202102,6369,18468,5530,16970,459,1552,3583,10762,4042,12314
292935,202102,2506,6119,1940,5490,17,92,1750,4970,1767,5062
292937,202102,2763,6903,2393,6425,64,173,2009,5407,2073,5580
292940,202102,2809,7075,2242,6246,171,388,1634,4745,1805,5133
292950,202102,9338,23458,8171,21788,515,1177,6170,16453,6685,17630
292960,202102,5192,12477,4351,11297,126,310,3486,8981,3612,9291
292970,202102,3810,10758,3384,10121,76,349,2849,8525,2925,8874
292975,202102,4431,9374,3945,8839,114,187,3606,8172,3720,8359
292980,202102,3364,7855,2745,6956,82,238,2303,5746,2385,5984
292990,202102,11190,30751,9411,27606,618,1896,6895,19942,7513,21838
293000,202102,2681,6213,2303,5650,40,136,1857,4559,1897,4695
293010,202102,18120,45914,14692,40658,1847,5308,9023,24985,10870,30293
293015,202102,8302,25103,6592,21834,441,1578,4362,14775,4803,16353
293020,202102,9802,28154,8833,26780,128,533,7982,24243,8110,24776
293030,202102,5201,13533,3995,11671,110,327,2759,8287,2869,8614
293040,202102,4433,11402,3734,10415,67,246,3282,9116,3349,9362
293050,202102,22693,54434,20072,50584,1153,2855,15230,37907,16383,40762
293060,202102,3527,9286,2862,8051,245,723,1978,5470,2223,6193
293070,202102,24805,59331,21780,55532,1903,5065,16301,41414,18204,46479
293075,202102,3570,11058,3108,10270,143,624,2501,8236,2644,8860
293076,202102,3521,8527,3221,8178,53,122,2892,7417,2945,7539
293077,202102,6387,17293,5154,15347,460,1463,3208,9977,3668,11440
293080,202102,4804,13902,4132,12751,85,383,3368,10187,3453,10570
293090,202102,3249,9310,2511,8095,219,681,1618,5318,1837,5999
293100,202102,5797,15190,4808,13437,203,565,3804,10538,4007,11103
293105,202102,3776,11895,3311,10942,243,818,2321,7637,2564,8455
293110,202102,2397,5913,1994,5330,65,225,1639,4290,1704,4515
293120,202102,4397,11811,3929,11090,134,327,3263,9259,3397,9586
293130,202102,3689,10086,3226,9486,69,260,2804,8170,2873,8430
293135,202102,30215,69795,22543,59840,3354,9717,10878,29165,14232,38882
293140,202102,2425,5248,2114,4877,55,108,1806,4165,1861,4273
293150,202102,5469,16092,4506,14293,322,1030,3093,9872,3415,10902
293160,202102,3761,9183,3206,8581,236,381,2701,7589,2937,7970
293170,202102,4972,10222,4350,9461,112,224,3829,8288,3941,8512
293180,202102,4339,12105,3617,10789,76,302,2884,8398,2960,8700
293190,202102,14152,37905,12549,35632,127,563,11229,31648,11356,32211
293200,202102,8478,20765,6859,18206,178,601,5581,14545,5759,15146
293210,202102,5139,13484,4433,12399,275,768,3438,9610,3713,10378
293220,202102,4852,12298,3583,10215,824,2355,1481,4355,2305,6710
293230,202102,3866,9782,2856,8367,211,646,1978,5877,2189,6523
293240,202102,4574,11873,3689,10443,71,152,2794,8261,2865,8413
293245,202102,3783,10211,3441,9716,143,453,2932,8181,3075,8634
293250,202102,5942,13651,4852,12266,162,399,4051,10251,4213,10650
293260,202102,4696,12257,3893,11002,153,441,2705,7723,2858,8164
293270,202102,7268,15816,5752,14198,404,578,4513,12024,4917,12602
293280,202102,4405,11530,3875,10789,236,585,3027,8555,3263,9140
293290,202102,14831,41885,13130,39262,1590,4838,8901,26824,10491,31662
293300,202102,5720,13759,4935,12625,277,682,3639,9394,3916,10076
293305,202102,4137,9650,3636,9046,61,127,3290,8208,3351,8335
293310,202102,2070,5262,1756,4784,48,144,1405,3792,1453,3936
293315,202102,4157,9640,3454,8591,207,457,2830,7049,3037,7506
293317,202102,2666,6175,2384,5790,150,270,1886,4604,2036,4874
293320,202102,12231,28867,10839,27331,224,633,9775,24485,9999,25118
293325,202102,1737,4236,1347,3727,207,558,814,2305,1021,2863
293330,202102,60345,166397,49272,147236,8541,26471,23523,69927,32064,96398
293340,202102,2182,6089,1814,5440,77,248,1291,3843,1368,4091
293345,202102,3582,9615,2869,8523,382,891,1807,5930,2189,6821
293350,202102,6512,18669,5631,17622,59,294,5149,16321,5208,16615
293360,202102,15116,37740,12890,34770,283,1175,11391,30181,11674,31356
310010,202102,950,2107,614,1646,45,164,233,581,278,745
310020,202102,2711,7194,2027,5999,433,1389,462,1302,895,2691
310030,202102,1896,5241,1460,4494,210,714,945,2804,1155,3518
310040,202102,872,2255,696,1953,31,126,472,1226,503,1352
310050,202102,1472,4345,1229,3964,117,481,819,2544,936,3025
310060,202102,3099,8715,2700,8179,74,300,2260,6778,2334,7078
310070,202102,340,762,241,622,11,23,178,457,189,480
310080,202102,675,1775,484,1432,71,231,231,643,302,874
310090,202102,4731,12261,3909,10938,277,818,2892,7973,3169,8791
310100,202102,3529,9527,2987,8640,65,298,2479,6981,2544,7279
310110,202102,4625,11975,3604,10232,733,2270,1640,4476,2373,6746
310120,202102,631,1507,403,1149,40,131,245,655,285,786
310130,202102,365,936,310,857,26,101,235,621,261,722
310140,202102,264,754,188,630,41,159,70,204,111,363
310150,202102,5591,14420,4180,11873,509,1650,2045,5480,2554,7130
310160,202102,8031,19699,5790,16037,1049,3179,2134,5923,3183,9102
310163,202102,1006,2989,821,2648,185,679,273,809,458,1488
310170,202102,9396,23487,7528,20613,642,1791,5317,14557,5959,16348
310180,202102,1781,4347,1309,3585,156,454,767,2060,923,2514
310190,202102,2668,7641,2172,6746,484,1685,358,1045,842,2730
310200,202102,1885,5484,1383,4523,162,606,679,2185,841,2791
310205,202102,1109,3019,888,2678,131,446,489,1456,620,1902
310210,202102,2555,6790,2120,6028,106,310,1528,4244,1634,4554
310220,202102,1266,3409,979,2853,78,246,654,1830,732,2076
310230,202102,2206,6016,1781,5236,219,703,1129,3099,1348,3802
310240,202102,998,2975,849,2718,48,175,605,1883,653,2058
310250,202102,1061,2778,858,2446,18,75,613,1732,631,1807
310260,202102,3145,7999,2095,6179,597,2040,648,1553,1245,3593
310270,202102,2742,6596,2201,5868,86,270,1830,4862,1916,5132
310280,202102,2478,5671,1941,4905,251,671,1172,2851,1423,3522
310285,202102,1880,5861,1566,5305,155,568,968,3267,1123,3835
310290,202102,1118,2895,911,2539,190,606,480,1205,670,1811
310300,202102,1516,4336,1290,3951,136,512,755,2148,891,2660
310310,202102,314,747,199,546,37,103,96,256,133,359
310320,202102,527,1318,364,1068,23,83,202,561,225,644
310330,202102,485,1128,297,804,43,136,120,289,163,425
310340,202102,8048,20969,6533,18454,848,2373,3379,9680,4227,12053
310350,202102,12729,30263,8817,24072,1434,4205,4207,11040,5641,15245
310360,202102,513,1159,396,1010,12,35,272,693,284,728
310370,202102,1281,3892,1096,3552,206,736,355,1217,561,1953
310375,202102,860,2126,605,1747,98,285,324,942,422,1227
310380,202102,398,898,219,615,33,98,102,268,135,366
310390,202102,454,1339,364,1165,81,268,104,296,185,564
310400,202102,10472,25298,7657,21064,677,2158,4779,12813,5456,14971
310410,202102,857,2452,566,1921,83,313,225,711,308,1024
310420,202102,4383,11279,3054,8800,389,1251,1294,3454,1683,4705
310430,202102,1476,3936,984,3030,201,686,365,985,566,1671
310440,202102,672,1745,467,1366,42,145,250,678,292,823
310445,202102,1391,3888,1022,3152,59,172,730,2218,789,2390
310450,202102,4542,11312,3447,9600,136,505,2647,7158,2783,7663
310460,202102,1750,4604,1322,3815,215,674,488,1301,703,1975
310470,202102,3687,8079,2894,7043,282,660,2043,5120,2325,5780
310480,202102,987,2513,771,2165,89,266,482,1309,571,1575
310490,202102,2826,7612,2242,6672,236,845,1279,3571,1515,4416
310500,202102,1326,3688,1007,3158,173,615,538,1623,711,2238
310510,202102,2095,5374,1405,4122,247,800,530,1554,777,2354
310520,202102,1169,3025,859,2470,145,405,448,1294,593,1699
310530,202102,740,1842,495,1420,65,221,175,415,240,636
310540,202102,2968,8303,2460,7417,504,1603,1126,3256,1630,4859
310550,202102,1271,3180,905,2574,75,274,514,1351,589,1625
310560,202102,14990,38603,10761,31218,1425,4689,4759,12476,6184,17165
310570,202102,1034,2692,817,2390,55,198,609,1751,664,1949
310590,202102,4055,10685,3241,9152,191,606,1883,5007,2074,5613
310600,202102,1335,3856,1102,3387,141,490,584,1707,725,2197
310610,202102,477,1271,303,984,113,380,41,116,154,496
310620,202102,174554,436777,128083,354449,16796,53947,64769,163155,81565,217102
310630,202102,4533,12220,3567,10341,352,1081,2195,6161,2547,7242
310640,202102,1096,3214,903,2843,181,615,372,1122,553,1737
310650,202102,2429,6726,1784,5493,170,565,1070,3172,1240,3737
310660,202102,1312,3477,1073,3154,28,94,911,2662,939,2756
310665,202102,1430,3603,1162,3225,22,89,953,2673,975,2762
310670,202102,58958,149184,49976,134131,4421,13445,34640,88629,39061,102074
310680,202102,767,1784,638,1607,18,64,547,1327,565,1391
310690,202102,2000,5095,1448,4171,109,357,841,2297,950,2654
310700,202102,481,1049,384,932,21,68,309,724,330,792
310710,202102,5685,15888,4201,13685,854,3275,798,2327,1652,5602
310720,202102,1051,2396,822,2109,28,85,631,1567,659,1652
310730,202102,10247,26652,8779,24349,356,1223,6602,17892,6958,19115
310740,202102,6408,17252,4631,13674,648,2140,1813,4836,2461,6976
310750,202102,1239,2964,943,2539,102,314,521,1302,623,1616
310760,202102,656,1655,464,1361,34,110,250,740,284,850
310770,202102,1094,2893,758,2386,79,305,396,1142,475,1447
310780,202102,4274,10082,3562,9156,65,176,2929,7536,2994,7712
310790,202102,1807,5645,1553,5103,347,1217,256,741,603,1958
310800,202102,2370,6908,1747,5661,339,1339,105,270,444,1609
310810,202102,1296,3155,1068,2785,47,131,771,1939,818,2070
310820,202102,1248,3110,762,2292,159,490,168,527,327,1017
310825,202102,2610,7698,2097,6850,62,363,1711,5386,1773,5749
310830,202102,1892,5228,1354,4185,235,851,579,1681,814,2532
310840,202102,2084,5590,1549,4690,329,1153,405,1060,734,2213
310850,202102,1441,3955,1207,3623,39,198,945,2712,984,2910
310855,202102,3083,8063,2390,6942,159,551,1712,4841,1871,5392
310860,202102,6838,19683,5526,17172,560,1807,3370,10613,3930,12420
310870,202102,953,2280,755,1993,55,128,555,1478,610,1606
310880,202102,991,2932,791,2534,107,363,440,1373,547,1736
310890,202102,2161,6145,1405,4641,254,908,209,598,463,1506
310900,202102,3837,10510,2638,7907,384,1183,1145,3217,1529,4400
310910,202102,2186,5251,1540,4243,140,447,333,849,473,1296
310920,202102,1903,4895,1459,4232,193,606,845,2403,1038,3009
310925,202102,908,2460,739,2182,65,227,504,1409,569,1636
310930,202102,5834,14992,4103,12214,804,2418,1835,5730,2639,8148
310940,202102,6615,15494,5338,13660,186,572,4114,10245,4300,10817
310945,202102,1278,3302,997,2854,175,523,485,1359,660,1882
310950,202102,1895,5557,1275,4179,224,802,373,1040,597,1842
310960,202102,726,1937,407,1265,66,242,77,218,143,460
310970,202102,1142,3320,810,2634,204,725,135,401,339,1126
310980,202102,253,602,166,472,19,64,106,291,125,355
310990,202102,1306,3520,1030,3056,146,472,561,1629,707,2101
311000,202102,3892,10672,2858,8986,696,2319,1160,3578,1856,5897
311010,202102,894,2529,721,2193,209,705,304,898,513,1603
311020,202102,1126,2829,718,2086,42,128,384,1092,426,1220
311030,202102,1673,4070,1192,3295,227,716,541,1423,768,2139
311040,202102,266,822,220,723,66,228,76,233,142,461
311050,202102,2972,7161,2233,6099,350,1085,1143,2953,1493,4038
311060,202102,3193,8068,2393,6618,321,1019,979,2462,1300,3481
311070,202102,2322,5689,1696,4735,156,567,976,2541,1132,3108
311080,202102,1159,2587,939,2248,60,159,729,1668,789,1827
311090,202102,2044,6426,1620,5638,371,1411,504,1712,875,3123
311100,202102,2397,6734,1427,4753,260,978,255,742,515,1720
311110,202102,3610,7350,2027,5147,362,970,721,1886,1083,2856
311115,202102,1391,3038,1177,2761,61,149,956,2207,1017,2356
311120,202102,6759,17554,5214,14811,753,2372,1965,4939,2718,7311
311130,202102,1855,4799,1412,4195,97,367,845,2437,942,2804
311140,202102,1438,3516,1151,3128,64,209,826,2200,890,2409
311150,202102,1446,4573,1132,3957,177,696,607,2069,784,2765
311160,202102,3818,10859,2706,8789,686,2433,784,2428,1470,4861
311170,202102,881,2209,698,1970,39,111,441,1316,480,1427
311180,202102,1341,2996,839,2260,155,458,373,994,528,1452
311190,202102,861,2345,658,1961,115,397,271,703,386,1100
311200,202102,2036,5443,1480,4379,267,867,550,1481,817,2348
311205,202102,867,2536,709,2229,43,184,450,1339,493,1523
311210,202102,981,2830,850,2647,108,299,610,1959,718,2258
311220,202102,749,2032,629,1817,40,141,423,1151,463,1292
311230,202102,7989,23521,6080,19665,1163,3912,2203,7235,3366,11147
311240,202102,1059,2723,823,2392,181,544,349,1019,530,1563
311250,202102,1121,3217,873,2741,182,545,334,1013,516,1558
311260,202102,2720,6560,1751,4897,229,715,778,1959,1007,2674
311265,202102,1288,3318,951,2755,39,151,650,1842,689,1993
311270,202102,2949,8729,2580,8135,132,573,1908,5786,2040,6359
311280,202102,1040,2661,484,1530,75,271,38,90,113,361
311290,202102,1859,5539,1695,5205,125,381,1163,3583,1288,3964
311300,202102,4744,12932,3904,11542,190,720,3114,9023,3304,9743
311310,202102,561,1539,478,1394,41,129,306,861,347,990
311320,202102,3240,9717,2794,8779,344,1291,1403,3995,1747,5286
311330,202102,5270,13495,4191,11760,445,1341,2374,6789,2819,8130
311340,202102,10367,28486,8244,24793,2014,6576,2418,6868,4432,13444
311350,202102,2454,5932,1763,4702,167,456,944,2285,1111,2741
311360,202102,1108,2681,729,2126,197,643,252,713,449,1356
311370,202102,4630,11057,3402,9150,141,544,2301,5808,2442,6352
311380,202102,353,1057,255,854,62,208,113,403,175,611
311390,202102,1750,5237,1395,4744,593,2236,366,1146,959,3382
311400,202102,1533,4145,1124,3362,190,586,377,1008,567,1594
311410,202102,1732,4994,1393,4487,215,784,786,2448,1001,3232
311420,202102,1512,4375,1074,3483,184,682,294,809,478,1491
311430,202102,4156,10767,2791,8115,462,1396,959,2701,1421,4097
311440,202102,2905,8007,2204,6834,566,2062,480,1366,1046,3428
311450,202102,1696,5000,1235,4160,328,1267,327,938,655,2205
311455,202102,999,2187,673,1714,173,453,253,687,426,1140
311460,202102,491,1489,327,1138,66,294,80,216,146,510
311470,202102,507,1530,337,1146,81,312,49,161,130,473
311480,202102,1046,2631,859,2345,52,137,655,1789,707,1926
311490,202102,250,729,189,614,33,131,87,251,120,382
311500,202102,464,1122,367,986,17,58,247,640,264,698
311510,202102,3250,8311,2268,6644,304,988,982,2708,1286,3696
311520,202102,647,1766,567,1617,70,252,324,905,394,1157
311530,202102,8512,19675,5435,14790,1292,3881,1434,3717,2726,7598
311535,202102,796,2165,541,1635,90,284,192,536,282,820
311540,202102,494,1524,441,1423,67,255,309,958,376,1213
311545,202102,1995,5637,1706,5187,91,309,1321,3983,1412,4292
311547,202102,1437,3650,1257,3384,64,165,844,2306,908,2471
311550,202102,2791,7628,2237,6649,297,991,988,2769,1285,3760
311560,202102,303,651,195,491,77,182,47,116,124,298
311570,202102,1608,3678,1142,3033,34,97,906,2437,940,2534
311580,202102,2122,3957,1425,3133,160,304,951,2097,1111,2401
311590,202102,500,1317,403,1167,69,228,229,653,298,881
311600,202102,1714,3854,1437,3491,69,161,1218,2925,1287,3086
311610,202102,2264,7130,1898,6388,169,660,1140,3736,1309,4396
311615,202102,3250,8981,2647,7988,110,405,2100,6216,2210,6621
311620,202102,430,1088,374,1026,9,34,327,885,336,919
311630,202102,1351,3662,1117,3191,87,286,739,2037,826,2323
311640,202102,678,1789,549,1590,61,200,273,726,334,926
311650,202102,1934,4890,1598,4375,175,509,988,2624,1163,3133
311660,202102,2848,8066,2132,6677,367,1262,580,1537,947,2799
311670,202102,1525,3950,1118,3225,164,523,441,1274,605,1797
311680,202102,2143,6010,1626,5063,148,431,1099,3439,1247,3870
311690,202102,599,1291,474,1138,34,65,351,897,385,962
311700,202102,2196,5205,1754,4589,20,106,1503,3813,1523,3919
311710,202102,1492,4265,1087,3549,262,930,383,1250,645,2180
311720,202102,425,1231,339,1082,42,148,168,542,210,690
311730,202102,3499,9011,2318,6698,652,2023,488,1450,1140,3473
311740,202102,891,2288,747,2116,68,184,608,1778,676,1962
311750,202102,3858,11367,3120,10050,398,1396,1830,5680,2228,7076
311760,202102,648,1795,532,1592,66,243,278,727,344,970
311770,202102,2126,5987,1670,5182,266,840,754,2272,1020,3112
311780,202102,1342,3803,968,3079,145,537,336,922,481,1459
311783,202102,2273,6043,1858,5349,33,156,1507,4166,1540,4322
311787,202102,802,2264,615,1835,87,293,270,690,357,983
311790,202102,1477,3973,970,3045,223,787,268,779,491,1566
311800,202102,4853,14410,3947,12504,829,2735,552,1503,1381,4238
311810,202102,937,2795,749,2469,45,161,508,1648,553,1809
311820,202102,771,1846,566,1532,61,197,360,914,421,1111
311830,202102,8191,23106,5708,17828,1579,5327,704,2160,2283,7487
311840,202102,3632,9021,2928,8022,208,616,2194,5967,2402,6583
311850,202102,366,953,298,829,13,41,200,529,213,570
311860,202102,60414,150229,46665,127017,6327,18701,26597,68920,32924,87621
311870,202102,1864,4892,1297,3891,214,738,518,1398,732,2136
311880,202102,6380,16245,5357,14847,285,666,4041,11447,4326,12113
311890,202102,1715,4049,1325,3514,89,261,928,2338,1017,2599
311900,202102,745,1873,561,1622,54,185,360,1010,414,1195
311910,202102,4087,10421,3098,9128,537,1547,1571,4832,2108,6379
311920,202102,2127,5519,1718,4929,118,295,1082,3219,1200,3514
311930,202102,3831,8829,2776,7378,817,2368,847,2082,1664,4450
311940,202102,15537,40145,11559,32690,1552,4803,5330,14049,6882,18852
311950,202102,2312,6110,1769,5211,124,408,1055,3174,1179,3582
311960,202102,480,1164,380,1015,24,90,247,600,271,690
311970,202102,412,1306,307,1040,57,232,73,208,130,440
311980,202102,448,1199,237,784,24,77,83,272,107,349
311990,202102,526,1219,334,930,60,208,145,357,205,565
311995,202102,965,2644,508,1604,20,64,75,152,95,216
312000,202102,763,1884,566,1591,54,141,344,1001,398,1142
312010,202102,958,2571,741,2225,44,146,485,1392,529,1538
312015,202102,1347,3883,1194,3637,45,196,976,2909,1021,3105
312020,202102,1632,4951,1237,4087,215,766,303,907,518,1673
312030,202102,2006,4866,1748,4581,15,54,1647,4308,1662,4362
312040,202102,836,2408,593,1944,65,216,265,840,330,1056
312050,202102,1182,3594,957,3168,213,855,314,906,527,1761
312060,202102,850,2043,551,1672,134,409,262,809,396,1218
312070,202102,908,2553,644,2021,37,133,365,1083,402,1216
312080,202102,2640,6423,1991,5467,109,318,1330,3515,1439,3833
312083,202102,848,2193,637,1867,48,177,434,1230,482,1407
312087,202102,2474,6387,2003,5663,42,133,1572,4483,1614,4616
312090,202102,10221,26315,8026,22890,1098,3440,4235,11691,5333,15131
312100,202102,1552,4412,1243,3843,91,346,771,2288,862,2634
312110,202102,1056,3201,875,2844,179,680,329,971,508,1651
312120,202102,1006,2662,685,2105,179,639,199,497,378,1136
312125,202102,1699,4312,1422,3926,100,319,1077,2865,1177,3184
312130,202102,1037,2509,782,2082,65,192,359,875,424,1067
312140,202102,707,2022,578,1760,113,391,260,719,373,1110
312150,202102,461,1262,396,1135,17,67,284,760,301,827
312160,202102,8949,23992,6871,20369,812,2697,3377,9592,4189,12289
312170,202102,893,2395,696,2015,38,126,457,1290,495,1416
312180,202102,1398,3693,1116,3169,156,456,584,1611,740,2067
312190,202102,664,1812,496,1506,75,259,180,504,255,763
312200,202102,4362,11947,3449,10474,1055,3185,1174,3708,2229,6893
312210,202102,1380,3043,1007,2518,36,107,761,1864,797,1971
312220,202102,1565,4834,1359,4446,104,372,857,2805,961,3177
312230,202102,13421,34235,9102,26524,2097,6945,1887,4623,3984,11568
312235,202102,1953,4862,1549,4297,84,272,1125,3028,1209,3300
312240,202102,715,2263,543,1904,110,420,159,539,269,959
312245,202102,2672,6818,2201,6101,53,138,1832,5049,1885,5187
312247,202102,951,2279,691,1904,117,338,373,1033,490,1371
312250,202102,963,2537,623,1867,76,241,231,671,307,912
312260,202102,950,2518,757,2227,39,154,586,1655,625,1809
312270,202102,731,1997,559,1659,31,121,315,854,346,975
312280,202102,416,1213,322,1042,89,299,47,140,136,439
312290,202102,782,2270,636,2016,123,436,207,622,330,1058
312300,202102,979,2933,660,2153,158,559,126,339,284,898
312310,202102,948,2805,768,2447,119,409,354,1077,473,1486
312320,202102,1985,5053,1465,4161,323,965,331,907,654,1872
312330,202102,832,2436,676,2100,65,236,420,1266,485,1502
312340,202102,244,632,172,510,44,159,74,192,118,351
312350,202102,246,492,176,419,17,46,123,284,140,330
312352,202102,1558,4635,1387,4327,89,275,846,2820,935,3095
312360,202102,2815,7992,2092,6648,399,1411,720,2119,1119,3530
312370,202102,1871,4750,1530,4177,159,490,950,2476,1109,2966
312380,202102,2133,4784,1767,4318,4,12,1591,3850,1595,3862
312385,202102,1215,3288,957,2832,148,461,430,1280,578,1741
312390,202102,1868,5323,1413,4492,192,707,528,1534,720,2241
312400,202102,2836,7987,2369,7205,692,2286,778,2336,1470,4622
312410,202102,11871,32168,9646,28495,1648,4987,5363,15664,7011,20651
312420,202102,3803,10067,3164,9030,594,1849,1676,4644,2270,6493
312430,202102,7905,20737,6517,18271,360,1173,4717,12897,5077,14070
312440,202102,951,3045,781,2665,369,1337,119,372,488,1709
312450,202102,1174,3417,897,2934,249,851,284,979,533,1830
312460,202102,438,1129,304,925,54,166,151,482,205,648
312470,202102,473,1137,300,833,30,87,108,270,138,357
312480,202102,1023,2509,717,2058,95,307,359,974,454,1281
312490,202102,2106,5087,1662,4445,209,602,907,2357,1116,2959
312500,202102,1036,2513,852,2260,44,156,618,1609,662,1765
312510,202102,3720,9788,2660,7803,633,1799,647,1935,1280,3734
312520,202102,227,593,176,510,40,132,75,212,115,344
312530,202102,564,1384,485,1289,15,52,427,1139,442,1191
312540,202102,1598,4356,1093,3367,142,468,621,1855,763,2323
312550,202102,790,2045,614,1712,45,147,405,1044,450,1191
312560,202102,1932,5004,1553,4415,73,215,1164,3313,1237,3528
312570,202102,2287,5422,1720,4711,482,1338,665,1920,1147,3258
312580,202102,611,1648,431,1273,58,198,189,513,247,711
312590,202102,1598,4594,1270,3931,82,360,810,2305,892,2665
312595,202102,2000,5744,1677,5213,253,729,1009,3305,1262,4034
312600,202102,1170,2763,692,1866,108,369,127,391,235,760
312610,202102,6807,17062,4538,12915,661,2071,1589,4088,2250,6159
312620,202102,2518,6449,1878,5547,55,219,1501,4523,1556,4742
312630,202102,283,806,201,650,35,129,79,255,114,384
312640,202102,513,1392,363,1136,38,130,152,480,190,610
312650,202102,2004,5104,1399,3983,62,201,991,2700,1053,2901
312660,202102,1321,3187,1013,2673,91,247,685,1756,776,2003
312670,202102,4922,12869,4115,11591,185,714,3032,8174,3217,8888
312675,202102,1287,3300,1057,2967,57,175,867,2405,924,2580
312680,202102,1400,3894,1214,3604,45,184,1003,2902,1048,3086
312690,202102,2923,6110,2285,5353,45,120,1920,4506,1965,4626
312695,202102,953,2535,813,2313,44,100,631,1800,675,1900
312700,202102,2053,5349,1495,4330,146,491,852,2334,998,2825
312705,202102,1401,3289,1208,3009,14,42,1106,2731,1120,2773
312707,202102,1312,3800,1017,3281,66,307,666,2033,732,2340
312710,202102,6431,14633,3854,10657,921,2734,1095,3165,2016,5899
312720,202102,1066,2798,803,2382,95,300,494,1425,589,1725
312730,202102,1632,3805,1153,3148,94,285,672,1771,766,2056
312733,202102,1356,3547,1026,2924,34,133,722,1949,756,2082
312735,202102,715,1890,600,1671,76,219,344,881,420,1100
312737,202102,790,1744,569,1432,66,182,380,934,446,1116
312738,202102,707,1775,509,1443,43,138,297,796,340,934
312740,202102,414,1033,249,754,46,155,59,132,105,287
312750,202102,1568,4482,1169,3729,194,646,514,1568,708,2214
312760,202102,1776,5171,1278,4150,231,787,465,1462,696,2249
312770,202102,44271,105270,28132,77828,5485,16350,9605,25762,15090,42112
312780,202102,2418,7110,2041,6499,240,797,1323,4230,1563,5027
312790,202102,238,556,128,388,5,21,39,96,44,117
312800,202102,4914,13618,3758,11425,856,2749,1399,4109,2255,6858
312810,202102,1519,4044,1025,3233,258,894,373,1089,631,1983
312820,202102,1735,4552,1409,3991,58,204,1061,2929,1119,3133
312825,202102,1346,3107,1178,2893,18,57,1024,2464,1042,2521
312830,202102,2753,7667,1706,5533,324,1190,452,1381,776,2571
312840,202102,1348,3569,1082,3125,78,305,644,1731,722,2036
312850,202102,939,2236,665,1836,18,68,421,1071,439,1139
312860,202102,1077,2766,735,2245,185,589,174,493,359,1082
312870,202102,6038,16027,3762,11710,564,1906,915,2617,1479,4523
312880,202102,1447,3557,1120,3010,40,131,663,1787,703,1918
312890,202102,2227,5464,1651,4535,117,295,839,2351,956,2646
312900,202102,1228,3114,1005,2830,147,466,467,1433,614,1899
312910,202102,1564,2848,841,1911,184,360,309,738,493,1098
312920,202102,991,2588,691,2110,110,387,289,808,399,1195
312930,202102,2382,5756,1840,4960,392,1070,817,2253,1209,3323
312940,202102,974,2638,769,2346,67,261,431,1256,498,1517
312950,202102,3021,7393,2013,5793,493,1573,641,1770,1134,3343
312960,202102,1795,4702,1519,4290,79,201,1168,3390,1247,3591
312965,202102,1610,4379,1338,3965,101,291,947,2775,1048,3066
312970,202102,1396,3862,1117,3416,147,534,676,1952,823,2486
312980,202102,23982,64843,19429,56842,3791,11972,9042,24845,12833,36817
312990,202102,492,1214,326,933,52,172,165,430,217,602
313000,202102,480,1363,364,1153,28,121,214,637,242,758
313005,202102,2531,7186,2151,6539,148,425,1544,4667,1692,5092
313010,202102,5062,13648,4067,12073,694,2243,2416,7059,3110,9302
313020,202102,1072,3174,772,2513,132,449,149,429,281,878
313030,202102,1094,2496,745,1990,87,283,476,1196,563,1479
313040,202102,809,2467,671,2197,39,165,411,1277,450,1442
313050,202102,1743,4754,1222,3984,198,774,395,1145,593,1919
313055,202102,1874,5004,1667,4710,53,175,1447,4057,1500,4232
313060,202102,960,2298,697,1853,164,531,130,308,294,839
313065,202102,1643,4815,1449,4502,45,156,1135,3450,1180,3606
313070,202102,947,2455,726,2086,68,213,422,1179,490,1392
313080,202102,387,1068,287,876,54,184,108,279,162,463
313090,202102,5123,13388,4356,12166,340,1058,2940,8119,3280,9177
313100,202102,1336,3426,1034,2993,25,102,793,2238,818,2340
313110,202102,1458,3843,1085,3204,105,367,589,1630,694,1997
313115,202102,2655,7520,2141,6540,263,924,1131,3213,1394,4137
313120,202102,3766,8856,2765,7552,196,598,1854,5051,2050,5649
313130,202102,31624,80023,24234,66701,2439,7629,13880,36044,16319,43673
313140,202102,621,1312,365,953,29,73,242,636,271,709
313150,202102,1346,3719,1007,3118,308,1033,169,466,477,1499
313160,202102,1203,2945,936,2544,21,75,723,1904,744,1979
313170,202102,11071,31046,8166,25716,1321,4565,3335,9823,4656,14388
313180,202102,2027,5337,1446,4166,191,569,833,2354,1024,2923
313190,202102,4256,12080,3146,9862,562,1914,1093,3192,1655,5106
313200,202102,1105,3013,966,2772,14,48,816,2269,830,2317
313210,202102,3811,10867,3133,9647,363,1201,1899,5703,2262,6904
313220,202102,1697,4427,1134,3322,162,528,460,1195,622,1723
313230,202102,2983,8216,2455,7567,44,146,2054,6473,2098,6619
313240,202102,9803,23747,6300,18213,983,3240,2767,7508,3750,10748
313250,202102,6047,17641,4649,14619,816,2567,2105,6417,2921,8984
313260,202102,664,1709,487,1406,64,234,241,638,305,872
313270,202102,5799,14174,4668,12625,551,1387,3211,8911,3762,10298
313280,202102,466,1297,302,963,38,139,130,390,168,529
313290,202102,969,2962,723,2522,202,773,234,810,436,1583
313300,202102,1598,4213,1169,3477,281,918,307,789,588,1707
313310,202102,1190,3477,928,2941,149,557,278,762,427,1319
313320,202102,2085,5523,1520,4611,256,900,598,1836,854,2736
313330,202102,4162,10733,3153,9213,172,591,2036,5931,2208,6522
313340,202102,1392,3101,992,2550,80,217,703,1792,783,2009
313350,202102,2929,8062,1909,5781,229,770,696,1842,925,2612
313360,202102,1515,3651,1050,2916,153,511,550,1401,703,1912
313370,202102,1440,3982,1185,3476,140,488,650,1748,790,2236
313375,202102,1782,4645,1146,3442,213,687,233,639,446,1326
313380,202102,6271,15489,4516,12327,736,2258,2179,5308,2915,7566
313390,202102,804,2544,700,2370,50,226,471,1525,521,1751
313400,202102,3591,8842,2782,7746,135,424,2141,5861,2276,6285
313410,202102,1334,3379,1041,2882,51,171,779,2092,830,2263
313420,202102,15644,34417,8175,22041,1856,5584,1086,2915,2942,8499
313430,202102,962,2797,745,2352,124,480,319,873,443,1353
313440,202102,5937,12921,3940,10305,387,1047,2406,6322,2793,7369
313450,202102,741,1947,525,1535,87,278,184,462,271,740
313460,202102,2096,5875,1662,5198,336,1186,769,2272,1105,3458
313470,202102,2846,7184,2255,6328,225,629,1501,4256,1726,4885
313480,202102,1004,2844,576,1891,59,217,180,542,239,759
313490,202102,2815,6828,1439,4333,348,1141,303,890,651,2031
313500,202102,527,1460,386,1161,38,113,146,410,184,523
313505,202102,10196,26573,8685,24527,323,1094,6999,19774,7322,20868
313507,202102,1468,3775,1201,3362,32,131,967,2624,999,2755
313510,202102,14018,38249,10951,32201,1300,3840,5109,14758,6409,18598
313520,202102,14380,39825,11570,35064,560,2030,8746,25897,9306,27927
313530,202102,536,1569,408,1297,48,173,168,469,216,642
313535,202102,2324,6368,1922,5605,252,674,1200,3519,1452,4193
313540,202102,783,2299,639,1954,113,353,268,741,381,1094
313545,202102,1130,3701,958,3355,142,537,521,1761,663,2298
313550,202102,1758,5293,1457,4589,288,1006,751,2261,1039,3267
313560,202102,2705,5258,2031,4438,56,88,1721,3791,1777,3879
313570,202102,990,2826,811,2504,197,637,324,975,521,1612
313580,202102,5841,14766,4554,12632,498,1420,2724,7572,3222,8992
313590,202102,1068,2943,870,2659,189,624,431,1383,620,2007
313600,202102,4107,10674,3421,9617,80,306,2903,8014,2983,8320
313610,202102,1069,2647,859,2296,84,257,557,1401,641,1658
313620,202102,5438,14202,4274,12119,485,1565,2516,6859,3001,8424
313630,202102,8668,20617,6201,16947,576,1840,3833,10242,4409,12082
313640,202102,1183,2556,713,1959,135,408,345,943,480,1351
313650,202102,1710,5052,1357,4459,102,393,882,2934,984,3327
313652,202102,771,2374,694,2224,107,362,440,1376,547,1738
313655,202102,1136,2820,892,2517,48,132,686,1952,734,2084
313657,202102,1113,2977,892,2631,35,133,666,1866,701,1999
313660,202102,938,2621,764,2311,74,270,482,1393,556,1663
313665,202102,4943,12968,3922,11194,394,1257,2481,6754,2875,8011
313670,202102,49045,118627,31874,89950,4355,13545,14558,38800,18913,52345
313680,202102,1017,2694,843,2412,61,200,570,1588,631,1788
313690,202102,784,2402,608,2082,146,558,162,525,308,1083
313695,202102,1859,4898,1402,4145,96,285,922,2792,1018,3077
313700,202102,2850,9056,2474,8554,230,782,1878,6559,2108,7341
313710,202102,1479,3288,1053,2726,75,204,705,1838,780,2042
313720,202102,5582,15226,3972,11887,534,1686,1663,4598,2197,6284
313730,202102,1373,3020,1038,2575,85,180,683,1716,768,1896
313740,202102,1675,5884,1414,5219,307,1315,270,850,577,2165
313750,202102,2024,5294,1574,4516,279,904,764,2044,1043,2948
313753,202102,2206,5226,1480,4060,154,459,814,2151,968,2610
313760,202102,5455,14786,4176,12345,781,2597,1931,5284,2712,7881
313770,202102,4035,11196,3234,9913,185,591,2443,7589,2628,8180
313780,202102,3959,10377,2905,8643,236,795,891,2716,1127,3511
313790,202102,496,1489,443,1397,40,133,267,838,307,971
313800,202102,1386,3109,1015,2603,114,332,533,1299,647,1631
313810,202102,1616,4043,1296,3590,44,157,1013,2729,1057,2886
313820,202102,17665,44728,11162,31003,1815,5198,2995,8066,4810,13264
313830,202102,388,1100,279,854,51,185,97,272,148,457
313835,202102,901,2621,750,2345,61,244,420,1226,481,1470
313840,202102,7277,18752,5603,16009,1272,3894,1229,3624,2501,7518
313850,202102,996,2396,786,2112,145,462,372,897,517,1359
313860,202102,2586,6811,1957,5632,281,930,860,2262,1141,3192
313862,202102,1309,2740,637,1757,37,105,306,835,343,940
313865,202102,2598,6779,2150,6049,77,217,1634,4531,1711,4748
313867,202102,1349,4027,1125,3619,180,560,647,2153,827,2713
313868,202102,1667,5094,1377,4528,44,213,1057,3356,1101,3569
313870,202102,810,2151,591,1760,94,292,233,632,327,924
313880,202102,1753,4491,1272,3668,155,509,623,1627,778,2136
313890,202102,2083,4409,1573,3748,35,111,1213,2799,1248,2910
313900,202102,4165,11870,2996,9503,741,2569,727,2116,1468,4685
313910,202102,662,1895,505,1606,104,356,110,340,214,696
313920,202102,2970,8930,2491,7941,511,1595,1229,3960,1740,5555
313925,202102,1577,3949,1284,3437,172,443,839,2250,1011,2693
313930,202102,4541,13602,3695,12057,266,1003,2409,7748,2675,8751
313940,202102,8844,25213,6580,21301,691,2758,1579,5805,2270,8563
313950,202102,5247,11428,3969,9878,333,1052,2532,6319,2865,7371
313960,202102,5712,13607,3843,10488,733,2258,1258,3137,1991,5395
313970,202102,1519,4029,1278,3634,19,61,830,2315,849,2376
313980,202102,1295,3332,853,2658,138,482,350,1020,488,1502
313990,202102,1895,5919,1376,4763,332,1338,448,1355,780,2693
314000,202102,9613,24356,8093,21777,601,2057,5391,14261,5992,16318
314010,202102,1464,3479,1163,3075,37,121,901,2307,938,2428
314015,202102,1936,5301,1496,4551,187,654,835,2477,1022,3131
314020,202102,503,1347,347,1084,76,283,66,225,142,508
314030,202102,787,2227,625,1923,61,186,336,1013,397,1199
314040,202102,602,1621,494,1427,77,257,259,712,336,969
314050,202102,1870,4905,1382,4022,143,494,759,2050,902,2544
314053,202102,1812,5344,1495,4723,317,982,791,2594,1108,3576
314055,202102,2190,5849,1847,5311,44,164,1511,4339,1555,4503
314060,202102,1297,3380,980,2884,37,132,700,2041,737,2173
314070,202102,4774,12828,3759,11047,731,2137,1688,4920,2419,7057
314080,202102,2140,5471,1496,4392,186,604,637,1690,823,2294
314085,202102,2226,6066,1828,5462,202,613,1066,3251,1268,3864
314090,202102,4748,12535,4073,11550,224,733,2695,7900,2919,8633
314100,202102,3029,7238,2346,6287,37,113,1758,4744,1795,4857
314110,202102,4925,13573,4047,11934,446,1483,2261,6232,2707,7715
314120,202102,722,1692,315,943,58,212,74,206,132,418
314130,202102,656,1720,425,1301,26,100,249,742,275,842
314140,202102,4521,12602,3631,10972,481,1489,1851,5510,2332,6999
314150,202102,1517,3745,1120,3068,66,174,765,2060,831,2234
314160,202102,2216,5734,1635,4666,219,698,692,1969,911,2667
314170,202102,903,2506,739,2186,36,137,495,1362,531,1499
314180,202102,5431,14896,4390,13217,342,1105,2689,8106,3031,9211
314190,202102,606,1481,436,1238,77,255,219,561,296,816
314200,202102,2990,8262,2481,7402,159,524,1735,5051,1894,5575
314210,202102,2033,5231,1624,4516,199,555,794,2164,993,2719
314220,202102,1379,3732,1015,3102,220,753,361,1010,581,1763
314225,202102,1020,2881,856,2615,70,175,629,1978,699,2153
314230,202102,796,2050,649,1865,87,267,409,1213,496,1480
314240,202102,1067,2844,824,2469,187,596,316,955,503,1551
314250,202102,495,1375,313,989,49,138,109,324,158,462
314260,202102,1006,2641,784,2340,162,522,441,1289,603,1811
314270,202102,3223,9067,2658,8199,74,313,1968,6020,2042,6333
314280,202102,3430,7862,2338,6207,240,706,1326,3333,1566,4039
314290,202102,4368,11260,3621,9943,302,842,2481,6678,2783,7520
314300,202102,2015,5632,1320,4169,218,745,469,1373,687,2118
314310,202102,3912,10105,2619,7901,800,2690,397,1027,1197,3717
314315,202102,951,3141,816,2854,47,210,580,1958,627,2168
314320,202102,3040,8142,2006,6216,340,1156,733,2164,1073,3320
314330,202102,48995,136252,37301,115707,9634,31215,7801,25497,17435,56712
314340,202102,2453,6045,1542,4428,275,917,392,967,667,1884
314345,202102,1457,4206,1171,3689,143,452,710,2224,853,2676
314350,202102,797,2141,517,1633,115,369,116,321,231,690
314360,202102,550,1588,362,1190,49,176,121,360,170,536
314370,202102,755,1979,611,1766,44,141,413,1153,457,1294
314380,202102,1105,2967,732,2316,165,591,153,460,318,1051
314390,202102,13868,34616,9235,26361,1486,4587,3028,7696,4514,12283
314400,202102,3809,11398,2906,9597,727,2486,1079,3701,1806,6187
314410,202102,2662,7421,1870,5951,245,905,610,2043,855,2948
314420,202102,846,2043,612,1659,36,133,415,1056,451,1189
314430,202102,7826,18861,5511,15047,787,2262,2619,6804,3406,9066
314435,202102,1901,4980,1485,4303,137,442,958,2700,1095,3142
314437,202102,905,2293,654,1884,71,218,330,950,401,1168
314440,202102,613,1735,441,1399,125,437,87,222,212,659
314450,202102,1390,3692,1174,3343,107,346,679,1873,786,2219
314460,202102,3154,9476,2316,7766,585,2092,559,1810,1144,3902
314465,202102,2219,6311,1893,5704,52,187,1474,4333,1526,4520
314467,202102,903,2356,762,2133,21,57,613,1678,634,1735
314470,202102,2329,6539,1933,5770,333,1068,907,2534,1240,3602
314480,202102,6581,18342,4879,14864,768,2640,1889,5108,2657,7748
314490,202102,1091,2834,800,2240,63,194,520,1410,583,1604
314500,202102,1693,4009,1225,3386,321,866,410,1194,731,2060
314505,202102,2008,4897,1639,4366,95,274,1206,3114,1301,3388
314510,202102,1963,5066,1393,4183,277,935,630,1849,907,2784
314520,202102,4877,14705,3691,12299,733,2689,467,1400,1200,4089
314530,202102,5337,17031,4819,16042,298,1196,3582,11667,3880,12863
314535,202102,2430,6332,1985,5695,72,283,1529,4348,1601,4631
314537,202102,1100,3080,845,2673,41,166,615,1895,656,2061
314540,202102,393,966,270,766,20,61,157,424,177,485
314545,202102,1964,4633,1759,4395,30,83,1547,3952,1577,4035
314550,202102,703,1684,523,1418,36,118,300,745,336,863
314560,202102,4497,13267,3325,10688,468,1701,1188,3376,1656,5077
314570,202102,304,835,223,684,28,96,97,298,125,394
314580,202102,445,1315,355,1142,93,298,113,360,206,658
314585,202102,655,2016,504,1688,55,212,218,716,273,928
314587,202102,2024,5454,1534,4676,189,547,905,2819,1094,3366
314590,202102,4099,10948,3026,8976,383,1262,1391,3807,1774,5069
314600,202102,1905,5138,1147,3707,237,807,132,417,369,1224
314610,202102,8867,21695,6358,18074,953,3248,2789,8105,3742,11353
314620,202102,2236,5201,1772,4613,42,134,1482,3846,1524,3980
314625,202102,1540,4165,1330,3871,29,170,1153,3283,1182,3453
314630,202102,5469,13526,4489,12194,105,409,3754,10103,3859,10512
314640,202102,699,1635,516,1355,71,216,295,719,366,935
314650,202102,815,1867,506,1383,51,163,288,708,339,871
314655,202102,1581,4310,1137,3525,170,524,558,1743,728,2267
314660,202102,322,723,212,535,11,23,140,341,151,364
314670,202102,1617,3636,1137,2964,22,67,764,1950,786,2017
314675,202102,1708,4436,1458,4023,64,197,1157,3116,1221,3313
314690,202102,2026,5524,1549,4835,391,1366,545,1660,936,3026
314700,202102,10451,28537,6949,21894,1297,4507,2320,7053,3617,11560
314710,202102,7889,21863,5813,17516,916,3063,2177,5726,3093,8789
314720,202102,2130,6241,1511,4998,290,1031,366,1141,656,2172
314730,202102,2313,5932,1686,4830,270,856,684,1787,954,2643
314740,202102,2961,8247,2306,7075,296,951,1180,3536,1476,4487
314750,202102,281,769,216,637,27,91,131,344,158,435
314760,202102,1978,5794,1300,4265,215,804,338,859,553,1663
314770,202102,1088,3128,605,1944,58,196,183,545,241,741
314780,202102,352,846,241,679,37,130,135,338,172,468
314790,202102,11467,30220,8076,23978,1542,5264,2982,8138,4524,13402
314795,202102,1528,3965,1300,3576,28,118,1053,2789,1081,2907
314800,202102,10609,26901,6702,19783,1151,3696,1827,4814,2978,8510
314810,202102,8816,23233,6443,19157,1642,5183,2068,6038,3710,11221
314820,202102,1255,3004,992,2603,69,233,620,1551,689,1784
314830,202102,1573,4662,1324,4201,215,770,663,2018,878,2788
314840,202102,852,2629,667,2302,50,220,455,1491,505,1711
314850,202102,2178,4880,1771,4371,45,119,1539,3811,1584,3930
314860,202102,3226,9299,2692,8343,161,645,1919,5776,2080,6421
314870,202102,6364,15712,4855,13740,270,806,3620,10384,3890,11190
314875,202102,1792,5282,1581,5011,145,362,1248,4082,1393,4444
314880,202102,800,1953,623,1687,31,89,375,1022,406,1111
314890,202102,415,1218,321,1030,50,180,136,408,186,588
314900,202102,718,1915,564,1644,72,245,261,717,333,962
314910,202102,1673,4668,1247,3975,188,700,648,1940,836,2640
314915,202102,2203,6443,1857,5831,122,389,1232,3796,1354,4185
314920,202102,461,1206,300,964,6,15,200,657,206,672
314930,202102,5521,15322,4197,12861,678,2317,1732,4905,2410,7222
314940,202102,402,990,329,867,38,98,211,532,249,630
314950,202102,544,1351,373,1076,24,86,197,512,221,598
314960,202102,846,1974,648,1655,29,91,471,1131,500,1222
314970,202102,953,2778,729,2318,133,456,324,934,457,1390
314980,202102,1568,3966,1179,3397,197,649,597,1667,794,2316
314990,202102,2406,6891,1744,5419,337,1103,375,1043,712,2146
314995,202102,1597,4356,1274,3787,32,133,877,2463,909,2596
315000,202102,1115,2790,797,2303,61,183,530,1511,591,1694
315010,202102,372,1012,283,860,46,162,137,398,183,560
315015,202102,2278,6318,1982,5822,180,601,1335,3851,1515,4452
315020,202102,805,2326,573,1814,63,248,251,734,314,982
315030,202102,588,1561,402,1219,87,271,83,221,170,492
315040,202102,834,2293,675,2005,87,284,414,1205,501,1489
315050,202102,1216,3115,899,2617,55,201,484,1352,539,1553
315053,202102,1102,2847,863,2449,57,168,501,1357,558,1525
315057,202102,1735,5129,1412,4591,143,447,942,3133,1085,3580
315060,202102,587,1730,430,1414,89,295,108,343,197,638
315070,202102,516,1345,359,1075,82,270,97,276,179,546
315080,202102,2975,8154,2321,6921,188,638,1546,4367,1734,5005
315090,202102,791,2350,589,1975,88,320,242,778,330,1098
315100,202102,1320,3822,883,2852,132,498,390,1107,522,1605
315110,202102,1966,4640,1432,3843,127,342,728,2009,855,2351
315120,202102,12482,28688,9302,23963,1156,2701,5190,13846,6346,16547
315130,202102,1653,4459,1379,3990,139,457,576,1560,715,2017
315140,202102,2899,7980,2281,6883,415,1363,1140,3250,1555,4613
315150,202102,4314,10324,3072,8360,429,1364,1487,3945,1916,5309
315160,202102,1771,4270,1168,3318,250,775,528,1460,778,2235
315170,202102,1321,4159,941,3242,208,786,244,794,452,1580
315180,202102,17089,41029,9623,27542,1207,3916,3234,8158,4441,12074
315190,202102,2217,4825,1725,4183,198,477,1247,3069,1445,3546
315200,202102,3962,11101,2905,9255,794,2746,768,2350,1562,5096
315210,202102,8671,22239,6000,16714,687,2057,2971,7487,3658,9544
315213,202102,1119,2911,973,2713,22,75,811,2214,833,2289
315217,202102,2848,8109,2186,7013,95,414,1508,4642,1603,5056
315220,202102,8531,22920,6727,19768,1060,3267,3001,8860,4061,12127
315230,202102,3016,7073,2552,6457,172,241,1978,5310,2150,5551
315240,202102,2380,6921,1993,6256,435,1421,964,3054,1399,4475
315250,202102,13259,35346,9707,28745,1447,4607,4155,11726,5602,16333
315260,202102,859,2342,465,1513,71,234,39,102,110,336
315270,202102,855,2423,620,1984,82,277,219,600,301,877
315280,202102,2767,6838,1706,4966,414,1303,278,790,692,2093
315290,202102,1145,2795,691,2074,181,614,199,579,380,1193
315300,202102,618,1504,436,1252,75,239,226,658,301,897
315310,202102,1222,3398,932,2855,74,249,535,1544,609,1793
315320,202102,657,1912,465,1529,68,246,185,560,253,806
315330,202102,748,2519,419,1634,66,307,131,456,197,763
315340,202102,2926,7019,2113,5849,310,874,1099,3022,1409,3896
315350,202102,1552,4220,1247,3741,176,629,707,2065,883,2694
315360,202102,1705,5002,1308,4194,186,627,549,1644,735,2271
315370,202102,491,1386,395,1197,73,220,163,485,236,705
315380,202102,201,582,148,468,40,141,33,76,73,217
315390,202102,1133,3151,911,2747,134,487,447,1234,581,1721
315400,202102,4017,10781,3188,9307,396,1238,1832,5093,2228,6331
315410,202102,2462,5571,1840,4651,438,1245,330,857,768,2102
315415,202102,1373,3710,1109,3301,239,839,410,1238,649,2077
315420,202102,1456,4056,1014,3223,180,606,215,644,395,1250
315430,202102,3597,8696,2549,7110,439,1424,1129,2976,1568,4400
315440,202102,1037,2721,828,2377,64,215,495,1337,559,1552
315445,202102,1900,4564,1365,3800,87,290,994,2722,1081,3012
315450,202102,2261,6159,1865,5516,235,627,1155,3453,1390,4080
315460,202102,37985,103538,31488,92079,4305,14276,17834,48937,22139,63213
315470,202102,635,1757,452,1316,28,90,258,711,286,801
315480,202102,1082,3116,771,2445,136,460,252,770,388,1230
315490,202102,2899,7280,2045,5908,276,832,784,2146,1060,2978
315500,202102,517,1373,325,958,39,128,169,444,208,572
315510,202102,1212,3124,1037,2884,20,87,911,2494,931,2581
315520,202102,986,2677,812,2391,44,150,628,1802,672,1952
315530,202102,595,1659,474,1439,119,412,238,676,357,1088
315540,202102,1511,3990,1071,3200,97,356,500,1436,597,1792
315550,202102,1876,4900,1231,3718,246,859,311,931,557,1790
315560,202102,6168,18620,5211,16884,298,903,3429,11383,3727,12286
315570,202102,2068,5479,1651,4785,114,370,927,2639,1041,3009
315580,202102,2967,6907,2260,5803,341,986,858,2085,1199,3071
315590,202102,875,2192,670,1873,66,235,394,1015,460,1250
315600,202102,2501,7700,1803,6315,286,928,887,3307,1173,4235
315610,202102,971,2431,724,1992,103,354,330,780,433,1134
315620,202102,516,1350,395,1174,42,140,221,665,263,805
315630,202102,1034,2731,790,2282,123,381,382,1009,505,1390
315640,202102,341,835,253,725,27,102,154,414,181,516
315645,202102,978,2510,679,2022,150,485,184,521,334,1006
315650,202102,1664,4016,1344,3575,33,106,1093,2821,1126,2927
315660,202102,2472,6061,1858,5007,102,307,1343,3494,1445,3801
315670,202102,13569,36497,10385,30833,1967,6117,4730,13468,6697,19585
315680,202102,3185,8975,2353,7406,286,1050,1279,3793,1565,4843
315690,202102,3473,8318,2123,6037,468,1322,574,1784,1042,3106
315700,202102,8092,22042,6164,18285,979,3052,2727,7792,3706,10844
315710,202102,1819,4464,1299,3679,46,191,917,2495,963,2686
315720,202102,4413,12118,3678,10788,191,719,2579,7265,2770,7984
315725,202102,2213,5689,1705,4866,194,537,1047,3136,1241,3673
315727,202102,565,1445,433,1234,58,200,182,492,240,692
315730,202102,556,1727,493,1592,96,342,150,435,246,777
315733,202102,1137,2876,834,2380,124,413,324,880,448,1293
315737,202102,1146,3186,904,2719,25,102,659,1902,684,2004
315740,202102,783,2169,634,1873,65,226,422,1166,487,1392
315750,202102,1236,3234,987,2843,93,281,602,1762,695,2043
315760,202102,1124,2627,990,2450,45,135,829,2002,874,2137
315765,202102,1974,5124,1626,4665,26,100,1446,4132,1472,4232
315770,202102,981,2691,754,2373,299,1030,156,414,455,1444
315780,202102,30147,80882,25245,72301,1298,4634,17634,48164,18932,52798
315790,202102,3583,10940,3071,9978,323,1090,1886,6272,2209,7362
315800,202102,1301,4381,978,3570,131,549,350,1116,481,1665
315810,202102,1265,3147,1038,2757,54,185,805,2040,859,2225
315820,202102,2570,6807,2095,6142,192,610,1455,4285,1647,4895
315830,202102,1202,3536,825,2713,76,276,292,862,368,1138
315840,202102,859,2046,609,1613,43,139,312,748,355,887
315850,202102,1173,3384,925,2952,181,616,449,1340,630,1956
315860,202102,478,1370,345,1136,56,207,125,364,181,571
315870,202102,465,1221,375,1083,17,60,271,750,288,810
315880,202102,1101,2794,744,2161,94,288,177,494,271,782
315890,202102,1659,4702,1342,4261,327,1143,669,2108,996,3251
315895,202102,6229,16606,4696,13639,430,1408,2467,6662,2897,8070
315900,202102,798,2024,687,1868,61,163,522,1387,583,1550
315910,202102,489,1334,408,1208,59,175,285,845,344,1020
315920,202102,1442,3640,816,2470,121,451,271,734,392,1185
315930,202102,1063,2344,722,1867,136,326,314,846,450,1172
315935,202102,811,2432,642,2113,128,452,228,739,356,1191
315940,202102,602,1643,480,1456,57,185,261,762,318,947
315950,202102,1135,3129,941,2815,77,223,735,2191,812,2414
315960,202102,5366,15011,3639,11524,1021,3641,373,779,1394,4420
315970,202102,585,1538,466,1379,58,183,311,933,369,1116
315980,202102,4236,9044,2357,6021,436,1166,872,2040,1308,3206
315990,202102,3563,9043,2799,7747,295,844,1566,4214,1861,5058
316000,202102,597,1501,460,1300,55,195,227,601,282,796
316010,202102,817,2187,614,1838,46,159,368,1020,414,1179
316020,202102,932,2784,746,2416,110,405,408,1237,518,1642
316030,202102,2721,7583,2111,6492,249,767,1339,4204,1588,4971
316040,202102,2371,6696,1803,5636,301,1061,503,1378,804,2439
316045,202102,2075,5322,1908,5123,78,155,1661,4575,1739,4730
316050,202102,383,1048,303,918,40,120,165,463,205,583
316060,202102,654,1623,485,1389,17,75,345,944,362,1019
316070,202102,5301,14514,4336,12724,765,2260,2005,5782,2770,8042
316080,202102,721,2240,561,1923,137,495,90,268,227,763
316090,202102,400,1145,308,955,45,144,150,437,195,581
316095,202102,1297,3973,1034,3317,282,955,346,1058,628,2013
316100,202102,2469,7099,1818,5757,312,1085,693,1997,1005,3082
316105,202102,821,2137,678,1906,38,122,465,1343,503,1465
316110,202102,13850,39173,11637,35456,835,2878,7972,23954,8807,26832
316120,202102,1220,3427,805,2468,127,404,240,593,367,997
316130,202102,1251,2828,824,2122,65,190,494,1231,559,1421
316140,202102,1215,3199,785,2396,101,341,370,1112,471,1453
316150,202102,2009,4418,1603,3853,220,671,668,1490,888,2161
316160,202102,1020,2732,821,2362,37,125,577,1623,614,1748
316165,202102,817,2031,631,1740,90,288,338,873,428,1161
316170,202102,1188,2914,899,2480,41,140,632,1673,673,1813
316180,202102,1371,3858,948,3009,140,525,165,484,305,1009
316190,202102,2677,7516,1604,4968,237,762,611,1673,848,2435
316200,202102,3172,9041,2409,7724,566,1943,656,2009,1222,3952
316210,202102,4499,13149,3266,10326,1154,3999,176,456,1330,4455
316220,202102,614,1825,413,1381,88,337,49,190,137,527
316225,202102,1579,3544,1184,2926,51,186,896,2049,947,2235
316230,202102,411,1110,319,961,46,146,162,483,208,629
316240,202102,5548,15944,4864,14746,360,1187,3682,11014,4042,12201
316245,202102,3005,9606,2729,9133,111,631,2137,6816,2248,7447
316250,202102,10404,24655,7712,20463,1591,4580,2904,7656,4495,12236
316255,202102,2856,7878,2516,7342,113,342,1906,5633,2019,5975
316257,202102,1391,3317,1020,2672,108,282,625,1558,733,1840
316260,202102,2188,5379,1731,4643,210,559,925,2528,1135,3087
316265,202102,1113,2972,873,2572,19,74,657,1895,676,1969
316270,202102,3685,11179,3171,10072,474,1594,1607,4902,2081,6496
316280,202102,2876,8018,2465,7265,311,1017,1404,3988,1715,5005
316290,202102,3329,9162,2676,7956,295,1010,1152,3284,1447,4294
316292,202102,5082,13359,4119,11814,519,1586,2649,7314,3168,8900
316294,202102,816,2405,619,2068,117,448,166,513,283,961
316295,202102,3257,9027,2658,7986,139,502,1867,5356,2006,5858
316300,202102,1016,2855,822,2542,40,142,612,1860,652,2002
316310,202102,787,2085,520,1609,109,394,98,254,207,648
316320,202102,677,1867,534,1649,59,217,249,740,308,957
316330,202102,1091,2778,840,2358,51,175,642,1744,693,1919
316340,202102,999,2653,746,2201,77,281,421,1182,498,1463
316350,202102,1285,3589,1062,3224,111,355,722,2172,833,2527
316360,202102,617,1647,508,1467,51,158,373,1068,424,1226
316370,202102,5032,13193,3786,11007,586,2006,1628,4245,2214,6251
316380,202102,1720,4111,1367,3607,57,118,947,2528,1004,2646
316390,202102,784,2117,561,1722,233,802,82,227,315,1029
316400,202102,1182,3303,786,2531,107,372,260,764,367,1136
316410,202102,1132,3099,953,2831,58,176,762,2222,820,2398
316420,202102,1969,5300,1714,4971,39,136,1432,4074,1471,4210
316430,202102,836,2168,544,1664,93,314,191,539,284,853
316440,202102,818,2474,651,2177,115,443,173,527,288,970
316443,202102,527,1468,394,1217,96,345,88,255,184,600
316447,202102,1944,5199,1712,4808,22,87,1498,4146,1520,4233
316450,202102,2134,6436,1643,5417,228,815,970,3115,1198,3930
316460,202102,1239,3102,1015,2754,117,362,666,1713,783,2075
316470,202102,6806,19362,4938,15462,760,2671,1919,5507,2679,8178
316480,202102,189,512,160,472,48,142,72,207,120,349
316490,202102,325,867,227,685,35,108,81,208,116,316
316500,202102,1167,3582,784,2678,158,589,187,598,345,1187
316510,202102,773,2447,618,2145,102,366,316,1088,418,1454
316520,202102,1341,3189,1055,2733,120,398,559,1306,679,1704
316530,202102,1130,2924,824,2375,79,294,432,1110,511,1404
316540,202102,901,2277,715,1996,109,347,369,931,478,1278
316550,202102,1329,3853,1146,3515,47,166,890,2710,937,2876
316553,202102,4381,12738,3166,9862,443,1533,1256,3465,1699,4998
316555,202102,2543,7918,2309,7593,95,342,1951,6435,2046,6777
316556,202102,519,1281,401,1067,30,81,236,569,266,650
316557,202102,1055,3206,921,2985,285,1008,347,1074,632,2082
316560,202102,324,896,223,742,44,172,76,232,120,404
316570,202102,1293,3686,1075,3289,272,836,363,1166,635,2002
316580,202102,378,796,225,551,35,99,106,239,141,338
316590,202102,1351,3431,948,2654,206,504,452,1246,658,1750
316600,202102,938,2846,805,2580,121,403,415,1327,536,1730
316610,202102,601,1867,491,1689,60,265,290,961,350,1226
316620,202102,2105,5437,1851,5086,82,245,1488,4068,1570,4313
316630,202102,1544,4589,1275,4086,322,1046,502,1762,824,2808
316640,202102,137,361,111,326,16,57,51,124,67,181
316650,202102,1055,3255,848,2932,85,317,534,1855,619,2172
316660,202102,182,447,79,237,7,26,15,34,22,60
316670,202102,1768,4434,1337,3758,333,994,461,1270,794,2264
316680,202102,2277,5766,1694,4662,104,306,1261,3378,1365,3684
316690,202102,1425,3948,1078,3333,177,592,487,1454,664,2046
316695,202102,1018,2930,835,2604,25,99,593,1836,618,1935
316700,202102,395,922,323,832,16,48,250,619,266,667
316710,202102,3113,10037,2420,8608,430,1646,1044,3657,1474,5303
316720,202102,20459,55172,15191,45239,2541,8120,6612,18622,9153,26742
316730,202102,463,1214,372,1048,41,140,190,502,231,642
316740,202102,752,2155,649,1992,73,260,402,1247,475,1507
316750,202102,389,1150,301,986,69,245,126,387,195,632
316760,202102,3309,10620,2744,9478,1083,4053,590,1920,1673,5973
316770,202102,1610,3601,1240,3100,24,72,1012,2587,1036,2659
316780,202102,544,1601,427,1373,164,572,76,221,240,793
316790,202102,727,1957,528,1558,97,316,158,432,255,748
316800,202102,6303,17516,5074,15299,604,2014,2496,7303,3100,9317
316805,202102,985,2181,793,1973,59,162,607,1525,666,1687
316810,202102,591,1637,416,1294,78,280,219,638,297,918
316820,202102,296,726,164,479,19,70,63,165,82,235
316830,202102,794,2054,639,1814,79,241,383,1069,462,1310
316840,202102,2790,7075,2216,6123,190,644,1553,4080,1743,4724
316850,202102,1875,4925,1365,3995,231,724,590,1657,821,2381
316860,202102,19158,48597,14080,41089,2191,7450,6485,18422,8676,25872
316870,202102,7801,21001,5829,17244,842,2713,2642,7331,3484,10044
316880,202102,921,2440,753,2201,138,437,379,1066,517,1503
316890,202102,1144,2519,684,1910,86,307,433,1124,519,1431
316900,202102,2295,6113,1792,5129,357,1121,537,1426,894,2547
316905,202102,515,1526,418,1339,108,377,163,528,271,905
316910,202102,851,2204,515,1613,132,450,42,122,174,572
316920,202102,1770,4309,1259,3557,207,628,620,1710,827,2338
316930,202102,7693,21841,5765,18406,1305,4477,1572,4740,2877,9217
316935,202102,3998,10754,2927,8785,509,1667,1180,3366,1689,5033
316940,202102,6411,18639,4967,15718,724,2509,2049,6014,2773,8523
316950,202102,1890,4389,1480,3832,40,130,1248,3184,1288,3314
316960,202102,5042,11273,3631,9371,333,949,2483,6254,2816,7203
316970,202102,3779,10567,3275,9645,495,1532,1391,3895,1886,5427
316980,202102,646,1926,495,1632,165,604,53,185,218,789
316990,202102,12054,31901,8915,25651,2152,6777,1448,3744,3600,10521
317000,202102,2486,7270,2189,6836,165,453,1628,5144,1793,5597
317005,202102,2566,7117,2060,6109,326,1008,1118,3245,1444,4253
317010,202102,23826,55447,14996,42031,2796,8714,5869,16798,8665,25512
317020,202102,61316,145139,36580,102653,6507,20002,11828,30721,18335,50723
317030,202102,689,1797,538,1590,13,54,417,1217,430,1271
317040,202102,10914,27266,7720,21847,1660,5084,2735,7952,4395,13036
317043,202102,846,1893,604,1553,46,120,442,1125,488,1245
317047,202102,1173,2801,815,2230,74,220,521,1368,595,1588
317050,202102,1143,3508,826,2775,107,384,340,991,447,1375
317052,202102,2354,6513,1895,5775,272,811,1159,3582,1431,4393
317057,202102,1808,4248,1336,3496,35,120,880,2290,915,2410
317060,202102,515,1329,335,978,40,126,140,359,180,485
317065,202102,1136,3331,933,2934,57,177,585,1751,642,1928
317070,202102,7250,20002,5235,16142,911,3140,1624,4742,2535,7882
317075,202102,909,2338,666,1935,99,322,319,840,418,1162
317080,202102,6045,13975,4495,11544,1161,3247,1563,3839,2724,7086
317090,202102,4726,13586,4206,12743,286,813,3146,9603,3432,10416
317100,202102,2634,6242,1714,4743,392,1110,622,1713,1014,2823
317103,202102,2250,5855,1937,5399,76,338,1532,4100,1608,4438
317107,202102,1466,3836,1126,3208,78,266,685,1750,763,2016
317110,202102,668,1567,346,1051,56,198,112,350,168,548
317115,202102,1047,3004,911,2760,55,147,619,1890,674,2037
317120,202102,14959,39708,12143,35249,1054,3666,7596,21026,8650,24692
317130,202102,11335,26078,7383,19677,1125,3337,2531,6703,3656,10040
317140,202102,855,2032,668,1753,39,105,451,1219,490,1324
317150,202102,992,2357,748,2053,30,94,594,1601,624,1695
317160,202102,3512,8370,2345,6531,159,465,1317,3760,1476,4225
317170,202102,1771,4392,1302,3600,183,597,596,1455,779,2052
317180,202102,1966,6064,1453,4840,277,989,388,1196,665,2185
317190,202102,1178,3173,877,2686,229,672,353,1099,582,1771
317200,202102,5766,15197,4352,12497,1031,3193,957,2528,1988,5721
317210,202102,1192,2870,929,2511,24,92,693,1897,717,1989
317220,202102,232,725,200,664,47,160,75,263,122,423
320010,202102,4516,13011,3645,11285,397,1348,2289,6889,2686,8237
320013,202102,2046,5474,1421,4249,233,720,621,1945,854,2665
320016,202102,2986,7599,2382,6699,172,455,1756,4964,1928,5419
320020,202102,3891,9939,2875,8208,603,1919,1039,3061,1642,4980
320030,202102,1716,4753,1138,3585,209,712,395,1194,604,1906
320035,202102,1908,5189,1563,4606,387,1252,681,1942,1068,3194
320040,202102,4145,11627,3453,10392,467,1476,1948,5643,2415,7119
320050,202102,1759,3983,1514,3635,188,537,898,2078,1086,2615
320060,202102,13025,35102,9742,28677,1480,4687,4547,12496,6027,17183
320070,202102,1537,4272,1102,3404,192,663,402,1166,594,1829
320080,202102,5799,14748,4077,11362,803,2381,1456,3824,2259,6205
320090,202102,8632,22724,5748,16835,1275,3945,2009,5476,3284,9421
320100,202102,3103,8337,2541,7378,429,1353,1311,3804,1740,5157
320110,202102,2088,4798,1416,3725,207,575,708,1781,915,2356
320115,202102,1873,5933,1585,5449,681,2508,399,1406,1080,3914
320120,202102,24197,61263,17003,48387,2351,7185,7904,21270,10255,28455
320130,202102,47595,130297,39328,115532,4864,15704,23271,66201,28135,81905
320140,202102,3535,9569,2368,7292,338,1214,963,2915,1301,4129
320150,202102,13750,35317,9977,28197,2449,7626,1568,3920,4017,11546
320160,202102,6091,16811,4517,13810,723,2452,2003,6028,2726,8480
320170,202102,1732,4913,1259,3967,346,1070,457,1528,803,2598
320180,202102,691,2161,553,1896,205,746,148,454,353,1200
320190,202102,2842,8964,2186,7528,512,1890,559,1792,1071,3682
320200,202102,1339,3559,911,2792,201,680,337,1024,538,1704
320210,202102,4316,10920,3345,9268,541,1608,1732,4589,2273,6197
320220,202102,3007,7734,2309,6607,342,1056,1253,3414,1595,4470
320225,202102,1353,4187,970,3291,338,1262,193,641,531,1903
320230,202102,5064,13830,3904,11923,802,2700,1567,4607,2369,7307
320240,202102,16274,40777,12132,34199,2913,8972,3845,10674,6758,19646
320245,202102,3137,9152,2468,7831,856,2867,431,1333,1287,4200
320250,202102,2442,6777,1666,4947,374,1229,478,1222,852,2451
320255,202102,1927,5920,1649,5402,412,1396,763,2565,1175,3961
320260,202102,1440,4021,870,2744,177,611,214,574,391,1185
320265,202102,2477,7555,2003,6608,874,3114,310,1002,1184,4116
320270,202102,2211,6297,1701,5299,442,1490,584,1826,1026,3316
320280,202102,7328,19318,6000,17076,1118,3479,3008,8271,4126,11750
320290,202102,1345,3959,875,2836,236,838,221,663,457,1501
320300,202102,3651,10884,2906,9374,809,2832,736,2221,1545,5053
320305,202102,5148,14411,4011,12192,725,2399,1958,5771,2683,8170
320310,202102,2255,6121,1583,4731,275,867,708,1977,983,2844
320313,202102,2441,6037,1626,4559,320,990,437,1114,757,2104
320316,202102,1481,4142,1208,3685,191,596,705,2155,896,2751
320320,202102,22239,57663,15960,46857,3636,11161,5703,16779,9339,27940
320330,202102,2934,7903,2290,6746,407,1216,1205,3609,1612,4825
320332,202102,7619,20236,6078,17485,1357,4226,2699,7631,4056,11857
320334,202102,1757,4886,1233,3823,256,972,316,731,572,1703
320335,202102,1445,4273,1038,3332,225,805,274,805,499,1610
320340,202102,4869,12018,4045,10822,496,1443,2375,6394,2871,7837
320350,202102,5454,13301,3884,10526,437,1324,2099,5322,2536,6646
320360,202102,1422,3612,1059,2933,136,367,518,1385,654,1752
320370,202102,2558,7790,1885,6347,569,2021,575,1925,1144,3946
320380,202102,2629,6950,2184,6229,247,755,1388,3849,1635,4604
320390,202102,7224,19257,5350,15570,1102,3429,2115,5769,3217,9198
320400,202102,3309,9257,2502,7550,691,2222,786,2247,1477,4469
320405,202102,4983,12888,3803,10868,556,1729,1901,5268,2457,6997
320410,202102,4760,12236,3607,10393,647,1817,1794,5411,2441,7228
320420,202102,2733,7128,2066,5947,515,1660,321,921,836,2581
320425,202102,2165,5191,1654,4331,130,361,1032,2637,1162,2998
320430,202102,3178,7926,2508,6740,342,1001,1532,3943,1874,4944
320435,202102,2079,6460,1645,5610,585,2125,514,1763,1099,3888
320440,202102,1508,4140,1112,3385,178,592,492,1414,670,2006
320450,202102,1750,4942,1367,4221,261,911,619,1785,880,2696
320455,202102,4388,13152,2989,9840,712,2528,731,2196,1443,4724
320460,202102,2086,6080,1495,4851,355,1244,408,1212,763,2456
320465,202102,1313,3640,998,3044,136,420,535,1643,671,2063
320470,202102,3644,9946,2648,7891,576,1824,663,1785,1239,3609
320480,202102,1674,4545,1370,4038,183,605,821,2359,1004,2964
320490,202102,21508,55966,16118,46638,2639,8311,6775,19447,9414,27758
320495,202102,1226,3345,880,2674,188,656,314,902,502,1558
320500,202102,52278,137937,41939,120412,5616,17539,24378,66995,29994,84534
320501,202102,4417,12762,3302,10734,895,3273,1054,3363,1949,6636
320503,202102,2305,6625,1518,4987,409,1455,412,1303,821,2758
320506,202102,2650,7878,1957,6347,583,2044,170,558,753,2602
320510,202102,10331,27608,8424,24393,862,2870,5227,14628,6089,17498
320515,202102,1795,4910,1391,4079,364,1181,459,1269,823,2450
320517,202102,2168,6455,1740,5540,541,1887,525,1636,1066,3523
320520,202102,37276,95103,28091,79800,4577,14344,12079,32959,16656,47303
320530,202102,33080,86360,26258,74441,2319,7763,16677,44666,18996,52429
330010,202102,23343,60678,19355,54187,2308,7094,12929,35099,15237,42193
330015,202102,1362,3328,1071,2909,183,563,614,1598,797,2161
330020,202102,19666,48796,16544,44351,2313,6913,11422,29948,13735,36861
330022,202102,1874,4997,1457,4300,235,694,843,2475,1078,3169
330023,202102,5128,12004,3745,10096,576,1734,2151,5684,2727,7418
330025,202102,6903,15900,4059,11205,882,2695,793,2104,1675,4799
330030,202102,10410,27430,7926,23443,784,2714,4907,13830,5691,16544
330040,202102,14716,37755,11762,32876,1011,3176,7989,21477,9000,24653
330045,202102,84645,198024,69746,179288,5274,13278,55188,141570,60462,154848
330050,202102,2497,6538,1849,5451,348,1092,928,2608,1276,3700
330060,202102,5215,13453,4075,11450,780,2460,1738,4486,2518,6946
330070,202102,22289,55639,17951,49487,2698,7955,10732,29350,13430,37305
330080,202102,8764,21898,7467,20101,901,2593,5176,13742,6077,16335
330090,202102,3379,7060,2361,5665,153,394,1650,3953,1803,4347
330093,202102,2680,6359,2021,5461,112,330,1540,4142,1652,4472
330095,202102,1258,3514,992,3040,77,282,606,1718,683,2000
330100,202102,71164,185794,60812,170746,3458,11489,46856,129623,50314,141112
330110,202102,2076,5732,1662,5053,257,856,956,2808,1213,3664
330115,202102,2548,6050,1802,4907,247,769,1020,2658,1267,3427
330120,202102,3547,7818,2666,6698,206,588,1903,4608,2109,5196
330130,202102,4399,11751,3591,10550,482,1480,2237,6546,2719,8026
330140,202102,3851,9856,3069,8748,405,1275,2002,5565,2407,6840
330150,202102,2096,5528,1591,4738,276,860,804,2347,1080,3207
330160,202102,1341,3612,989,2988,182,589,520,1497,702,2086
330170,202102,111558,271197,89572,241797,11914,31566,60397,165286,72311,196852
330180,202102,1935,4601,1484,3982,90,275,1023,2677,1113,2952
330185,202102,9845,24409,8219,22185,465,1529,6624,17438,7089,18967
330187,202102,4453,11074,3508,9549,454,1345,2134,5725,2588,7070
330190,202102,34217,81205,28782,73828,1873,5206,22843,57860,24716,63066
330200,202102,16044,39980,12974,36237,2512,6584,8066,23403,10578,29987
330205,202102,2165,5285,1643,4456,102,321,1137,2957,1239,3278
330210,202102,3526,8652,2569,7015,355,1035,1286,3281,1641,4316
330220,202102,12114,29517,8571,23698,1677,5228,3219,8215,4896,13443
330225,202102,3920,9726,3001,8354,190,651,2170,5882,2360,6533
330227,202102,16891,40316,14048,36902,515,1481,12048,31329,12563,32810
330230,202102,2121,4558,1380,3636,118,332,810,2154,928,2486
330240,202102,23352,60104,19291,53930,2172,6710,13084,35741,15256,42451
330245,202102,1768,4315,1065,3095,207,608,392,1120,599,1728
330250,202102,38496,96851,31695,86953,5158,14580,19671,53668,24829,68248
330260,202102,4931,11708,3720,10076,315,1003,2695,7052,3010,8055
330270,202102,31875,71002,19717,51246,2975,8269,8117,20085,11092,28354
330280,202102,2344,6057,1762,5078,184,565,1040,2902,1224,3467
330285,202102,25188,59103,19859,51555,1323,4064,14916,37424,16239,41488
330290,202102,3954,9445,3185,8448,341,1021,2278,5828,2619,6849
330300,202102,5829,13545,4255,11321,317,944,2993,7797,3310,8741
330310,202102,2721,6553,1940,5273,130,302,1316,3587,1446,3889
330320,202102,17144,39583,13128,34616,1511,3781,9385,25098,10896,28879
330330,202102,42052,90109,32626,77458,2748,7211,23454,54365,26202,61576
330340,202102,17920,41359,12810,33625,1784,5424,6844,16650,8628,22074
330350,202102,145801,331136,120294,300293,7454,19263,99164,245934,106618,265197
330360,202102,7425,17869,6340,16569,198,508,5383,14010,5581,14518
330370,202102,4934,13931,3817,12054,907,2927,1565,5173,2472,8100
330380,202102,5437,14213,4127,11939,636,2171,2167,5948,2803,8119
330385,202102,4047,11385,3294,10297,737,2541,1592,4893,2329,7434
330390,202102,26713,70604,20429,60077,2653,9024,12109,33524,14762,42548
330395,202102,3209,7827,2646,7119,152,477,1934,5074,2086,5551
330400,202102,3408,8850,2894,8051,151,545,2174,5691,2325,6236
330410,202102,3345,8765,2394,7124,497,1605,1013,2843,1510,4448
330411,202102,2759,7393,2137,6267,136,480,1496,4217,1632,4697
330412,202102,1537,4303,1250,3836,133,471,773,2242,906,2713
330414,202102,23887,59414,19391,53327,1415,4169,14582,39540,15997,43709
330415,202102,4373,11769,3399,10098,351,1091,1994,5870,2345,6961
330420,202102,12013,29294,8544,23713,954,3036,4557,11750,5511,14786
330430,202102,9664,22967,8102,20856,298,968,6446,16103,6744,17071
330440,202102,2628,6876,1997,5827,283,965,1178,3286,1461,4251
330450,202102,1417,3947,1117,3444,146,490,615,1856,761,2346
330452,202102,17811,44440,14313,39125,1635,5104,9394,24703,11029,29807
330455,202102,552807,1293591,428700,1118256,57107,159259,277869,711330,334976,870589
330460,202102,1168,3129,878,2720,143,480,480,1451,623,1931
330470,202102,4807,11823,3469,9801,1127,3309,927,2718,2054,6027
330475,202102,9823,24908,7923,22478,1184,3852,5138,14210,6322,18062
330480,202102,6002,15302,5051,13930,416,1254,3510,9376,3926,10630
330490,202102,112736,255822,91359,227311,9982,25731,65237,160867,75219,186598
330500,202102,7488,18196,6186,16431,604,1801,4458,11640,5062,13441
330510,202102,40506,98174,29910,83403,4557,13693,18592,50982,23149,64675
330513,202102,1237,3140,982,2796,203,622,475,1355,678,1977
330515,202102,2506,6568,2005,5878,367,1181,1123,3188,1490,4369
330520,202102,11340,29394,9252,26214,1120,3543,5831,16052,6951,19595
330530,202102,1724,4107,1265,3434,252,735,580,1555,832,2290
330540,202102,2802,7354,2185,6302,536,1584,918,2579,1454,4163
330550,202102,9168,22997,6998,20184,1840,5856,3053,8655,4893,14511
330555,202102,18522,38403,15337,34686,766,1928,12605,28761,13371,30689
330560,202102,4097,10784,3319,9532,505,1473,1958,5500,2463,6973
330570,202102,2684,7288,2291,6716,337,1071,1519,4418,1856,5489
330575,202102,5403,13818,4637,12540,285,870,3721,9769,4006,10639
330580,202102,17745,46525,13880,39693,2330,7184,6988,19139,9318,26323
330590,202102,1445,3853,1187,3520,218,645,743,2239,961,2884
330600,202102,12377,31864,10032,28158,877,2873,6485,17636,7362,20509
330610,202102,9096,24112,7282,21296,532,1825,5062,14469,5594,16294
330615,202102,2102,5688,1674,5119,309,965,1040,3257,1349,4222
330620,202102,4034,11340,3165,9869,670,2243,1380,4055,2050,6298
330630,202102,24384,60341,19207,52408,1249,4064,13805,36420,15054,40484
350010,202102,2041,5267,1115,3330,222,704,211,470,433,1174
350020,202102,707,1790,407,1220,56,183,133,370,189,553
350030,202102,3495,9645,2635,8174,630,2172,1164,3366,1794,5538
350040,202102,727,2054,425,1413,48,186,149,379,197,565
350050,202102,1350,3273,881,2470,184,597,319,732,503,1329
350055,202102,914,2374,723,2076,81,247,424,1159,505,1406
350060,202102,218,562,130,381,17,56,56,159,73,215
350070,202102,3217,8454,2088,6426,410,1407,680,1859,1090,3266
350075,202102,595,1714,444,1425,171,577,57,194,228,771
350080,202102,649,1680,429,1294,59,203,168,457,227,660
350090,202102,598,1395,361,999,67,197,155,401,222,598
350100,202102,2319,6085,1628,4894,122,456,1011,2841,1133,3297
350110,202102,477,1187,329,932,17,55,189,528,206,583
350115,202102,1223,3499,1009,3070,177,600,518,1418,695,2018
350120,202102,671,1548,376,1013,33,113,205,486,238,599
350130,202102,3124,8193,2453,6969,439,1259,1181,3203,1620,4462
350140,202102,786,2186,549,1745,46,192,289,854,335,1046
350150,202102,544,1644,439,1441,96,314,131,398,227,712
350160,202102,11048,27678,7489,21165,948,3004,4472,12011,5420,15015
350170,202102,2331,6547,1901,5629,313,1012,890,2390,1203,3402
350180,202102,1003,2447,545,1607,99,304,136,368,235,672
350190,202102,2804,7890,1917,6015,340,1207,783,2092,1123,3299
350200,202102,455,1270,351,1076,17,62,232,664,249,726
350210,202102,5836,13368,3986,10513,481,1397,2458,6223,2939,7620
350220,202102,2888,7838,1966,6025,410,1322,632,1748,1042,3070
350230,202102,953,2422,780,2186,138,412,441,1203,579,1615
350240,202102,636,1828,406,1291,94,289,97,286,191,575
350250,202102,2618,7278,1974,6220,590,2046,505,1562,1095,3608
350260,202102,830,1932,546,1457,56,170,334,847,390,1017
350270,202102,4532,12010,3618,10300,516,1623,1953,5148,2469,6771
350275,202102,2323,6199,1823,5440,298,977,1057,3013,1355,3990
350280,202102,18501,41778,11238,30081,1786,5013,4518,11536,6304,16549
350290,202102,3170,8690,2179,6672,387,1297,861,2468,1248,3765
350300,202102,626,1666,467,1376,58,169,255,705,313,874
350310,202102,903,2575,670,2121,110,398,266,749,376,1147
350315,202102,588,1456,390,1126,22,79,203,540,225,619
350320,202102,15272,38677,11172,31505,2207,6886,4423,11504,6630,18390
350330,202102,13880,33701,9971,26374,1047,3057,6273,15608,7320,18665
350335,202102,368,1043,284,882,38,134,127,369,165,503
350340,202102,1185,2991,733,2174,118,400,303,793,421,1193
350350,202102,757,1873,585,1685,65,215,360,1025,425,1240
350360,202102,1059,3118,808,2605,210,686,242,808,452,1494
350370,202102,614,1521,431,1192,149,385,132,376,281,761
350380,202102,4403,11953,3159,9431,893,2609,824,2540,1717,5149
350390,202102,10811,28041,8519,24220,1579,4719,4204,11452,5783,16171
350395,202102,419,1076,219,692,24,71,81,238,105,309
350400,202102,7967,19344,5531,15401,1334,4022,1525,4190,2859,8212
350410,202102,10001,27509,7329,22413,1442,4903,2880,8142,4322,13045
350420,202102,753,2002,521,1503,79,254,123,297,202,551
350430,202102,663,1761,541,1577,73,245,333,894,406,1139
350440,202102,2089,5174,1697,4590,129,367,1114,2955,1243,3322
350450,202102,6412,17517,4964,15024,1069,3570,2051,5818,3120,9388
350460,202102,1718,4389,938,2837,140,448,285,776,425,1224
350470,202102,255,643,198,546,12,38,141,373,153,411
350480,202102,999,2422,652,1840,138,475,171,368,309,843
350490,202102,1955,5032,1395,4142,314,962,448,1221,762,2183
350500,202102,669,1758,507,1473,64,204,242,656,306,860
350510,202102,1184,3041,885,2500,93,299,538,1443,631,1742
350520,202102,2138,6423,1659,5499,262,968,727,2175,989,3143
350530,202102,2782,6956,2081,5646,220,670,1243,3140,1463,3810
350535,202102,1443,3922,1251,3654,178,572,777,2199,955,2771
350540,202102,2000,4643,1496,3912,179,481,959,2396,1138,2877
350550,202102,8279,20260,5740,16086,598,2014,3335,8649,3933,10663
350560,202102,3879,10802,3101,9465,286,920,1979,5844,2265,6764
350570,202102,24790,68131,20153,59378,3513,11459,10495,29523,14008,40982
350580,202102,2062,5476,1258,3846,334,1116,231,570,565,1686
350590,202102,5071,13548,3745,10632,487,1570,2202,5750,2689,7320
350600,202102,34825,79758,21757,57414,3125,9368,10159,24570,13284,33938
350610,202102,6829,18489,4895,14671,815,2707,2300,6455,3115,9162
350620,202102,413,1039,256,796,23,72,149,442,172,514
350630,202102,1436,3692,1061,3031,62,223,698,1864,760,2087
350635,202102,9367,22773,7012,19128,928,2793,4284,11188,5212,13981
350640,202102,903,2394,485,1492,69,211,138,373,207,584
350650,202102,8483,22399,5863,17293,1090,3495,2235,6115,3325,9610
350660,202102,4505,11653,3476,9961,559,1616,1845,5308,2404,6924
350670,202102,1771,4671,1444,4199,140,416,983,2869,1123,3285
350680,202102,1093,2910,744,2281,127,410,308,896,435,1306
350690,202102,1286,3296,913,2685,156,485,484,1393,640,1878
350700,202102,4836,12116,3496,10055,709,2329,1498,4123,2207,6452
350710,202102,2811,7619,2383,6873,405,1367,1294,3423,1699,4790
350715,202102,780,2217,650,1997,69,269,358,1024,427,1293
350720,202102,155,413,114,342,18,58,34,82,52,140
350730,202102,627,1669,531,1511,24,87,404,1089,428,1176
350740,202102,1698,4468,1180,3426,204,636,404,1078,608,1714
350745,202102,563,1407,324,978,33,124,135,375,168,499
350750,202102,9801,25197,7466,21231,1259,4180,3454,8801,4713,12981
350760,202102,14805,36409,10714,29432,2150,6536,4596,11379,6746,17915
350770,202102,997,2484,635,1850,37,119,405,1148,442,1267
350775,202102,683,1559,473,1252,58,149,226,606,284,755
350780,202102,2304,5523,1632,4573,270,892,564,1823,834,2715
350790,202102,1982,5198,1266,3860,244,808,344,856,588,1664
350800,202102,3485,9894,2987,9038,236,813,2072,6084,2308,6897
350810,202102,2825,6820,2181,5876,334,827,1144,3170,1478,3997
350820,202102,947,2185,553,1492,61,191,268,649,329,840
350830,202102,870,2390,502,1587,72,236,155,402,227,638
350840,202102,3278,9454,2468,7952,550,1975,1097,3236,1647,5211
350850,202102,7582,20752,5948,17842,1107,3592,2883,8177,3990,11769
350860,202102,3591,9530,3086,8859,110,407,2371,6760,2481,7167
350870,202102,2565,7164,1915,6134,260,930,1076,3354,1336,4284
350880,202102,1294,3658,1017,3111,264,843,264,768,528,1611
350890,202102,539,1390,342,977,53,159,125,310,178,469
350900,202102,7067,18897,4547,13702,921,3038,1610,4480,2531,7518
350910,202102,917,2200,790,2009,96,248,569,1426,665,1674
350920,202102,12186,29691,10346,26751,401,1283,8520,21234,8921,22517
350925,202102,4129,11131,2955,9039,553,1825,1407,3987,1960,5812
350930,202102,1485,3834,1040,2976,76,230,652,1822,728,2052
350940,202102,2249,5819,1726,4984,171,562,1088,2994,1259,3556
350945,202102,833,2330,631,1938,94,321,317,895,411,1216
350950,202102,89641,227525,69482,190438,8597,25806,43178,113011,51775,138817
350960,202102,6438,17257,4996,14587,587,1968,2986,8267,3573,10235
350970,202102,3516,9725,2513,7876,718,2510,534,1426,1252,3936
350980,202102,646,1754,521,1518,128,389,240,699,368,1088
350990,202102,1741,4801,1291,4079,306,1084,453,1349,759,2433
350995,202102,776,2403,696,2245,54,211,485,1507,539,1718
351000,202102,2833,7337,1977,5843,356,1105,719,2072,1075,3177
351010,202102,333,816,224,632,29,94,113,303,142,397
351015,202102,812,2431,657,2101,106,372,290,827,396,1199
351020,202102,8664,23342,6622,19887,1447,4364,3027,8942,4474,13306
351030,202102,2819,8281,2269,7222,327,1168,1217,3737,1544,4905
351040,202102,5003,12348,4196,11154,208,653,3435,8892,3643,9545
351050,202102,16600,40229,12063,33279,2295,6712,5426,14800,7721,21512
351060,202102,48496,120932,37294,102023,3619,10962,25300,66897,28919,77859
351070,202102,1363,3338,743,2291,175,593,124,369,299,962
351080,202102,2771,6594,1986,5675,203,698,1342,3645,1545,4343
351090,202102,323,931,236,772,43,143,70,231,113,374
351100,202102,2551,6889,1667,5131,367,1195,481,1543,848,2738
351110,202102,6092,15375,3977,11532,650,2083,1760,4793,2410,6876
351120,202102,766,1929,517,1520,62,188,198,574,260,762
351130,202102,1188,3019,549,1694,99,312,146,409,245,721
351140,202102,2158,6006,1599,4963,296,1032,692,1931,988,2963
351150,202102,2665,7551,1811,5692,290,1007,712,2012,1002,3019
351160,202102,1077,3315,786,2643,159,576,204,571,363,1147
351170,202102,1343,3664,1152,3333,84,267,827,2305,911,2572
351190,202102,1018,2793,681,2114,118,375,253,722,371,1097
351200,202102,1591,3763,1183,3170,90,279,834,2089,924,2368
351210,202102,1533,3744,961,2672,76,246,554,1431,630,1677
351220,202102,3312,9200,2829,8414,295,905,1888,5560,2183,6465
351230,202102,1730,4645,1284,3867,220,768,592,1629,812,2397
351240,202102,2394,6005,1468,4117,321,980,523,1318,844,2298
351250,202102,1053,2791,638,1964,83,276,233,699,316,975
351260,202102,900,2255,650,1802,133,376,245,638,378,1014
351270,202102,441,1179,354,1027,37,134,202,514,239,648
351280,202102,3741,9722,2881,8127,575,1638,1310,3559,1885,5197
351290,202102,1211,2971,848,2348,116,351,505,1338,621,1689
351300,202102,18310,49114,12664,38406,2167,7146,5503,15898,7670,23044
351310,202102,3430,8246,2608,7000,154,522,1936,4933,2090,5455
351320,202102,939,2684,698,2190,120,399,250,708,370,1107
351330,202102,495,1185,407,1022,22,65,288,651,310,716
351340,202102,6189,17427,5001,15336,1198,3846,2217,6753,3415,10599
351350,202102,11341,28096,9352,25002,925,2623,6851,17831,7776,20454
351360,202102,3741,9893,3070,8898,719,2222,1235,3314,1954,5536
351370,202102,2035,5583,1374,4233,315,1037,428,1199,743,2236
351380,202102,48100,114772,34072,90710,4108,11810,19771,50182,23879,61992
351385,202102,335,882,154,479,29,86,43,121,72,207
351390,202102,1351,3251,838,2506,111,395,484,1354,595,1749
351400,202102,895,2477,741,2171,111,324,463,1330,574,1654
351410,202102,2584,7116,1865,5713,315,1003,748,2224,1063,3227
351420,202102,438,1039,248,709,29,76,144,386,173,462
351430,202102,931,2473,740,2162,63,181,504,1430,567,1611
351440,202102,3418,8864,2268,6570,410,1242,632,1562,1042,2804
351450,202102,1692,4457,1121,3408,222,732,190,452,412,1184
351460,202102,857,2210,674,1926,150,418,371,1056,521,1474
351470,202102,1188,2992,932,2571,84,291,611,1580,695,1871
351480,202102,2476,7215,1964,6338,369,1319,843,2540,1212,3859
351490,202102,2037,5664,1746,5147,67,273,1431,4078,1498,4351
351492,202102,346,931,284,802,7,21,218,602,225,623
351495,202102,172,439,133,366,16,39,73,199,89,238
351500,202102,38062,92358,29058,77587,4095,11649,17726,45276,21821,56925
351510,202102,12835,31488,9348,25611,1103,3464,5849,15286,6952,18750
351512,202102,476,1276,349,1001,62,184,117,305,179,489
351515,202102,3204,7120,2019,5303,362,1073,581,1625,943,2698
351518,202102,2296,5729,1477,4286,190,624,827,2182,1017,2806
351519,202102,693,1894,439,1400,83,264,72,207,155,471
351520,202102,1301,3199,566,1696,54,184,247,659,301,843
351530,202102,351,912,210,618,34,107,88,208,122,315
351535,202102,1839,4505,1343,3661,205,611,689,1754,894,2365
351540,202102,2563,6300,1701,4780,253,830,683,1690,936,2520
351550,202102,7164,17570,4833,13383,472,1496,2746,7029,3218,8525
351560,202102,433,1231,337,1045,80,271,103,294,183,565
351565,202102,234,652,187,567,42,143,50,128,92,271
351570,202102,21338,56208,16327,46374,1615,4951,10254,27930,11869,32881
351580,202102,236,604,137,419,12,38,59,193,71,231
351590,202102,519,1179,276,755,24,90,159,384,183,474
351600,202102,1359,3579,1044,2994,112,351,600,1616,712,1967
351610,202102,786,1855,496,1341,25,71,288,733,313,804
351620,202102,22627,58750,16372,48217,2557,8592,7532,20089,10089,28681
351630,202102,28451,73728,22899,64362,3060,9222,14428,39109,17488,48331
351640,202102,17683,45874,13917,39177,1313,4266,9404,25297,10717,29563
351650,202102,368,969,183,582,24,79,54,151,78,230
351660,202102,736,2035,474,1466,73,236,86,220,159,456
351670,202102,5926,15765,3876,11368,814,2371,1628,4461,2442,6832
351680,202102,430,1202,278,874,40,129,79,203,119,332
351685,202102,398,1126,317,995,84,267,101,298,185,565
351690,202102,1104,2745,612,1773,85,279,269,701,354,980
351700,202102,1293,3189,947,2611,174,491,497,1286,671,1777
351710,202102,754,2011,547,1625,49,172,303,815,352,987
351720,202102,1376,3526,908,2722,144,454,373,1049,517,1503
351730,202102,942,2475,785,2233,59,212,498,1338,557,1550
351740,202102,3441,8605,2734,7272,473,1361,1381,3375,1854,4736
351750,202102,1312,3379,821,2529,137,449,334,982,471,1431
351760,202102,3246,9084,2389,7391,487,1711,892,2483,1379,4194
351770,202102,1752,5077,1418,4447,246,814,769,2338,1015,3152
351780,202102,1186,2989,723,2134,97,331,273,750,370,1081
351790,202102,1343,3187,1065,2819,168,459,625,1673,793,2132
351800,202102,524,1192,262,705,27,76,103,228,130,304
351810,202102,1052,2746,880,2499,56,149,614,1667,670,1816
351820,202102,2573,7191,1796,5692,460,1569,420,1236,880,2805
351830,202102,4504,11959,3480,10190,316,1112,2213,6154,2529,7266
351840,202102,8563,23230,6414,19327,880,3008,3431,9611,4311,12619
351850,202102,1515,4128,1011,3152,159,573,353,945,512,1518
351860,202102,2664,7593,2041,6441,340,1204,1089,3431,1429,4635
351870,202102,23477,59213,17402,49328,4136,12186,7256,20820,11392,33006
351880,202102,133909,339774,100670,283560,21224,66223,48863,130445,70087,196668
351885,202102,927,2420,728,2095,58,206,480,1320,538,1526
351890,202102,843,2159,531,1636,109,358,96,251,205,609
351900,202102,1117,2921,859,2542,114,334,507,1486,621,1820
351905,202102,421,1133,296,896,23,76,148,395,171,471
351907,202102,21036,54483,16398,46340,1820,5729,10608,28785,12428,34514
351910,202102,1637,4220,1145,3173,76,236,673,1690,749,1926
351920,202102,852,2246,643,1850,97,318,282,735,379,1053
351925,202102,918,2383,706,2004,88,295,365,949,453,1244
351930,202102,3257,8983,2922,8389,587,1693,1933,5460,2520,7153
351940,202102,1083,2766,780,2240,119,370,386,1089,505,1459
351950,202102,1685,3794,1265,3177,53,162,907,2188,960,2350
351960,202102,4990,12478,3635,10092,791,2366,1632,4201,2423,6567
351970,202102,7082,20655,5571,18044,851,3111,3076,9639,3927,12750
351980,202102,955,2207,615,1667,86,272,347,851,433,1123
351990,202102,1475,3475,1070,2880,52,195,523,1267,575,1462
352000,202102,2638,7442,2275,6695,247,835,1516,4200,1763,5035
352010,202102,2271,5999,1829,5281,489,1543,400,1182,889,2725
352020,202102,1341,3656,1031,3149,147,499,514,1486,661,1985
352030,202102,5738,15002,4467,12926,824,2597,2192,6142,3016,8739
352040,202102,2898,7584,2002,5824,283,923,757,1884,1040,2807
352042,202102,2919,7014,1943,5489,353,1151,881,2369,1234,3520
352044,202102,2078,5393,1215,3778,195,688,236,693,431,1381
352050,202102,12512,32832,8252,24575,1987,6789,1628,4067,3615,10856
352060,202102,695,1868,516,1534,83,276,219,582,302,858
352070,202102,934,1866,599,1425,58,149,303,644,361,793
352080,202102,487,1217,278,803,29,103,97,244,126,347
352090,202102,1494,4365,1239,3866,142,515,610,1727,752,2242
352100,202102,3370,9417,2721,8205,562,1861,1197,3481,1759,5342
352110,202102,589,1682,446,1408,93,298,182,537,275,835
352115,202102,525,1386,431,1238,58,197,259,728,317,925
352120,202102,880,2589,729,2287,78,228,429,1267,507,1495
352130,202102,2064,5694,1391,4078,204,640,579,1572,783,2212
352140,202102,1141,3109,820,2490,141,459,372,1089,513,1548
352150,202102,887,2321,693,2004,69,211,497,1409,566,1620
352160,202102,1008,2458,730,2020,75,266,417,1092,492,1358
352170,202102,2994,7903,2379,6723,311,980,1469,3880,1780,4860
352180,202102,2368,6329,1814,5338,402,1345,564,1463,966,2808
352190,202102,1274,3402,1014,3001,192,519,510,1582,702,2101
352200,202102,326,976,229,778,36,143,82,271,118,414
352210,202102,19841,46243,15636,40729,922,2722,12259,31262,13181,33984
352215,202102,663,1697,566,1556,77,237,350,923,427,1160
352220,202102,20917,51206,14516,40037,2623,7928,6602,16808,9225,24736
352230,202102,14473,41079,11241,35086,2673,9326,4037,11569,6710,20895
352240,202102,10170,25924,7788,22033,1652,5253,3425,9004,5077,14257
352250,202102,22417,62006,17942,54452,2805,9107,10789,32237,13594,41344
352260,202102,4712,11711,3150,8742,443,1415,1770,4401,2213,5816
352265,202102,921,2541,812,2393,50,174,616,1767,666,1941
352270,202102,1426,4194,1060,3425,216,741,375,1139,591,1880
352280,202102,2435,6069,1840,5218,189,648,1112,2930,1301,3578
352290,202102,1108,3156,903,2779,119,405,489,1362,608,1767
352300,202102,853,2295,584,1732,76,263,306,841,382,1104
352310,202102,43036,113694,32180,94954,7673,23259,13987,41530,21660,64789
352320,202102,6561,17023,5105,14303,749,2360,2745,6939,3494,9299
352330,202102,2180,5759,1660,5034,282,1005,905,2569,1187,3574
352340,202102,6048,15814,4470,12945,673,2240,2261,6011,2934,8251
352350,202102,2182,6149,1683,5053,166,611,970,2660,1136,3271
352360,202102,1221,3233,1006,2864,80,275,758,2086,838,2361
352370,202102,1087,3023,941,2784,16,64,776,2260,792,2324
352380,202102,832,2235,626,1871,131,393,217,627,348,1020
352390,202102,14329,35096,9811,27240,1555,4706,5386,14159,6941,18865
352400,202102,3474,9502,2850,8357,598,2053,1419,3872,2017,5925
352410,202102,3254,8244,2476,6974,209,708,1543,4162,1752,4870
352420,202102,824,1985,586,1646,114,340,222,578,336,918
352430,202102,8114,19982,5849,16045,1110,3472,2859,7353,3969,10825
352440,202102,17835,47823,13405,39459,3221,9796,4904,14049,8125,23845
352450,202102,745,1780,369,1147,53,184,129,382,182,566
352460,202102,2961,8085,2085,6512,404,1386,851,2499,1255,3885
352470,202102,3328,8379,2524,7095,281,899,1577,4218,1858,5117
352480,202102,3999,9413,2688,7092,399,1220,1298,3033,1697,4253
352490,202102,756,2157,602,1889,99,353,286,844,385,1197
352500,202102,10136,25960,6856,19875,2733,8703,682,1121,3415,9824
352510,202102,3811,10257,2840,8558,555,1814,1342,3849,1897,5663
352520,202102,2900,7418,2251,6347,380,1234,1308,3339,1688,4573
352530,202102,10577,26937,7161,20531,1210,3993,2592,6374,3802,10367
352540,202102,580,1696,423,1342,59,203,151,433,210,636
352550,202102,1001,2759,695,2182,120,423,245,693,365,1116
352560,202102,557,1530,423,1272,78,250,201,559,279,809
352570,202102,2331,6595,1499,4786,348,1203,156,389,504,1592
352580,202102,655,1687,549,1495,44,136,380,985,424,1121
352585,202102,328,867,237,712,19,73,143,394,162,467
352590,202102,12996,33847,9117,26554,2195,6966,4094,11052,6289,18018
352600,202102,1897,5086,1495,4366,155,497,941,2604,1096,3101
352610,202102,2780,7732,2087,6529,405,1433,879,2593,1284,4026
352620,202102,5555,14024,4231,12151,1161,3382,1676,4878,2837,8260
352630,202102,826,2028,614,1728,114,366,281,718,395,1084
352640,202102,2963,7526,2140,6077,209,617,1223,3331,1432,3948
352650,202102,584,1648,404,1266,53,179,145,431,198,610
352660,202102,1068,3114,893,2765,101,332,536,1620,637,1952
352670,202102,9552,25490,6408,19311,1580,5157,1808,4994,3388,10151
352680,202102,3316,9720,2324,7467,355,1354,1101,3161,1456,4515
352690,202102,27197,67552,21309,57702,1313,4262,15246,39528,16559,43790
352700,202102,580,1450,439,1269,144,475,121,348,265,823
352710,202102,5197,13282,3721,10632,871,2751,1554,4084,2425,6835
352720,202102,7797,20903,6098,17820,2311,6950,1578,4296,3889,11246
352725,202102,583,1393,333,948,25,69,167,450,192,519
352730,202102,5192,15007,4697,13894,545,1753,2151,5578,2696,7331
352740,202102,2279,5402,1724,4588,174,550,1049,2622,1223,3172
352750,202102,423,1049,263,759,44,146,111,280,155,426
352760,202102,1626,4473,1278,3811,95,271,761,2272,856,2543
352770,202102,862,2324,595,1814,125,387,223,651,348,1038
352780,202102,618,1714,445,1376,98,278,114,370,212,648
352790,202102,454,1198,324,949,35,120,129,327,164,447
352800,202102,1254,3780,883,2908,242,817,111,319,353,1136
352810,202102,1166,2714,745,1982,127,357,437,1089,564,1446
352820,202102,466,1307,339,1077,66,195,70,225,136,420
352830,202102,583,1475,281,854,24,76,71,178,95,254
352840,202102,3959,11221,3242,9949,1037,3414,1082,3199,2119,6613
352850,202102,10744,26020,7449,20733,1947,5897,2438,6112,4385,12009
352860,202102,1024,2809,781,2381,144,482,284,814,428,1296
352870,202102,860,2126,599,1611,51,162,372,946,423,1108
352880,202102,1708,4030,1203,3161,203,559,625,1570,828,2129
352885,202102,307,837,231,707,23,75,138,407,161,482
352890,202102,689,1662,448,1158,40,121,267,610,307,731
352900,202102,17851,46181,11941,34612,1947,6031,5197,14127,7144,20158
352910,202102,415,1089,238,718,27,85,74,193,101,278
352920,202102,2618,6621,1911,5434,119,371,1330,3675,1449,4046
352930,202102,5691,15236,4256,12470,731,2378,2041,5577,2772,7955
352940,202102,21792,58161,15956,46239,3028,9595,7296,19828,10324,29423
352950,202102,538,1401,332,1027,89,276,68,196,157,472
352960,202102,730,1919,417,1268,72,242,118,295,190,537
352965,202102,220,618,141,463,41,132,34,102,75,234
352970,202102,2959,7061,2281,5938,238,676,1504,3833,1742,4509
352980,202102,1358,3576,1083,3172,256,831,553,1576,809,2407
352990,202102,4116,11359,3209,9862,625,2103,1609,4731,2234,6834
353000,202102,472,1289,271,823,38,123,63,159,101,282
353010,202102,2592,6407,1716,4818,336,1082,724,1833,1060,2915
353020,202102,3536,9065,2139,6221,290,948,742,2020,1032,2968
353030,202102,4438,11051,3063,8693,679,2099,907,2434,1586,4533
353040,202102,634,1432,439,1151,82,207,224,577,306,784
353050,202102,5163,14607,3659,11559,674,2297,1663,5027,2337,7324
353060,202102,47837,121356,39605,108337,2656,8679,29835,78797,32491,87476
353070,202102,9435,26717,6912,21341,1251,4253,2974,8454,4225,12707
353080,202102,4080,11051,2690,8382,474,1690,1062,2894,1536,4584
353090,202102,601,1773,482,1530,36,121,302,925,338,1046
353100,202102,291,777,140,442,24,81,39,101,63,182
353110,202102,7468,19580,6012,17532,1271,3818,3041,9220,4312,13038
353120,202102,390,958,293,804,38,126,144,350,182,476
353130,202102,2488,5778,1558,4195,377,1140,515,1234,892,2374
353140,202102,2729,6708,1983,5465,102,340,1416,3740,1518,4080
353150,202102,1587,3870,1130,3133,226,646,478,1254,704,1900
353160,202102,618,1580,451,1306,69,205,191,500,260,705
353170,202102,516,1368,384,1188,76,261,169,520,245,781
353180,202102,9888,23815,7824,20619,709,2075,5791,14804,6500,16879
353190,202102,3335,8900,2669,7591,348,1060,1548,4135,1896,5195
353200,202102,1787,4710,981,3083,159,552,253,723,412,1275
353205,202102,382,1143,325,1020,53,180,157,471,210,651
353210,202102,892,2048,582,1553,25,71,400,1050,425,1121
353215,202102,375,1027,294,884,43,143,142,393,185,536
353220,202102,722,1900,475,1405,97,272,79,222,176,494
353230,202102,837,2295,659,2019,180,605,255,713,435,1318
353240,202102,2300,6203,1900,5558,269,906,1143,3212,1412,4118
353250,202102,1308,2936,827,2160,102,302,464,1148,566,1450
353260,202102,1171,2655,644,1806,84,259,309,829,393,1088
353270,202102,681,1757,582,1583,46,136,406,1040,452,1176
353280,202102,663,1759,466,1412,134,413,111,332,245,745
353282,202102,1813,5057,1532,4546,178,582,939,2639,1117,3221
353284,202102,355,809,196,518,20,76,92,208,112,284
353286,202102,174,429,105,319,16,52,36,101,52,153
353290,202102,1480,3904,929,2805,163,493,281,786,444,1279
353300,202102,2018,5311,1483,4268,236,765,675,1742,911,2507
353310,202102,394,964,289,780,23,80,190,484,213,564
353320,202102,631,1544,535,1415,7,31,467,1221,474,1252
353325,202102,669,1915,467,1475,95,294,163,502,258,796
353330,202102,521,1330,362,1042,43,128,200,533,243,661
353340,202102,2797,7568,2029,6059,399,1325,964,2683,1363,4008
353350,202102,3552,8973,2476,6909,552,1607,718,1793,1270,3400
353360,202102,657,1820,507,1533,51,159,296,872,347,1031
353370,202102,551,1580,458,1437,37,117,327,995,364,1112
353380,202102,288,855,241,763,25,82,128,373,153,455
353390,202102,6317,15449,4758,12873,449,1387,2898,7398,3347,8785
353400,202102,465,1219,352,1010,63,215,140,333,203,548
353410,202102,525,1407,395,1177,70,206,224,680,294,886
353420,202102,413,1079,262,770,56,153,19,50,75,203
353430,202102,2202,6015,1704,5100,329,1060,801,2294,1130,3354
353440,202102,65003,173187,47644,140313,7328,23662,26028,72282,33356,95944
353450,202102,359,898,243,697,34,113,119,308,153,421
353460,202102,3163,8529,2290,6891,173,576,1030,2997,1203,3573
353470,202102,7758,20130,5620,16237,887,2967,2524,6674,3411,9641
353475,202102,1535,3943,1085,3040,165,494,546,1427,711,1921
353480,202102,1602,4251,1282,3710,49,181,921,2582,970,2763
353490,202102,1088,2856,741,2206,106,353,334,924,440,1277
353500,202102,1073,2528,799,2119,171,468,440,1143,611,1611
353510,202102,760,2265,558,1780,136,469,144,389,280,858
353520,202102,1026,2660,655,1994,75,257,311,876,386,1133
353530,202102,2385,6237,1874,5329,260,839,1000,2622,1260,3461
353540,202102,2075,5526,1707,4945,268,822,1006,2830,1274,3652
353550,202102,5775,14752,4702,13051,738,2153,2698,7189,3436,9342
353560,202102,2287,6111,1730,5257,455,1513,514,1398,969,2911
353570,202102,578,1482,429,1247,45,137,252,697,297,834
353580,202102,2051,5395,1558,4441,350,1012,704,1959,1054,2971
353590,202102,681,1774,459,1364,84,264,201,602,285,866
353600,202102,1708,4211,1292,3493,155,419,704,1857,859,2276
353610,202102,563,1676,407,1364,83,342,119,361,202,703
353620,202102,2637,6941,1866,5623,362,1213,617,1704,979,2917
353625,202102,500,1229,342,958,26,88,210,569,236,657
353630,202102,1318,3993,1110,3556,234,836,434,1271,668,2107
353640,202102,1378,3558,1110,3148,156,439,607,1712,763,2151
353650,202102,7476,19703,5671,16366,604,1957,3416,9306,4020,11263
353657,202102,386,1006,287,841,26,86,135,366,161,452
353660,202102,1291,2718,878,2172,407,1014,201,486,608,1500
353670,202102,4062,11145,3157,9400,593,1992,1545,4228,2138,6220
353680,202102,685,1771,507,1519,69,238,294,817,363,1055
353690,202102,409,1070,197,603,24,79,38,99,62,178
353700,202102,2062,5327,1713,4759,115,380,1270,3378,1385,3758
353710,202102,5320,11843,3197,8124,345,919,1751,3957,2096,4876
353715,202102,421,1109,253,794,5,23,94,282,99,305
353720,202102,1964,5121,1513,4453,229,716,843,2439,1072,3155
353730,202102,4411,11391,3358,9576,461,1546,1808,4711,2269,6257
353740,202102,1982,5181,1396,4163,330,1075,462,1230,792,2305
353750,202102,856,2557,618,2095,136,524,127,408,263,932
353760,202102,12602,28932,9618,24972,1921,5075,5151,13192,7072,18267
353770,202102,736,2188,432,1440,76,280,55,160,131,440
353780,202102,5192,14177,4160,12254,854,2839,2112,5724,2966,8563
353790,202102,2658,7934,1945,6437,505,1856,404,1159,909,3015
353800,202102,18152,46952,14257,40751,2037,6123,7965,22706,10002,28829
353810,202102,1148,3045,747,2229,105,351,325,916,430,1267
353820,202102,1734,4616,1217,3600,253,813,402,1119,655,1932
353830,202102,623,1569,464,1301,80,238,204,547,284,785
353850,202102,1601,4409,1234,3724,253,746,455,1341,708,2087
353860,202102,2614,7092,1999,6061,467,1630,897,2447,1364,4077
353870,202102,29400,76197,21081,60334,2656,8523,11090,28988,13746,37511
353880,202102,3145,8584,2496,7384,211,720,1523,4326,1734,5046
353890,202102,2708,5799,1890,4666,128,352,1356,3137,1484,3489
353900,202102,732,2039,533,1653,80,275,216,618,296,893
353910,202102,2366,6501,1972,5896,197,693,1354,3967,1551,4660
353920,202102,1864,5100,1335,4068,312,1080,329,825,641,1905
353930,202102,4340,11420,2951,8812,481,1669,1248,3286,1729,4955
353940,202102,1047,2948,730,2339,125,420,264,777,389,1197
353950,202102,3249,8697,2509,7356,495,1565,1309,3588,1804,5153
353960,202102,699,1805,481,1389,89,267,205,566,294,833
353970,202102,640,1516,482,1281,43,127,328,849,371,976
353980,202102,16299,40656,12753,34579,790,2518,9267,24028,10057,26546
353990,202102,937,2259,571,1600,102,305,255,675,357,980
354000,202102,2438,5831,1390,3908,304,897,231,620,535,1517
354010,202102,340,887,238,720,48,157,125,361,173,518
354020,202102,3534,9546,2789,8037,611,1898,1173,3086,1784,4984
354025,202102,707,1968,476,1516,70,251,130,391,200,642
354030,202102,510,1108,277,726,62,173,129,311,191,484
354040,202102,779,1802,501,1349,23,76,370,960,393,1036
354050,202102,927,2600,652,2107,141,490,213,661,354,1151
354060,202102,3256,9166,2284,7124,474,1610,871,2481,1345,4091
354070,202102,3624,9391,2435,7082,409,1398,1093,2738,1502,4136
354075,202102,2654,7529,2092,6517,275,958,1207,3664,1482,4622
354080,202102,1347,3656,888,2772,179,575,242,693,421,1268
354085,202102,438,906,345,784,0,0,265,560,265,560
354090,202102,1656,4569,1426,4100,76,227,1108,3120,1184,3347
354100,202102,19291,51628,13281,41289,2867,9711,5004,15408,7871,25119
354105,202102,1404,3535,977,2767,123,353,448,1196,571,1549
354110,202102,441,1238,313,990,52,168,107,331,159,499
354120,202102,1323,3551,888,2628,177,575,306,795,483,1370
354130,202102,5319,13946,3548,10599,844,2659,201,414,1045,3073
354140,202102,19065,46644,12963,35515,2105,6438,5641,14172,7746,20610
354150,202102,2893,6827,2211,5764,470,1266,867,2235,1337,3501
354160,202102,2778,8013,2083,6643,581,2016,574,1664,1155,3680
354165,202102,671,1988,517,1685,81,309,263,793,344,1102
354170,202102,1821,5012,1525,4464,98,336,957,2678,1055,3014
354180,202102,369,1014,269,803,46,143,110,295,156,438
354190,202102,1468,4071,1039,3204,70,238,510,1502,580,1740
354200,202102,870,2097,672,1798,66,198,445,1123,511,1321
354210,202102,822,2122,664,1863,38,129,491,1307,529,1436
354220,202102,3123,8338,2373,6866,350,1085,1272,3477,1622,4562
354230,202102,765,1855,613,1675,38,129,462,1219,500,1348
354240,202102,1692,4649,1152,3580,193,657,362,991,555,1648
354250,202102,524,1257,324,947,88,262,82,254,170,516
354260,202102,8042,21138,6140,17843,1206,3788,2664,7406,3870,11194
354270,202102,992,2977,810,2626,172,558,324,1024,496,1582
354280,202102,785,1949,663,1780,61,196,428,1062,489,1258
354290,202102,922,2914,779,2622,129,436,390,1354,519,1790
354300,202102,3524,10257,2986,9273,781,2428,1215,3736,1996,6164
354310,202102,715,2088,587,1835,131,438,226,659,357,1097
354320,202102,990,2395,658,1846,104,326,248,616,352,942
354323,202102,459,1097,306,816,41,96,136,348,177,444
354325,202102,1478,4402,1038,3390,169,548,341,1063,510,1611
354330,202102,9412,23628,6409,17614,756,2370,3793,9684,4549,12054
354340,202102,32727,81483,22210,63240,3251,10483,11869,32171,15120,42654
354350,202102,1177,3005,932,2604,111,319,604,1620,715,1939
354360,202102,590,1504,350,1115,65,204,77,246,142,450
354370,202102,1006,2844,808,2531,127,434,479,1450,606,1884
354380,202102,682,1785,491,1478,88,355,126,287,214,642
354390,202102,13571,32484,8952,24481,1572,4611,4040,10410,5612,15021
354400,202102,1542,4896,1188,4073,201,761,441,1484,642,2245
354410,202102,5943,15798,4541,13054,913,2834,2117,5734,3030,8568
354420,202102,1458,3769,1075,3093,147,461,647,1767,794,2228
354425,202102,2675,6417,1893,5087,430,1152,814,2193,1244,3345
354430,202102,1499,3975,1165,3454,109,363,713,2009,822,2372
354440,202102,560,1497,379,1130,64,216,161,445,225,661
354450,202102,413,1070,230,719,33,99,76,215,109,314
354460,202102,843,2116,559,1617,72,226,311,878,383,1104
354470,202102,467,1160,325,895,25,79,163,393,188,472
354480,202102,1226,2756,799,2090,63,159,532,1335,595,1494
354490,202102,812,2376,595,1897,101,337,269,792,370,1129
354500,202102,2098,5813,1705,5225,513,1635,385,1219,898,2854
354510,202102,717,1982,579,1721,49,156,323,871,372,1027
354515,202102,340,972,249,788,38,139,109,333,147,472
354520,202102,6964,18878,4933,14598,657,2245,2734,7494,3391,9739
354530,202102,4319,12175,3350,10308,822,2537,1199,3780,2021,6317
354540,202102,1314,3452,958,2829,208,643,354,1042,562,1685
354550,202102,577,1486,455,1256,71,218,259,680,330,898
354560,202102,2276,5456,1221,3440,145,422,607,1594,752,2016
354570,202102,1217,3026,491,1385,78,232,58,151,136,383
354580,202102,8329,21661,5425,16174,812,2620,2730,7829,3542,10449
354600,202102,1901,4944,1482,4190,140,466,985,2624,1125,3090
354610,202102,443,1131,257,759,21,63,132,369,153,432
354620,202102,459,1274,292,953,46,178,112,324,158,502
354625,202102,296,789,172,553,31,105,26,54,57,159
354630,202102,2040,6044,1636,5227,558,1894,289,851,847,2745
354640,202102,3243,9235,2417,7578,381,1303,954,2801,1335,4104
354650,202102,890,2290,717,2011,56,159,460,1266,516,1425
354660,202102,3596,8388,1896,5559,162,579,897,2401,1059,2980
354670,202102,1059,2909,729,2247,148,480,274,780,422,1260
354680,202102,5340,13751,4016,11622,899,2742,1993,5869,2892,8611
354690,202102,483,1524,348,1220,75,276,97,335,172,611
354700,202102,886,2384,645,1923,79,258,335,921,414,1179
354710,202102,477,1269,346,1012,47,147,142,357,189,504
354720,202102,273,651,121,356,46,144,27,79,73,223
354730,202102,9559,26791,7279,22417,979,3307,4164,12353,5143,15660
354740,202102,308,825,133,435,17,67,25,70,42,137
354750,202102,2592,6624,1712,5019,259,830,766,2011,1025,2841
354760,202102,2111,5565,1486,4401,335,1094,488,1257,823,2351
354765,202102,342,898,143,451,19,65,35,91,54,156
354770,202102,2405,5916,1788,4859,323,942,824,2093,1147,3035
354780,202102,53898,135604,41065,110764,4053,12345,26303,66604,30356,78949
354790,202102,976,2669,757,2307,73,254,464,1348,537,1602
354800,202102,2550,6484,2010,5660,485,1381,911,2424,1396,3805
354805,202102,1359,3096,942,2495,106,287,552,1368,658,1655
354810,202102,629,1854,366,1294,46,188,95,315,141,503
354820,202102,943,2658,672,2149,121,440,189,479,310,919
354830,202102,460,1114,294,822,50,150,94,243,144,393
354840,202102,923,2281,569,1574,54,156,309,801,363,957
354850,202102,20757,53395,14456,42268,1591,5343,8641,23961,10232,29304
354860,202102,1734,4804,1059,3390,170,611,309,893,479,1504
354870,202102,57829,145572,44778,121675,4582,13652,28280,72707,32862,86359
354880,202102,5768,14068,2871,8046,321,1040,1137,2617,1458,3657
354890,202102,15736,39244,12189,33306,1617,5009,7161,18948,8778,23957
354900,202102,393,986,251,741,49,155,66,165,115,320
354910,202102,5574,14519,3392,10569,792,2594,590,1763,1382,4357
354920,202102,512,1388,264,880,30,103,61,183,91,286
354925,202102,302,859,186,594,21,75,49,134,70,209
354930,202102,363,873,236,655,19,60,117,294,136,354
354940,202102,2318,6831,1644,5346,558,1935,330,981,888,2916
354950,202102,1502,3839,1200,3423,55,219,902,2432,957,2651
354960,202102,913,2450,694,2121,54,190,403,1167,457,1357
354970,202102,4145,11373,3240,9854,347,1213,2099,6159,2446,7372
354980,202102,32976,77648,22402,59576,2292,7249,13863,34394,16155,41643
354990,202102,66854,167575,50487,137772,3909,12480,33405,85698,37314,98178
354995,202102,2858,6336,2149,5417,138,406,1605,3899,1743,4305
355000,202102,1568,3857,1175,3285,197,639,569,1466,766,2105
355010,202102,3762,10132,2286,7040,744,2346,283,903,1027,3249
355020,202102,3637,10090,2695,8429,543,1878,1068,3159,1611,5037
355030,202102,1357936,3312177,988988,2609781,145455,421880,504175,1225632,649630,1647512
355040,202102,2949,7203,2283,6337,274,764,1641,4562,1915,5326
355050,202102,983,2271,718,1896,170,515,284,673,454,1188
355060,202102,6048,16198,4406,13198,714,2464,2162,5906,2876,8370
355070,202102,8858,22551,7193,19950,831,2650,4601,12026,5432,14676
355080,202102,914,2599,576,1964,111,412,84,232,195,644
355090,202102,1162,3276,900,2842,210,665,324,1000,534,1665
355100,202102,21330,55401,16452,48244,2587,8002,9822,28622,12409,36624
355110,202102,785,2146,557,1790,164,609,96,274,260,883
355120,202102,704,1816,508,1537,43,145,232,661,275,806
355130,202102,832,1859,426,1121,27,90,266,650,293,740
355140,202102,1942,4363,1633,3940,88,234,1346,3161,1434,3395
355150,202102,4175,10961,3326,9474,356,1138,2155,5896,2511,7034
355160,202102,2027,5481,1470,4504,370,1236,367,1054,737,2290
355170,202102,10559,26368,8203,22448,1438,4264,4432,11727,5870,15991
355180,202102,2863,7578,2029,6189,402,1342,759,2119,1161,3461
355190,202102,1849,4830,1449,4195,374,1068,734,2238,1108,3306
355200,202102,784,2423,660,2220,179,667,272,874,451,1541
355210,202102,2955,8004,2296,6668,410,1343,1162,3153,1572,4496
355220,202102,44335,116665,35145,99161,7677,23018,15027,39379,22704,62397
355230,202102,1113,2789,612,1808,104,294,217,600,321,894
355240,202102,24594,64545,17239,49898,2157,6809,9479,25763,11636,32572
355250,202102,36860,97822,27439,79696,6775,20755,10426,28997,17201,49752
355255,202102,651,1620,354,1083,55,188,132,391,187,579
355260,202102,1484,3597,1078,2928,134,445,618,1542,752,1987
355270,202102,1123,3305,856,2766,197,655,301,899,498,1554
355280,202102,31175,78748,22300,62271,2893,8782,11377,29782,14270,38564
355290,202102,872,2346,671,1994,133,379,289,836,422,1215
355300,202102,1275,3732,1007,3211,170,589,344,1025,514,1614
355310,202102,952,2614,710,2214,99,294,394,1253,493,1547
355320,202102,522,1360,393,1130,74,244,158,369,232,613
355330,202102,2945,7375,2251,6206,123,443,1713,4491,1836,4934
355340,202102,4154,9161,3181,7867,382,860,1984,5006,2366,5866
355350,202102,1292,3673,961,3050,196,650,370,1146,566,1796
355360,202102,1201,3041,925,2627,114,355,551,1529,665,1884
355365,202102,345,924,190,650,39,128,29,105,68,233
355370,202102,5319,13581,4106,11656,988,2603,1754,5507,2742,8110
355380,202102,2871,7640,2181,6388,370,1187,811,2056,1181,3243
355385,202102,1448,3777,1194,3405,105,361,766,1995,871,2356
355390,202102,823,2236,594,1743,132,419,234,623,366,1042
355395,202102,1958,5342,1374,4180,231,750,482,1296,713,2046
355400,202102,8919,25226,7072,21628,1664,5801,2582,7051,4246,12852
355410,202102,22344,61008,13842,43465,2747,9450,3757,11512,6504,20962
355420,202102,622,1967,517,1771,137,505,134,444,271,949
355430,202102,3669,9240,2758,7598,604,1675,1311,3551,1915,5226
355440,202102,765,2066,469,1449,78,252,132,385,210,637
355450,202102,2978,7581,1943,5573,327,1022,827,2140,1154,3162
355460,202102,496,1193,307,885,42,150,147,382,189,532
355465,202102,410,1069,319,922,45,144,171,478,216,622
355470,202102,1053,2701,608,1819,158,534,186,492,344,1026
355475,202102,341,806,275,716,15,34,205,523,220,557
355480,202102,3898,10651,3166,9567,432,1518,2097,6167,2529,7685
355490,202102,931,2473,521,1611,40,130,275,791,315,921
355495,202102,808,2245,583,1859,66,253,211,593,277,846
355500,202102,6582,16847,3975,11845,595,1961,1393,3831,1988,5792
355510,202102,1336,3242,851,2417,105,340,368,938,473,1278
355520,202102,363,815,177,517,29,81,54,159,83,240
355530,202102,398,927,148,432,18,61,53,141,71,202
355535,202102,505,1361,382,1161,74,278,177,492,251,770
355540,202102,10770,26631,8808,23877,1224,3640,5862,15362,7086,19002
355550,202102,603,1764,497,1563,61,216,272,793,333,1009
355560,202102,1111,2818,620,1903,137,490,33,100,170,590
355570,202102,244,681,129,422,25,92,32,89,57,181
355580,202102,1188,2864,763,2155,135,433,300,768,435,1201
355590,202102,170,426,131,366,17,54,79,207,96,261
355600,202102,1524,3687,1009,2848,161,483,376,1057,537,1540
355610,202102,1756,4292,1163,3276,124,383,624,1669,748,2052
355620,202102,4714,12442,3528,10155,375,1297,1999,5306,2374,6603
355630,202102,2302,6282,1643,5054,257,835,810,2440,1067,3275
355635,202102,869,2522,639,2070,110,384,189,550,299,934
355640,202102,2961,8170,1973,6190,371,1261,584,1787,955,3048
355645,202102,4141,11545,3025,9595,443,1556,1620,4977,2063,6533
355650,202102,6175,16636,4761,14047,1288,3920,1423,3787,2711,7707
355660,202102,1302,3340,910,2634,137,424,299,855,436,1279
355670,202102,3648,9737,2446,7050,298,1005,1215,3073,1513,4078
355680,202102,2712,7390,1217,3905,308,1043,110,374,418,1417
355690,202102,796,2340,511,1771,118,446,15,31,133,477
355695,202102,249,702,155,491,16,75,26,57,42,132
355700,202102,7356,20812,6002,17840,958,3078,3318,9268,4276,12346
355710,202102,8867,20801,5844,15370,834,2463,2789,6507,3623,8970
355715,202102,463,1238,256,788,54,179,49,132,103,311
355720,202102,1453,4024,1142,3478,183,603,621,1765,804,2368
355730,202102,900,2485,738,2184,123,401,362,997,485,1398
410010,202102,1279,3524,981,2905,194,623,234,658,428,1281
410020,202102,1024,3076,788,2542,279,850,167,567,446,1417
410030,202102,1540,4189,1318,3849,180,567,740,2180,920,2747
410040,202102,12374,33989,9088,27841,1981,6496,2842,8093,4823,14589
410045,202102,859,2260,602,1766,89,290,222,599,311,889
410050,202102,2264,5649,1568,4449,284,882,541,1429,825,2311
410060,202102,2074,5798,1617,4910,360,1153,498,1451,858,2604
410070,202102,1954,4932,1460,4042,237,718,563,1415,800,2133
410080,202102,1336,3553,962,2864,256,794,227,690,483,1484
410090,202102,1107,2823,940,2557,98,256,548,1565,646,1821
410100,202102,1807,5167,1198,3723,179,629,142,423,321,1052
410105,202102,487,1225,281,826,31,93,103,287,134,380
410110,202102,3289,8188,2307,6348,272,818,1091,2797,1363,3615
410115,202102,566,1459,412,1195,59,183,159,440,218,623
410120,202102,2605,7195,2247,6661,464,1504,1199,3429,1663,4933
410130,202102,1231,3295,1072,2999,198,642,563,1456,761,2098
410140,202102,15852,38228,10476,28706,1885,5680,2770,6925,4655,12605
410150,202102,16460,38396,8443,22904,1414,4251,2031,4940,3445,9191
410160,202102,2830,7749,2263,6763,514,1651,750,2271,1264,3922
410165,202102,744,1981,611,1715,57,192,360,943,417,1135
410170,202102,2835,7318,1885,5290,410,1272,122,359,532,1631
410180,202102,13810,38111,10612,31707,1433,4719,5547,15485,6980,20204
410185,202102,413,1208,301,923,58,186,86,239,144,425
410190,202102,2155,5351,1569,4335,310,900,418,1097,728,1997
410200,202102,5413,12336,3022,8268,476,1488,420,1114,896,2602
410210,202102,3091,7684,1955,5685,301,984,671,1675,972,2659
410220,202102,514,1327,336,996,59,182,81,236,140,418
410230,202102,1709,4509,1326,3762,194,603,616,1619,810,2222
410240,202102,5106,13311,3529,10304,777,2525,401,1042,1178,3567
410250,202102,2677,6290,1982,5194,152,498,963,2433,1115,2931
410260,202102,1739,4345,1085,3110,170,505,490,1376,660,1881
410270,202102,460,1225,331,1003,46,158,124,363,170,521
410275,202102,606,1715,444,1393,67,230,185,538,252,768
410280,202102,2251,5969,1491,4472,212,707,593,1631,805,2338
410290,202102,3349,9320,2302,7134,641,1941,567,1787,1208,3728
410300,202102,642,1639,518,1449,52,164,257,669,309,833
410302,202102,355,896,204,616,23,80,99,291,122,371
410304,202102,1237,3205,1025,2809,118,334,616,1635,734,1969
410305,202102,1720,4097,1201,3358,120,383,767,2067,887,2450
410310,202102,2503,7021,2012,6096,303,1011,1009,3012,1312,4023
410315,202102,616,1474,376,1087,131,380,93,281,224,661
410320,202102,1068,2959,732,2286,113,392,130,383,243,775
410322,202102,559,1457,327,949,32,108,166,435,198,543
410330,202102,1517,3655,1058,2812,172,485,296,780,468,1265
410335,202102,859,2273,657,1900,93,288,284,762,377,1050
410337,202102,841,2042,600,1587,68,182,238,600,306,782
410340,202102,516,1469,349,1056,19,66,175,455,194,521
410345,202102,2434,6293,1288,3802,256,798,333,845,589,1643
410347,202102,740,1869,550,1523,55,179,178,493,233,672
410350,202102,1540,3803,1105,3083,145,422,493,1296,638,1718
410360,202102,4320,10565,3328,8825,453,1281,1615,4135,2068,5416
410370,202102,13584,36230,8866,25199,1024,3174,3763,9420,4787,12594
410380,202102,1608,4027,1189,3284,166,461,391,992,557,1453
410390,202102,2635,6609,1760,5070,379,1215,542,1410,921,2625
410395,202102,918,2615,752,2269,162,507,283,861,445,1368
410400,202102,6552,16954,4951,13904,680,2045,2569,6803,3249,8848
410405,202102,879,2047,627,1677,110,334,285,711,395,1045
410410,202102,1286,3402,1206,3277,159,507,762,2141,921,2648
410420,202102,10641,28851,8140,23945,1229,4077,3387,8961,4616,13038
410425,202102,3228,8926,2207,6847,344,1162,793,2233,1137,3395
410430,202102,13021,32412,9192,25517,1369,4158,3353,8661,4722,12819
410440,202102,2270,6725,1945,6133,276,980,1039,3213,1315,4193
410442,202102,2173,6581,1788,5758,434,1436,482,1459,916,2895
410445,202102,2243,6428,1646,5275,324,1171,302,1047,626,2218
410450,202102,1437,3519,1067,2944,196,601,404,1049,600,1650
410460,202102,2125,5236,1629,4448,170,499,812,2121,982,2620
410465,202102,2712,7785,2152,6737,380,1251,764,2235,1144,3486
410470,202102,1967,5416,1391,4377,356,1277,213,713,569,1990
410480,202102,36379,86436,19839,57331,3040,9831,4355,10828,7395,20659
410490,202102,10965,30257,8009,24243,1418,4633,3254,9212,4672,13845
410500,202102,1882,4863,1313,3798,272,899,373,939,645,1838
410510,202102,1804,4506,1206,3397,229,624,348,977,577,1601
410520,202102,3028,9469,2691,8793,944,3158,875,2951,1819,6109
410530,202102,1598,3856,767,2147,96,279,201,461,297,740
410540,202102,2767,7385,1930,5712,299,982,850,2406,1149,3388
410550,202102,7341,19451,4898,14173,791,2494,1363,3382,2154,5876
410560,202102,1463,3831,1099,3102,226,714,377,926,603,1640
410570,202102,2486,6734,1822,5573,493,1787,200,638,693,2425
410580,202102,25334,65240,18435,52798,3321,10232,8048,21558,11369,31790
410590,202102,1551,4378,1060,3240,146,470,296,759,442,1229
410600,202102,1772,4678,1380,3926,316,869,424,1272,740,2141
410610,202102,703,1812,534,1509,53,176,241,632,294,808
410620,202102,2486,7086,1679,5191,353,1213,259,733,612,1946
410630,202102,2433,6364,1599,4709,296,1011,318,777,614,1788
410640,202102,4739,10990,3226,8391,685,2068,394,1035,1079,3103
410645,202102,1050,2967,856,2720,275,898,352,1133,627,2031
410650,202102,2291,6174,1594,4793,314,1011,550,1507,864,2518
410655,202102,911,2166,644,1690,26,79,334,825,360,904
410657,202102,615,1655,387,1168,48,163,130,330,178,493
410660,202102,3342,8513,1966,5541,354,1020,558,1466,912,2486
410670,202102,1026,2540,637,1812,121,338,221,577,342,915
410680,202102,2578,7694,1802,5755,416,1351,293,968,709,2319
410685,202102,516,1316,390,1107,91,295,153,391,244,686
410690,202102,130303,314828,87436,236767,13160,40802,34492,82447,47652,123249
410700,202102,2479,6222,2051,5559,339,939,1007,2663,1346,3602
410710,202102,886,2225,584,1667,107,313,226,589,333,902
410712,202102,640,1802,527,1591,123,411,215,614,338,1025
410715,202102,786,2264,500,1646,65,231,180,565,245,796
410720,202102,3098,7830,2480,6673,346,1112,572,1490,918,2602
410725,202102,1108,2736,643,1871,123,393,86,210,209,603
410730,202102,687,1806,537,1530,118,391,113,320,231,711
410740,202102,914,2549,674,2086,83,290,274,833,357,1123
410750,202102,1746,4381,1396,3744,199,602,646,1657,845,2259
410752,202102,352,873,185,550,26,77,83,236,109,313
410753,202102,309,927,212,709,36,139,45,134,81,273
410754,202102,1073,2757,894,2492,59,129,618,1814,677,1943
410755,202102,538,1394,381,1086,54,168,168,429,222,597
410760,202102,3611,9257,2610,7474,665,2187,569,1499,1234,3686
410765,202102,13598,37581,10637,31835,1761,5716,2449,6520,4210,12236
410770,202102,1068,2501,750,1976,65,183,387,1029,452,1212
410773,202102,1277,3383,1121,3152,107,338,725,1974,832,2312
410775,202102,1499,3681,1311,3404,64,192,890,2245,954,2437
410780,202102,636,1566,428,1172,63,182,116,291,179,473
410785,202102,696,1819,539,1556,97,314,184,539,281,853
410790,202102,799,2233,659,1970,163,531,61,127,224,658
410800,202102,3426,7570,2786,6667,48,145,1825,4242,1873,4387
410810,202102,417,1099,329,931,22,67,174,437,196,504
410820,202102,910,2551,487,1473,99,307,82,208,181,515
410830,202102,38459,92518,26780,73254,5028,15756,10252,26130,15280,41886
410832,202102,1030,2681,831,2341,93,295,495,1308,588,1603
410840,202102,8501,21393,5107,14994,972,3084,1293,3559,2265,6643
410845,202102,1140,2827,895,2467,179,519,363,992,542,1511
410850,202102,2222,6347,1950,5854,318,1014,954,2800,1272,3814
410855,202102,767,1910,504,1404,47,124,239,617,286,741
410860,202102,4230,10314,3333,8894,312,984,1941,4881,2253,5865
410865,202102,1417,4097,1227,3730,134,456,728,2239,862,2695
410870,202102,1222,3285,1008,2924,89,278,665,1909,754,2187
410880,202102,4600,12150,3266,9751,533,1637,495,1571,1028,3208
410890,202102,964,2717,724,2246,151,531,190,566,341,1097
410895,202102,983,3100,836,2781,255,940,189,594,444,1534
410900,202102,849,2256,607,1785,98,306,135,335,233,641
410910,202102,406,958,250,662,10,35,144,346,154,381
410920,202102,849,2021,611,1635,76,225,309,804,385,1029
410930,202102,1664,4235,1147,3346,270,924,218,614,488,1538
410940,202102,22391,60428,16281,49635,3304,11084,5061,15103,8365,26187
410950,202102,1914,5564,1718,5272,48,172,1425,4325,1473,4497
410960,202102,7484,18489,5194,14673,1179,3706,2044,5689,3223,9395
410965,202102,1128,2872,790,2236,84,266,445,1240,529,1506
410970,202102,4009,10663,2847,8462,632,2247,389,946,1021,3193
410975,202102,1307,3224,998,2740,111,331,483,1302,594,1633
410980,202102,7587,18792,4926,14036,566,1782,2119,5477,2685,7259
410990,202102,1367,3313,937,2637,211,699,331,890,542,1589
411000,202102,643,1683,437,1304,64,222,118,283,182,505
411005,202102,452,1153,273,774,48,156,87,211,135,367
411007,202102,2236,6207,1818,5495,433,1394,628,1880,1061,3274
411010,202102,4129,12341,3266,10607,805,2865,348,1027,1153,3892
411020,202102,2319,6505,1880,5720,521,1654,498,1489,1019,3143
411030,202102,779,1889,552,1441,37,132,307,695,344,827
411040,202102,975,2436,530,1476,73,235,163,370,236,605
411050,202102,1931,5984,1575,5200,398,1436,224,640,622,2076
411060,202102,1936,5087,1243,3661,271,916,208,557,479,1473
411065,202102,388,990,263,750,33,95,119,321,152,416
411070,202102,7321,18444,5793,15939,727,2219,2940,7810,3667,10029
411080,202102,2087,5455,1651,4721,409,1355,334,923,743,2278
411090,202102,817,2145,542,1612,44,151,158,446,202,597
411095,202102,2784,6442,1521,4122,176,510,394,983,570,1493
411100,202102,1211,3094,849,2459,83,276,296,865,379,1141
411110,202102,623,1620,304,945,37,113,21,46,58,159
411120,202102,1305,3559,1080,3143,315,1059,229,606,544,1665
411125,202102,5152,14959,4613,13991,1021,3038,2231,7112,3252,10150
411130,202102,725,1928,516,1537,111,300,177,584,288,884
411140,202102,2223,6842,1904,6173,559,1951,495,1584,1054,3535
411150,202102,3799,9541,2599,7183,519,1689,238,462,757,2151
411155,202102,952,2434,569,1719,80,223,234,675,314,898
411160,202102,355,818,247,662,30,88,60,165,90,253
411170,202102,714,2096,560,1747,127,402,194,589,321,991
411180,202102,5465,14358,4293,12334,616,1954,2076,5576,2692,7530
411190,202102,1716,4366,1275,3581,203,606,505,1287,708,1893
411200,202102,4792,12955,3450,10461,817,2764,729,1911,1546,4675
411210,202102,3197,7090,2129,5361,358,999,730,1732,1088,2731
411220,202102,863,2205,613,1724,149,467,162,414,311,881
411230,202102,832,2213,603,1777,123,391,218,624,341,1015
411240,202102,1586,3765,1082,2872,109,335,545,1325,654,1660
411250,202102,2224,5879,1631,4814,309,1073,505,1421,814,2494
411260,202102,325,837,223,634,24,69,90,220,114,289
411270,202102,2032,5369,1518,4347,207,618,750,1979,957,2597
411275,202102,1437,3300,1007,2604,140,438,469,1117,609,1555
411280,202102,1309,3529,888,2730,246,774,114,338,360,1112
411290,202102,834,2179,537,1604,59,166,282,849,341,1015
411295,202102,1265,3172,899,2456,104,293,406,1049,510,1342
411300,202102,1014,2521,660,1837,60,177,312,761,372,938
411310,202102,877,2004,671,1721,60,149,291,745,351,894
411320,202102,5461,13947,3994,11368,604,1839,1742,4476,2346,6315
411325,202102,1374,3955,1168,3595,188,557,650,2079,838,2636
411330,202102,3296,8865,2400,7242,519,1692,740,2275,1259,3967
411340,202102,826,2240,496,1524,76,246,148,428,224,674
411342,202102,1048,2513,607,1654,107,313,220,558,327,871
411345,202102,1062,2726,799,2291,62,186,570,1647,632,1833
411350,202102,2780,7419,1794,5414,438,1423,291,809,729,2232
411360,202102,707,1696,501,1372,81,233,159,414,240,647
411370,202102,57985,141238,42221,114762,2951,9591,25279,63983,28230,73574
411373,202102,1381,3479,1117,3085,104,332,599,1669,703,2001
411375,202102,1096,2745,800,2197,131,366,308,823,439,1189
411380,202102,1143,2613,785,1962,41,115,482,1122,523,1237
411390,202102,1472,4051,1164,3376,183,587,494,1261,677,1848
411400,202102,2308,5636,1731,4558,164,507,917,2277,1081,2784
411410,202102,2603,7130,1930,5712,417,1346,432,1196,849,2542
411420,202102,4314,10407,2324,6625,292,940,439,943,731,1883
411430,202102,3420,9197,2625,7720,533,1703,927,2524,1460,4227
411435,202102,399,1107,251,795,50,160,76,199,126,359
411440,202102,2466,6861,2007,6002,422,1362,694,2007,1116,3369
411450,202102,2442,6586,1849,5587,240,720,990,3049,1230,3769
411460,202102,4176,10683,2662,7822,404,1403,483,1272,887,2675
411470,202102,769,1957,579,1596,108,323,220,548,328,871
411480,202102,4942,12993,3647,10611,700,2446,1356,3497,2056,5943
411490,202102,1636,4227,1253,3594,158,516,522,1346,680,1862
411500,202102,1276,3405,863,2535,146,461,162,384,308,845
411510,202102,2317,5860,1864,5093,375,1201,488,1336,863,2537
411520,202102,30814,74665,17935,49893,2042,6579,6941,17299,8983,23878
411530,202102,944,2472,568,1747,87,283,93,270,180,553
411535,202102,497,1422,310,979,35,129,86,224,121,353
411540,202102,2608,6361,1786,4884,146,468,923,2460,1069,2928
411545,202102,900,2596,760,2355,70,223,486,1505,556,1728
411550,202102,713,1795,528,1467,77,229,90,271,167,500
411560,202102,1919,5157,1106,3447,154,551,62,165,216,716
411570,202102,7203,16592,4859,13087,1085,3203,855,2324,1940,5527
411573,202102,741,1994,628,1810,97,279,311,892,408,1171
411575,202102,2019,5468,1508,4428,280,881,354,1008,634,1889
411580,202102,4808,10982,2920,8108,424,1434,528,1318,952,2752
411585,202102,612,1835,288,946,66,232,50,149,116,381
411590,202102,389,1058,277,831,42,127,136,386,178,513
411600,202102,312,777,197,596,40,123,55,154,95,277
411605,202102,1549,3561,1003,2712,136,468,512,1351,648,1819
411610,202102,2552,5964,1816,4705,65,220,1249,3021,1314,3241
411620,202102,2716,7241,2322,6625,397,1194,1247,3562,1644,4756
411630,202102,758,1971,510,1500,74,272,187,486,261,758
411640,202102,471,1220,335,936,44,136,111,274,155,410
411650,202102,208,593,134,435,25,88,29,73,54,161
411660,202102,921,2340,669,1877,57,164,270,714,327,878
411670,202102,1336,3215,914,2423,98,272,450,1109,548,1381
411680,202102,1400,3743,1047,3040,141,466,456,1279,597,1745
411690,202102,3882,9781,2950,8202,642,1816,812,2412,1454,4228
411695,202102,631,1888,424,1351,47,163,175,510,222,673
411700,202102,1686,4326,1133,3277,241,733,186,517,427,1250
411705,202102,1891,5769,1603,5285,284,898,959,3354,1243,4252
411710,202102,1935,4878,1337,3786,294,837,269,752,563,1589
411720,202102,1031,2350,738,1862,143,370,284,690,427,1060
411721,202102,979,2431,738,1989,140,374,213,558,353,932
411722,202102,872,2283,503,1461,87,277,181,439,268,716
411725,202102,1151,3197,793,2514,187,641,176,551,363,1192
411727,202102,1480,4054,954,2930,212,671,148,418,360,1089
411729,202102,684,1643,435,1178,54,196,170,403,224,599
411730,202102,5250,13818,4127,11662,825,2511,1804,4976,2629,7487
411740,202102,522,1340,269,794,59,161,59,156,118,317
411745,202102,785,2235,544,1694,74,246,118,290,192,536
411750,202102,5459,14289,4015,11504,543,1665,1938,5235,2481,6900
411760,202102,6531,17381,5056,14865,1598,4896,978,3238,2576,8134
411770,202102,3008,8663,2210,6935,497,1674,352,1011,849,2685
411780,202102,2675,7485,2322,6838,664,2040,785,2353,1449,4393
411790,202102,2761,6642,1574,4532,301,1012,332,823,633,1835
411800,202102,996,2803,757,2277,127,409,148,409,275,818
411810,202102,1578,4043,1177,3247,194,534,520,1356,714,1890
411820,202102,11031,31403,8977,27882,2139,7191,3913,11818,6052,19009
411830,202102,557,1394,434,1201,79,239,97,282,176,521
411840,202102,12073,31978,8281,24208,1380,4353,2242,5930,3622,10283
411845,202102,579,1618,342,1067,44,158,80,214,124,372
411850,202102,7176,18248,4925,14363,1199,3919,806,2188,2005,6107
411860,202102,679,1882,490,1481,78,239,123,330,201,569
411870,202102,578,1678,408,1299,97,344,95,267,192,611
411880,202102,2285,5607,1676,4660,220,690,632,1654,852,2344
411885,202102,1091,2829,784,2279,118,403,239,630,357,1033
411890,202102,1367,3611,980,2904,156,526,108,313,264,839
411900,202102,761,2093,488,1516,109,355,80,233,189,588
411910,202102,963,2836,717,2316,157,589,282,835,439,1424
411915,202102,14788,36290,10161,27947,1435,4440,4203,10349,5638,14789
411920,202102,1107,3222,930,2839,194,689,342,956,536,1645
411925,202102,455,1197,322,957,69,229,126,355,195,584
411930,202102,4855,14696,4101,13303,1793,6323,264,1042,2057,7365
411940,202102,3242,9480,2534,7992,617,2005,810,2299,1427,4304
411950,202102,14181,38010,11732,33995,1533,5067,6993,19381,8526,24448
411960,202102,5935,15760,4710,13292,851,2607,1885,5040,2736,7647
411965,202102,472,1294,345,1039,49,161,146,416,195,577
411970,202102,1107,2550,865,2228,166,409,384,1121,550,1530
411980,202102,1464,3603,1059,2942,265,730,391,1079,656,1809
411990,202102,37454,97352,24112,73155,4335,14493,8347,24080,12682,38573
411995,202102,3458,8396,2623,7122,760,2283,702,1860,1462,4143
412000,202102,1850,4281,1302,3360,31,101,916,2212,947,2313
412010,202102,598,1842,454,1527,79,279,124,361,203,640
412015,202102,535,1513,442,1350,62,203,262,790,324,993
412020,202102,438,1213,280,879,42,155,116,330,158,485
412030,202102,603,1686,446,1395,71,222,142,433,213,655
412033,202102,948,2514,688,1986,90,278,260,651,350,929
412035,202102,741,2013,474,1521,46,179,262,805,308,984
412040,202102,598,1593,375,1142,57,173,55,164,112,337
412050,202102,1611,4008,1103,3071,236,737,260,722,496,1459
412060,202102,7243,20928,6069,18607,1592,5509,1703,5017,3295,10526
412065,202102,605,1657,456,1367,102,330,105,307,207,637
412070,202102,1182,3038,937,2571,120,365,384,967,504,1332
412080,202102,2163,5998,1480,4638,223,748,380,1076,603,1824
412085,202102,297,709,104,316,10,31,22,56,32,87
412090,202102,5784,14965,4305,12230,1031,3074,1643,4686,2674,7760
412100,202102,1613,4387,1225,3651,379,1246,252,826,631,2072
412110,202102,820,2171,573,1672,80,252,182,496,262,748
412120,202102,1976,5635,1518,4748,307,1045,395,1062,702,2107
412125,202102,612,1733,429,1353,81,267,117,354,198,621
412130,202102,816,2042,566,1578,92,262,145,416,237,678
412135,202102,623,1649,293,883,49,160,86,220,135,380
412140,202102,1669,4004,1126,3080,179,619,240,613,419,1232
412150,202102,2753,7140,2348,6443,345,1082,1425,3699,1770,4781
412160,202102,881,2721,503,1702,70,258,73,207,143,465
412170,202102,4278,11655,3603,10596,718,2349,1482,3987,2200,6336
412175,202102,1294,3658,1088,3308,220,683,481,1463,701,2146
412180,202102,1606,4406,1180,3615,145,510,533,1522,678,2032
412190,202102,3333,8330,2467,6824,311,937,1077,2950,1388,3887
412200,202102,1674,4909,1207,3871,311,1102,185,546,496,1648
412210,202102,629,1483,393,1078,53,162,153,374,206,536
412215,202102,3308,8953,2592,7545,620,1759,1104,3531,1724,5290
412217,202102,979,2522,832,2264,51,148,576,1510,627,1658
412220,202102,5482,15287,4484,13481,1281,3738,1404,4568,2685,8306
412230,202102,2646,7717,2106,6685,342,1235,536,1458,878,2693
412240,202102,7266,18575,4622,13345,778,2406,1367,3554,2145,5960
412250,202102,2005,5145,1491,4167,359,1038,316,816,675,1854
412260,202102,1209,3240,891,2575,133,401,273,752,406,1153
412265,202102,892,2433,708,2120,157,482,278,803,435,1285
412270,202102,996,2705,631,1931,84,283,243,668,327,951
412280,202102,394,1086,311,945,78,238,88,258,166,496
412290,202102,1019,2589,707,2027,104,327,232,617,336,944
412300,202102,1659,4267,1152,3382,251,772,252,781,503,1553
412310,202102,744,2087,592,1781,98,344,200,558,298,902
412320,202102,815,2093,527,1505,51,172,161,465,212,637
412330,202102,1603,4237,1102,3296,228,742,362,1107,590,1849
412340,202102,1135,3094,724,2203,96,356,125,339,221,695
412350,202102,2894,7494,1873,5510,355,1115,309,829,664,1944
412360,202102,255,700,183,550,7,35,112,310,119,345
412370,202102,853,2433,586,1869,114,405,62,196,176,601
412380,202102,1488,4029,1063,3201,280,866,120,423,400,1289
412382,202102,486,1181,323,921,40,147,144,336,184,483
412385,202102,2171,5921,1780,5167,556,1519,553,1795,1109,3314
412390,202102,2460,5888,1976,5146,333,898,711,1840,1044,2738
412395,202102,657,1880,473,1469,58,167,207,649,265,816
412400,202102,914,2400,651,1906,121,389,178,503,299,892
412402,202102,2093,5142,1458,4113,360,1036,182,538,542,1574
412405,202102,2994,7868,1977,5982,506,1792,95,263,601,2055
412410,202102,6090,15613,4521,13076,752,2551,1547,4181,2299,6732
412420,202102,537,1353,359,998,30,96,170,407,200,503
412430,202102,589,1479,309,898,36,115,122,329,158,444
412440,202102,2680,7220,1765,5454,415,1405,264,866,679,2271
412450,202102,480,1381,331,1021,48,146,30,72,78,218
412460,202102,1059,2732,825,2346,159,485,368,1028,527,1513
412470,202102,1488,4730,1235,4175,308,1108,259,868,567,1976
412480,202102,1009,2652,686,1960,115,356,221,551,336,907
412490,202102,1304,3204,1056,2754,138,353,514,1269,652,1622
412500,202102,1926,4833,1464,3980,321,890,390,978,711,1868
412510,202102,1864,5646,1295,4235,289,1011,136,371,425,1382
412520,202102,1149,2996,651,1925,148,406,59,194,207,600
412530,202102,700,1838,513,1456,74,236,109,307,183,543
412535,202102,795,2040,538,1553,89,278,117,284,206,562
412540,202102,1187,2998,861,2409,92,313,290,852,382,1165
412545,202102,672,1731,472,1338,79,234,156,430,235,664
412550,202102,32583,86346,23305,67920,3658,11643,9478,25131,13136,36774
412555,202102,283,730,194,543,21,62,56,122,77,184
412560,202102,4543,13012,3442,10511,630,2097,947,2905,1577,5002
412570,202102,4429,11101,2572,7534,502,1661,310,992,812,2653
412575,202102,1027,2572,825,2227,108,319,442,1116,550,1435
412580,202102,1413,3666,1014,2915,75,256,551,1522,626,1778
412590,202102,403,1054,227,699,34,112,23,62,57,174
412600,202102,1631,4358,1243,3577,183,590,566,1508,749,2098
412610,202102,805,2112,572,1615,67,205,270,662,337,867
412620,202102,1264,3284,964,2830,190,631,286,782,476,1413
412625,202102,8507,22258,5222,15772,711,2434,329,903,1040,3337
412627,202102,1145,3201,748,2377,137,477,197,623,334,1100
412630,202102,2834,8225,2071,6620,395,1307,598,1743,993,3050
412635,202102,389,1058,260,786,29,107,87,216,116,323
412640,202102,1043,2731,596,1801,67,205,183,499,250,704
412650,202102,1678,4526,1345,3874,213,684,534,1338,747,2022
412660,202102,2405,6154,1722,4863,265,799,534,1351,799,2150
412665,202102,383,979,307,848,55,157,146,389,201,546
412667,202102,1779,4673,1332,3810,188,581,558,1520,746,2101
412670,202102,872,2025,560,1514,108,334,154,379,262,713
412680,202102,2007,5298,1397,4131,175,609,521,1364,696,1973
412690,202102,1117,2940,811,2350,130,407,300,816,430,1223
412700,202102,1939,5096,1614,4592,197,624,875,2436,1072,3060
412710,202102,5773,16683,4341,13645,821,2921,1215,3360,2036,6281
412720,202102,1114,3293,856,2734,136,459,177,487,313,946
412730,202102,2481,6505,1735,5017,318,1029,624,1686,942,2715
412740,202102,1856,5124,1277,3962,219,792,182,548,401,1340
412750,202102,3886,10140,3187,9141,280,951,2127,5785,2407,6736
412760,202102,2877,7745,2398,6944,449,1454,1257,3399,1706,4853
412770,202102,10067,25475,5517,16554,729,2356,1280,3260,2009,5616
412780,202102,1160,3074,876,2555,196,615,327,924,523,1539
412785,202102,2069,4896,1472,3902,124,339,1010,2616,1134,2955
412788,202102,1354,3748,1112,3334,299,907,440,1281,739,2188
412790,202102,1332,3507,770,2366,107,383,241,642,348,1025
412795,202102,1230,3137,664,2002,93,306,133,357,226,663
412796,202102,2133,6094,1763,5410,357,1158,593,1683,950,2841
412800,202102,3661,8831,2537,6773,283,876,1185,2794,1468,3670
412810,202102,11764,29768,7652,21544,902,2961,3001,7489,3903,10450
412820,202102,6222,16997,4418,13365,1058,3408,1259,3790,2317,7198
412830,202102,338,956,242,748,34,100,66,193,100,293
412840,202102,1858,4591,1332,3581,154,469,604,1469,758,1938
412850,202102,2728,7135,1975,5830,316,995,828,2413,1144,3408
412853,202102,1464,3695,1227,3283,186,550,620,1472,806,2022
412855,202102,1244,3237,797,2322,116,387,223,603,339,990
412860,202102,743,1828,505,1453,70,226,275,738,345,964
412862,202102,673,1638,462,1288,82,233,191,501,273,734
412863,202102,1250,3741,1114,3497,253,823,560,1745,813,2568
412865,202102,698,1896,514,1522,138,403,132,428,270,831
412870,202102,836,2163,605,1777,170,553,131,429,301,982
412880,202102,851,2281,567,1700,92,311,101,270,193,581
420005,202102,397,1167,244,825,31,103,115,397,146,500
420010,202102,3226,7870,2169,6093,128,389,1594,4507,1722,4896
420020,202102,398,1250,265,909,41,168,60,159,101,327
420030,202102,63,206,44,168,12,53,18,60,30,113
420040,202102,491,1470,300,1045,57,221,20,52,77,273
420050,202102,706,1601,475,1199,65,195,299,674,364,869
420055,202102,152,456,82,288,14,66,24,69,38,135
420060,202102,95,251,55,159,8,25,15,31,23,56
420070,202102,659,1985,495,1656,103,361,198,635,301,996
420075,202102,76,188,39,113,7,26,14,22,21,48
420080,202102,343,977,271,817,71,241,104,311,175,552
420090,202102,401,1237,257,896,54,205,43,121,97,326
420100,202102,1242,3219,1039,2908,52,167,844,2331,896,2498
420110,202102,232,740,211,696,43,166,104,321,147,487
420120,202102,560,1495,377,1096,62,208,181,452,243,660
420125,202102,338,1021,238,797,56,199,91,293,147,492
420127,202102,277,730,104,325,14,52,31,88,45,140
420130,202102,3274,8985,2498,7693,354,1292,1221,3432,1575,4724
420140,202102,3400,9136,2434,7458,680,2338,350,1125,1030,3463
420150,202102,673,1687,466,1333,43,141,283,774,326,915
420160,202102,188,457,68,223,8,28,20,65,28,93
420165,202102,147,415,86,283,20,68,26,75,46,143
420170,202102,267,854,183,634,26,95,58,165,84,260
420180,202102,164,523,102,363,15,58,30,91,45,149
420190,202102,196,603,119,409,33,127,35,108,68,235
420195,202102,1316,3334,962,2778,282,976,119,257,401,1233
420200,202102,4522,10826,2749,7569,348,1188,1149,2714,1497,3902
420205,202102,1704,4587,1128,3411,163,523,611,1839,774,2362
420207,202102,1666,4327,1043,3139,196,686,426,1203,622,1889
420208,202102,308,874,181,635,54,202,43,135,97,337
420209,202102,150,484,96,314,16,55,39,110,55,165
420210,202102,2941,7486,1989,5947,319,1100,997,2866,1316,3966
420213,202102,744,2278,632,2064,141,498,323,1040,464,1538
420215,202102,186,554,132,431,35,132,33,101,68,233
420220,202102,261,747,161,530,24,93,77,238,101,331
420230,202102,5008,13436,3827,11251,559,1793,2061,5805,2620,7598
420240,202102,13232,36350,8486,25551,1034,3554,4121,10871,5155,14425
420243,202102,361,1022,289,882,47,164,176,515,223,679
420245,202102,1216,3174,882,2606,64,226,561,1588,625,1814
420250,202102,420,1171,351,1057,54,186,202,568,256,754
420253,202102,460,1130,326,937,31,102,187,533,218,635
420257,202102,152,397,95,295,15,57,48,148,63,205
420260,202102,1061,2750,771,2354,118,416,503,1504,621,1920
420270,202102,517,1353,269,790,38,122,119,331,157,453
420280,202102,1108,3313,866,2808,150,541,319,1006,469,1547
420285,202102,124,260,55,159,10,44,16,36,26,80
420287,202102,425,974,306,815,90,244,106,287,196,531
420290,202102,4540,12831,3489,10475,472,1622,2039,5674,2511,7296
420300,202102,7082,19959,4172,13069,734,2579,1323,3601,2057,6180
420310,202102,750,1717,377,1045,33,102,211,544,244,646
420315,202102,746,2064,512,1661,98,341,214,690,312,1031
420320,202102,4990,13405,3577,11065,971,3336,932,2663,1903,5999
420325,202102,305,834,219,664,31,91,102,288,133,379
420330,202102,949,2736,601,2013,100,395,181,549,281,944
420340,202102,900,2506,682,2121,157,509,114,314,271,823
420350,202102,1124,2934,829,2416,71,238,584,1666,655,1904
420360,202102,2758,7518,1498,4814,280,988,119,378,399,1366
420370,202102,1087,2919,896,2608,79,267,618,1745,697,2012
420380,202102,4165,10884,2798,8430,587,1893,1060,3047,1647,4940
420390,202102,1042,2526,724,1890,125,388,296,531,421,919
420395,202102,1067,2997,732,2335,105,386,109,244,214,630
420400,202102,944,2636,656,2036,110,400,266,768,376,1168
420410,202102,541,1445,421,1200,36,106,293,823,329,929
420415,202102,271,800,206,663,51,185,83,267,134,452
420417,202102,569,1681,463,1462,124,409,168,545,292,954
420419,202102,132,467,106,409,38,155,8,32,46,187
420420,202102,10790,27753,7231,21331,1953,6590,2029,5443,3982,12033
420425,202102,599,1595,402,1189,35,118,207,598,242,716
420430,202102,3019,8051,1796,5406,406,1264,578,1633,984,2897
420435,202102,244,631,124,402,15,52,62,194,77,246
420440,202102,695,1871,430,1314,123,408,140,403,263,811
420445,202102,249,599,164,448,30,81,76,194,106,275
420450,202102,675,1976,498,1591,88,335,176,496,264,831
420455,202102,1933,4716,1393,3898,190,616,673,1768,863,2384
420460,202102,8795,23339,6615,19378,907,2997,3429,9632,4336,12629
420470,202102,565,1470,307,965,54,207,59,158,113,365
420475,202102,64,166,24,79,6,21,2,7,8,28
420480,202102,5101,12542,3135,9312,617,2020,1087,3216,1704,5236
420490,202102,343,959,249,771,55,195,95,281,150,476
420500,202102,1334,3663,856,2769,145,517,377,1208,522,1725
420510,202102,150,426,86,278,9,37,25,69,34,106
420515,202102,59,155,36,103,3,18,15,36,18,54
420517,202102,730,2010,626,1815,50,150,443,1288,493,1438
420519,202102,273,668,199,561,23,71,118,346,141,417
420520,202102,267,724,141,476,27,92,9,32,36,124
420530,202102,760,2228,526,1718,82,325,204,569,286,894
420535,202102,234,685,100,341,15,59,43,142,58,201
420540,202102,35691,84626,23452,64449,3339,10443,8400,19975,11739,30418
420543,202102,196,581,151,479,20,65,83,246,103,311
420545,202102,1132,3379,857,2779,147,542,328,937,475,1479
420550,202102,3337,8836,2143,6818,334,1254,883,2873,1217,4127
420555,202102,276,793,191,613,23,87,115,346,138,433
420560,202102,377,934,254,751,49,156,147,431,196,587
420570,202102,2192,5912,1731,5046,287,976,798,2217,1085,3193
420580,202102,1756,4481,1267,3744,288,915,434,1333,722,2248
420590,202102,2612,6933,1537,4621,275,983,435,1010,710,1993
420600,202102,974,2807,748,2388,92,349,433,1317,525,1666
420610,202102,305,884,177,593,40,143,62,218,102,361
420620,202102,744,1811,496,1412,104,320,195,547,299,867
420630,202102,880,2632,642,2054,74,263,384,1170,458,1433
420640,202102,473,1283,237,802,71,234,24,85,95,319
420650,202102,3454,9055,2144,6354,295,948,838,2158,1133,3106
420660,202102,405,1046,265,751,50,151,71,180,121,331
420665,202102,594,1528,380,1164,68,236,158,422,226,658
420670,202102,1199,3327,772,2441,130,497,285,779,415,1276
420675,202102,172,477,100,333,18,84,49,140,67,224
420680,202102,307,712,158,504,29,101,78,240,107,341
420690,202102,815,2402,506,1679,70,283,131,368,201,651
420700,202102,2377,6200,1770,5192,208,660,1033,2939,1241,3599
420710,202102,947,2640,735,2187,70,285,466,1241,536,1526
420720,202102,1109,3097,802,2561,138,472,417,1270,555,1742
420730,202102,2929,7589,2177,6355,339,1106,1179,3316,1518,4422
420740,202102,477,1407,267,941,64,254,21,92,85,346
420750,202102,1852,5352,1204,3856,206,775,498,1453,704,2228
420757,202102,79,191,39,123,4,6,17,54,21,60
420760,202102,298,872,159,497,32,112,44,121,76,233
420765,202102,425,1242,198,683,30,118,84,275,114,393
420768,202102,1317,3670,1145,3388,144,425,844,2475,988,2900
420770,202102,438,1182,217,739,37,146,86,273,123,419
420775,202102,258,768,176,581,37,135,60,160,97,295
420780,202102,882,2437,538,1672,108,360,94,259,202,619
420785,202102,194,504,137,382,11,39,72,165,83,204
420790,202102,985,2968,732,2460,125,493,401,1262,526,1755
420800,202102,617,1553,308,935,75,255,96,283,171,538
420810,202102,1367,4212,1111,3710,312,1197,408,1170,720,2367
420820,202102,11848,29365,8551,24066,1558,4935,3996,10376,5554,15311
420830,202102,3952,10331,2969,8584,524,1631,1292,3625,1816,5256
420840,202102,450,1314,218,786,59,229,23,72,82,301
420845,202102,2318,5896,1430,4301,258,937,586,1681,844,2618
420850,202102,1027,3284,646,2285,119,462,126,389,245,851
420860,202102,297,746,167,521,30,105,49,130,79,235
420870,202102,727,2034,542,1691,150,536,215,612,365,1148
420880,202102,990,2995,767,2535,155,611,296,883,451,1494
420890,202102,7831,21192,4908,15213,683,2344,1725,4761,2408,7105
420895,202102,168,489,109,337,28,85,32,104,60,189
420900,202102,1463,3618,888,2616,114,412,416,1064,530,1476
420910,202102,29026,76129,18324,55591,2659,9192,7345,19748,10004,28940
420915,202102,481,1737,354,1373,51,191,194,771,245,962
420917,202102,336,805,186,508,30,87,92,248,122,335
420920,202102,70,195,30,108,1,2,5,20,6,22
420930,202102,15501,40369,11038,32596,1963,6443,4881,13723,6844,20166
420940,202102,2894,7026,1704,4987,384,1278,349,840,733,2118
420945,202102,127,363,100,305,24,83,39,110,63,193
420950,202102,327,943,185,602,27,104,46,141,73,245
420960,202102,988,2409,718,1957,116,362,321,795,437,1157
420970,202102,2254,6166,1593,4961,450,1454,464,1433,914,2887
420980,202102,265,867,230,795,106,377,63,227,169,604
420985,202102,283,818,143,510,37,150,41,124,78,274
420990,202102,279,872,163,578,28,100,36,124,64,224
421000,202102,524,1559,384,1259,82,290,94,279,176,569
421003,202102,461,1083,159,455,6,16,19,45,25,61
421005,202102,54,146,39,124,9,27,18,61,27,88
421010,202102,3123,8559,2241,6922,432,1508,624,1687,1056,3195
421020,202102,351,1080,276,945,44,182,141,458,185,640
421030,202102,711,2121,549,1800,169,627,177,529,346,1156
421040,202102,610,1449,383,1102,25,87,241,680,266,767
421050,202102,977,2615,647,1899,126,410,250,637,376,1047
421055,202102,166,455,93,286,15,50,57,157,72,207
421060,202102,612,1761,434,1375,84,309,209,590,293,899
421070,202102,632,1900,393,1289,66,244,135,409,201,653
421080,202102,486,1396,406,1249,40,145,245,748,285,893
421085,202102,342,975,125,442,16,47,16,47,32,94
421090,202102,260,670,144,413,12,47,42,105,54,152
421100,202102,745,1664,323,968,84,291,86,210,170,501
421105,202102,1481,4025,1022,3116,166,533,479,1387,645,1920
421110,202102,1059,2725,869,2485,16,46,643,1948,659,1994
421120,202102,963,2892,713,2336,107,384,218,624,325,1008
421125,202102,286,743,204,594,74,240,73,180,147,420
421130,202102,4599,13349,3798,11803,850,3029,1957,5690,2807,8719
421140,202102,327,882,194,590,32,96,69,198,101,294
421145,202102,429,1180,277,847,73,238,96,271,169,509
421150,202102,568,1534,369,1144,61,222,194,561,255,783
421160,202102,497,1359,368,1110,49,168,231,659,280,827
421165,202102,218,636,133,434,27,88,56,178,83,266
421170,202102,954,2630,816,2407,134,380,497,1515,631,1895
421175,202102,952,2362,584,1795,113,395,262,774,375,1169
421180,202102,369,955,206,629,34,132,92,241,126,373
421185,202102,309,818,210,613,21,65,125,357,146,422
421187,202102,266,810,168,560,27,90,59,188,86,278
421189,202102,322,937,257,814,42,146,103,304,145,450
421190,202102,10743,28916,7406,22628,1337,4384,2763,7810,4100,12194
421200,202102,633,1807,520,1607,67,241,326,969,393,1210
421205,202102,181,480,132,402,23,87,62,168,85,255
421210,202102,1019,2564,592,1851,117,377,232,721,349,1098
421220,202102,1308,3887,1011,3265,223,802,321,936,544,1738
421223,202102,307,843,192,634,44,141,93,306,137,447
421225,202102,799,2334,673,2123,110,409,413,1269,523,1678
421227,202102,610,1745,391,1281,73,262,169,567,242,829
421230,202102,545,1410,347,1042,57,205,138,407,195,612
421240,202102,268,793,132,461,11,45,25,77,36,122
421250,202102,1922,4864,1370,3969,130,445,849,2358,979,2803
421260,202102,188,570,49,180,13,58,9,28,22,86
421265,202102,633,1696,560,1592,11,35,489,1365,500,1400
421270,202102,328,855,138,474,21,67,47,159,68,226
421280,202102,1806,4778,1369,4055,180,665,802,2251,982,2916
421290,202102,928,2480,486,1466,94,296,110,310,204,606
421300,202102,265,682,134,430,11,48,21,60,32,108
421310,202102,171,478,115,369,23,78,62,198,85,276
421315,202102,212,565,139,410,43,117,30,101,73,218
421320,202102,612,1933,331,1110,34,99,35,74,69,173
421330,202102,560,1658,405,1337,82,312,115,354,197,666
421335,202102,318,971,263,878,63,234,106,353,169,587
421340,202102,1330,3636,956,2951,163,572,447,1267,610,1839
421350,202102,1420,3668,954,2845,177,597,384,1078,561,1675
421360,202102,2173,5813,1275,3953,222,808,486,1328,708,2136
421370,202102,672,2178,416,1490,77,284,121,379,198,663
421380,202102,788,2081,680,1915,86,273,401,1085,487,1358
421390,202102,157,423,57,203,14,42,19,62,33,104
421400,202102,297,929,214,741,35,138,108,354,143,492
421410,202102,176,495,83,299,21,83,24,74,45,157
421415,202102,165,491,103,329,23,77,21,57,44,134
421420,202102,548,1489,450,1305,50,167,282,793,332,960
421430,202102,93,291,70,231,8,31,18,55,26,86
421440,202102,570,1534,343,1121,69,222,146,462,215,684
421450,202102,439,1296,257,886,33,125,42,151,75,276
421460,202102,357,1067,198,721,22,88,32,97,54,185
421470,202102,265,746,159,521,32,106,58,205,90,311
421480,202102,2618,6980,1738,5214,344,1230,685,1845,1029,3075
421490,202102,112,389,70,263,10,36,16,48,26,84
421500,202102,1977,5766,1377,4528,348,1350,334,958,682,2308
421505,202102,276,776,231,713,31,118,151,445,182,563
421507,202102,408,1143,222,746,51,186,79,247,130,433
421510,202102,320,897,207,620,31,99,106,295,137,394
421520,202102,467,1225,313,888,24,76,186,478,210,554
421530,202102,264,767,157,530,25,106,42,118,67,224
421535,202102,362,952,229,717,38,135,123,375,161,510
421540,202102,290,685,157,467,24,77,55,143,79,220
421545,202102,612,1794,463,1534,101,406,227,699,328,1105
421550,202102,1940,5142,1569,4598,291,882,901,2627,1192,3509
421555,202102,162,491,73,258,8,34,10,23,18,57
421560,202102,82,274,54,203,10,38,17,59,27,97
421565,202102,864,2244,568,1779,147,518,146,449,293,967
421567,202102,401,1264,261,886,84,304,72,219,156,523
421568,202102,318,947,240,770,32,114,109,345,141,459
421569,202102,149,418,73,230,10,32,39,123,49,155
421570,202102,1128,3027,805,2414,171,581,236,644,407,1225
421575,202102,272,779,204,600,28,93,96,258,124,351
421580,202102,3989,10793,2594,7919,373,1342,1010,2637,1383,3979
421590,202102,133,416,109,361,30,108,36,110,66,218
421600,202102,543,1465,375,1112,74,247,118,298,192,545
421605,202102,715,1850,515,1522,90,236,275,867,365,1103
421610,202102,1000,2718,683,2109,112,376,221,659,333,1035
421620,202102,3619,9542,2189,6954,427,1591,656,1955,1083,3546
421625,202102,123,345,60,189,13,38,16,51,29,89
421630,202102,2386,6176,1540,4563,263,948,566,1387,829,2335
421635,202102,250,672,182,530,16,51,118,319,134,370
421640,202102,662,1768,480,1495,99,351,212,646,311,997
421650,202102,2291,6257,1548,4891,342,1260,505,1379,847,2639
421660,202102,9676,26769,6812,21291,1016,3530,3040,8713,4056,12243
421670,202102,723,2063,516,1571,94,325,239,702,333,1027
421680,202102,985,2669,739,2235,188,615,373,1036,561,1651
421690,202102,1251,3532,843,2677,149,537,303,948,452,1485
421700,202102,485,1413,332,1075,64,233,114,349,178,582
421710,202102,193,623,98,341,21,75,22,74,43,149
421715,202102,103,277,82,231,19,52,43,121,62,173
421720,202102,1839,4946,1111,3415,293,939,271,718,564,1657
421725,202102,242,577,123,368,20,68,54,131,74,199
421730,202102,375,1050,212,621,29,94,110,297,139,391
421740,202102,705,1987,480,1503,107,359,143,399,250,758
421750,202102,829,1938,391,1135,94,292,134,354,228,646
421755,202102,145,407,89,274,15,59,45,122,60,181
421760,202102,926,2405,630,1866,101,342,237,584,338,926
421770,202102,2239,5914,1624,4860,424,1242,569,1828,993,3070
421775,202102,204,523,120,358,14,44,49,137,63,181
421780,202102,756,2195,485,1629,100,382,211,656,311,1038
421790,202102,833,2268,500,1649,112,381,225,725,337,1106
421795,202102,168,460,121,349,23,80,44,114,67,194
421800,202102,2417,6515,1763,5299,209,730,1032,2956,1241,3686
421810,202102,604,1642,412,1285,45,166,241,732,286,898
421820,202102,872,2521,514,1648,100,372,170,443,270,815
421825,202102,1261,3554,1121,3342,120,380,788,2303,908,2683
421830,202102,1908,5586,1556,4945,312,1064,649,2011,961,3075
421835,202102,203,498,130,377,28,95,45,117,73,212
421840,202102,204,661,144,525,30,116,35,120,65,236
421850,202102,346,971,199,673,45,175,53,137,98,312
421860,202102,294,805,165,547,22,84,63,185,85,269
421870,202102,4111,10233,3036,8287,460,1503,1593,3861,2053,5364
421875,202102,273,802,117,362,17,57,34,88,51,145
421880,202102,613,1724,417,1285,91,322,112,330,203,652
421885,202102,199,565,126,398,32,104,32,85,64,189
421890,202102,792,2399,595,2005,105,425,326,1027,431,1452
421895,202102,386,984,329,910,40,116,222,643,262,759
421900,202102,998,2613,760,2130,96,312,367,920,463,1232
421910,202102,301,872,189,610,30,127,46,114,76,241
421915,202102,362,1013,210,660,46,140,40,120,86,260
421917,202102,552,1290,317,991,110,362,78,262,188,624
421920,202102,343,1047,246,860,95,343,67,234,162,577
421930,202102,2429,6097,1285,3947,274,962,448,1200,722,2162
421935,202102,379,1178,300,1008,60,212,168,551,228,763
421940,202102,355,1034,173,561,23,81,38,104,61,185
421950,202102,2811,7006,1636,4811,325,1044,420,1096,745,2140
421960,202102,174,436,90,277,13,60,27,64,40,124
421970,202102,1791,4581,1112,3200,215,727,434,1069,649,1796
421985,202102,284,769,174,543,18,63,68,198,86,261
422000,202102,1877,4814,1531,4280,144,488,1057,2905,1201,3393
430003,202102,566,1520,371,1168,64,215,163,515,227,730
430005,202102,259,676,165,508,28,95,81,235,109,330
430010,202102,1648,3963,1309,3448,162,450,898,2311,1060,2761
430020,202102,576,1316,437,1136,43,133,289,722,332,855
430030,202102,931,2198,510,1443,119,383,165,433,284,816
430040,202102,10147,23909,6091,16896,1597,4729,783,2307,2380,7036
430045,202102,465,1172,331,925,26,84,223,611,249,695
430047,202102,231,499,95,257,23,60,27,75,50,135
430050,202102,851,2162,504,1465,108,330,124,342,232,672
430055,202102,258,643,133,384,18,67,72,180,90,247
430057,202102,79,166,31,81,7,22,11,23,18,45
430060,202102,16705,43993,12930,38141,2588,8102,6096,17771,8684,25873
430063,202102,800,2225,652,1924,129,380,354,1047,483,1427
430064,202102,1008,2728,750,2206,210,644,300,861,510,1505
430066,202102,92,196,65,155,7,17,48,107,55,124
430070,202102,716,1818,103,342,9,35,14,33,23,68
430080,202102,836,2044,515,1428,77,247,278,657,355,904
430085,202102,859,1909,521,1373,107,294,214,553,321,847
430087,202102,772,1858,645,1692,63,171,448,1165,511,1336
430090,202102,499,1307,197,626,9,35,64,200,73,235
430100,202102,779,1841,480,1289,92,286,167,387,259,673
430105,202102,1149,3032,762,2372,118,424,363,1091,481,1515
430107,202102,166,484,103,325,22,76,28,75,50,151
430110,202102,2208,5455,1652,4644,298,890,836,2316,1134,3206
430120,202102,1130,3317,760,2394,138,457,332,1043,470,1500
430130,202102,3366,7645,2455,6363,832,2194,442,1404,1274,3598
430140,202102,950,2437,686,1955,170,446,348,977,518,1423
430150,202102,534,1366,290,872,64,214,93,265,157,479
430155,202102,237,600,112,337,19,53,22,61,41,114
430160,202102,19612,45125,15346,39237,1769,4889,9184,23174,10953,28063
430163,202102,3047,7144,2147,5724,82,294,1581,4101,1663,4395
430165,202102,285,699,88,276,11,24,13,38,24,62
430170,202102,949,2487,333,1123,48,168,47,146,95,314
430175,202102,648,1892,547,1674,139,428,252,773,391,1201
430180,202102,608,1454,480,1248,56,134,330,872,386,1006
430185,202102,631,1567,328,940,89,227,55,148,144,375
430187,202102,707,1531,500,1279,73,198,273,722,346,920
430190,202102,1389,3573,1104,3131,236,723,504,1365,740,2088
430192,202102,121,323,39,117,5,15,8,19,13,34
430195,202102,400,1175,59,212,5,19,7,17,12,36
430200,202102,1016,3010,814,2648,278,931,218,735,496,1666
430205,202102,451,1188,406,1106,14,49,357,946,371,995
430210,202102,5606,14289,3805,10506,591,1736,1263,2822,1854,4558
430215,202102,299,768,193,560,39,117,71,209,110,326
430220,202102,642,1588,204,663,21,76,41,106,62,182
430222,202102,179,495,132,399,14,49,45,128,59,177
430223,202102,241,616,193,536,14,35,121,327,135,362
430225,202102,16,32,10,23,0,0,7,16,7,16
430230,202102,1929,5188,1597,4677,139,459,1162,3327,1301,3786
430235,202102,348,965,228,711,51,177,69,182,120,359
430237,202102,509,1182,380,976,17,47,289,727,306,774
430240,202102,1283,2985,736,2015,81,269,392,980,473,1249
430245,202102,696,1942,545,1661,149,471,254,798,403,1269
430250,202102,923,2234,668,1839,235,693,38,95,273,788
430258,202102,137,367,98,289,6,15,52,149,58,164
430260,202102,645,1689,449,1315,57,190,252,740,309,930
430265,202102,210,605,139,460,30,93,43,148,73,241
430270,202102,2895,7093,2290,6152,389,1152,1389,3601,1778,4753
430280,202102,5031,11674,3524,9145,663,1730,1546,3954,2209,5684
430290,202102,2226,5040,1818,4570,44,141,1578,3869,1622,4010
430300,202102,9982,24830,7498,20570,1140,3431,4014,10656,5154,14087
430310,202102,11607,28413,7898,21677,994,3025,3871,9903,4865,12928
430320,202102,1007,2539,565,1681,59,178,317,943,376,1121
430330,202102,687,1653,410,1102,76,215,159,378,235,593
430340,202102,580,1353,384,1035,66,175,226,599,292,774
430350,202102,7695,19146,5826,15902,732,2169,3500,9067,4232,11236
430355,202102,302,801,112,361,17,57,13,33,30,90
430360,202102,813,1926,538,1444,102,311,228,569,330,880
430367,202102,299,682,174,468,30,95,100,254,130,349
430370,202102,438,1202,216,651,31,100,61,151,92,251
430380,202102,700,1717,340,1055,77,268,99,291,176,559
430390,202102,3126,7426,1878,5170,371,1180,294,580,665,1760
430400,202102,1003,2144,774,1835,66,176,463,1062,529,1238
430410,202102,530,1256,371,1003,61,169,225,599,286,768
430420,202102,2540,6804,1957,5579,454,1362,922,2506,1376,3868
430430,202102,563,1419,262,804,63,182,58,190,121,372
430435,202102,1457,3653,1133,3143,196,592,599,1652,795,2244
430440,202102,3699,9976,2909,8643,287,967,1814,5347,2101,6314
430450,202102,6598,16319,5257,13970,934,2729,2617,6630,3551,9359
430460,202102,32210,80537,24051,67357,3948,12179,12530,33585,16478,45764
430461,202102,233,614,78,242,13,43,32,86,45,129
430462,202102,259,700,154,485,28,100,50,153,78,253
430463,202102,5921,15261,4372,12528,852,2740,2011,5450,2863,8190
430465,202102,439,1105,354,951,58,178,222,571,280,749
430466,202102,4071,10161,3177,8735,736,2100,1476,3862,2212,5962
430467,202102,497,1170,353,952,46,151,197,482,243,633
430468,202102,1249,3043,988,2659,79,244,675,1761,754,2005
430469,202102,520,1372,73,234,8,25,16,34,24,59
430470,202102,5388,13747,3584,10545,1045,3345,900,2461,1945,5806
430471,202102,532,1480,433,1302,61,199,259,743,320,942
430480,202102,678,1885,437,1354,51,176,101,272,152,448
430485,202102,171,444,66,201,19,50,6,24,25,74
430490,202102,338,876,194,579,25,91,99,266,124,357
430495,202102,397,1047,266,800,37,118,129,362,166,480
430500,202102,968,2472,668,1969,228,730,172,461,400,1191
430510,202102,26020,66413,18753,52611,2983,9476,8885,22920,11868,32396
430511,202102,318,911,140,452,19,64,20,61,39,125
430512,202102,945,2098,735,1786,167,413,270,679,437,1092
430513,202102,787,1937,367,1051,59,180,175,471,234,651
430515,202102,362,1025,266,828,32,95,144,445,176,540
430517,202102,1172,3480,877,2810,167,534,416,1369,583,1903
430520,202102,1247,3140,670,1904,126,384,155,402,281,786
430530,202102,966,2390,398,1186,68,201,112,320,180,521
430535,202102,3411,8702,2482,7022,347,1024,1251,3394,1598,4418
430537,202102,331,1109,304,1039,18,54,248,846,266,900
430540,202102,602,1423,337,964,58,166,159,454,217,620
430543,202102,817,1403,462,1008,56,115,191,486,247,601
430544,202102,744,2069,517,1562,122,381,173,508,295,889
430545,202102,2271,5755,1679,4859,313,913,877,2596,1190,3509
430550,202102,340,933,250,745,47,150,97,268,144,418
430558,202102,112,259,54,145,9,18,18,49,27,67
430560,202102,275,641,134,400,21,71,50,132,71,203
430570,202102,834,2014,590,1572,101,302,303,743,404,1045
430580,202102,818,2027,582,1666,149,459,245,702,394,1161
430583,202102,200,495,38,115,4,12,12,30,16,42
430585,202102,227,550,120,329,19,59,51,120,70,179
430587,202102,193,521,145,435,21,68,58,166,79,234
430590,202102,1364,3264,1125,2907,58,178,927,2344,985,2522
430593,202102,17,50,13,39,2,4,5,15,7,19
430595,202102,427,1056,123,394,11,48,21,45,32,93
430597,202102,461,1165,248,739,22,65,84,201,106,266
430600,202102,1960,4998,893,2539,151,441,239,624,390,1065
430605,202102,1272,3317,920,2668,110,366,446,1231,556,1597
430607,202102,516,1208,433,1082,26,67,318,783,344,850
430610,202102,5800,13350,3896,10518,1064,3318,855,2225,1919,5543
430613,202102,265,613,74,211,12,31,18,35,30,66
430620,202102,622,1498,461,1201,66,199,278,648,344,847
430630,202102,391,1061,117,377,21,68,25,67,46,135
430632,202102,450,1166,202,605,30,87,85,244,115,331
430635,202102,530,1231,398,1014,47,122,291,745,338,867
430637,202102,455,1101,353,949,36,114,239,613,275,727
430640,202102,1043,2750,686,2028,105,332,268,725,373,1057
430642,202102,349,955,261,757,45,130,135,370,180,500
430645,202102,153,358,59,158,7,21,22,53,29,74
430650,202102,1615,4551,1286,3995,388,1197,543,1832,931,3029
430655,202102,280,694,170,479,29,95,82,197,111,292
430660,202102,5186,13103,3981,11142,865,2528,1727,4790,2592,7318
430670,202102,642,1560,488,1293,33,93,285,770,318,863
430673,202102,526,1191,224,626,38,104,88,228,126,332
430675,202102,238,686,53,190,5,17,20,70,25,87
430676,202102,5044,12329,4002,10733,499,1459,2516,6600,3015,8059
430680,202102,1039,2743,608,1857,156,491,142,419,298,910
430690,202102,2748,7386,2172,6355,746,2288,576,1631,1322,3919
430692,202102,215,663,167,581,14,48,122,435,136,483
430693,202102,919,2388,565,1704,107,382,146,404,253,786
430695,202102,403,1016,250,712,31,84,135,365,166,449
430697,202102,394,988,306,852,76,198,149,447,225,645
430700,202102,7224,17575,4422,12419,839,2575,1075,2705,1914,5280
430705,202102,402,951,201,578,17,47,86,223,103,270
430710,202102,1649,3499,1153,2840,151,417,695,1678,846,2095
430720,202102,666,1589,353,1053,42,122,185,553,227,675
430730,202102,987,2667,688,2103,96,292,364,1093,460,1385
430740,202102,637,1690,329,1053,55,177,83,269,138,446
430745,202102,336,905,221,667,48,165,70,183,118,348
430750,202102,1340,3357,935,2678,203,611,437,1229,640,1840
430755,202102,442,1081,284,763,22,67,158,399,180,466
430760,202102,1996,4865,1529,4155,313,936,733,1892,1046,2828
430770,202102,6158,15301,4775,13218,580,1835,3060,8174,3640,10009
430780,202102,1801,4399,1074,3157,198,661,419,1174,617,1835
430781,202102,455,1263,262,820,35,105,80,214,115,319
430783,202102,348,790,210,576,21,63,133,342,154,405
430786,202102,31,110,21,78,3,13,2,9,5,22
430790,202102,4316,10388,3043,8229,330,1055,1883,4743,2213,5798
430800,202102,756,1723,570,1454,41,104,381,968,422,1072
430805,202102,328,851,217,620,14,50,140,384,154,434
430807,202102,480,1189,256,759,36,115,96,255,132,370
430810,202102,671,1592,293,866,32,119,137,374,169,493
430820,202102,1112,2981,681,2156,122,411,217,655,339,1066
430825,202102,253,621,84,230,11,28,30,76,41,104
430830,202102,1682,4721,1366,4124,103,311,951,2834,1054,3145
430840,202102,1061,2553,725,1991,103,276,469,1305,572,1581
430843,202102,165,387,76,204,4,13,32,79,36,92
430845,202102,457,1067,305,825,49,143,140,360,189,503
430850,202102,2225,5700,1510,4351,236,737,569,1671,805,2408
430860,202102,837,1936,385,1079,50,172,177,415,227,587
430865,202102,494,1233,365,1014,77,219,144,394,221,613
430870,202102,581,1534,264,831,39,137,78,211,117,348
430880,202102,1489,3341,1018,2629,165,434,551,1377,716,1811
430885,202102,170,448,90,293,5,16,57,180,62,196
430890,202102,962,2350,647,1830,59,249,142,372,201,621
430900,202102,3078,6670,2148,5361,175,530,1443,3383,1618,3913
430905,202102,810,2022,528,1490,91,288,215,574,306,862
430910,202102,1827,4876,1356,3918,203,672,646,1647,849,2319
430912,202102,505,1415,350,1099,28,87,226,713,254,800
430915,202102,476,1420,363,1210,133,426,90,320,223,746
430920,202102,22013,55443,16764,46847,2167,6681,10099,27570,12266,34251
430925,202102,88,201,36,112,4,12,19,56,23,68
430930,202102,10046,23597,6434,18081,1228,3490,2609,7724,3837,11214
430940,202102,916,2346,555,1598,118,355,188,480,306,835
430950,202102,781,1769,502,1293,35,121,327,767,362,888
430955,202102,374,974,91,266,21,64,26,64,47,128
430957,202102,164,552,150,524,20,75,101,346,121,421
430960,202102,1252,2967,706,1977,146,430,302,812,448,1242
430965,202102,1593,3761,1236,3205,70,184,938,2489,1008,2673
430970,202102,335,793,173,481,23,75,86,209,109,284
430975,202102,489,1439,375,1179,75,253,208,615,283,868
430980,202102,380,859,225,598,26,84,106,252,132,336
430990,202102,510,1437,337,1037,50,157,158,479,208,636
430995,202102,538,1356,410,1150,46,139,238,648,284,787
431000,202102,1312,3090,560,1629,98,305,45,117,143,422
431010,202102,2123,5591,1391,4312,271,927,345,946,616,1873
431020,202102,7522,16271,4463,11715,982,2939,1544,3515,2526,6454
431030,202102,355,956,168,560,33,122,23,70,56,192
431033,202102,3696,8493,2404,6499,494,1377,887,2393,1381,3770
431036,202102,332,722,67,198,7,24,21,46,28,70
431040,202102,861,2180,559,1667,79,264,261,715,340,979
431041,202102,433,1001,319,829,25,56,193,501,218,557
431043,202102,309,786,181,554,43,146,87,258,130,404
431046,202102,100,267,41,128,4,9,7,21,11,30
431050,202102,1333,3215,950,2596,179,530,432,1228,611,1758
431053,202102,644,1702,381,1141,72,253,127,325,199,578
431055,202102,570,1374,480,1234,52,122,346,886,398,1008
431057,202102,212,604,119,384,25,81,32,95,57,176
431060,202102,5432,13546,3658,10568,834,2643,1067,2958,1901,5601
431065,202102,401,989,290,804,42,125,149,406,191,531
431070,202102,414,1125,248,753,58,193,68,195,126,388
431075,202102,217,623,134,433,33,113,37,117,70,230
431080,202102,561,1510,389,1148,55,193,149,413,204,606
431085,202102,771,1983,494,1359,56,154,258,691,314,845
431087,202102,383,1086,311,941,20,58,219,683,239,741
431090,202102,397,932,157,485,29,98,45,142,74,240
431100,202102,3292,7139,2265,5815,315,829,1185,3100,1500,3929
431110,202102,1387,3160,944,2403,244,655,383,874,627,1529
431112,202102,587,1602,497,1435,61,203,323,897,384,1100
431113,202102,365,989,313,888,48,156,197,540,245,696
431115,202102,944,2639,741,2267,91,342,450,1281,541,1623
431120,202102,2565,6715,1776,5228,499,1630,385,1037,884,2667
431123,202102,395,1057,259,769,51,136,138,429,189,565
431125,202102,954,2698,770,2342,282,838,259,850,541,1688
431127,202102,199,529,63,210,7,23,13,41,20,64
431130,202102,2880,7264,2137,6058,318,1008,1200,3324,1518,4332
431140,202102,5519,12833,3409,8944,413,1201,1552,3528,1965,4729
431142,202102,491,1281,368,1070,44,135,228,669,272,804
431150,202102,1034,2722,749,2204,132,428,339,962,471,1390
431160,202102,629,1803,415,1317,80,269,119,368,199,637
431162,202102,479,1135,281,786,29,88,159,415,188,503
431164,202102,165,373,40,124,9,30,4,10,13,40
431170,202102,434,1186,305,922,90,281,85,249,175,530
431171,202102,652,1522,532,1362,118,265,305,812,423,1077
431173,202102,361,960,274,836,76,260,115,333,191,593
431175,202102,1273,2929,805,2145,135,369,301,757,436,1126
431177,202102,773,2066,609,1805,123,428,381,1077,504,1505
431179,202102,331,725,100,295,20,56,26,75,46,131
431180,202102,2106,5301,1316,3753,304,898,406,1107,710,2005
431190,202102,548,1390,263,760,28,82,94,228,122,310
431198,202102,368,1050,291,906,94,308,88,295,182,603
431200,202102,360,887,87,234,18,54,11,29,29,83
431205,202102,197,545,101,331,28,88,35,123,63,211
431210,202102,599,1451,484,1294,124,335,216,610,340,945
431213,202102,260,678,195,563,13,46,101,291,114,337
431215,202102,589,1408,273,802,21,64,139,383,160,447
431217,202102,150,387,103,301,14,47,55,145,69,192
431220,202102,510,1315,315,939,28,100,180,498,208,598
431225,202102,1470,3429,1135,2881,119,314,764,1936,883,2250
431230,202102,659,1870,532,1603,76,238,329,954,405,1192
431235,202102,147,377,23,82,3,8,4,20,7,28
431237,202102,289,910,234,783,47,170,122,394,169,564
431238,202102,30,80,24,67,5,16,11,23,16,39
431240,202102,4398,10720,3497,9314,425,1317,2180,5463,2605,6780
431242,202102,239,624,208,573,39,113,116,306,155,419
431244,202102,305,734,162,454,22,79,60,138,82,217
431245,202102,1235,2863,791,2100,70,205,430,1088,500,1293
431247,202102,272,679,166,463,30,91,73,177,103,268
431250,202102,1661,4089,1228,3511,270,775,639,1955,909,2730
431260,202102,250,687,165,522,23,86,54,164,77,250
431261,202102,233,695,189,624,13,45,106,339,119,384
431262,202102,333,933,168,550,10,28,113,376,123,404
431265,202102,1560,3644,633,1835,84,277,206,521,290,798
431267,202102,258,641,171,462,8,33,126,312,134,345
431270,202102,2782,6197,1501,4061,319,873,502,1383,821,2256
431275,202102,115,330,65,214,23,70,13,46,36,116
431280,202102,237,637,77,242,5,14,9,21,14,35
431290,202102,319,925,204,640,36,111,36,88,72,199
431295,202102,68,166,20,60,3,8,5,13,8,21
431300,202102,278,714,56,171,7,20,17,38,24,58
431301,202102,300,844,70,217,7,19,8,25,15,44
431303,202102,556,1455,343,1013,23,87,156,422,179,509
431306,202102,2275,5360,1411,3929,183,564,612,1514,795,2078
431308,202102,25,76,23,72,10,34,10,31,20,65
431310,202102,536,1473,378,1125,52,158,168,471,220,629
431320,202102,598,1627,322,1034,48,146,65,174,113,320
431330,202102,1677,3933,848,2414,145,465,339,871,484,1336
431333,202102,211,546,117,342,21,60,39,96,60,156
431335,202102,35,100,21,70,4,8,1,2,5,10
431337,202102,2486,6492,1846,5447,308,1042,1038,2939,1346,3981
431339,202102,407,1055,304,870,84,249,115,324,199,573
431340,202102,17833,43017,12482,34156,1969,5942,5719,14688,7688,20630
431342,202102,419,916,310,749,27,50,253,613,280,663
431344,202102,385,972,231,682,9,30,123,352,132,382
431346,202102,231,570,92,293,16,53,25,76,41,129
431349,202102,600,1579,340,1002,80,219,118,351,198,570
431350,202102,4011,10156,2989,8432,388,1257,1634,4405,2022,5662
431360,202102,543,1293,266,751,83,239,68,194,151,433
431365,202102,2020,4690,1602,4128,121,352,1214,3093,1335,3445
431370,202102,4373,10460,3162,8519,611,1737,1605,4398,2216,6135
431380,202102,790,2096,636,1849,46,143,445,1292,491,1435
431390,202102,2620,6347,1625,4605,161,544,812,2018,973,2562
431395,202102,1273,3114,900,2548,189,562,407,1193,596,1755
431400,202102,305,853,168,535,36,109,36,112,72,221
431402,202102,865,1915,634,1565,72,190,437,1052,509,1242
431403,202102,201,550,158,464,23,66,71,197,94,263
431405,202102,4510,11766,3488,10069,582,1848,1721,4734,2303,6582
431406,202102,513,1454,375,1164,73,221,200,635,273,856
431407,202102,447,1231,316,957,68,231,162,469,230,700
431410,202102,16518,40870,11191,31652,1545,5068,5895,15467,7440,20535
431413,202102,198,519,54,176,5,15,10,35,15,50
431415,202102,634,1536,395,1135,68,234,198,508,266,742
431417,202102,543,1200,373,947,62,178,201,502,263,680
431420,202102,1606,3552,1203,2997,159,411,691,1677,850,2088
431430,202102,554,1413,271,832,44,146,85,239,129,385
431440,202102,29032,67147,20131,53375,3284,9521,8116,20111,11400,29632
431442,202102,122,344,56,194,10,39,8,25,18,64
431445,202102,389,1078,118,370,16,42,10,26,26,68
431446,202102,245,717,187,601,34,125,94,290,128,415
431447,202102,720,1878,417,1226,85,264,142,418,227,682
431449,202102,772,1989,471,1371,92,247,178,534,270,781
431450,202102,2269,4621,1774,3931,74,174,1394,3014,1468,3188
431454,202102,33,105,28,91,8,23,8,24,16,47
431455,202102,585,1373,290,774,37,109,146,350,183,459
431460,202102,2833,6780,1982,5288,511,1423,510,1369,1021,2792
431470,202102,1380,3844,1011,3056,181,564,441,1341,622,1905
431475,202102,237,636,58,197,5,18,7,14,12,32
431477,202102,369,963,228,675,35,98,95,255,130,353
431478,202102,219,579,51,158,11,30,7,17,18,47
431480,202102,3216,7866,2573,6890,582,1565,1333,3600,1915,5165
431490,202102,104239,243261,78933,205150,5481,16903,57371,143370,62852,160273
431500,202102,473,1195,354,970,59,169,187,491,246,660
431505,202102,243,584,165,467,10,33,119,336,129,369
431507,202102,331,774,136,395,44,139,35,91,79,230
431510,202102,1550,3947,1051,2982,248,758,342,979,590,1737
431513,202102,208,459,118,312,10,20,78,209,88,229
431514,202102,110,278,78,220,4,12,54,143,58,155
431515,202102,438,1098,322,891,79,215,174,457,253,672
431517,202102,54,165,45,141,6,17,21,62,27,79
431520,202102,389,974,159,495,15,55,67,179,82,234
431530,202102,4191,8752,2399,6110,548,1407,624,1612,1172,3019
431531,202102,205,503,129,359,13,33,54,138,67,171
431532,202102,539,1241,333,873,73,213,141,360,214,573
431535,202102,236,618,108,334,20,64,24,64,44,128
431540,202102,1742,5586,1617,5414,56,219,1316,4431,1372,4650
431545,202102,339,879,61,203,5,17,12,37,17,54
431550,202102,2077,5214,1507,4164,235,688,754,2001,989,2689
431555,202102,664,1481,389,1022,29,82,228,596,257,678
431560,202102,22247,53387,15285,42598,3160,9109,5181,15240,8341,24349
431570,202102,4208,10265,3528,9266,440,1264,2487,6279,2927,7543
431575,202102,232,565,181,477,67,158,44,124,111,282
431580,202102,559,1443,354,1035,36,121,198,553,234,674
431590,202102,569,1579,429,1291,92,283,167,521,259,804
431595,202102,356,960,239,715,47,139,91,245,138,384
431600,202102,1336,3095,933,2511,213,621,375,1000,588,1621
431610,202102,1367,3472,933,2678,136,376,476,1401,612,1777
431620,202102,479,1226,225,649,35,104,88,234,123,338
431630,202102,1296,3178,626,1827,100,308,230,626,330,934
431640,202102,6111,14373,5153,13176,491,1299,3893,9984,4384,11283
431642,202102,547,1325,347,926,31,82,157,388,188,470
431643,202102,381,920,181,510,17,44,54,156,71,200
431645,202102,1817,4012,1426,3494,56,177,1165,2806,1221,2983
431647,202102,294,716,97,283,11,29,25,61,36,90
431650,202102,114,316,77,258,5,20,43,127,48,147
431660,202102,825,2166,412,1306,66,249,113,298,179,547
431670,202102,1143,2694,698,1889,105,288,338,863,443,1151
431673,202102,238,602,95,318,8,30,22,69,30,99
431675,202102,412,1071,113,377,7,28,25,72,32,100
431680,202102,7607,19185,5569,15455,1286,3696,2341,6339,3627,10035
431690,202102,23649,57311,15910,43572,3070,8977,6605,17905,9675,26882
431695,202102,169,407,105,306,22,77,52,128,74,205
431697,202102,457,1071,354,911,51,123,211,554,262,677
431700,202102,1310,3336,1087,2938,181,440,641,1755,822,2195
431710,202102,13040,30698,9144,25147,1454,4305,4756,13146,6210,17451
431720,202102,6406,15620,3863,10815,933,2742,787,1988,1720,4730
431725,202102,28,81,22,71,3,10,10,30,13,40
431730,202102,3895,9146,2440,6900,552,1641,764,2328,1316,3969
431740,202102,5062,11814,3345,8977,870,2719,863,1992,1733,4711
431750,202102,7281,18614,5511,15810,1217,3733,2219,6298,3436,10031
431755,202102,315,850,77,259,11,38,9,32,20,70
431760,202102,5299,11781,3622,9150,402,1149,2210,5292,2612,6441
431770,202102,1905,4401,1474,3829,126,338,1083,2756,1209,3094
431775,202102,196,497,99,306,20,60,12,31,32,91
431780,202102,2087,5076,1350,3744,209,633,570,1534,779,2167
431790,202102,757,2022,533,1592,97,276,243,730,340,1006
431795,202102,227,579,114,348,27,74,27,78,54,152
431800,202102,8100,19042,5043,14268,1231,4144,487,1447,1718,5591
431805,202102,291,672,87,277,12,42,21,64,33,106
431810,202102,3230,7560,2029,5388,383,1048,860,2182,1243,3230
431820,202102,2076,5511,1625,4798,476,1466,539,1693,1015,3159
431830,202102,8835,18944,6471,15820,1633,4744,1708,4123,3341,8867
431840,202102,2557,6561,2048,5753,304,858,1307,3669,1611,4527
431842,202102,510,1275,173,531,21,72,71,193,92,265
431843,202102,330,863,246,699,33,98,119,321,152,419
431844,202102,201,532,70,228,14,50,25,84,39,134
431845,202102,499,1314,354,1028,36,104,207,599,243,703
431846,202102,262,682,224,625,10,30,200,561,210,591
431848,202102,103,264,63,184,10,30,14,32,24,62
431849,202102,406,978,75,219,9,26,10,21,19,47
431850,202102,4071,10885,3140,9061,722,2242,1052,2982,1774,5224
431860,202102,638,1498,348,946,54,154,201,525,255,679
431861,202102,87,238,51,157,10,34,16,45,26,79
431862,202102,440,1380,363,1248,70,261,181,595,251,856
431870,202102,20101,50242,16228,44269,1783,5560,10211,26712,11994,32272
431880,202102,3871,9815,2750,7856,412,1357,1322,3571,1734,4928
431890,202102,4400,10959,2755,7876,760,2374,483,1551,1243,3925
431900,202102,935,2317,610,1741,91,288,314,848,405,1136
431910,202102,744,1768,283,781,42,123,90,202,132,325
431912,202102,474,1268,374,1093,74,220,210,621,284,841
431915,202102,1021,2490,816,2159,24,82,633,1633,657,1715
431920,202102,1229,2813,1014,2533,32,69,862,2154,894,2223
431930,202102,656,1732,447,1335,162,449,160,504,322,953
431935,202102,86,226,62,179,16,49,13,37,29,86
431936,202102,304,863,169,529,33,105,75,220,108,325
431937,202102,142,347,92,248,12,33,43,98,55,131
431940,202102,3016,7047,1744,4755,195,571,869,2278,1064,2849
431950,202102,1795,4681,1427,4077,404,1200,547,1518,951,2718
431960,202102,2899,6984,2160,5667,576,1620,586,1530,1162,3150
431970,202102,396,990,168,487,37,106,49,123,86,229
431971,202102,80,199,33,106,4,16,4,8,8,24
431973,202102,465,1488,386,1333,37,129,278,962,315,1091
431975,202102,107,216,21,64,2,7,2,6,4,13
431980,202102,943,2440,728,2091,144,435,349,968,493,1403
431990,202102,5422,12891,3745,10489,422,1443,1959,5284,2381,6727
432000,202102,11036,25973,8056,21437,1955,5234,3372,9148,5327,14382
432010,202102,2233,5343,1624,4329,282,813,910,2296,1192,3109
432020,202102,1737,4487,1073,3074,224,659,386,1071,610,1730
432023,202102,483,1143,257,716,32,101,128,321,160,422
432026,202102,938,2585,695,2120,179,540,208,643,387,1183
432030,202102,355,869,204,563,15,44,119,319,134,363
432032,202102,327,837,227,638,23,73,130,336,153,409
432035,202102,648,1819,560,1669,172,486,245,772,417,1258
432040,202102,1029,2393,382,1169,54,179,135,364,189,543
432045,202102,156,447,103,336,21,65,39,132,60,197
432050,202102,505,1244,374,1024,79,214,153,442,232,656
432055,202102,556,1486,366,1134,126,393,67,196,193,589
432057,202102,186,509,147,403,11,28,70,177,81,205
432060,202102,423,1005,128,394,32,105,38,109,70,214
432065,202102,196,540,140,422,30,95,55,164,85,259
432067,202102,715,2041,607,1800,57,188,456,1305,513,1493
432070,202102,1620,4181,1075,3140,224,728,363,953,587,1681
432080,202102,4703,10905,3578,9166,588,1771,1686,4074,2274,5845
432085,202102,362,950,259,791,61,192,114,363,175,555
432090,202102,1788,4385,1087,3070,184,562,514,1325,698,1887
432100,202102,968,2401,481,1446,106,335,80,195,186,530
432110,202102,1964,5143,1353,4066,316,1064,143,383,459,1447
432120,202102,2632,7059,2049,6089,367,1221,851,2377,1218,3598
432130,202102,2523,6332,2094,5699,619,1725,893,2470,1512,4195
432132,202102,176,502,108,353,20,66,53,149,73,215
432135,202102,977,2281,653,1736,40,124,475,1247,515,1371
432140,202102,1580,4674,1200,3909,179,608,728,2356,907,2964
432143,202102,1351,3493,1033,3016,63,205,685,1976,748,2181
432145,202102,1660,4337,1063,3109,155,484,353,891,508,1375
432146,202102,101,282,70,231,24,87,23,67,47,154
432147,202102,447,1246,270,880,87,306,68,190,155,496
432149,202102,435,1045,228,634,20,56,109,271,129,327
432150,202102,3038,7546,2233,6149,445,1318,928,2489,1373,3807
432160,202102,4881,12650,3562,10576,825,2745,1291,3670,2116,6415
432162,202102,226,488,31,87,7,25,6,11,13,36
432163,202102,100,249,20,52,0,0,3,4,3,4
432166,202102,614,1699,485,1437,97,323,173,452,270,775
432170,202102,1436,3825,961,2942,174,592,390,1130,564,1722
432180,202102,3037,7117,1652,4554,302,873,617,1495,919,2368
432183,202102,345,1005,241,770,54,194,72,208,126,402
432185,202102,802,2057,463,1392,36,121,227,639,263,760
432190,202102,1900,4525,1293,3580,178,559,730,1876,908,2435
432195,202102,795,2041,538,1573,156,421,183,571,339,992
432200,202102,3225,8049,2342,6673,363,1059,1339,3843,1702,4902
432210,202102,375,984,235,706,45,162,106,274,151,436
432215,202102,607,1784,553,1702,51,132,416,1306,467,1438
432218,202102,244,604,116,336,13,44,56,143,69,187
432220,202102,3472,8088,2578,6673,484,1286,1314,3374,1798,4660
432225,202102,81,232,62,194,9,24,35,115,44,139
432230,202102,715,1651,387,1041,43,119,177,419,220,538
432232,202102,468,1148,292,848,59,180,104,274,163,454
432234,202102,253,640,118,355,18,51,16,43,34,94
432235,202102,44,125,18,57,5,17,4,13,9,30
432237,202102,303,783,271,732,10,19,228,607,238,626
432240,202102,15629,38143,11355,32461,850,2453,7264,21780,8114,24233
432250,202102,5309,14961,3971,12318,1010,3273,1647,5076,2657,8349
432252,202102,413,982,266,718,31,88,141,359,172,447
432253,202102,849,2568,564,1841,136,474,57,171,193,645
432254,202102,685,1595,196,576,34,92,40,108,74,200
432255,202102,98,251,57,172,3,9,28,78,31,87
432260,202102,4760,12062,3557,9794,999,2824,1201,3164,2200,5988
432270,202102,1815,4972,1467,4309,441,1400,363,999,804,2399
432280,202102,1385,3412,741,2176,101,306,272,679,373,985
432285,202102,142,427,22,67,2,6,3,7,5,13
432290,202102,327,892,183,561,58,183,32,70,90,253
432300,202102,25108,62599,18749,52461,2582,8166,10991,29640,13573,37806
432310,202102,822,2181,593,1766,65,199,405,1205,470,1404
432320,202102,197,456,77,235,7,24,29,83,36,107
432330,202102,247,548,76,246,10,25,13,43,23,68
432335,202102,159,455,59,210,5,21,17,58,22,79
432340,202102,301,723,133,416,8,26,47,136,55,162
432345,202102,710,1578,618,1468,16,42,515,1198,531,1240
432350,202102,338,854,182,558,27,89,71,221,98,310
432360,202102,231,676,44,146,4,7,15,50,19,57
432370,202102,289,705,196,549,14,50,135,366,149,416
432375,202102,460,1150,348,932,68,179,173,462,241,641
432377,202102,167,538,34,125,6,27,5,12,11,39
432380,202102,1632,4316,1083,3317,172,609,561,1666,733,2275
500020,202102,2530,6516,1881,5449,176,588,1178,3309,1354,3897
500025,202102,1175,2860,750,2073,73,205,402,1078,475,1283
500060,202102,7878,22049,5415,16932,655,2134,3175,10160,3830,12294
500070,202102,4110,10583,2900,8530,532,1605,1241,3721,1773,5326
500080,202102,1611,3914,995,2790,180,556,388,956,568,1512
500085,202102,1956,4839,1362,3829,334,977,621,1686,955,2663
500090,202102,2143,5629,1451,4427,242,791,488,1602,730,2393
500100,202102,3523,8927,2679,7560,424,1365,1347,3579,1771,4944
500110,202102,7803,19752,5055,15494,1049,3580,1482,5381,2531,8961
500124,202102,1992,5797,1588,5126,261,778,844,2878,1105,3656
500150,202102,1322,2957,836,2261,134,382,339,901,473,1283
500190,202102,4813,12455,3084,9106,637,1894,733,2068,1370,3962
500200,202102,2354,5547,1706,4470,164,440,1040,2634,1204,3074
500210,202102,4558,10790,3234,9067,882,2400,1411,4100,2293,6500
500215,202102,1388,3789,1009,3114,98,334,565,1733,663,2067
500220,202102,2711,7530,1778,5747,281,972,483,1484,764,2456
500230,202102,1975,4575,1507,3928,184,449,1013,2627,1197,3076
500240,202102,3908,11403,2767,9026,416,1481,1154,3846,1570,5327
500260,202102,3273,6898,2100,5329,279,720,1132,2746,1411,3466
500270,202102,134526,314168,82344,227349,12890,39248,31515,81206,44405,120454
500280,202102,1307,3276,894,2644,146,443,445,1314,591,1757
500290,202102,3548,8468,2117,5995,312,1037,696,1712,1008,2749
500295,202102,3509,8385,2231,6143,357,1106,885,2105,1242,3211
500310,202102,969,1998,662,1617,91,200,347,867,438,1067
500315,202102,3750,10199,2996,9082,238,734,2175,6724,2413,7458
500320,202102,19024,50761,13227,41243,3333,10800,4488,15033,7821,25833
500325,202102,4393,9760,3042,7971,249,664,2023,5366,2272,6030
500330,202102,6512,14705,4326,11595,353,1040,2319,6421,2672,7461
500345,202102,2042,4975,1375,3947,311,935,465,1318,776,2253
500348,202102,2343,6069,1765,5069,243,739,1007,2925,1250,3664
500350,202102,1300,3528,731,2294,84,259,297,896,381,1155
500370,202102,26503,67172,19034,55166,2333,7792,10276,29274,12609,37066
500375,202102,2387,6285,1594,4683,275,874,529,1440,804,2314
500380,202102,3289,8191,2286,6490,648,1997,460,1330,1108,3327
500390,202102,623,1298,377,993,51,161,231,581,282,742
500400,202102,1523,3838,1014,2864,170,532,352,899,522,1431
500410,202102,2364,5768,1665,4728,179,492,941,2795,1120,3287
500430,202102,2535,6220,1750,5051,234,791,751,2277,985,3068
500440,202102,1189,2872,754,2210,118,378,270,842,388,1220
500450,202102,1475,3588,849,2473,135,421,233,619,368,1040
500460,202102,3456,9268,2118,6643,341,1206,661,2027,1002,3233
500470,202102,2333,6253,1434,4414,394,1354,307,820,701,2174
500480,202102,2044,6248,1736,5776,165,565,1295,4367,1460,4932
500490,202102,1044,2384,621,1753,120,406,166,480,286,886
500500,202102,4150,10977,2669,8575,838,3141,336,1105,1174,4246
500510,202102,670,1683,447,1269,30,92,282,785,312,877
500515,202102,1658,4267,1279,3663,152,469,775,2124,927,2593
500520,202102,3214,9618,2520,8388,648,2133,1034,3774,1682,5907
500525,202102,917,2627,726,2347,61,217,473,1512,534,1729
500540,202102,4303,11154,2643,8278,665,2645,237,659,902,3304
500560,202102,5400,14569,4342,13255,302,908,3471,10816,3773,11724
500568,202102,4223,9223,2617,6878,661,1741,890,2431,1551,4172
500570,202102,7537,17400,4762,12797,810,2373,1873,4693,2683,7066
500580,202102,2998,7957,2194,6543,513,1577,973,2932,1486,4509
500600,202102,3368,8354,2427,6865,544,1588,992,2879,1536,4467
500620,202102,7853,20355,5348,15669,1037,3210,2078,5841,3115,9051
500625,202102,535,1461,350,1078,69,218,87,254,156,472
500627,202102,745,1930,468,1442,84,280,140,409,224,689
500630,202102,6858,15501,3932,10771,765,2282,1106,3001,1871,5283
500635,202102,2947,9099,2257,8203,162,616,1554,6230,1716,6846
500640,202102,1682,3654,1116,2908,37,111,764,1967,801,2078
500660,202102,17635,44565,12215,36853,3744,12891,3114,9655,6858,22546
500690,202102,2300,6290,1498,4924,494,1911,99,254,593,2165
500710,202102,2689,7153,2084,6151,568,1795,678,1869,1246,3664
500720,202102,4732,11825,3111,9142,713,2225,939,2856,1652,5081
500730,202102,1083,2663,593,1766,112,311,139,447,251,758
500740,202102,4526,10774,3097,8532,411,1180,1539,4173,1950,5353
500750,202102,964,2430,665,1915,83,211,252,679,335,890
500755,202102,897,2296,501,1556,90,302,106,304,196,606
500769,202102,5050,12303,2842,8181,529,1677,362,889,891,2566
500770,202102,1404,3783,935,2969,163,590,307,954,470,1544
500780,202102,1168,2813,760,2148,151,495,203,517,354,1012
500790,202102,6604,17681,5142,15235,1044,3340,2480,7382,3524,10722
500793,202102,2024,5144,1465,4184,347,1063,490,1287,837,2350
500795,202102,2703,6629,2169,5960,113,282,1720,4985,1833,5267
500797,202102,726,1826,463,1361,136,408,131,390,267,798
500800,202102,3268,7288,2009,5445,630,2024,210,625,840,2649
500830,202102,17760,44020,12304,34142,2521,7477,4417,11568,6938,19045
500840,202102,1352,3283,859,2362,116,325,338,870,454,1195
510010,202102,1771,3992,1196,3272,116,263,843,2346,959,2609
510020,202102,3677,9157,1919,5732,359,1172,446,1155,805,2327
510025,202102,6419,15405,3939,11488,570,1825,1702,4826,2272,6651
510030,202102,2624,5835,1754,4558,330,842,743,1905,1073,2747
510035,202102,1223,3175,781,2484,94,322,451,1528,545,1850
510040,202102,2359,5210,1748,4419,195,469,1077,2867,1272,3336
510050,202102,2093,4346,1403,3479,177,456,956,2346,1133,2802
510060,202102,1368,3409,863,2508,171,551,211,569,382,1120
510080,202102,1233,3211,805,2520,231,767,269,758,500,1525
510100,202102,654,1510,467,1218,58,151,259,651,317,802
510120,202102,270,488,147,342,11,24,107,252,118,276
510125,202102,1920,4764,1503,4169,144,526,826,2157,970,2683
510130,202102,1425,3555,992,2865,203,645,310,923,513,1568
510140,202102,3032,7667,2050,6442,719,2608,747,2284,1466,4892
510160,202102,1687,4333,1245,3766,162,472,894,2781,1056,3253
510170,202102,4321,11370,3207,9586,774,2410,1259,3877,2033,6287
510180,202102,14536,32282,9440,25008,1999,5809,2914,8693,4913,14502
510185,202102,1724,4420,1102,3536,439,1431,244,1054,683,2485
510190,202102,1981,5612,1261,4417,348,1342,220,862,568,2204
510250,202102,17078,42657,12661,36059,2454,7312,6080,18035,8534,25347
510260,202102,1811,7711,1508,7187,247,1284,937,4829,1184,6113
510263,202102,3084,8608,1903,6188,303,1091,349,1007,652,2098
510267,202102,4919,13864,2838,9274,490,1742,418,1213,908,2955
510268,202102,1199,2941,929,2537,101,259,621,1696,722,1955
510269,202102,991,2673,611,1952,140,488,188,573,328,1061
510270,202102,2977,8355,2045,6700,333,1253,844,2722,1177,3975
510279,202102,1716,4396,1043,3239,177,618,427,1254,604,1872
510285,202102,1108,2890,743,2267,233,794,166,458,399,1252
510300,202102,3590,9016,2652,7764,382,1135,1539,4766,1921,5901
510305,202102,1400,3854,874,2840,173,599,203,752,376,1351
510310,202102,858,2092,584,1645,169,490,168,493,337,983
510320,202102,3507,8613,2429,6821,527,1664,567,1560,1094,3224
510325,202102,4143,12129,3045,10109,851,2994,845,2904,1696,5898
510330,202102,2557,7698,1719,6227,315,1149,627,2685,942,3834
510335,202102,4858,13830,3675,11944,562,1938,2036,6784,2598,8722
510336,202102,438,1221,319,1040,50,161,166,603,216,764
510337,202102,1435,4110,916,3179,351,1345,186,655,537,2000
510340,202102,90793,201116,58906,155726,14137,43616,17520,44053,31657,87669
510343,202102,950,2607,659,2072,113,404,288,861,401,1265
510345,202102,1244,3529,941,2933,146,448,425,1297,571,1745
510350,202102,2779,7070,1858,5531,368,1191,792,2300,1160,3491
510360,202102,1960,3964,1228,3115,74,139,850,2343,924,2482
510370,202102,1672,4696,1247,4015,170,608,740,2498,910,3106
510380,202102,536,1320,314,949,48,168,131,394,179,562
510385,202102,1193,3976,893,3419,89,396,586,2323,675,2719
510390,202102,1253,3242,846,2737,249,823,271,1039,520,1862
510395,202102,715,1596,488,1262,26,72,308,846,334,918
510410,202102,4668,12776,3428,10641,650,2090,1754,5706,2404,7796
510420,202102,2495,5136,1679,4058,112,272,1120,2714,1232,2986
510450,202102,395,996,235,690,61,185,29,104,90,289
510452,202102,807,2233,596,1853,80,266,346,1041,426,1307
510454,202102,904,2472,709,2147,76,228,437,1392,513,1620
510455,202102,932,2528,675,2024,107,345,287,801,394,1146
510460,202102,1676,4159,1209,3477,89,304,781,2176,870,2480
510480,202102,4614,10981,3113,8311,567,1677,1209,3124,1776,4801
510490,202102,1655,4226,1236,3710,183,548,800,2425,983,2973
510500,202102,1506,3718,926,2799,183,585,306,942,489,1527
510510,202102,3427,9827,2502,8215,589,2205,808,2803,1397,5008
510515,202102,5062,12807,3360,9824,752,2487,939,2402,1691,4889
510517,202102,1019,2915,766,2483,231,836,145,424,376,1260
510520,202102,2133,4290,1203,3133,97,250,599,1678,696,1928
510523,202102,1130,2700,836,2258,170,449,489,1352,659,1801
510525,202102,7231,19583,5405,16068,806,2614,2579,7272,3385,9886
510530,202102,543,1391,398,1176,27,85,260,764,287,849
510550,202102,2210,6526,1615,5509,354,1272,745,2562,1099,3834
510558,202102,2313,6159,1697,5218,224,639,787,2670,1011,3309
510560,202102,1470,4192,904,3085,179,691,217,813,396,1504
510562,202102,5508,14050,4079,11571,966,2937,1365,4096,2331,7033
510590,202102,2994,7451,2206,6422,154,443,1604,4801,1758,5244
510600,202102,1279,2913,855,2309,150,410,395,1067,545,1477
510610,202102,2517,6045,1720,5027,174,570,1093,3197,1267,3767
510615,202102,2566,6325,1801,5118,281,844,994,2877,1275,3721
510617,202102,984,2953,765,2606,87,346,516,1799,603,2145
510618,202102,1178,3103,842,2548,190,630,378,1098,568,1728
510619,202102,750,1869,484,1427,63,180,136,379,199,559
510620,202102,1441,3241,677,2003,163,578,34,72,197,650
510621,202102,1533,4105,928,2931,196,692,295,858,491,1550
510622,202102,4581,12659,3142,9696,1000,3352,421,1200,1421,4552
510623,202102,2620,6498,1901,5367,475,1521,612,1692,1087,3213
510624,202102,1578,4008,775,2531,93,337,190,566,283,903
510625,202102,2880,6933,1548,4595,258,910,338,1003,596,1913
510626,202102,1414,3430,892,2609,230,778,199,598,429,1376
510627,202102,614,1566,340,1046,87,300,79,256,166,556
510628,202102,1395,3216,926,2600,177,530,351,974,528,1504
510629,202102,1551,4373,1134,3622,220,759,400,1280,620,2039
510630,202102,3346,9155,1982,6593,443,1578,363,1313,806,2891
510631,202102,572,1355,422,1131,13,30,321,886,334,916
510637,202102,3622,8520,2548,6957,649,1991,707,1944,1356,3935
510642,202102,5295,14945,4020,13036,924,3300,1807,5910,2731,9210
510645,202102,975,1857,591,1383,183,388,229,573,412,961
510650,202102,6997,17757,5543,16157,648,1688,3744,12182,4392,13870
510665,202102,1810,3897,1155,2870,247,579,414,1123,661,1702
510670,202102,428,911,246,651,26,68,134,361,160,429
510675,202102,6175,16842,4292,13389,1174,4049,853,2532,2027,6581
510677,202102,2108,5327,1453,4367,198,696,794,2332,992,3028
510680,202102,678,1719,386,1178,74,254,88,227,162,481
510682,202102,1432,4168,1050,3547,359,1359,251,813,610,2172
510685,202102,467,1354,341,1109,53,186,178,575,231,761
510700,202102,3980,9418,2782,7785,252,770,2086,5829,2338,6599
510704,202102,10503,24596,7040,18774,1625,4607,1733,4539,3358,9146
510706,202102,2027,5974,1414,4957,273,973,730,2780,1003,3753
510710,202102,2577,6384,1698,4740,368,1090,549,1473,917,2563
510715,202102,563,1212,409,1005,30,95,209,502,239,597
510718,202102,2325,5230,1375,3954,348,1001,524,1813,872,2814
510719,202102,449,949,264,706,25,69,152,386,177,455
510720,202102,805,1885,544,1490,89,276,262,679,351,955
510724,202102,801,2156,553,1680,73,236,302,877,375,1113
510726,202102,1028,1866,547,1292,66,172,258,615,324,787
510729,202102,586,1356,269,768,31,104,64,203,95,307
510730,202102,2889,6907,1967,5518,246,796,1024,2779,1270,3575
510735,202102,1051,2940,799,2593,75,294,598,1926,673,2220
510740,202102,935,2314,605,1703,107,306,283,781,390,1087
510757,202102,473,1498,374,1346,114,462,148,503,262,965
510760,202102,42909,93443,26010,68072,5282,15915,8211,19828,13493,35743
510770,202102,4165,9364,2845,7696,204,524,1971,5554,2175,6078
510774,202102,337,836,235,680,32,93,127,376,159,469
510775,202102,605,1592,383,1233,79,285,83,251,162,536
510776,202102,465,1151,321,903,71,200,121,344,192,544
510777,202102,1481,3938,1062,3403,147,522,694,2222,841,2744
510779,202102,684,1820,530,1580,53,153,306,990,359,1143
510780,202102,3618,9221,2684,7904,650,1873,1162,3882,1812,5755
510785,202102,1903,4940,1130,3579,303,1045,190,685,493,1730
510787,202102,2630,7412,1782,5691,521,1760,213,707,734,2467
510788,202102,580,1367,406,1101,63,176,191,597,254,773
510790,202102,17547,44534,11177,33213,2483,8202,1879,5034,4362,13236
510792,202102,8844,24234,5558,17876,1148,4156,888,2578,2036,6734
510794,202102,1132,3024,787,2441,256,863,150,414,406,1277
510795,202102,8132,21020,5386,16171,1195,3966,1469,4312,2664,8278
510800,202102,1606,4053,1057,3170,316,981,133,376,449,1357
510805,202102,1415,3929,1012,3203,226,778,361,1049,587,1827
510810,202102,588,1190,367,896,100,245,142,374,242,619
510820,202102,745,1404,413,994,32,96,209,512,241,608
510830,202102,800,1925,578,1646,38,102,429,1305,467,1407
510835,202102,532,1277,354,1025,42,139,216,607,258,746
510840,202102,56291,117759,38301,95955,7530,17711,18507,51343,26037,69054
510850,202102,1724,4114,1016,3013,317,1088,135,361,452,1449
510860,202102,2210,5783,1374,4386,414,1574,109,344,523,1918
510880,202102,720,2010,543,1678,136,441,189,585,325,1026
510885,202102,635,1496,416,1183,77,226,137,395,214,621
510890,202102,652,1881,488,1597,115,397,207,690,322,1087
510895,202102,1241,3132,811,2426,149,536,359,1005,508,1541
520005,202102,2675,6731,2061,5985,600,1751,828,2823,1428,4574
520010,202102,2303,6475,1671,5268,399,1397,540,1516,939,2913
520013,202102,2815,7085,1864,5366,440,1292,510,1626,950,2918
520015,202102,496,1229,359,1032,84,242,145,437,229,679
520017,202102,1179,2943,881,2494,198,588,433,1214,631,1802
520020,202102,416,918,322,807,24,74,257,627,281,701
520025,202102,32701,90687,28036,84242,2772,8994,20177,60416,22949,69410
520030,202102,5545,13901,4455,12401,299,906,3189,8839,3488,9745
520050,202102,390,919,243,665,17,45,154,436,171,481
520055,202102,1826,4332,1200,3153,144,318,658,1725,802,2043
520060,202102,1418,3762,1050,3114,241,837,291,830,532,1667
520080,202102,1760,4578,1342,4005,241,726,658,2145,899,2871
520082,202102,928,2317,718,1973,75,204,384,1100,459,1304
520085,202102,803,2104,624,1827,111,342,312,903,423,1245
520090,202102,817,1598,562,1322,67,110,422,1054,489,1164
520110,202102,36397,97075,25262,78763,7449,26611,2278,6483,9727,33094
520120,202102,193,462,110,325,11,34,43,131,54,165
520130,202102,3681,8880,2893,7676,587,1574,1248,3405,1835,4979
520140,202102,39039,102966,27046,82809,9422,31449,3443,11040,12865,42489
520145,202102,594,1323,409,1077,60,177,244,593,304,770
520150,202102,618,1420,454,1222,75,212,238,639,313,851
520160,202102,709,1639,513,1339,105,261,215,617,320,878
520170,202102,4729,9541,3139,7733,165,474,2429,5937,2594,6411
520180,202102,2283,6113,1869,5527,318,1016,1019,2979,1337,3995
520215,202102,1697,4063,1212,3328,288,832,407,1083,695,1915
520235,202102,611,1379,361,1002,34,111,157,419,191,530
520250,202102,1479,3723,1052,3024,320,984,252,811,572,1795
520260,202102,789,1816,516,1396,98,271,202,556,300,827
520280,202102,722,1733,570,1506,110,297,272,777,382,1074
520310,202102,997,2148,657,1650,140,396,255,677,395,1073
520320,202102,1555,4160,1165,3515,151,498,640,1876,791,2374
520330,202102,4062,10681,2984,8947,414,1467,1622,4755,2036,6222
520340,202102,2468,5395,1546,4130,182,459,899,2519,1081,2978
520350,202102,2703,6428,1948,5321,565,1629,776,2148,1341,3777
520355,202102,1847,5008,1327,4006,449,1449,231,593,680,2042
520357,202102,713,1690,512,1401,29,70,377,1075,406,1145
520360,202102,688,1785,532,1530,140,423,164,492,304,915
520380,202102,1380,3420,831,2419,84,255,415,1135,499,1390
520390,202102,1007,2187,593,1676,174,532,195,595,369,1127
520393,202102,477,1135,322,896,40,127,143,375,183,502
520396,202102,852,2156,712,1947,37,114,533,1429,570,1543
520400,202102,1581,3844,1225,3365,144,443,848,2311,992,2754
520410,202102,1855,4196,1144,3107,187,544,462,1194,649,1738
520420,202102,370,858,291,740,22,60,228,556,250,616
520425,202102,1430,3476,788,2268,202,614,154,443,356,1057
520430,202102,2262,5113,1296,3636,229,765,44,115,273,880
520440,202102,2811,6747,1703,4823,402,1256,439,1177,841,2433
520450,202102,11505,26918,7759,21432,2364,7209,1629,4691,3993,11900
520455,202102,679,1862,493,1577,138,466,135,458,273,924
520460,202102,1008,2324,786,2047,74,165,626,1666,700,1831
520465,202102,714,1814,577,1631,70,237,418,1137,488,1374
520470,202102,2007,5125,1525,4484,463,1434,569,1794,1032,3228
520480,202102,881,2391,616,1955,191,635,151,487,342,1122
520485,202102,1518,4321,1267,3984,150,480,907,2850,1057,3330
520490,202102,3905,10664,2941,9130,982,3185,1074,3446,2056,6631
520495,202102,1566,3422,1196,2924,54,138,971,2372,1025,2510
520500,202102,1146,3081,781,2376,181,592,323,979,504,1571
520505,202102,764,1670,527,1376,59,165,343,884,402,1049
520510,202102,7227,17796,4873,14248,1053,3462,1481,4580,2534,8042
520520,202102,1160,2872,867,2419,204,615,315,877,519,1492
520530,202102,2056,5703,1581,4926,386,1289,713,2276,1099,3565
520540,202102,2826,7310,1829,5411,325,1050,499,1372,824,2422
520545,202102,932,2399,707,2032,142,404,309,902,451,1306
520547,202102,786,2137,637,1892,149,453,315,928,464,1381
520549,202102,13667,35880,11423,32739,1460,4456,7834,22251,9294,26707
520551,202102,4513,11977,3756,10873,385,1280,2684,7620,3069,8900
520552,202102,807,2051,667,1873,142,381,379,1142,521,1523
520570,202102,492,1096,334,873,82,178,122,371,204,549
520580,202102,2152,4872,1634,4273,117,360,1199,3088,1316,3448
520590,202102,1231,3015,854,2411,278,787,223,655,501,1442
520620,202102,7742,20857,6141,18504,1487,4679,2815,8760,4302,13439
520630,202102,711,1835,519,1495,95,294,171,466,266,760
520640,202102,2335,5682,1778,4735,408,1075,768,2126,1176,3201
520650,202102,864,1965,646,1669,95,251,364,997,459,1248
520660,202102,518,1245,284,840,45,148,82,250,127,398
520670,202102,923,2476,780,2273,60,182,530,1523,590,1705
520680,202102,647,1646,497,1414,71,198,265,767,336,965
520690,202102,300,698,206,558,62,159,61,185,123,344
520710,202102,392,958,286,786,13,32,201,543,214,575
520725,202102,1441,3395,997,2680,110,341,633,1645,743,1986
520735,202102,741,1820,488,1400,101,271,192,593,293,864
520740,202102,2140,4735,1636,4159,304,690,920,2586,1224,3276
520750,202102,644,1535,444,1218,79,212,207,576,286,788
520753,202102,1201,3254,916,2721,167,530,362,995,529,1525
520760,202102,1196,2679,1053,2506,30,55,965,2332,995,2387
520780,202102,1422,3338,1043,2816,119,314,540,1456,659,1770
520790,202102,3388,8000,2413,6431,350,958,1273,3537,1623,4495
520800,202102,15955,41092,12522,36055,1788,5357,7518,22188,9306,27545
520810,202102,1269,2665,958,2312,158,389,615,1573,773,1962
520815,202102,530,1629,407,1376,75,273,119,405,194,678
520830,202102,1869,3893,1323,3272,56,110,1088,2691,1144,2801
520840,202102,2541,6759,2071,6152,850,2766,560,1778,1410,4544
520850,202102,624,1560,464,1330,146,487,134,387,280,874
520860,202102,6487,17242,4785,14503,1274,4187,1764,5224,3038,9411
520870,202102,105834,243563,71889,193417,15131,44061,26226,69365,41357,113426
520880,202102,6653,18967,5164,16321,1123,3712,1939,6170,3062,9882
520890,202102,3914,9277,2690,7377,492,1499,1225,3286,1717,4785
520910,202102,4588,11412,2954,8624,681,2159,711,2017,1392,4176
520915,202102,691,1931,403,1281,72,247,134,407,206,654
520920,202102,4385,9744,3106,8163,409,1105,1639,4533,2048,5638
520929,202102,671,1580,510,1347,52,112,293,823,345,935
520940,202102,903,2405,710,2133,40,109,528,1572,568,1681
520945,202102,494,1064,383,916,16,38,272,641,288,679
520960,202102,1069,2501,840,2167,230,538,395,1086,625,1624
520970,202102,2432,6584,1904,5745,448,1532,491,1611,939,3143
520980,202102,746,1811,546,1544,92,274,226,620,318,894
520990,202102,2977,7802,2384,7053,342,969,1587,4781,1929,5750
520993,202102,1129,2640,781,2107,129,390,423,1088,552,1478
520995,202102,2275,5722,1714,4947,253,737,696,2105,949,2842
521000,202102,8541,22161,5633,16906,1069,3319,1655,4910,2724,8229
521010,202102,3508,9065,2642,7577,249,715,1554,4422,1803,5137
521015,202102,773,1904,538,1487,40,130,338,887,378,1017
521020,202102,3164,7982,1866,5505,539,1802,128,398,667,2200
521030,202102,500,1087,337,839,72,156,137,372,209,528
521040,202102,7369,17924,5455,14944,1161,3315,2250,6350,3411,9665
521056,202102,899,2341,703,2055,224,640,197,649,421,1289
521060,202102,943,2515,699,2058,113,354,282,828,395,1182
521080,202102,1093,2340,567,1529,79,232,239,563,318,795
521090,202102,3123,8329,2106,6303,539,1748,259,811,798,2559
521100,202102,1652,3855,1217,3236,191,491,743,2017,934,2508
521120,202102,4467,10605,3307,9173,186,478,1633,5283,1819,5761
521130,202102,965,2132,548,1436,18,51,282,784,300,835
521140,202102,1269,3226,950,2683,96,292,502,1419,598,1711
521150,202102,12114,26320,7591,19920,1279,3849,3578,9643,4857,13492
521160,202102,611,1276,438,1030,62,128,283,657,345,785
521170,202102,998,2318,733,1932,53,149,481,1233,534,1382
521180,202102,7111,19395,5854,17264,935,3006,3068,8800,4003,11806
521190,202102,10609,26010,6262,18874,1545,5017,1276,4078,2821,9095
521200,202102,687,1645,487,1332,41,123,301,819,342,942
521205,202102,625,1535,473,1290,16,49,365,956,381,1005
521210,202102,643,1637,381,1127,68,215,78,182,146,397
521220,202102,3424,8274,2239,6462,361,1153,881,2562,1242,3715
521225,202102,380,797,277,683,52,120,156,399,208,519
521230,202102,1320,3321,1163,3131,349,933,583,1708,932,2641
521250,202102,30172,79336,23582,69776,8484,26106,6977,22280,15461,48386
521260,202102,526,1223,390,1006,59,153,226,568,285,721
521270,202102,1781,4433,1554,4169,77,178,1211,3274,1288,3452
521280,202102,1746,4640,1305,3904,309,1009,555,1674,864,2683
521290,202102,481,1107,337,928,43,138,215,576,258,714
521295,202102,1081,2357,840,2097,64,110,701,1806,765,1916
521300,202102,1881,4570,1484,4007,280,701,909,2560,1189,3261
521305,202102,707,1661,506,1372,78,194,285,790,363,984
521308,202102,4710,12460,3277,9790,293,867,1935,5678,2228,6545
521310,202102,8061,20469,5731,16620,1169,3719,2534,7043,3703,10762
521340,202102,395,917,290,766,23,62,193,505,216,567
521350,202102,1989,5007,1513,4305,127,450,1077,2926,1204,3376
521370,202102,1212,3058,729,2236,206,736,92,318,298,1054
521375,202102,1187,2865,807,2325,182,525,244,789,426,1314
521377,202102,1501,3159,1112,2689,106,176,883,2256,989,2432
521380,202102,6118,16026,3970,12127,445,1480,1023,3348,1468,4828
521385,202102,651,1557,510,1380,51,134,297,860,348,994
521390,202102,693,1683,485,1383,147,468,172,518,319,986
521400,202102,2558,5906,1995,5232,215,539,1376,3722,1591,4261
521405,202102,1294,3294,937,2670,158,470,477,1343,635,1813
521410,202102,776,2072,577,1727,93,268,288,916,381,1184
521440,202102,1105,2733,797,2280,269,854,215,630,484,1484
521450,202102,3883,11381,2851,9407,757,2481,673,2451,1430,4932
521460,202102,5416,14079,3807,11248,1224,3793,932,2833,2156,6626
521470,202102,595,1571,368,1128,54,152,121,375,175,527
521480,202102,349,876,213,622,45,131,68,194,113,325
521483,202102,2333,5487,1628,4436,326,947,689,1856,1015,2803
521486,202102,1753,4156,1324,3557,88,220,931,2512,1019,2732
521487,202102,398,946,280,787,40,108,153,445,193,553
521490,202102,888,2335,667,1977,36,135,460,1316,496,1451
521500,202102,2186,5228,1636,4413,99,322,1198,3147,1297,3469
521520,202102,703,1627,501,1338,73,200,204,558,277,758
521523,202102,11563,34742,9484,31476,2635,9551,2447,8477,5082,18028
521525,202102,1042,2353,797,2022,80,205,568,1443,648,1648
521530,202102,2197,5576,1345,3904,273,817,372,1081,645,1898
521540,202102,816,2034,564,1639,74,240,278,838,352,1078
521550,202102,1597,4033,887,2606,164,544,212,640,376,1184
521560,202102,4359,11291,2977,9438,441,1610,1503,5107,1944,6717
521565,202102,628,1488,480,1286,73,179,292,775,365,954
521570,202102,3156,8667,2173,6774,423,1561,177,590,600,2151
521580,202102,469,1118,270,786,36,111,85,227,121,338
521590,202102,613,1431,452,1211,77,226,266,695,343,921
521600,202102,365,976,236,724,28,69,110,341,138,410
521630,202102,1665,3595,1035,2701,214,602,348,881,562,1483
521640,202102,1838,4218,1211,3315,257,734,434,1176,691,1910
521645,202102,541,1388,347,1040,83,238,104,310,187,548
521680,202102,1059,3193,813,2721,232,845,134,497,366,1342
521690,202102,533,1271,445,1162,59,167,282,718,341,885
521710,202102,3162,7738,2056,5975,363,1207,559,1487,922,2694
521720,202102,2110,4840,1363,3726,133,411,765,2107,898,2518
521730,202102,3439,9426,2647,8095,697,2544,793,2021,1490,4565
521740,202102,3746,9655,2833,8349,645,2064,1065,3310,1710,5374
521760,202102,14439,38949,11142,33976,2683,9010,4165,13497,6848,22507
521770,202102,3036,7117,1982,5467,563,1680,513,1446,1076,3126
521800,202102,6403,16872,4660,14014,999,3052,1949,6366,2948,9418
521805,202102,438,1070,336,926,99,244,147,420,246,664
521810,202102,596,1399,424,1170,55,156,258,717,313,873
521830,202102,5439,14886,4318,13174,273,1005,3134,9378,3407,10383
521839,202102,717,1683,511,1355,79,245,285,672,364,917
521850,202102,5365,12358,3415,9532,611,1907,657,1785,1268,3692
521860,202102,1481,3916,1032,3119,185,607,332,966,517,1573
521870,202102,679,1888,494,1531,99,355,126,337,225,692
521878,202102,654,1672,455,1287,56,187,252,644,308,831
521880,202102,18069,43805,12364,35046,3197,9537,4276,12289,7473,21826
521890,202102,3002,7755,2010,6026,556,1818,399,1084,955,2902
521900,202102,1454,3370,815,2393,238,670,77,232,315,902
521910,202102,1237,2640,821,2152,74,194,461,1323,535,1517
521920,202102,477,1287,348,1070,59,207,155,454,214,661
521925,202102,749,1926,545,1621,80,257,308,918,388,1175
521930,202102,5328,12640,3526,9957,910,2439,1307,4165,2217,6604
521935,202102,1055,2483,713,1898,66,190,412,1043,478,1233
521940,202102,1278,2764,812,2144,189,560,329,853,518,1413
521945,202102,627,1639,504,1438,108,315,266,781,374,1096
521950,202102,731,1756,512,1417,125,350,206,556,331,906
521960,202102,719,1848,478,1395,47,153,253,695,300,848
521970,202102,2470,6043,1972,5453,161,434,1493,4185,1654,4619
521971,202102,733,1723,524,1411,152,402,149,409,301,811
521973,202102,1404,3591,1143,3238,46,121,917,2589,963,2710
521975,202102,11756,30823,9659,27928,1645,4857,5926,17273,7571,22130
521980,202102,2503,5824,1928,5066,147,388,1458,3914,1605,4302
521990,202102,1010,2870,807,2506,181,594,288,895,469,1489
522000,202102,2603,6782,2090,6155,349,1025,1247,3864,1596,4889
522005,202102,318,763,236,639,48,135,112,304,160,439
522010,202102,3975,9582,2839,7774,567,1709,1119,2977,1686,4686
522015,202102,1008,2594,740,2182,234,665,277,857,511,1522
522020,202102,5493,12850,3574,9842,741,2170,1367,3930,2108,6100
522026,202102,752,1979,506,1552,87,295,182,517,269,812
522028,202102,406,985,302,821,70,194,128,355,198,549
522040,202102,3039,6791,2175,5655,261,738,1484,3799,1745,4537
522045,202102,17049,46744,12677,39112,2955,9813,3529,10639,6484,20452
522050,202102,1088,2822,753,2253,188,618,271,714,459,1332
522060,202102,2934,7594,2058,6154,193,582,1180,3645,1373,4227
522068,202102,1728,4418,1375,4001,114,307,1083,3197,1197,3504
522070,202102,655,1560,533,1383,18,50,451,1154,469,1204
522100,202102,711,1797,485,1454,65,221,253,725,318,946
522108,202102,1043,2564,819,2247,57,182,660,1769,717,1951
522119,202102,1596,3819,1226,3342,200,554,615,1809,815,2363
522130,202102,411,1043,291,878,22,64,213,659,235,723
522140,202102,18966,48940,13293,38973,3291,10297,3666,10349,6957,20646
522145,202102,760,1873,517,1508,141,405,183,538,324,943
522150,202102,1063,2579,766,2097,198,548,223,650,421,1198
522155,202102,1077,2675,834,2300,158,375,468,1356,626,1731
522157,202102,592,1379,486,1245,25,78,390,1004,415,1082
522160,202102,5748,14719,3747,11087,1013,3234,306,1010,1319,4244
522170,202102,2536,6453,1916,5551,282,824,1094,3237,1376,4061
522180,202102,549,1271,349,910,57,157,85,236,142,393
522185,202102,19681,47911,13982,40112,5375,16912,2863,8910,8238,25822
522190,202102,743,1759,501,1347,91,250,203,531,294,781
522200,202102,1592,4470,1078,3524,214,762,212,650,426,1412
522205,202102,1705,3970,1290,3406,157,449,806,2124,963,2573
522220,202102,1269,3072,938,2582,114,318,563,1578,677,1896
522230,202102,1107,2767,879,2445,195,663,432,1116,627,1779
530010,202102,165048,438937,133283,393196,19541,63285,79961,232168,99502,295453
110001,202101,3910,10848,2622,8468,596,2081,1015,3335,1611,5416
110002,202101,12838,32984,9327,27086,2512,7765,2506,7429,5018,15194
110003,202101,574,1710,430,1407,112,384,115,362,227,746
110004,202101,11543,29642,7785,23085,1594,5167,2230,6735,3824,11902
110005,202101,2472,6345,1718,5134,348,1129,457,1488,805,2617
110006,202101,1728,4794,1077,3420,184,668,217,663,401,1331
110007,202101,1211,3080,775,2354,236,778,188,709,424,1487
110008,202101,3291,8963,2437,7693,275,838,1593,5403,1868,6241
110009,202101,4298,11928,2793,9217,575,2014,1115,3734,1690,5748
110010,202101,7844,24557,5756,20511,1120,4075,2822,10911,3942,14986
110011,202101,7016,18475,4740,14374,1569,5029,618,1995,2187,7024
110012,202101,15528,38614,9299,27756,2001,6607,784,2534,2785,9141
110013,202101,5229,15024,3663,11854,1426,4895,442,1604,1868,6499
110014,202101,3864,10072,2694,7876,565,1761,1145,3243,1710,5004
110015,202101,5661,14457,3412,10143,726,2378,818,2231,1544,4609
110018,202101,3736,9361,2161,6599,404,1434,571,1757,975,3191
110020,202101,73603,174861,53305,147384,11789,33756,21569,66165,33358,99921
110025,202101,5166,12396,3487,9550,680,1997,1553,4249,2233,6246
110026,202101,527,1314,383,1110,87,292,151,461,238,753
110028,202101,6776,17016,4104,12280,980,3220,615,1871,1595,5091
110029,202101,1511,3667,876,2549,189,567,308,944,497,1511
110030,202101,12473,28477,7682,21414,1552,5058,1331,4137,2883,9195
110032,202101,3167,8830,1908,6162,595,1919,364,1295,959,3214
110033,202101,3492,10739,2645,9219,941,3315,675,2645,1616,5960
110034,202101,3278,7643,2185,6146,661,2098,709,2181,1370,4279
110037,202101,1641,4798,1222,4057,268,869,592,2037,860,2906
110040,202101,2864,7912,2073,6474,576,1943,650,1989,1226,3932
110045,202101,4868,13891,3581,11539,918,3190,1210,4020,2128,7210
110050,202101,1818,4890,1284,3973,488,1678,202,637,690,2315
110060,202101,864,2557,594,1916,198,692,74,239,272,931
110070,202101,1497,4685,1101,3810,338,1245,223,708,561,1953
110080,202101,6309,14622,4750,12774,668,1673,3093,8895,3761,10568
110090,202101,580,1552,398,1229,87,293,175,535,262,828
110092,202101,1165,3356,831,2737,143,491,413,1471,556,1962
110094,202101,2729,8112,2044,6784,826,2947,251,859,1077,3806
110100,202101,1673,4925,1337,4268,360,1220,556,1811,916,3031
110110,202101,1725,4671,1230,3866,405,1321,261,933,666,2254
110120,202101,1297,3716,990,3119,234,817,337,1031,571,1848
110130,202101,2750,6861,1686,4872,218,688,303,800,521,1488
110140,202101,2038,5972,1400,4668,324,1137,402,1392,726,2529
110143,202101,1321,3617,933,2851,275,853,153,478,428,1331
110145,202101,859,2226,518,1594,114,366,192,610,306,976
110146,202101,460,1192,324,987,68,191,154,511,222,702
110147,202101,754,1957,482,1435,60,204,185,481,245,685
110148,202101,728,1994,434,1411,120,457,50,154,170,611
110149,202101,3017,8188,2075,6680,708,2417,435,1501,1143,3918
110150,202101,2785,6757,1808,5352,528,1716,433,1558,961,3274
110155,202101,720,2101,509,1600,111,376,171,507,282,883
110160,202101,1452,4481,1065,3618,309,1073,252,897,561,1970
110170,202101,2105,5379,1317,3911,233,734,683,1962,916,2696
110175,202101,1750,4924,1215,3904,188,632,507,1716,695,2348
110180,202101,1434,3895,1013,3047,133,437,534,1579,667,2016
120001,202101,3261,9556,2666,8678,439,1519,1664,5538,2103,7057
120005,202101,1963,7360,1789,7118,147,646,1441,5821,1588,6467
120010,202101,5348,15823,4528,14616,432,1334,3315,11069,3747,12403
120013,202101,2111,7378,1857,7074,399,1440,1184,4822,1583,6262
120017,202101,2512,7981,2202,7513,360,1239,1373,4980,1733,6219
120020,202101,15128,57527,13945,55269,1034,4601,11163,44517,12197,49118
120025,202101,3098,8693,2479,7959,362,1148,1720,5726,2082,6874
120030,202101,6325,25083,5871,24238,434,2235,4560,19013,4994,21248
120032,202101,1728,7575,1647,7431,104,651,1385,6134,1489,6785
120033,202101,4119,15096,3877,14661,109,642,3415,12746,3524,13388
120034,202101,2692,9688,2312,9036,104,615,1925,7410,2029,8025
120035,202101,3745,14576,3556,14251,287,1376,2928,11711,3215,13087
120038,202101,2643,8431,2240,7771,498,1784,1214,4305,1712,6089
120039,202101,2007,8638,1879,8391,113,717,1521,6740,1634,7457
120040,202101,43681,135948,37202,125573,5069,18099,23315,79897,28384,97996
120042,202101,3397,12369,3162,11946,131,693,2689,10064,2820,10757
120043,202101,1413,5746,1291,5556,37,225,1185,5105,1222,5330
120045,202101,6125,15666,5305,14750,125,502,4822,13255,4947,13757
120050,202101,9237,33424,8468,32261,374,1998,7129,27207,7503,29205
120060,202101,9488,36910,8686,35746,366,2247,7593,30974,7959,33221
120070,202101,3203,10115,2774,9544,259,885,2004,7140,2263,8025
120080,202101,4308,13595,3842,12908,450,1575,2841,9738,3291,11313
130002,202101,3176,12048,2843,11573,192,740,2438,10127,2630,10867
130006,202101,2476,9032,2060,8294,159,640,1583,6422,1742,7062
130008,202101,2703,9394,2405,8961,67,352,2098,7806,2165,8158
130010,202101,4000,11515,3375,10810,76,208,3091,10076,3167,10284
130014,202101,3259,9419,2520,8250,427,1408,1562,5239,1989,6647
130020,202101,2908,11086,2581,10578,128,748,2096,8518,2224,9266
130030,202101,10287,32775,9393,31744,375,1078,8338,28776,8713,29854
130040,202101,4204,12085,3471,11117,219,638,2844,9263,3063,9901
130050,202101,7577,27711,6339,26097,177,852,5729,23875,5906,24727
130060,202101,7669,29888,6576,28482,422,2220,5480,23728,5902,25948
130063,202101,6494,20919,5810,20171,197,836,5298,18496,5495,19332
130068,202101,3934,13370,3344,12544,201,1118,2545,9435,2746,10553
130070,202101,7591,21119,6226,19632,273,794,5157,16836,5430,17630
130080,202101,7346,25834,6457,24816,251,1309,5549,21683,5800,22992
130083,202101,2749,8910,2441,8530,143,568,2082,7329,2225,7897
130090,202101,3568,10950,3172,10466,50,218,2832,9536,2882,9754
130100,202101,8141,24200,6917,22926,73,143,6519,22180,6592,22323
130110,202101,8578,24290,7043,22404,1059,2704,5032,17393,6091,20097
130115,202101,5200,16203,4482,15409,99,346,3979,13884,4078,14230
130120,202101,14096,49627,12404,47394,1057,4433,10082,38965,11139,43398
130130,202101,5562,17116,4291,15456,380,1414,3263,11953,3643,13367
130140,202101,7350,25423,6451,24397,178,1034,5667,21527,5845,22561
130150,202101,3616,13564,3397,13321,70,442,3131,12310,3201,12752
130160,202101,5170,18259,4457,17360,279,1072,3778,15122,4057,16194
130165,202101,3213,12102,3026,11870,125,526,2731,10816,2856,11342
130170,202101,11784,33925,9538,31321,700,2473,7704,25835,8404,28308
130180,202101,4468,14367,4243,14115,44,223,4097,13599,4141,13822
130185,202101,18273,45057,14922,41492,975,1769,12533,37036,13508,38805
130190,202101,18815,61805,15146,56400,1677,6331,10760,41556,12437,47887
130195,202101,2490,8941,2008,8298,75,436,1695,6987,1770,7423
130200,202101,2627,7241,2152,6630,95,370,1810,5543,1905,5913
130210,202101,1358,5079,1230,4929,97,565,1008,3921,1105,4486
130220,202101,2258,7724,1923,7299,44,249,1717,6535,1761,6784
130230,202101,4840,19296,4216,18414,215,1327,3672,15981,3887,17308
130240,202101,12336,36758,10047,33745,172,1009,9057,30424,9229,31433
130250,202101,26392,78009,22652,73817,1611,4763,18323,62072,19934,66835
130255,202101,4570,14871,3994,13880,141,612,3268,11366,3409,11978
130260,202101,259905,714751,211642,646702,57343,185216,96364,307346,153707,492562
130270,202101,9915,34423,8236,31824,1385,5236,5277,21427,6662,26663
130280,202101,3591,14293,3307,13980,75,388,3104,13259,3179,13647
130290,202101,13382,43722,11621,41493,649,2365,9824,35890,10473,38255
130300,202101,4819,16417,4386,15833,141,777,3844,13831,3985,14608
130310,202101,6375,20990,5529,19907,278,1219,4736,17069,5014,18288
130320,202101,3375,10987,2804,10235,377,1323,2043,7760,2420,9083
130330,202101,4660,14836,3764,13758,207,918,3216,11774,3423,12692
130340,202101,24260,73288,20911,69507,1467,4027,17584,60529,19051,64556
130350,202101,4007,14360,3611,13866,148,773,3188,12191,3336,12964
130353,202101,7507,20085,6016,18218,765,2192,4315,13622,5080,15814
130356,202101,5250,16544,4358,15181,791,2650,2613,9742,3404,12392
130360,202101,2900,9618,2522,9096,86,381,2221,7961,2307,8342
130370,202101,5701,22615,4983,21591,315,1709,3988,17293,4303,19002
130380,202101,7366,30470,6852,29735,397,2184,5847,25204,6244,27388
130390,202101,5789,24376,5138,23301,552,2770,3910,17885,4462,20655
130395,202101,2340,7366,2023,6863,190,665,1573,5374,1763,6039
130400,202101,2846,8639,2443,8105,106,315,2187,7392,2293,7707
130406,202101,10918,37559,9126,35412,1727,6667,6047,24584,7774,31251
130410,202101,4327,15170,3703,14131,1073,4305,1686,6644,2759,10949
130420,202101,13888,47796,11570,44901,986,4585,8965,35168,9951,39753
130423,202101,4391,13580,3843,12961,191,805,3375,11314,3566,12119
130426,202101,2766,10991,2575,10768,61,339,2386,10050,2447,10389
130430,202101,4303,11977,3715,11203,236,849,3161,9422,3397,10271
130440,202101,4953,15287,4201,14390,76,342,3905,13449,3981,13791
140002,202101,2218,6501,1934,6160,88,339,1637,5293,1725,5632
140005,202101,3242,9036,2820,8549,135,357,2391,7495,2526,7852
140010,202101,54995,145595,44227,129816,10867,33740,18947,56975,29814,90715
140015,202101,3859,11361,3296,10679,227,710,2864,9463,3091,10173
140017,202101,4405,12140,3821,11398,251,664,3154,9718,3405,10382
140020,202101,5329,15302,4607,14369,238,952,3808,11800,4046,12752
140023,202101,2508,7424,2058,6779,203,667,1563,5290,1766,5957
140028,202101,2007,5162,1704,4784,80,255,1380,3878,1460,4133
140030,202101,5290,13403,4696,12721,330,638,4117,11528,4447,12166
140040,202101,2648,10133,2448,9871,86,528,2239,8894,2325,9422
140045,202101,2553,9447,2129,8863,334,1212,1421,6402,1755,7614
140047,202101,6312,17776,5310,16349,556,1748,3865,12078,4421,13826
140050,202101,1454,4221,1235,3912,117,342,935,3081,1052,3423
140060,202101,1691,4382,1467,4068,108,269,1201,3406,1309,3675
140070,202101,1872,9718,1812,9603,112,794,1536,8051,1648,8845
150010,202101,45128,112979,40824,107509,950,2188,36631,96533,37581,98721
150013,202101,1971,4988,1657,4657,146,273,1301,3913,1447,4186
150020,202101,14585,43348,13488,41943,1819,4708,10540,34288,12359,38996
150030,202101,8848,33099,8045,32114,477,1993,6968,28134,7445,30127
150034,202101,4221,10253,3477,9338,235,558,2890,7959,3125,8517
150040,202101,16331,42358,14393,40213,1297,1984,12033,36600,13330,38584
150050,202101,6967,24132,6372,23352,131,564,5859,21698,5990,22262
150060,202101,22140,59499,17824,53113,2768,8417,11426,34842,14194,43259
150070,202101,6858,25249,6024,24251,240,1098,5382,21899,5622,22997
150080,202101,91975,205084,76260,183726,19067,50379,20497,60928,39564,111307
150085,202101,7889,22467,7181,21631,110,360,6742,20460,6852,20820
150090,202101,9925,36144,9366,35064,837,2967,7401,28151,8238,31118
150095,202101,5712,16407,5001,15529,275,589,4272,13830,4547,14419
150100,202101,2819,9808,2494,9272,207,654,1974,7552,2181,8206
150110,202101,4417,17958,4104,17606,178,814,3785,16359,3963,17173
150120,202101,8210,25266,7790,24782,268,662,6952,22772,7220,23434
150125,202101,765,1995,569,1727,97,359,343,1024,440,1383
150130,202101,22301,63990,19307,59509,3555,9811,12141,40158,15696,49969
150140,202101,263127,597891,222181,542180,33276,78042,127807,324280,161083,402322
150145,202101,4253,13233,3593,12187,1004,3169,1754,6740,2758,9909
150150,202101,16182,41057,14114,38470,525,1598,11815,32120,12340,33718
150157,202101,3553,9566,2857,8676,308,903,2004,6381,2312,7284
150160,202101,2997,8752,2787,8455,518,1463,1756,5577,2274,7040
150170,202101,24475,79635,21468,74605,3951,12947,13044,48490,16995,61437
150172,202101,4970,13417,3989,12042,284,751,2984,9358,3268,10109
150175,202101,1637,5111,1389,4640,251,873,801,2722,1052,3595
150178,202101,10382,27848,8669,25870,196,459,7793,23616,7989,24075
150180,202101,22664,79202,20479,76723,1221,3659,17953,69208,19174,72867
150190,202101,6774,22240,6302,21671,214,936,5655,19367,5869,20303
150195,202101,5104,16167,4809,15713,106,490,4378,14167,4484,14657
150200,202101,5892,17151,5386,16594,63,171,5092,15803,5155,15974
150210,202101,26372,90527,24653,88303,1734,5966,20331,75420,22065,81386
150215,202101,7677,21618,6635,20109,1133,3360,3993,12612,5126,15972
150220,202101,12731,35269,11139,33019,1140,3146,7686,23399,8826,26545
150230,202101,12362,34973,10961,33115,1237,3389,7460,23573,8697,26962
150240,202101,32475,89008,27085,80048,7000,21244,9708,29024,16708,50268
150250,202101,4292,16074,3992,15741,589,2239,3120,12632,3709,14871
150260,202101,2775,8883,2504,8480,146,464,2023,6950,2169,7414
150270,202101,8946,25251,6300,20547,1967,6763,1526,5385,3493,12148
150275,202101,7011,22016,6397,21164,243,891,5519,18247,5762,19138
150276,202101,2378,6184,2059,5803,265,673,1367,4329,1632,5002
150277,202101,5210,13505,4173,12293,318,848,3162,9953,3480,10801
150280,202101,6983,27647,6738,27261,469,1851,5782,23653,6251,25504
150285,202101,3272,11428,2876,10812,268,994,2096,8074,2364,9068
150290,202101,10321,27911,9321,26848,286,581,8448,24951,8734,25532
150293,202101,9218,22646,7132,19933,892,2501,4468,13135,5360,15636
150295,202101,7445,20151,5483,17479,1794,6091,1890,6906,3684,12997
150300,202101,2363,7057,2138,6778,34,120,1966,6264,2000,6384
150304,202101,4075,11996,3358,10902,593,1800,2056,7068,2649,8868
150307,202101,6045,19434,5581,18667,315,1110,4549,15337,4864,16447
150309,202101,6314,18647,5081,16541,840,2703,2881,9816,3721,12519
150310,202101,7467,29272,7144,28890,214,1123,6401,26149,6615,27272
150320,202101,9225,25172,8428,24014,396,1215,6579,18720,6975,19935
150330,202101,13782,43964,12781,42425,1182,3597,9659,33180,10841,36777
150340,202101,2529,7361,2243,6935,339,982,1520,4897,1859,5879
150345,202101,8100,23632,7273,22543,419,1369,6169,19193,6588,20562
150350,202101,8947,22363,8278,21505,668,1251,6845,18329,7513,19580
150360,202101,24068,65460,19295,59472,2045,4866,13681,45278,15726,50144
150370,202101,10853,32540,8939,29973,1042,2923,6460,23462,7502,26385
150375,202101,3635,14533,3294,14055,222,1076,2821,12118,3043,13194
150380,202101,11249,28416,9268,25836,104,417,8225,22908,8329,23325
150390,202101,7828,31125,7032,29914,1069,3938,5046,22835,6115,26773
150400,202101,6648,23537,6380,23039,267,948,5617,20389,5884,21337
150405,202101,9178,24180,8015,22806,491,1127,6514,19161,7005,20288
150410,202101,1927,6022,1644,5544,244,719,1012,3544,1256,4263
150420,202101,39301,107533,30238,94365,8370,27359,10510,38378,18880,65737
150430,202101,8524,24578,7767,23606,942,2087,5993,19228,6935,21315
150440,202101,5749,18037,5215,17301,1043,3025,3255,11719,4298,14744
150442,202101,26118,61454,21522,55789,2250,5653,14944,39640,17194,45293
150445,202101,6233,19214,5493,18094,193,680,4709,15546,4902,16226
150450,202101,5140,21770,4741,21239,388,1900,3992,17978,4380,19878
150460,202101,8396,27376,7683,26471,237,882,6644,23698,6881,24580
150470,202101,21415,55553,19113,52939,333,954,18035,49957,18368,50911
150475,202101,4911,15275,4222,14254,166,592,3545,12126,3711,12718
150480,202101,13771,43731,12370,41683,2303,6759,8162,29643,10465,36402
150490,202101,8456,29061,7757,28198,313,1228,6814,24975,7127,26203
150495,202101,5274,17775,5042,17454,110,537,4596,15818,4706,16355
150497,202101,2786,8817,2242,7889,483,1737,1189,4493,1672,6230
150500,202101,3299,8358,2930,7850,270,659,2228,6009,2498,6668
150503,202101,4705,12020,3244,10131,948,3220,1041,3735,1989,6955
150506,202101,10198,29991,8527,27730,1822,5161,5285,19226,7107,24387
150510,202101,9855,35555,8570,33219,1380,4915,5455,22577,6835,27492
150520,202101,6879,27099,6587,26737,224,1364,5916,23921,6140,25285
150530,202101,12151,41432,10521,39163,1487,4468,7578,30180,9065,34648
150540,202101,4922,13374,4220,12330,244,670,3522,10336,3766,11006
150543,202101,7185,19216,5925,17650,469,1401,4590,14287,5059,15688
150548,202101,10145,31676,9130,30284,239,985,8127,27032,8366,28017
150549,202101,1988,5844,1702,5442,50,192,1433,4609,1483,4801
150550,202101,20578,59764,17136,54180,4294,13753,7229,24472,11523,38225
150553,202101,30600,86136,24145,74902,6949,21818,8746,28932,15695,50750
150555,202101,1973,5159,1538,4469,175,391,1035,3205,1210,3596
150560,202101,1868,5599,1667,5211,293,865,955,3136,1248,4001
150563,202101,2574,7631,2152,6920,422,1415,1209,3946,1631,5361
150565,202101,4415,13939,3932,13194,97,422,3298,11171,3395,11593
150570,202101,6204,19624,5790,19059,267,970,5051,16618,5318,17588
150580,202101,10478,40805,8975,39137,621,3126,7228,32827,7849,35953
150590,202101,8254,28104,7072,26692,163,948,6473,24365,6636,25313
150600,202101,9723,31911,9063,31127,212,814,8422,29096,8634,29910
150610,202101,2925,8426,2619,7954,79,317,2239,6729,2318,7046
150611,202101,3247,8899,2891,8416,86,305,2564,7426,2650,7731
150613,202101,13620,36920,10325,31369,1836,5948,5184,15689,7020,21637
150616,202101,3528,9547,2581,7985,599,1930,1102,3395,1701,5325
150618,202101,6815,19604,5520,17637,475,1500,3571,12066,4046,13566
150619,202101,6578,18064,5447,16505,204,592,4615,14179,4819,14771
150620,202101,6836,22430,5898,20877,686,2314,3959,14485,4645,16799
150630,202101,6256,16739,5728,16100,354,944,4865,13765,5219,14709
150635,202101,4812,13103,4036,11876,559,1515,2604,7942,3163,9457
150640,202101,2274,6650,2081,6410,40,110,1934,6031,1974,6141
150650,202101,11261,31059,9795,28760,2854,7916,4300,13870,7154,21786
150655,202101,5742,16391,5203,15608,195,604,4517,13555,4712,14159
150658,202101,4487,12591,3492,11065,546,1814,2031,6806,2577,8620
150660,202101,5706,16217,5064,15337,473,1369,3541,11001,4014,12370
150670,202101,8227,18893,6469,16930,674,1377,5061,14079,5735,15456
150680,202101,68790,199652,53260,175315,12721,40879,23542,88165,36263,129044
150690,202101,2753,6800,2367,6357,72,163,2118,5805,2190,5968
150700,202101,6123,17940,5468,17100,352,846,4360,14065,4712,14911
150710,202101,3797,12539,3455,11997,302,1012,2601,9236,2903,10248
150715,202101,4914,14048,4018,12696,302,904,3148,10148,3450,11052
150720,202101,6915,24181,6446,23490,443,1680,5351,19811,5794,21491
150730,202101,12097,36239,10396,33826,1191,3976,7711,25828,8902,29804
150740,202101,4031,11036,3543,10272,318,762,2665,7938,2983,8700
150745,202101,4983,14013,4005,12598,792,2617,2539,8116,3331,10733
150746,202101,1651,4992,1500,4785,74,240,1228,3925,1302,4165
150747,202101,4953,15411,4387,14512,702,1994,2978,10423,3680,12417
150750,202101,3665,11373,3075,10482,231,832,2311,8175,2542,9007
150760,202101,11712,34519,10641,33051,1434,4062,7547,24240,8981,28302
150770,202101,6559,23012,6179,22590,189,540,5632,21237,5821,21777
150775,202101,937,2570,731,2300,129,439,401,1280,530,1719
150780,202101,4482,13509,3975,12911,157,428,3561,11897,3718,12325
150790,202101,5782,16077,4989,15223,246,607,3816,13192,4062,13799
150795,202101,14122,42997,12307,40241,3007,9269,6911,24238,9918,33507
150796,202101,3891,9346,3398,8787,221,488,2856,7552,3077,8040
150797,202101,4086,12298,3547,11570,142,346,3042,10149,3184,10495
150800,202101,13232,41206,11924,39484,1445,4460,8945,30723,10390,35183
150803,202101,7185,22511,6721,21793,411,1130,5679,18721,6090,19851
150805,202101,3484,10564,2958,9811,231,730,2284,7765,2515,8495
150808,202101,5835,16466,4284,13942,1672,6014,599,2261,2271,8275
150810,202101,20790,54023,15851,48106,3367,10438,7902,26801,11269,37239
150812,202101,5436,14971,4789,13926,417,1280,3553,10145,3970,11425
150815,202101,9649,27876,8049,26004,634,2001,6658,21898,7292,23899
150820,202101,11721,32131,9912,29894,1067,2748,7532,23842,8599,26590
150830,202101,11940,42866,11033,41769,459,1781,9480,37203,9939,38984
150835,202101,2312,7565,1966,6991,329,1143,1136,4121,1465,5264
150840,202101,7549,20975,6077,18665,975,3243,3454,10540,4429,13783
160005,202101,1228,3329,1088,3155,67,223,915,2673,982,2896
160010,202101,2422,6361,2253,6177,18,102,2188,5924,2206,6026
160015,202101,2807,8057,2487,7670,68,229,2293,7098,2361,7327
160020,202101,2087,6587,1824,6265,156,500,1422,5099,1578,5599
160021,202101,1194,4377,1105,4263,53,287,889,3460,942,3747
160023,202101,1290,4514,1142,4264,125,425,788,3143,913,3568
160025,202101,1852,5569,1753,5457,12,38,1703,5317,1715,5355
160027,202101,8911,24722,7961,23508,635,1779,6411,19330,7046,21109
160030,202101,73875,208175,60463,190105,12780,37772,32233,111989,45013,149761
160040,202101,5898,19526,5381,18877,68,303,5064,17868,5132,18171
160050,202101,4715,14087,3696,12719,1389,4580,1273,5562,2662,10142
160053,202101,3847,11701,3472,11233,285,780,2798,9447,3083,10227
160055,202101,914,2634,880,2596,28,93,818,2411,846,2504
160060,202101,25061,65303,20336,59986,933,2849,16101,50006,17034,52855
160070,202101,2639,10023,2363,9598,191,758,1868,7857,2059,8615
160080,202101,3353,10543,2980,10126,27,139,2796,9572,2823,9711
170025,202101,597,1559,437,1319,65,194,229,724,294,918
170030,202101,1237,3719,955,3234,150,503,458,1607,608,2110
170035,202101,1458,3769,1085,3183,86,272,685,2004,771,2276
170040,202101,1891,5258,1502,4706,107,376,944,3049,1051,3425
170070,202101,1888,4384,1349,3697,85,264,798,2285,883,2549
170100,202101,2427,6907,2030,6254,212,586,1276,4079,1488,4665
170105,202101,728,2105,507,1636,137,397,162,550,299,947
170110,202101,964,2878,741,2466,115,392,365,1196,480,1588
170130,202101,1280,3806,925,3133,183,658,437,1523,620,2181
170190,202101,1391,3870,1014,3266,365,1270,151,623,516,1893
170200,202101,2053,4835,1344,3679,197,559,570,1571,767,2130
170210,202101,24241,65533,18557,56170,6144,20357,2606,8726,8750,29083
170215,202101,1322,3518,1057,3149,39,161,834,2473,873,2634
170220,202101,5843,17932,4901,16245,1357,4317,1875,6955,3232,11272
170230,202101,1205,3575,902,2993,259,874,149,555,408,1429
170240,202101,2533,7082,2001,6222,127,466,1444,4400,1571,4866
170255,202101,3909,11258,2819,9314,498,1685,1281,4341,1779,6026
170270,202101,931,2257,628,1824,36,97,374,1081,410,1178
170290,202101,2823,8338,2447,7840,121,391,1914,6309,2035,6700
170300,202101,1998,5328,1626,4775,197,555,1080,3252,1277,3807
170305,202101,625,1694,524,1528,70,229,260,754,330,983
170307,202101,959,3207,784,2872,106,412,434,1603,540,2015
170310,202101,1553,3848,1095,3128,166,520,510,1468,676,1988
170320,202101,1008,2614,759,2220,61,184,485,1449,546,1633
170330,202101,902,2758,820,2638,40,181,684,2140,724,2321
170360,202101,522,1400,364,1145,21,73,238,714,259,787
170370,202101,1251,3353,907,2772,279,798,232,843,511,1641
170380,202101,1762,5064,1331,4403,95,365,776,2628,871,2993
170382,202101,534,1560,445,1414,29,118,332,1019,361,1137
170384,202101,1543,5456,1267,4934,253,1032,650,2592,903,3624
170386,202101,976,2627,613,1933,79,276,216,658,295,934
170388,202101,603,1718,426,1408,56,199,198,663,254,862
170389,202101,1031,3162,851,2872,44,178,620,2139,664,2317
170390,202101,1741,3936,1312,3423,36,88,1087,2909,1123,2997
170410,202101,571,1644,418,1365,30,117,248,778,278,895
170460,202101,341,908,283,818,37,100,187,556,224,656
170510,202101,906,2560,687,2163,44,173,445,1333,489,1506
170550,202101,6379,16973,4713,14302,1215,3960,1066,3526,2281,7486
170555,202101,1407,3755,1108,3293,79,237,543,1695,622,1932
170560,202101,1024,2829,781,2496,67,206,495,1693,562,1899
170600,202101,1233,3344,999,3015,222,538,542,1803,764,2341
170610,202101,1586,4182,1145,3528,84,285,711,2167,795,2452
170625,202101,413,1124,263,827,43,131,84,256,127,387
170650,202101,1205,3561,956,3152,124,428,554,1888,678,2316
170700,202101,3293,9745,2509,8224,501,1648,1115,3736,1616,5384
170710,202101,1442,3782,1127,3296,151,473,697,2059,848,2532
170720,202101,1707,4317,1290,3637,334,1004,527,1514,861,2518
170730,202101,1060,2839,795,2404,141,373,404,1310,545,1683
170740,202101,2083,6783,1797,6261,172,661,1273,4429,1445,5090
170755,202101,877,2405,621,1974,68,217,302,957,370,1174
170765,202101,1117,2894,788,2367,149,442,342,1077,491,1519
170770,202101,1835,5282,1492,4748,170,525,977,3210,1147,3735
170820,202101,3281,9838,2581,8564,542,1842,1156,3981,1698,5823
170825,202101,990,2283,805,2035,95,214,579,1485,674,1699
170830,202101,1399,3707,1148,3319,151,408,768,2292,919,2700
170900,202101,2748,8476,2311,7853,210,644,1806,6280,2016,6924
170930,202101,3652,10054,2799,8459,653,2094,890,2709,1543,4803
170950,202101,10989,30253,7676,24307,2077,7542,850,2973,2927,10515
170980,202101,452,1189,359,1042,27,92,239,668,266,760
171050,202101,1624,5043,1422,4701,51,222,1184,3886,1235,4108
171070,202101,1343,3800,1151,3518,306,904,498,1804,804,2708
171090,202101,1049,2586,832,2280,81,231,546,1465,627,1696
171110,202101,562,1502,392,1190,61,183,183,514,244,697
171150,202101,1053,2606,661,1950,58,198,410,1198,468,1396
171180,202101,771,2087,521,1625,96,272,216,682,312,954
171190,202101,1805,5944,1572,5549,248,921,956,3510,1204,4431
171195,202101,775,2466,627,2187,83,337,378,1308,461,1645
171200,202101,578,1590,440,1359,98,320,154,473,252,793
171215,202101,365,1009,301,901,30,102,206,596,236,698
171240,202101,762,2483,611,2194,32,180,411,1442,443,1622
171245,202101,667,1958,522,1664,49,169,329,1008,378,1177
171250,202101,999,2644,734,2253,128,408,340,1071,468,1479
171270,202101,475,1661,377,1453,80,307,163,693,243,1000
171280,202101,858,2568,683,2249,64,228,402,1373,466,1601
171320,202101,3956,10996,3055,9428,627,1891,1113,3656,1740,5547
171330,202101,2758,7555,2135,6454,470,1401,920,2912,1390,4313
171360,202101,1370,3964,1094,3560,80,270,788,2642,868,2912
171370,202101,690,1736,526,1509,46,123,356,1036,402,1159
171380,202101,1437,3857,1213,3549,141,393,845,2567,986,2960
171395,202101,967,2643,678,2111,60,223,423,1278,483,1501
171420,202101,1970,5722,1423,4638,249,855,627,2056,876,2911
171430,202101,1016,2971,852,2665,56,180,591,1794,647,1974
171488,202101,2315,6836,1839,6046,275,887,945,3269,1220,4156
171500,202101,973,2389,742,2042,49,133,557,1554,606,1687
171510,202101,809,2629,701,2424,44,197,495,1686,539,1883
171515,202101,464,1176,351,1013,33,94,215,586,248,680
171525,202101,708,1982,534,1707,30,111,309,960,339,1071
171550,202101,343,990,263,862,37,137,138,441,175,578
171570,202101,1117,3361,943,3055,124,405,554,1852,678,2257
171575,202101,1771,4746,1156,3645,121,400,513,1629,634,2029
171610,202101,5609,15551,4224,13206,867,3052,1135,3851,2002,6903
171620,202101,2522,7228,2144,6680,102,417,1743,5419,1845,5836
171630,202101,977,2526,772,2247,101,298,528,1589,629,1887
171650,202101,1981,5607,1530,4848,383,1327,453,1587,836,2914
171660,202101,2335,5854,1621,4676,226,579,845,2488,1071,3067
171665,202101,1234,3456,968,3019,177,625,445,1392,622,2017
171670,202101,1894,5006,1459,4291,205,653,779,2319,984,2972
171700,202101,1195,3362,876,2787,106,333,474,1534,580,1867
171720,202101,794,2009,630,1757,49,147,465,1282,514,1429
171750,202101,1308,3631,906,2884,222,736,115,459,337,1195
171780,202101,1189,3048,877,2593,91,292,586,1706,677,1998
171790,202101,1401,4496,1162,4009,191,673,570,1991,761,2664
171800,202101,699,1918,532,1673,61,237,302,927,363,1164
171820,202101,11174,31180,8373,26393,1998,6580,2384,8213,4382,14793
171830,202101,1544,4889,1320,4498,131,511,845,2887,976,3398
171840,202101,752,2001,580,1733,21,61,382,1135,403,1196
171845,202101,639,1553,492,1344,50,172,315,825,365,997
171850,202101,897,2954,770,2667,72,320,538,1814,610,2134
171855,202101,1024,3112,875,2842,65,219,555,1781,620,2000
171865,202101,357,1114,297,1014,49,180,151,495,200,675
171870,202101,825,2245,585,1814,73,218,295,932,368,1150
171875,202101,1281,3676,1030,3275,37,157,775,2470,812,2627
171880,202101,1180,3499,1037,3312,43,132,818,2673,861,2805
171884,202101,848,2418,635,2053,123,454,232,773,355,1227
171886,202101,1324,3614,953,3029,274,996,193,627,467,1623
171888,202101,724,2009,505,1610,28,101,310,972,338,1073
171889,202101,369,1143,296,998,60,222,120,399,180,621
171890,202101,1167,3256,842,2731,172,521,466,1572,638,2093
171900,202101,535,1845,399,1510,81,300,162,642,243,942
172000,202101,567,1676,476,1515,54,171,269,828,323,999
172010,202101,957,3303,820,3033,67,281,505,1864,572,2145
172015,202101,373,1274,283,1095,70,275,106,437,176,712
172020,202101,2683,7546,2365,7131,173,555,1735,5459,1908,6014
172025,202101,699,1916,520,1626,38,142,380,1183,418,1325
172030,202101,1213,3569,1036,3290,54,208,807,2560,861,2768
172049,202101,1295,3093,869,2509,185,493,430,1372,615,1865
172065,202101,1417,3573,1122,3204,97,214,889,2726,986,2940
172080,202101,2352,6902,1907,6127,111,383,1274,4083,1385,4466
172085,202101,467,1267,305,923,55,165,103,296,158,461
172090,202101,4017,9958,3136,8795,133,379,2384,6777,2517,7156
172093,202101,460,1366,334,1139,17,88,200,645,217,733
172097,202101,676,1764,476,1425,62,192,210,636,272,828
172100,202101,48077,117987,34567,97114,5828,18095,12640,36419,18468,54514
172110,202101,1570,5729,1357,5398,130,544,1001,4151,1131,4695
172120,202101,4928,14455,3868,12730,484,1679,2195,7450,2679,9129
172125,202101,370,989,284,847,22,75,173,488,195,563
172130,202101,617,1501,488,1298,24,86,342,829,366,915
172208,202101,2570,6211,2068,5560,199,425,1497,4165,1696,4590
172210,202101,2644,6681,2027,5895,322,1010,1163,3542,1485,4552
210005,202101,18563,52825,14046,45370,4043,13596,5315,18021,9358,31617
210010,202101,1922,5885,1740,5666,71,299,1520,4961,1591,5260
210015,202101,3278,9793,2915,9318,155,495,2409,7721,2564,8216
210020,202101,7288,17180,6215,15937,97,317,5688,14595,5785,14912
210030,202101,4617,15267,4259,14728,259,1037,3588,12457,3847,13494
210040,202101,1801,4289,1593,4038,32,86,1362,3377,1394,3463
210043,202101,5970,17289,5135,16120,410,1237,3994,12760,4404,13997
210047,202101,6393,19939,5233,18400,133,697,4520,15895,4653,16592
210050,202101,2180,7330,1738,6516,159,668,1205,4523,1364,5191
210055,202101,1877,6016,1706,5752,64,237,1453,4926,1517,5163
210060,202101,7242,26315,6456,24950,646,2579,4492,17832,5138,20411
210070,202101,7009,19966,6570,19395,45,207,6204,18254,6249,18461
210080,202101,4334,14331,4121,14104,45,264,3797,13075,3842,13339
210083,202101,5475,15730,4560,14757,34,161,4339,14097,4373,14258
210087,202101,2963,8083,2535,7511,91,277,2151,6427,2242,6704
210090,202101,9111,28432,8519,27406,490,1263,7246,23595,7736,24858
210095,202101,6408,20460,5850,19752,246,1035,4887,16836,5133,17871
210100,202101,6719,20414,5995,19252,409,1420,4621,14922,5030,16342
210110,202101,2885,9268,2663,9007,55,323,2398,8062,2453,8385
210120,202101,22624,61410,18718,56347,1880,4545,12632,40741,14512,45286
210125,202101,4391,11739,3818,11067,747,1724,2651,8249,3398,9973
210130,202101,4301,11174,3567,10261,158,333,3009,8785,3167,9118
210135,202101,1428,4267,1237,3960,61,172,1000,3293,1061,3465
210140,202101,19041,49394,14660,43770,2890,8131,8048,25709,10938,33840
210150,202101,4313,10441,3861,9821,141,391,3277,8203,3418,8594
210160,202101,16297,47217,14034,44394,1171,3953,9961,32764,11132,36717
210170,202101,15152,46584,14097,45247,788,2142,12335,40128,13123,42270
210173,202101,2248,8650,2112,8415,110,615,1789,7100,1899,7715
210177,202101,3459,9462,3011,8914,174,389,2568,7911,2742,8300
210180,202101,1435,3802,1256,3590,25,62,1145,3291,1170,3353
210190,202101,5366,14265,4556,13195,78,323,3925,11255,4003,11578
210193,202101,1317,3817,1159,3567,31,135,864,2702,895,2837
210197,202101,2099,6445,1942,6234,151,474,1579,5164,1730,5638
210200,202101,7620,24362,6758,22933,396,1508,5342,18086,5738,19594
210203,202101,6951,20483,5928,19108,397,1350,4711,15492,5108,16842
210207,202101,3935,9470,3001,8478,157,326,2503,7291,2660,7617
210210,202101,7947,25705,7256,24726,167,956,6210,20948,6377,21904
210215,202101,2481,7755,2120,7216,119,608,1575,5285,1694,5893
210220,202101,6082,20959,5778,20513,178,1159,5061,17603,5239,18762
210230,202101,5049,15304,4603,14638,441,1118,3783,12418,4224,13536
210232,202101,10953,34399,9019,31444,1621,5551,5505,20576,7126,26127
210235,202101,3298,10004,2922,9484,165,660,2452,7957,2617,8617
210237,202101,2763,8942,2377,8494,31,185,2198,7851,2229,8036
210240,202101,2572,8038,2371,7688,72,250,1962,6253,2034,6503
210250,202101,5613,17016,5102,16368,74,430,4622,14767,4696,15197
210255,202101,2463,7558,2094,6921,288,984,1325,4380,1613,5364
210260,202101,5456,16192,4823,15281,256,964,4037,12693,4293,13657
210270,202101,4874,13353,4365,12737,91,418,3913,11316,4004,11734
210275,202101,3427,8699,3007,8177,73,196,2497,6786,2570,6982
210280,202101,5585,15774,4496,14107,262,994,3330,10302,3592,11296
210290,202101,7264,19235,6505,18289,100,325,6084,17083,6184,17408
210300,202101,32223,87729,26342,79304,1916,6083,18615,58114,20531,64197
210310,202101,3052,7785,2712,7294,134,291,2350,6390,2484,6681
210312,202101,2645,6756,2342,6432,31,137,2201,5980,2232,6117
210315,202101,2956,8204,2550,7751,75,223,2258,7003,2333,7226
210317,202101,4085,12809,3698,12353,136,673,3283,10880,3419,11553
210320,202101,18962,56757,17343,54632,376,1737,15417,48378,15793,50115
210325,202101,3652,10247,3141,9585,110,318,2715,8511,2825,8829
210330,202101,23922,67266,19151,61198,5739,16485,9099,33848,14838,50333
210340,202101,9957,29216,8865,27760,715,2183,6762,21827,7477,24010
210350,202101,8969,25918,7926,24662,143,495,7090,22189,7233,22684
210355,202101,4246,13971,3761,13216,98,474,3203,11313,3301,11787
210360,202101,13659,42387,12186,40254,599,2742,9219,29904,9818,32646
210370,202101,10875,24368,8442,21811,244,409,7729,20450,7973,20859
210375,202101,3166,8442,2432,7442,664,2104,997,3391,1661,5495
210380,202101,5350,13717,4639,12896,189,465,3990,11191,4179,11656
210390,202101,2533,8905,2348,8588,126,584,1973,7192,2099,7776
210400,202101,4466,13521,3974,12939,129,394,3556,11778,3685,12172
210405,202101,6724,18108,5448,16313,1036,2880,3060,9828,4096,12708
210407,202101,1952,6414,1666,5909,78,338,1341,4708,1419,5046
210408,202101,2559,9396,2398,9160,148,688,1901,7308,2049,7996
210409,202101,3765,12922,3447,12488,108,577,2866,10466,2974,11043
210410,202101,3375,10232,2877,9409,157,612,2194,7127,2351,7739
210420,202101,3771,12006,3423,11397,192,593,2885,9719,3077,10312
210430,202101,2222,6487,1973,6167,85,238,1681,5336,1766,5574
210440,202101,4327,11620,3765,10916,76,267,3418,9835,3494,10102
210450,202101,2355,7012,2029,6543,79,286,1685,5404,1764,5690
210455,202101,4364,11367,3320,10051,942,2888,1500,4843,2442,7731
210460,202101,3671,10433,3115,9716,60,258,2727,8463,2787,8721
210462,202101,1640,4949,1407,4573,39,155,1143,3757,1182,3912
210465,202101,2700,7796,2354,7318,85,369,1861,5652,1946,6021
210467,202101,5814,18440,5087,17495,296,1110,4194,14663,4490,15773
210470,202101,1958,5228,1453,4507,102,229,1100,3579,1202,3808
210480,202101,16009,47067,13284,43714,1121,3348,9753,34687,10874,38035
210490,202101,3616,9161,2943,8236,92,267,2479,6931,2571,7198
210500,202101,6396,24090,5880,23217,393,1852,4798,18855,5191,20707
210510,202101,5868,19402,5139,18625,117,516,4634,17056,4751,17572
210515,202101,3706,10874,3226,10329,256,927,2553,8325,2809,9252
210520,202101,2500,7198,2243,6860,69,250,1911,5793,1980,6043
210530,202101,50214,123815,38837,107093,6842,22581,10961,37483,17803,60064
210535,202101,3054,10300,2867,10009,154,571,2377,8362,2531,8933
210540,202101,14572,41766,12098,38307,1498,4357,8342,27815,9840,32172
210542,202101,6492,14938,5205,13539,351,596,4228,11779,4579,12375
210545,202101,2190,6778,2067,6579,45,184,1835,5784,1880,5968
210547,202101,3518,12518,3133,11789,287,1046,2387,9177,2674,10223
210550,202101,6019,18067,4780,16134,348,1326,3390,11761,3738,13087
210560,202101,3549,10696,3178,10107,121,373,2681,8475,2802,8848
210565,202101,1463,4752,1222,4405,72,377,922,3331,994,3708
210570,202101,10325,27971,9191,26591,334,911,7907,23405,8241,24316
210580,202101,2958,7877,2383,7116,123,276,1664,5170,1787,5446
210590,202101,4175,12449,3622,11750,66,371,3232,10404,3298,10775
210592,202101,2610,7659,2391,7304,22,106,2035,6135,2057,6241
210594,202101,2451,6609,1879,5727,89,269,1377,4363,1466,4632
210596,202101,2523,8868,2289,8415,105,431,1892,6978,1997,7409
210598,202101,1798,5231,1662,5026,60,243,1451,4322,1511,4565
210600,202101,2992,7940,2464,7200,112,282,1895,5596,2007,5878
210610,202101,2701,7475,2324,7026,62,270,1989,6014,2051,6284
210620,202101,2783,7341,2315,6779,55,170,2076,6093,2131,6263
210630,202101,2962,9930,2708,9511,123,587,2231,7741,2354,8328
210632,202101,4372,13948,3896,13261,223,934,3080,10426,3303,11360
210635,202101,1709,6102,1622,5954,95,344,1340,5015,1435,5359
210637,202101,2409,7964,2100,7532,157,685,1543,5603,1700,6288
210640,202101,4483,16020,4211,15702,68,338,3828,14321,3896,14659
210650,202101,7402,21050,6735,20201,103,366,6058,18185,6161,18551
210660,202101,7897,23559,7079,22244,276,1134,5978,18477,6254,19611
210663,202101,2541,7360,2334,7121,148,348,1971,6227,2119,6575
210667,202101,1937,6283,1745,5996,57,238,1551,5383,1608,5621
210670,202101,4502,14991,4111,14376,106,508,3619,12576,3725,13084
210675,202101,5000,13486,4285,12572,272,674,3471,10539,3743,11213
210680,202101,4599,11043,3889,10209,108,184,3493,9302,3601,9486
210690,202101,7538,23017,6294,21645,233,1015,5583,19353,5816,20368
210700,202101,2739,7664,2168,6836,145,437,1566,5151,1711,5588
210710,202101,4755,14941,4192,14151,97,553,3705,12340,3802,12893
210720,202101,2899,9550,2593,9175,70,410,2255,7920,2325,8330
210725,202101,1290,4314,1133,4081,45,175,795,2992,840,3167
210730,202101,1157,3048,972,2787,47,127,833,2385,880,2512
210735,202101,4657,13470,3988,12594,197,540,3409,11083,3606,11623
210740,202101,5245,13822,4569,13062,79,249,3944,11292,4023,11541
210745,202101,4366,11878,4056,11489,109,333,3676,10385,3785,10718
210750,202101,22907,58566,19882,54766,1984,4891,13607,39826,15591,44717
210760,202101,5862,15425,4974,14494,31,67,4724,13908,4755,13975
210770,202101,5996,15443,5187,14511,59,258,4869,13524,4928,13782
210780,202101,7326,22857,6417,21353,614,1781,4889,16674,5503,18455
210790,202101,4189,13220,3793,12713,186,458,3129,10999,3315,11457
210800,202101,4804,12836,4130,11948,120,466,3615,10333,3735,10799
210805,202101,3923,14146,3738,13880,117,630,3282,12113,3399,12743
210810,202101,4752,13848,4340,13316,319,733,3545,11246,3864,11979
210820,202101,6728,19181,5623,17408,680,2148,3227,10370,3907,12518
210825,202101,6658,20621,6014,19770,268,863,5140,17193,5408,18056
210830,202101,7694,21419,7009,20615,313,726,6155,18493,6468,19219
210840,202101,3120,8352,2829,7981,58,195,2504,7001,2562,7196
210845,202101,6486,17343,5809,16609,36,114,5537,15978,5573,16092
210850,202101,5697,19369,4781,18007,210,1098,3791,14282,4001,15380
210860,202101,21212,53483,17687,49124,1044,2462,13880,40862,14924,43324
210870,202101,7197,18732,5714,17060,231,611,4985,15035,5216,15646
210880,202101,4216,12875,3787,12359,185,742,3026,9843,3211,10585
210890,202101,3766,11066,3392,10609,255,661,2683,8711,2938,9372
210900,202101,4386,12740,3401,10899,1330,4590,485,1798,1815,6388
210905,202101,1982,5434,1657,5019,46,82,1512,4692,1558,4774
210910,202101,7012,21238,5838,19337,778,2610,3773,12657,4551,15267
210920,202101,3162,10388,2737,9832,72,412,2442,8676,2514,9088
210923,202101,1564,4613,1325,4233,84,299,938,3017,1022,3316
210927,202101,5118,16247,4509,15521,364,1217,3498,12433,3862,13650
210930,202101,2415,8363,2128,7810,152,620,1603,5879,1755,6499
210940,202101,4034,11311,3750,10983,107,449,3430,9911,3537,10360
210945,202101,6533,18592,5854,17787,236,670,4910,15336,5146,16006
210950,202101,5095,14169,3931,12553,612,1510,2560,8992,3172,10502
210955,202101,1493,4755,1289,4413,133,461,886,3134,1019,3595
210960,202101,8777,26095,7631,24377,1210,3541,5016,16804,6226,20345
210970,202101,1321,4045,1057,3591,92,291,753,2549,845,2840
210975,202101,1724,5357,1552,5086,72,265,1245,4096,1317,4361
210980,202101,9957,23181,8720,21905,95,238,8239,20800,8334,21038
210990,202101,16107,44879,12640,40312,670,2296,9324,30813,9994,33109
211000,202101,14426,41926,12072,39002,814,2666,9214,31130,10028,33796
211003,202101,5587,16557,4712,15500,145,552,4074,13679,4219,14231
211010,202101,6288,22408,5641,21622,173,784,4997,19495,5170,20279
211020,202101,8044,23227,6972,22012,267,1002,5871,19111,6138,20113
211023,202101,1915,6227,1790,6067,89,314,1522,5161,1611,5475
211027,202101,3028,9682,2881,9459,193,513,2475,8250,2668,8763
211030,202101,3742,10352,3353,9875,231,571,2727,8251,2958,8822
211040,202101,4582,16455,4245,15879,121,702,3788,14054,3909,14756
211050,202101,8899,23178,8100,22111,76,277,7414,20206,7490,20483
211060,202101,6869,20698,6267,19890,165,670,5531,17545,5696,18215
211065,202101,2171,6075,1806,5614,106,343,1419,4529,1525,4872
211070,202101,7729,24236,6577,22509,557,1823,5044,17540,5601,19363
211080,202101,1284,3539,1032,3143,34,187,798,2288,832,2475
211085,202101,2024,5654,1740,5286,103,236,1484,4707,1587,4943
211090,202101,3143,8638,2842,8294,32,156,2648,7685,2680,7841
211100,202101,6761,16915,6244,16299,44,145,5795,15192,5839,15337
211102,202101,3078,10385,2819,10006,144,663,2429,8513,2573,9176
211105,202101,2328,7287,1946,6602,176,611,1377,4645,1553,5256
211107,202101,4673,14494,4014,13555,143,612,3149,11077,3292,11689
211110,202101,5884,15877,4590,13926,359,1013,3379,10471,3738,11484
211120,202101,44159,107343,36161,98031,5272,12915,23095,67113,28367,80028
211125,202101,2065,6151,1747,5664,52,187,1473,4808,1525,4995
211130,202101,180234,426042,154970,393694,23591,56407,74839,216352,98430,272759
211140,202101,4917,14457,4323,13720,228,620,3604,11612,3832,12232
211150,202101,9153,24955,7762,23158,334,909,6538,19691,6872,20600
211153,202101,2366,6948,1882,6343,235,824,1255,4404,1490,5228
211157,202101,1128,3548,943,3210,33,153,679,2313,712,2466
211160,202101,3970,11186,3127,9975,144,510,2364,7484,2508,7994
211163,202101,1578,5122,1443,4937,76,323,1242,4253,1318,4576
211167,202101,1497,4750,1407,4610,43,191,1232,3992,1275,4183
211170,202101,6356,15665,5911,15164,69,168,5593,14330,5662,14498
211172,202101,2509,6724,2173,6239,109,348,1667,4655,1776,5003
211174,202101,2825,8157,2558,7859,35,182,2398,7329,2433,7511
211176,202101,4158,11814,3234,10450,150,639,2589,8333,2739,8972
211178,202101,4501,10577,3945,9975,31,133,3750,9404,3781,9537
211180,202101,4009,13161,3730,12760,216,806,3086,10594,3302,11400
211190,202101,3035,8872,2575,8197,34,191,2298,7251,2332,7442
211195,202101,1390,3895,1193,3593,82,156,990,3094,1072,3250
211200,202101,2119,6028,1714,5467,206,623,1197,3898,1403,4521
211210,202101,6137,18800,5585,18081,260,1052,4711,15132,4971,16184
211220,202101,36540,91727,30058,83815,2970,7609,22210,63654,25180,71263
211223,202101,5224,13635,4297,12415,383,1115,3124,9069,3507,10184
211227,202101,1729,5679,1557,5435,63,305,1206,4251,1269,4556
211230,202101,7487,21535,6554,20131,405,1046,5280,16631,5685,17677
211240,202101,7920,25053,7539,24569,131,725,7023,22632,7154,23357
211245,202101,6971,17275,6190,16469,80,196,5973,15901,6053,16097
211250,202101,12918,40778,11713,39087,734,2737,9451,31479,10185,34216
211260,202101,7986,25743,7139,24632,239,992,6345,22065,6584,23057
211270,202101,10344,32769,8854,30773,369,1675,7176,25165,7545,26840
211280,202101,12376,33994,11133,32435,828,1924,9163,27754,9991,29678
211285,202101,1771,5745,1572,5466,137,522,1160,4130,1297,4652
211290,202101,7359,22029,6659,21127,173,698,5758,18237,5931,18935
211300,202101,7603,21942,6728,20568,224,756,5608,16943,5832,17699
211400,202101,11392,32049,9343,29268,1069,3369,6198,20436,7267,23805
220005,202101,1826,4681,1667,4471,34,112,1419,3754,1453,3866
220010,202101,1468,4179,1202,3702,26,111,937,2856,963,2967
220020,202101,3646,9969,3155,9287,132,461,2604,7615,2736,8076
220025,202101,2201,5022,1891,4568,27,74,1581,3703,1608,3777
220027,202101,1274,3185,1095,2950,20,73,937,2479,957,2552
220030,202101,3323,8369,3115,8099,82,224,2746,7086,2828,7310
220040,202101,7064,21213,6220,19620,1511,4301,3143,10559,4654,14860
220045,202101,1449,4420,1197,4009,27,147,983,3240,1010,3387
220050,202101,4723,12702,4031,11816,57,264,3708,10745,3765,11009
220060,202101,2347,4914,2005,4523,25,60,1891,4254,1916,4314
220070,202101,2397,6032,2052,5519,70,143,1710,4627,1780,4770
220080,202101,734,2056,635,1913,21,68,543,1630,564,1698
220090,202101,1732,4165,1453,3769,17,53,1206,3252,1223,3305
220095,202101,640,1595,601,1556,26,43,539,1421,565,1464
220100,202101,1362,3732,1100,3323,43,144,885,2608,928,2752
220105,202101,2012,6211,1769,5740,110,415,1344,4352,1454,4767
220110,202101,3325,9163,3064,8708,34,167,2752,7726,2786,7893
220115,202101,2682,7696,2493,7448,71,209,2262,6743,2333,6952
220117,202101,1393,3299,1114,2920,5,23,945,2431,950,2454
220120,202101,12830,34096,11781,32824,80,286,11052,30770,11132,31056
220130,202101,1103,2951,949,2742,14,80,865,2467,879,2547
220140,202101,2142,4377,1813,3993,103,252,1579,3436,1682,3688
220150,202101,6247,18450,5712,17543,105,510,4851,14642,4956,15152
220155,202101,1178,3346,949,2934,32,104,692,2107,724,2211
220157,202101,1059,2566,893,2315,24,81,708,1778,732,1859
220160,202101,2867,7872,2477,7168,34,149,2036,5789,2070,5938
220170,202101,1598,4111,1373,3776,13,56,1223,3320,1236,3376
220173,202101,2161,5932,1772,5261,45,192,1391,4033,1436,4225
220177,202101,1984,5586,1883,5474,10,37,1861,5401,1871,5438
220180,202101,1099,2637,907,2338,4,21,713,1732,717,1753
220190,202101,7005,17246,5976,15848,373,1009,4504,12200,4877,13209
220191,202101,1574,4666,1432,4434,81,280,1021,3111,1102,3391
220192,202101,2070,5383,1522,4416,27,86,1224,3500,1251,3586
220194,202101,1702,4818,1522,4536,57,206,1252,3692,1309,3898
220196,202101,2010,5142,1826,4869,29,112,1576,4136,1605,4248
220198,202101,1279,3481,1089,3233,7,32,1008,3011,1015,3043
220200,202101,5099,14594,4455,13765,73,326,3859,11910,3932,12236
220202,202101,2144,5990,1857,5525,26,138,1593,4656,1619,4794
220205,202101,2450,7031,2208,6597,53,200,1868,5497,1921,5697
220207,202101,761,2278,627,2047,59,203,402,1321,461,1524
220208,202101,1654,5027,1381,4506,177,619,797,2571,974,3190
220209,202101,1561,4434,1369,4090,23,98,1135,3344,1158,3442
220210,202101,1763,4204,1531,3849,10,42,1329,3256,1339,3298
220211,202101,1614,4059,1492,3894,17,68,1302,3407,1319,3475
220213,202101,1768,4657,1534,4272,25,85,1227,3328,1252,3413
220217,202101,2209,6434,2071,6273,40,81,1921,5924,1961,6005
220220,202101,10369,26888,8660,24294,590,1448,5796,17222,6386,18670
220225,202101,998,2619,819,2386,5,33,772,2225,777,2258
220230,202101,5602,13959,4829,12892,160,374,4159,11185,4319,11559
220240,202101,3007,8619,2750,8201,112,357,2243,6691,2355,7048
220245,202101,1793,4069,1382,3567,13,55,1262,3281,1275,3336
220250,202101,2947,8188,2613,7770,15,85,2460,7286,2475,7371
220253,202101,1584,4285,1428,4030,59,191,1204,3321,1263,3512
220255,202101,1920,4449,1653,4082,29,127,1433,3419,1462,3546
220260,202101,4345,13179,3823,12232,167,593,3012,9627,3179,10220
220265,202101,1291,4101,1159,3932,31,167,963,3215,994,3382
220270,202101,6016,19197,5704,18633,209,1005,4770,15097,4979,16102
220271,202101,1476,3757,1291,3500,27,92,1132,3052,1159,3144
220272,202101,1743,5004,1555,4667,50,152,1173,3437,1223,3589
220273,202101,1231,3474,1032,3108,35,136,794,2358,829,2494
220275,202101,2303,5361,1854,4755,40,88,1627,4205,1667,4293
220277,202101,2131,5329,1834,4908,27,70,1539,4061,1566,4131
220280,202101,1650,3827,1379,3482,23,74,1162,2916,1185,2990
220285,202101,1414,3543,1229,3331,10,38,1136,3055,1146,3093
220290,202101,6584,18150,5253,16281,369,1173,3812,12179,4181,13352
220300,202101,1950,5584,1602,5131,34,176,1349,4295,1383,4471
220310,202101,3022,8012,2383,7275,44,215,1999,6066,2043,6281
220320,202101,3060,8823,2373,7555,69,322,1860,5753,1929,6075
220323,202101,1615,4675,1278,4130,50,193,1059,3361,1109,3554
220325,202101,1250,3681,1079,3399,22,108,899,2776,921,2884
220327,202101,1538,4281,1346,3979,37,153,1113,3207,1150,3360
220330,202101,4505,10610,3827,9798,59,194,3449,8783,3508,8977
220335,202101,1646,4948,1490,4750,31,99,1327,4249,1358,4348
220340,202101,1862,4846,1441,4159,58,182,984,2745,1042,2927
220342,202101,1159,3339,1036,3153,53,183,816,2481,869,2664
220345,202101,3104,6923,2402,5935,17,49,2172,5348,2189,5397
220350,202101,3307,8350,2661,7408,132,380,1891,5297,2023,5677
220360,202101,1226,3126,978,2722,16,43,777,2161,793,2204
220370,202101,8583,24810,7857,23653,151,631,6831,20324,6982,20955
220375,202101,1582,4474,1405,4259,2,13,1335,4072,1337,4085
220380,202101,1460,3447,1198,3087,13,36,1046,2678,1059,2714
220385,202101,831,1968,682,1703,6,15,596,1472,602,1487
220390,202101,10338,26526,7963,22889,2039,5758,2756,8918,4795,14676
220400,202101,1481,3487,1146,2973,28,87,875,2189,903,2276
220410,202101,1145,3148,945,2805,49,143,760,2228,809,2371
220415,202101,798,2017,672,1825,22,57,542,1454,564,1511
220420,202101,2006,5549,1627,4833,52,163,1251,3673,1303,3836
220430,202101,2470,6590,2316,6364,67,222,1996,5418,2063,5640
220435,202101,1734,4449,1504,4116,49,165,1243,3325,1292,3490
220440,202101,2367,7319,2025,6791,79,353,1729,5692,1808,6045
220450,202101,2481,6397,2024,5828,62,201,1724,4981,1786,5182
220455,202101,1254,3877,1197,3799,9,52,1068,3388,1077,3440
220460,202101,979,2394,912,2312,35,82,781,1965,816,2047
220465,202101,2309,7108,2050,6697,184,590,1499,5029,1683,5619
220470,202101,3536,9660,3204,9139,97,240,2613,7377,2710,7617
220480,202101,2831,7188,2282,6315,226,514,1455,4098,1681,4612
220490,202101,2473,6107,2139,5692,23,112,1863,4880,1886,4992
220500,202101,2860,7170,2519,6648,66,183,2004,5196,2070,5379
220510,202101,2529,7099,2023,6194,74,203,1575,4879,1649,5082
220515,202101,1633,3933,1510,3761,41,58,1311,3272,1352,3330
220520,202101,4883,12634,4439,12013,104,293,3856,10372,3960,10665
220525,202101,1355,3367,1174,3139,7,37,1083,2857,1090,2894
220527,202101,1292,3588,1115,3333,11,51,952,2900,963,2951
220530,202101,1416,3504,1232,3266,29,89,1129,2971,1158,3060
220535,202101,806,2173,757,2107,29,74,612,1706,641,1780
220540,202101,3210,10173,3014,9796,130,428,2555,8287,2685,8715
220545,202101,1420,4218,1324,4065,66,247,1101,3349,1167,3596
220550,202101,8454,25844,7565,24311,471,1606,5755,18367,6226,19973
220551,202101,1402,3929,1257,3700,26,109,1023,2951,1049,3060
220552,202101,1579,4548,1296,4049,24,117,1052,3183,1076,3300
220553,202101,1764,4482,1465,4089,55,99,1182,3430,1237,3529
220554,202101,915,2354,669,1958,54,130,427,1243,481,1373
220555,202101,2348,6854,2095,6522,41,168,1742,5539,1783,5707
220556,202101,1187,3405,1039,3126,49,199,759,2192,808,2391
220557,202101,1629,4937,1379,4417,66,245,1021,3166,1087,3411
220558,202101,1390,3587,1093,3177,17,71,944,2720,961,2791
220559,202101,1788,4365,1527,3967,13,32,1245,3268,1258,3300
220560,202101,1733,3882,1427,3496,39,73,1293,3202,1332,3275
220570,202101,7047,21014,6432,20148,454,1415,5108,16140,5562,17555
220580,202101,6846,18594,6267,17665,82,278,5685,15934,5767,16212
220585,202101,2045,6371,1689,5726,43,134,1376,4730,1419,4864
220590,202101,1342,3575,1108,3229,76,206,793,2362,869,2568
220595,202101,2552,6906,2333,6610,21,103,2075,5822,2096,5925
220600,202101,1382,3071,1171,2818,86,105,974,2437,1060,2542
220605,202101,1566,4605,1348,4212,20,118,1101,3342,1121,3460
220610,202101,2767,8004,2598,7748,27,116,2435,7244,2462,7360
220620,202101,7767,23867,7172,23071,166,845,6544,20821,6710,21666
220630,202101,371,1079,287,922,22,76,192,611,214,687
220635,202101,1678,5173,1499,4788,49,242,1152,3563,1201,3805
220640,202101,2438,6766,2080,6254,74,301,1685,5017,1759,5318
220650,202101,2050,5632,1796,5255,37,136,1444,4226,1481,4362
220660,202101,2552,7954,2180,7325,74,362,1824,6008,1898,6370
220665,202101,1221,3665,1031,3347,31,172,863,2722,894,2894
220667,202101,1611,4941,1451,4651,58,216,1171,3737,1229,3953
220669,202101,1585,4795,1520,4697,42,198,1361,4102,1403,4300
220670,202101,2188,5617,1762,5018,16,76,1535,4364,1551,4440
220672,202101,3217,7810,2609,7073,94,315,2320,6206,2414,6521
220675,202101,1263,3443,1127,3192,29,91,931,2612,960,2703
220680,202101,2689,7237,2566,7068,98,218,2352,6542,2450,6760
220690,202101,1544,4057,1369,3793,53,156,1098,3039,1151,3195
220695,202101,904,2476,839,2364,23,68,732,2055,755,2123
220700,202101,9876,24100,7996,21554,323,893,6148,16509,6471,17402
220710,202101,907,2456,676,2029,37,105,500,1476,537,1581
220720,202101,2107,4971,1898,4693,17,71,1663,4060,1680,4131
220730,202101,1309,3626,1120,3314,12,65,945,2736,957,2801
220735,202101,978,2238,776,1934,19,64,642,1544,661,1608
220740,202101,1345,3467,1088,3136,27,70,913,2677,940,2747
220750,202101,3766,9560,3313,8918,189,456,2874,7783,3063,8239
220755,202101,1336,3220,1109,2883,20,75,912,2307,932,2382
220760,202101,3085,8388,2720,7895,62,183,2467,7219,2529,7402
220770,202101,23234,68047,19685,62054,5875,19558,6801,22487,12676,42045
220775,202101,1153,2900,1027,2743,13,43,983,2612,996,2655
220777,202101,1584,4009,1204,3428,31,78,923,2646,954,2724
220779,202101,1253,3205,1087,2965,17,59,960,2593,977,2652
220780,202101,5593,13912,4863,12818,209,640,3968,10238,4177,10878
220785,202101,1485,3262,1307,3036,10,30,1250,2883,1260,2913
220790,202101,10133,28541,9148,27121,204,921,7691,22598,7895,23519
220793,202101,926,2422,744,2104,9,22,622,1776,631,1798
220795,202101,1375,3525,1227,3325,20,73,1080,2921,1100,2994
220800,202101,17868,39358,15228,35936,624,1402,11839,27984,12463,29386
220810,202101,2997,8235,2540,7437,52,155,2089,6066,2141,6221
220820,202101,4822,12633,4219,11747,261,641,3189,8877,3450,9518
220830,202101,7205,18950,6477,17952,254,792,5368,14669,5622,15461
220840,202101,12024,36688,10077,32733,2232,6912,4682,15883,6914,22795
220850,202101,3115,9522,2814,9145,53,276,2511,8160,2564,8436
220855,202101,690,1739,602,1622,14,50,548,1466,562,1516
220860,202101,1055,2597,922,2392,16,66,834,2127,850,2193
220865,202101,2435,6395,1902,5450,87,324,1379,3818,1466,4142
220870,202101,3025,8224,2538,7583,28,139,2340,6978,2368,7117
220880,202101,5263,12339,4535,11436,81,292,4135,10318,4216,10610
220885,202101,1384,4144,1152,3755,54,186,909,3009,963,3195
220887,202101,1580,3341,1333,3029,14,31,1231,2783,1245,2814
220890,202101,1399,4217,1230,3972,45,156,1023,3349,1068,3505
220900,202101,1998,4715,1679,4307,31,70,1475,3780,1506,3850
220910,202101,1509,4111,1274,3767,57,170,1045,3125,1102,3295
220915,202101,949,2535,782,2236,5,21,601,1674,606,1695
220920,202101,1432,4389,1243,4143,53,221,1026,3444,1079,3665
220930,202101,1753,4656,1473,4254,17,52,1374,3960,1391,4012
220935,202101,1085,3109,882,2679,25,102,570,1639,595,1741
220937,202101,1470,3850,1270,3547,25,91,1010,2778,1035,2869
220940,202101,1539,4237,1233,3697,35,114,956,2833,991,2947
220945,202101,436,1496,379,1375,20,116,283,988,303,1104
220950,202101,1407,3228,933,2502,17,57,744,1926,761,1983
220955,202101,1613,4056,1339,3588,24,69,1145,3027,1169,3096
220960,202101,790,1998,597,1673,20,62,417,1110,437,1172
220965,202101,1778,4810,1555,4483,21,130,1346,3793,1367,3923
220970,202101,1979,4633,1460,3873,30,80,1222,3201,1252,3281
220975,202101,682,1915,595,1809,14,79,527,1555,541,1634
220980,202101,1131,3188,1003,3015,38,140,831,2476,869,2616
220985,202101,1235,3205,1075,2971,43,120,877,2356,920,2476
220987,202101,1410,4199,1237,3895,55,202,994,3122,1049,3324
220990,202101,1707,4636,1507,4343,18,95,1283,3642,1301,3737
220995,202101,1082,3238,898,2897,40,133,649,2107,689,2240
220997,202101,2343,7081,2168,6801,45,199,1934,6010,1979,6209
221000,202101,4455,12027,3942,11269,81,368,3377,9536,3458,9904
221005,202101,1467,3802,1346,3608,17,82,1168,3042,1185,3124
221010,202101,1254,2792,1003,2485,20,58,875,2124,895,2182
221020,202101,1511,4626,1407,4436,20,72,1072,3347,1092,3419
221030,202101,1628,3987,1402,3715,22,63,1211,3253,1233,3316
221035,202101,1481,3823,1305,3589,19,25,1156,3264,1175,3289
221037,202101,679,1854,567,1665,8,25,405,1140,413,1165
221038,202101,514,1451,403,1258,13,51,277,859,290,910
221039,202101,859,2327,746,2136,23,100,611,1683,634,1783
221040,202101,3995,11802,3501,10928,154,532,2767,8655,2921,9187
221050,202101,3861,10111,3418,9551,63,221,3078,8590,3141,8811
221060,202101,8537,23626,7107,21297,306,789,5714,17316,6020,18105
221062,202101,1125,3615,975,3373,37,171,789,2698,826,2869
221063,202101,1063,2888,921,2682,56,175,722,2062,778,2237
221065,202101,2604,6655,2299,6117,18,61,2021,5301,2039,5362
221070,202101,3381,10392,2750,9085,292,935,1670,5644,1962,6579
221080,202101,3466,8494,2850,7580,61,220,2341,6113,2402,6333
221090,202101,1395,3545,1159,3168,9,34,993,2661,1002,2695
221093,202101,1349,3793,1230,3558,140,391,817,2332,957,2723
221095,202101,863,2242,737,2052,11,35,624,1708,635,1743
221097,202101,840,2151,645,1805,20,52,480,1289,500,1341
221100,202101,116240,307501,96992,274949,9962,30310,62661,172778,72623,203088
221110,202101,9828,29156,9039,28133,138,694,8114,25017,8252,25711
221120,202101,4752,12976,4238,12163,155,468,3696,10608,3851,11076
221130,202101,5348,13775,4038,11258,836,2191,1869,5314,2705,7505
221135,202101,1644,4271,1481,4057,48,141,1308,3593,1356,3734
221140,202101,1313,3067,1111,2815,11,37,1001,2490,1012,2527
221150,202101,1098,2715,864,2316,21,96,667,1674,688,1770
221160,202101,716,1768,633,1663,16,20,518,1372,534,1392
221170,202101,969,2787,889,2637,13,46,773,2265,786,2311
230010,202101,2981,7735,2467,6878,31,112,2050,5593,2081,5705
230015,202101,3029,9646,2686,8963,162,595,1887,6289,2049,6884
230020,202101,12677,39772,11866,38539,330,1345,10121,32713,10451,34058
230030,202101,12931,31873,10850,29199,201,568,9517,25610,9718,26178
230040,202101,4466,11382,3704,10150,49,225,3106,8373,3155,8598
230050,202101,2736,8411,2097,6942,337,1073,928,3010,1265,4083
230060,202101,2305,6327,1861,5541,37,158,1464,4293,1501,4451
230070,202101,3933,10263,3168,8816,149,441,2246,6172,2395,6613
230075,202101,8759,28508,8051,27280,481,1976,6390,21398,6871,23374
230080,202101,3006,6303,2291,5440,6,18,2095,4991,2101,5009
230090,202101,4332,10561,3682,9553,185,449,2943,7610,3128,8059
230100,202101,18048,46177,15852,43242,1298,3408,11320,31240,12618,34648
230110,202101,12600,37100,10612,33256,1711,5297,5532,17562,7243,22859
230120,202101,7552,19945,6667,18529,543,1290,4894,13825,5437,15115
230125,202101,3159,8281,2566,7339,86,284,1979,5581,2065,5865
230130,202101,5646,17268,4597,14983,402,1374,2958,9538,3360,10912
230140,202101,3374,10041,2892,9064,94,383,2213,6774,2307,7157
230150,202101,1585,4728,1304,4113,204,561,756,2475,960,3036
230160,202101,6363,16417,5495,15085,174,600,4496,12144,4670,12744
230170,202101,6253,17600,5155,15391,290,842,3700,10914,3990,11756
230180,202101,1626,4460,1383,3999,18,79,1135,3188,1153,3267
230185,202101,4427,12375,3756,11261,274,881,2785,8350,3059,9231
230190,202101,13221,38080,11126,34234,1456,4595,6396,19589,7852,24184
230195,202101,5246,15331,4805,14502,416,1210,3539,10713,3955,11923
230200,202101,4949,13568,4171,12126,156,490,3194,9122,3350,9612
230205,202101,4159,12106,3658,11356,210,657,2765,8578,2975,9235
230210,202101,10084,24233,8523,22157,332,1090,6727,17152,7059,18242
230220,202101,13738,34391,12073,32018,583,1535,9959,26208,10542,27743
230230,202101,6792,20158,6071,18704,415,1245,4467,13772,4882,15017
230240,202101,12807,34208,11094,31279,266,1150,9186,25304,9452,26454
230250,202101,8902,24637,8269,23656,236,801,6720,18723,6956,19524
230260,202101,14670,43000,12707,39576,1982,5864,7002,22426,8984,28290
230270,202101,7638,20363,5852,17017,511,1422,3799,11150,4310,12572
230280,202101,20259,53742,16636,47684,463,1889,13066,36111,13529,38000
230290,202101,4968,13488,4110,11891,246,636,3130,9034,3376,9670
230300,202101,4839,12655,4387,12051,97,269,3860,10576,3957,10845
230310,202101,4522,12843,3835,11628,126,539,2770,8204,2896,8743
230320,202101,7781,22249,6564,20047,227,938,5050,15088,5277,16026
230330,202101,4548,12388,3622,10628,134,447,2729,7821,2863,8268
230340,202101,3651,11180,3125,10108,262,900,2115,6752,2377,7652
230350,202101,17968,48663,15720,45385,815,2691,10688,31039,11503,33730
230360,202101,2921,7629,2306,6558,124,357,1597,4473,1721,4830
230365,202101,3041,7445,2506,6655,54,237,2138,5584,2192,5821
230370,202101,58381,160080,49788,147524,7182,21419,29998,90053,37180,111472
230380,202101,6170,17061,4900,14753,122,483,3634,10701,3756,11184
230390,202101,3374,9844,2925,9126,90,363,2293,7059,2383,7422
230393,202101,3321,9640,2661,8273,81,405,2053,6146,2134,6551
230395,202101,5693,15474,4973,14280,324,885,3526,10147,3850,11032
230400,202101,5347,14659,4783,13738,92,474,3857,10762,3949,11236
230410,202101,13769,40462,11454,36215,881,3005,7886,24938,8767,27943
230420,202101,29096,78670,23778,69650,2871,8715,13392,38930,16263,47645
230423,202101,4724,13809,4134,12639,82,370,3412,10239,3494,10609
230425,202101,5625,17066,5139,16084,421,1390,3661,11388,4082,12778
230426,202101,2796,7238,2042,5772,28,106,1534,4233,1562,4339
230427,202101,1804,5061,1325,4061,60,200,855,2531,915,2731
230428,202101,9459,25015,8087,22997,1096,3052,4742,13485,5838,16537
230430,202101,5044,13914,3987,12088,162,529,2952,8830,3114,9359
230435,202101,5910,15327,4935,13626,641,1650,2950,8266,3591,9916
230440,202101,415576,1016129,346480,916190,32691,91747,227146,592446,259837,684193
230445,202101,4244,11193,3468,9865,182,508,2349,6542,2531,7050
230450,202101,3543,10061,3097,9424,246,911,2241,6625,2487,7536
230460,202101,2109,5816,1842,5400,52,215,1551,4514,1603,4729
230465,202101,4058,11247,3456,10097,94,363,2633,7413,2727,7776
230470,202101,11231,36814,10073,34697,881,3395,7077,24056,7958,27451
230480,202101,1442,4155,1225,3766,63,250,915,2704,978,2954
230490,202101,2519,7013,2126,6270,170,575,1328,3681,1498,4256
230495,202101,5673,16724,5022,15577,408,1450,3321,10197,3729,11647
230500,202101,9353,29557,8364,27768,246,1008,6868,22797,7114,23805
230510,202101,1601,4744,1264,4021,170,577,649,2035,819,2612
230520,202101,4571,12712,3955,11633,337,919,2739,8121,3076,9040
230523,202101,15384,44810,12332,38396,2718,8456,3165,10519,5883,18975
230526,202101,3690,10426,3170,9557,189,527,2288,6992,2477,7519
230530,202101,5397,16702,4549,15042,276,1034,3316,10785,3592,11819
230533,202101,4541,10616,3765,9389,103,277,3137,7696,3240,7973
230535,202101,5242,14477,4450,13152,303,901,2985,8913,3288,9814
230540,202101,15905,42999,13694,39772,280,1051,11337,32700,11617,33751
230550,202101,21004,54805,16964,48043,1493,4328,10941,30826,12434,35154
230560,202101,8040,19462,6564,17147,58,231,5645,14616,5703,14847
230565,202101,3040,8370,2571,7520,100,401,1966,5632,2066,6033
230570,202101,3342,8579,2867,7924,81,231,2353,6493,2434,6724
230580,202101,11007,28130,9451,25930,364,986,7794,21317,8158,22303
230590,202101,8940,24974,7457,22286,421,1440,5537,16007,5958,17447
230600,202101,3667,9368,2914,8059,81,219,2021,5620,2102,5839
230610,202101,6691,18235,5947,16993,461,1259,4689,13332,5150,14591
230620,202101,2078,5558,1616,4684,115,351,980,2743,1095,3094
230625,202101,7964,22250,6705,19992,1984,6166,1832,5907,3816,12073
230630,202101,10736,31635,9344,28917,1400,4109,5479,17333,6879,21442
230640,202101,27411,82076,24855,78061,1155,4492,19984,61882,21139,66374
230650,202101,5270,13897,4464,12512,130,476,3631,9931,3761,10407
230655,202101,9245,30914,8703,29997,659,2264,6932,24204,7591,26468
230660,202101,6012,17665,4928,15783,149,784,4006,12560,4155,13344
230670,202101,6186,14527,4556,11949,132,433,3656,9359,3788,9792
230680,202101,2663,7200,2256,6483,125,345,1618,4666,1743,5011
230690,202101,7165,20910,6173,18979,398,1396,3917,11838,4315,13234
230700,202101,10139,25882,8240,22403,326,830,6054,16217,6380,17047
230710,202101,6774,21194,5956,19470,628,1962,3949,12865,4577,14827
230720,202101,1818,5357,1494,4712,112,321,1023,3173,1135,3494
230725,202101,4033,11709,3625,11016,361,1241,2166,6471,2527,7712
230730,202101,56171,150136,44250,132260,9667,31167,14989,47374,24656,78541
230740,202101,6052,16605,5141,15140,134,453,4106,12065,4240,12518
230750,202101,8325,21915,6963,19697,159,519,5567,15388,5726,15907
230760,202101,10929,28540,9546,26500,475,1572,7275,19720,7750,21292
230763,202101,4962,13124,4175,11733,116,529,3401,9251,3517,9780
230765,202101,40903,109572,34004,98538,5129,15382,17504,50204,22633,65586
230770,202101,24936,61367,20829,55977,2081,5634,13889,37459,15970,43093
230780,202101,6436,22278,5870,20944,848,2958,3424,12593,4272,15551
230790,202101,3001,8542,2706,8078,109,442,2057,5956,2166,6398
230800,202101,8153,25630,7163,23625,921,3202,4143,13509,5064,16711
230810,202101,11019,32904,9899,31123,363,1346,7724,23879,8087,25225
230820,202101,3395,10988,2789,9646,268,1052,1640,5429,1908,6481
230830,202101,7446,20145,6388,18390,126,528,5290,14862,5416,15390
230835,202101,4249,10056,3296,8573,91,272,2607,6675,2698,6947
230837,202101,3047,9258,2731,8729,107,460,2183,6846,2290,7306
230840,202101,9170,26429,7915,24323,906,2565,5515,17216,6421,19781
230850,202101,9654,27612,8103,24573,343,1193,5885,17562,6228,18755
230860,202101,5270,13099,4378,11832,58,191,3882,10445,3940,10636
230870,202101,16366,39420,14118,35716,391,1081,11609,28846,12000,29927
230880,202101,2114,6298,1943,6028,49,245,1545,4667,1594,4912
230890,202101,4504,14259,4117,13496,330,1153,3002,9726,3332,10879
230900,202101,2929,8355,2530,7608,182,620,1708,5028,1890,5648
230910,202101,3116,8312,2534,7419,60,275,2040,5962,2100,6237
230920,202101,4589,12800,3876,11683,117,479,3085,9117,3202,9596
230930,202101,6467,17858,5436,16045,303,858,3790,11220,4093,12078
230940,202101,8268,20497,7182,18863,214,509,5995,15662,6209,16171
230945,202101,6525,18458,5596,16713,288,1004,3987,11667,4275,12671
230950,202101,6134,15368,5437,14419,101,255,4692,12478,4793,12733
230960,202101,13307,38059,11700,35055,1986,5845,5736,17413,7722,23258
230970,202101,13540,35489,11316,32088,1673,4595,6556,18873,8229,23468
230980,202101,2654,7646,2355,7132,337,961,1476,4633,1813,5594
230990,202101,1648,4596,1365,4039,64,258,979,2762,1043,3020
231000,202101,2498,6640,2048,5769,80,203,1513,4161,1593,4364
231010,202101,3606,8353,2835,7034,35,138,2462,5921,2497,6059
231020,202101,7904,24407,7074,22833,1284,3767,4049,13622,5333,17389
231025,202101,7445,20243,6473,18659,717,2007,4532,13196,5249,15203
231030,202101,7363,21597,5821,18375,1003,2989,2918,9335,3921,12324
231040,202101,2931,8294,2549,7595,127,373,1990,5842,2117,6215
231050,202101,11511,29335,9457,25749,635,1677,7019,18770,7654,20447
231060,202101,2866,7965,2525,7427,58,180,2110,6207,2168,6387
231070,202101,7718,22233,6641,20365,677,2141,4404,13413,5081,15554
231080,202101,3925,11022,3343,10079,131,522,2544,7512,2675,8034
231085,202101,6691,16051,5303,14426,211,521,4149,11309,4360,11830
231090,202101,4533,11684,3370,9499,108,410,2261,6130,2369,6540
231095,202101,2255,6627,1790,5644,144,443,1199,3782,1343,4225
231100,202101,3183,9073,2627,8023,117,418,1969,5956,2086,6374
231110,202101,3655,10530,3329,9926,143,490,2503,7370,2646,7860
231120,202101,2264,6470,1870,5792,86,310,1351,4149,1437,4459
231123,202101,1883,4823,1592,4328,77,157,1160,3195,1237,3352
231126,202101,5406,14755,4463,12979,302,834,3182,9195,3484,10029
231130,202101,21472,53898,17850,49404,1054,3584,13272,36082,14326,39666
231135,202101,4066,11415,3394,10105,159,519,2434,7144,2593,7663
231140,202101,16327,45352,13170,39938,634,2472,9332,27622,9966,30094
231150,202101,5791,15549,4445,13046,661,1946,1951,5897,2612,7843
231160,202101,6205,18788,5548,17603,774,2358,3149,10323,3923,12681
231170,202101,4160,12081,3493,10855,165,591,2479,7461,2644,8052
231180,202101,14199,39733,11640,34458,3107,8880,4018,12414,7125,21294
231190,202101,3816,10674,3140,9455,73,292,2405,7104,2478,7396
231195,202101,4959,14698,4159,13075,267,929,3008,9413,3275,10342
231200,202101,7791,23897,6852,22015,177,887,5432,16916,5609,17803
231210,202101,4762,13824,4080,12716,164,612,3126,9561,3290,10173
231220,202101,12047,30958,9464,26146,409,1200,6835,18330,7244,19530
231230,202101,9188,29073,8120,27106,539,2031,5934,19895,6473,21926
231240,202101,11495,33108,10157,30627,1568,4560,6128,18762,7696,23322
231250,202101,2155,5462,1424,3861,113,319,845,2233,958,2552
231260,202101,3243,9039,2815,8364,270,766,1906,5805,2176,6571
231270,202101,6242,16258,5081,14386,145,553,3827,10575,3972,11128
231280,202101,1668,5191,1527,4932,83,277,1161,3733,1244,4010
231290,202101,37817,111550,31536,99050,5338,16525,14580,45617,19918,62142
231300,202101,4067,11123,3215,9438,178,578,2167,6213,2345,6791
231310,202101,7382,18793,5917,16124,491,1348,4037,10789,4528,12137
231320,202101,7787,21120,6114,18174,87,392,4788,14021,4875,14413
231325,202101,2404,6216,1985,5598,162,349,1377,4002,1539,4351
231330,202101,9393,27656,7830,24572,1420,4228,4141,13659,5561,17887
231335,202101,5595,14671,4785,13394,76,342,4225,11694,4301,12036
231340,202101,17714,53439,16011,50438,1300,4057,11805,37591,13105,41648
231350,202101,15628,42589,14308,40696,245,888,12855,36213,13100,37101
231355,202101,4352,12815,3943,12054,224,733,3080,9300,3304,10033
231360,202101,7383,22064,6393,20355,267,944,5080,16123,5347,17067
231370,202101,2138,5868,1720,5124,37,115,1307,3890,1344,4005
231375,202101,4260,13239,3900,12657,131,595,3265,10463,3396,11058
231380,202101,6004,16234,5441,15463,192,505,4418,12732,4610,13237
231390,202101,3284,9534,2948,8970,121,460,2184,6465,2305,6925
231395,202101,3998,11584,3322,10520,420,1325,1971,6332,2391,7657
231400,202101,9660,27463,8111,24661,254,1076,6152,18306,6406,19382
231410,202101,14613,44908,13378,42890,620,2173,10805,34450,11425,36623
240010,202101,2605,6735,2047,5742,203,576,1225,3382,1428,3958
240020,202101,12379,34457,10422,31005,622,2303,6961,20417,7583,22720
240030,202101,2837,6878,2571,6475,88,244,2224,5564,2312,5808
240040,202101,814,2326,693,2100,31,121,470,1370,501,1491
240050,202101,3271,8712,2656,7604,49,150,2036,5725,2085,5875
240060,202101,1375,3667,1132,3229,24,87,926,2590,950,2677
240070,202101,2095,6037,1893,5615,178,562,1374,3967,1552,4529
240080,202101,2881,7728,2356,6791,58,224,1809,5125,1867,5349
240090,202101,2209,5441,1810,4776,18,48,1522,3981,1540,4029
240100,202101,10058,24487,8027,20888,196,578,6292,15835,6488,16413
240110,202101,4511,12693,3801,11420,175,640,2779,8180,2954,8820
240120,202101,3247,8966,2622,8201,182,601,1872,5997,2054,6598
240130,202101,3614,7506,3013,6726,27,83,2757,6076,2784,6159
240140,202101,1713,5162,1477,4694,151,533,1010,3179,1161,3712
240145,202101,6401,17730,5227,15744,783,2404,2963,9050,3746,11454
240150,202101,906,2648,796,2421,45,159,615,1819,660,1978
240160,202101,1431,4302,1195,3862,42,186,905,2931,947,3117
240165,202101,963,2614,799,2302,24,83,659,1867,683,1950
240170,202101,2568,6843,2168,6135,191,595,1483,4083,1674,4678
240180,202101,2960,8715,2378,7543,565,1696,1045,3537,1610,5233
240185,202101,1206,3744,1109,3571,57,221,915,2916,972,3137
240190,202101,1077,3115,925,2866,19,94,793,2459,812,2553
240200,202101,10696,27052,8539,23444,853,2539,4928,13237,5781,15776
240210,202101,3275,7983,2662,7014,25,130,2247,5733,2272,5863
240220,202101,7199,21416,6475,20294,325,1413,5146,15833,5471,17246
240230,202101,5763,14557,4619,12663,218,566,3644,10060,3862,10626
240240,202101,1799,5160,1165,3703,104,344,387,1096,491,1440
240250,202101,2967,7670,2604,7183,86,257,2212,6067,2298,6324
240260,202101,13737,40393,11924,37364,1698,4979,7361,24222,9059,29201
240270,202101,2264,6697,1981,6230,103,312,1421,4643,1524,4955
240280,202101,1687,4291,1432,3878,55,149,1142,3055,1197,3204
240290,202101,1149,3335,938,2871,30,135,677,1951,707,2086
240300,202101,2297,5817,1659,4661,67,207,1036,2848,1103,3055
240310,202101,8343,21948,6601,18871,855,2595,3398,9571,4253,12166
240320,202101,2088,5604,1532,4530,34,151,1142,3219,1176,3370
240325,202101,31255,82438,24982,71618,4233,12427,11355,32683,15588,45110
240330,202101,1749,4743,1354,3996,55,194,928,2622,983,2816
240340,202101,1912,4400,1575,3900,59,145,1301,3170,1360,3315
240350,202101,2186,5494,1961,5244,33,90,1767,4744,1800,4834
240360,202101,9101,24649,8111,23128,773,2231,5776,16633,6549,18864
240370,202101,1928,4952,1515,4133,61,169,1077,2868,1138,3037
240375,202101,901,2253,754,1993,27,101,611,1562,638,1663
240380,202101,2211,6246,1663,5046,149,420,950,2857,1099,3277
240390,202101,1049,2518,752,1958,29,65,475,1160,504,1225
240400,202101,1468,3541,1138,2981,34,110,802,1980,836,2090
240410,202101,573,1662,466,1452,36,131,299,885,335,1016
240420,202101,4487,15657,3956,14479,442,1913,2356,8446,2798,10359
240430,202101,3386,8598,2821,7640,171,529,2111,5537,2282,6066
240440,202101,2489,5380,2116,4874,140,262,1720,3999,1860,4261
240450,202101,4474,12059,3520,10313,336,1016,2065,5831,2401,6847
240460,202101,2910,8225,2580,7689,215,697,2024,6007,2239,6704
240470,202101,3611,10819,2753,9043,485,1504,1393,4780,1878,6284
240480,202101,578,1570,390,1161,32,103,186,532,218,635
240485,202101,2191,6037,1777,5297,124,372,1214,3625,1338,3997
240490,202101,1586,4062,1258,3455,84,192,925,2575,1009,2767
240500,202101,2148,5745,1878,5289,107,278,1496,4243,1603,4521
240510,202101,1677,4376,1464,4064,63,227,1203,3277,1266,3504
240520,202101,1480,3544,1158,3104,58,160,858,2329,916,2489
240530,202101,2158,6043,1950,5717,92,283,1631,4748,1723,5031
240540,202101,2277,5648,1995,5209,61,105,1718,4523,1779,4628
240550,202101,680,1926,617,1799,20,80,514,1456,534,1536
240560,202101,3248,8401,2749,7736,271,668,1994,5750,2265,6418
240570,202101,2794,7258,1889,5288,280,784,709,1882,989,2666
240580,202101,7957,23192,7055,21538,565,1616,5606,17307,6171,18923
240590,202101,730,1892,643,1748,11,38,472,1257,483,1295
240600,202101,1764,4784,1307,3836,46,149,868,2462,914,2611
240610,202101,4067,10887,3476,9824,122,409,2690,7471,2812,7880
240615,202101,1261,3209,1016,2780,112,293,685,1847,797,2140
240620,202101,1821,5063,1574,4648,105,268,1245,3694,1350,3962
240630,202101,2045,5754,1846,5418,137,292,1322,4047,1459,4339
240640,202101,958,2540,767,2227,31,112,568,1615,599,1727
240650,202101,4021,11162,3463,10021,243,698,2613,7452,2856,8150
240660,202101,3051,7758,2713,7329,46,146,2470,6675,2516,6821
240670,202101,2446,6868,1977,5913,150,469,1264,3690,1414,4159
240680,202101,1613,4241,1315,3737,50,146,997,2766,1047,2912
240690,202101,1005,2493,796,2149,16,68,635,1649,651,1717
240700,202101,2446,7004,2003,6183,58,198,1560,4747,1618,4945
240710,202101,15928,40986,13383,36688,1688,4534,8389,22984,10077,27518
240720,202101,5057,12335,4373,11394,385,1033,3227,8326,3612,9359
240725,202101,1112,3143,860,2650,39,124,572,1707,611,1831
240730,202101,2266,6263,1827,5402,53,183,1385,4040,1438,4223
240740,202101,1817,4850,1463,4157,45,171,1071,2890,1116,3061
240750,202101,2086,6837,1778,6200,257,977,947,3326,1204,4303
240760,202101,1650,3783,1191,3090,69,101,901,2430,970,2531
240770,202101,3203,8762,2704,8041,123,428,2201,6481,2324,6909
240780,202101,4634,12806,3824,11464,520,1533,2354,7264,2874,8797
240790,202101,864,2425,730,2166,18,78,558,1612,576,1690
240800,202101,47915,113440,37245,97495,5104,13560,19266,50424,24370,63984
240810,202101,89980,229815,76449,207759,8659,24294,49708,132866,58367,157160
240820,202101,5848,17206,5081,15846,691,2128,3137,9985,3828,12113
240830,202101,8699,24469,7745,23062,259,1052,6395,18811,6654,19863
240840,202101,1102,2711,885,2371,29,74,628,1620,657,1694
240850,202101,1359,3672,980,2882,53,166,543,1544,596,1710
240860,202101,1311,3475,987,2891,16,76,742,2075,758,2151
240870,202101,1076,2708,818,2276,133,382,440,1253,573,1635
240880,202101,1255,3949,1107,3664,78,335,858,2771,936,3106
240890,202101,4355,11804,3340,9902,442,1429,1702,4861,2144,6290
240895,202101,2844,8621,2625,8274,165,486,2219,7122,2384,7608
240910,202101,3388,9055,2901,8180,54,187,2378,6581,2432,6768
240920,202101,910,2448,753,2194,70,181,423,1296,493,1477
240930,202101,3641,8227,3009,7464,195,284,2250,5907,2445,6191
240933,202101,1678,4073,1412,3702,37,146,1244,3213,1281,3359
240940,202101,5859,14481,4597,12322,530,1440,2747,7191,3277,8631
240950,202101,1026,3031,902,2805,28,119,730,2218,758,2337
240960,202101,681,2082,612,1945,27,97,470,1466,497,1563
240970,202101,1858,4769,1497,4160,60,216,1215,3276,1275,3492
240980,202101,3292,9748,2905,9053,102,459,2362,7235,2464,7694
240990,202101,2547,7116,2249,6540,255,814,1583,4444,1838,5258
241000,202101,937,2451,743,2106,27,67,551,1539,578,1606
241010,202101,2786,8788,2548,8271,165,619,1866,5984,2031,6603
241020,202101,2117,5590,1594,4557,138,394,1032,2895,1170,3289
241025,202101,1787,5048,1428,4385,47,193,1038,3130,1085,3323
241030,202101,2461,7639,1997,6665,225,760,1271,4268,1496,5028
241040,202101,2279,7150,2017,6692,86,385,1613,5300,1699,5685
241050,202101,1345,3734,1112,3314,34,120,817,2377,851,2497
241060,202101,736,2059,649,1882,28,88,460,1286,488,1374
241070,202101,654,1778,559,1616,12,38,440,1234,452,1272
241080,202101,1122,3165,868,2654,8,35,654,1969,662,2004
241090,202101,1969,5721,1609,5106,46,221,1270,3968,1316,4189
241100,202101,1188,3278,919,2740,70,214,590,1711,660,1925
241105,202101,947,2859,778,2547,240,765,254,866,494,1631
241110,202101,972,2708,737,2224,35,99,490,1425,525,1524
241120,202101,7560,21216,6402,19177,939,2743,3789,11686,4728,14429
241140,202101,3275,8608,2578,7231,139,403,1866,5124,2005,5527
241142,202101,778,2069,574,1686,29,98,340,949,369,1047
241150,202101,5909,15243,5257,14193,143,460,4324,11487,4467,11947
241160,202101,1139,3050,913,2635,135,400,592,1665,727,2065
241170,202101,1338,3359,1136,3016,30,110,950,2428,980,2538
241180,202101,1036,2616,773,2111,95,262,385,1051,480,1313
241190,202101,1110,2909,934,2564,17,69,687,1818,704,1887
241200,202101,19602,50645,16980,46370,2681,7307,9848,26914,12529,34221
241210,202101,1409,3704,1028,2956,112,350,583,1648,695,1998
241220,202101,8928,25766,7805,23899,1728,5255,3786,12053,5514,17308
241230,202101,2937,7662,2605,7150,110,320,2150,5851,2260,6171
241240,202101,1216,3358,783,2414,70,220,336,1044,406,1264
241250,202101,5539,15773,4434,13707,153,680,3237,9632,3390,10312
241255,202101,2228,6897,1982,6382,111,443,1513,4773,1624,5216
241260,202101,4914,12662,3900,10990,79,314,3089,8519,3168,8833
241270,202101,1662,4790,1395,4284,106,355,1000,3083,1106,3438
241280,202101,2197,5432,1892,4883,67,165,1604,4088,1671,4253
241290,202101,3366,8196,2498,6810,74,237,1960,5199,2034,5436
241300,202101,1495,3949,1204,3445,40,140,810,2255,850,2395
241310,202101,2121,5200,1832,4793,13,51,1580,4173,1593,4224
241320,202101,926,2979,797,2738,84,353,525,1785,609,2138
241330,202101,1748,4463,1374,3967,17,93,1201,3430,1218,3523
241335,202101,3320,9130,2925,8412,110,347,2375,6751,2485,7098
241340,202101,1541,4260,1206,3583,252,799,496,1422,748,2221
241350,202101,2083,5872,1822,5411,96,324,1418,4159,1514,4483
241355,202101,1297,3497,1071,3063,14,42,830,2352,844,2394
241360,202101,2026,5224,1541,4246,38,110,1126,3011,1164,3121
241370,202101,1346,3697,1051,3084,48,151,732,2073,780,2224
241380,202101,640,1778,488,1482,71,185,245,770,316,955
241390,202101,2728,7915,2433,7477,195,529,1876,5884,2071,6413
241400,202101,3548,9751,3161,9154,140,468,2577,7398,2717,7866
241410,202101,2424,7137,1981,6232,341,1095,999,3168,1340,4263
241415,202101,1634,4822,1344,4259,60,215,942,2947,1002,3162
241420,202101,2315,7169,1989,6618,464,1709,968,3233,1432,4942
241430,202101,598,1634,426,1267,17,56,266,747,283,803
241440,202101,7690,23162,6890,21754,382,1285,5419,17136,5801,18421
241445,202101,1125,2811,997,2645,23,57,882,2411,905,2468
241450,202101,2665,6513,2280,5903,387,850,1470,3987,1857,4837
241460,202101,3815,10204,3112,8745,201,571,2154,5925,2355,6496
241470,202101,1364,3605,1119,3239,28,101,929,2688,957,2789
241475,202101,1217,3358,969,2880,21,97,704,1997,725,2094
241480,202101,2932,9075,2412,7939,722,2347,794,2914,1516,5261
241490,202101,628,1476,516,1328,26,62,371,940,397,1002
241500,202101,789,2190,706,2086,3,10,658,1964,661,1974
250010,202101,2521,7517,2116,6689,56,213,1549,4792,1605,5005
250020,202101,1661,4346,1205,3467,46,82,847,2465,893,2547
250030,202101,6924,18796,6147,17576,554,1570,4568,12972,5122,14542
250040,202101,3988,12107,3453,11133,235,833,2521,8005,2756,8838
250050,202101,3589,9541,3250,9096,118,420,2687,7509,2805,7929
250053,202101,1180,3274,1080,3117,81,223,770,2248,851,2471
250057,202101,644,2290,603,2228,10,44,544,2039,554,2083
250060,202101,5428,14013,4879,13344,262,700,4074,11216,4336,11916
250070,202101,3993,10993,3373,9917,34,138,2727,7833,2761,7971
250073,202101,776,2027,634,1813,10,20,516,1446,526,1466
250077,202101,2191,5863,1654,4985,56,197,1255,3758,1311,3955
250080,202101,4861,12051,4111,11101,61,280,3600,9584,3661,9864
250090,202101,3364,8117,2930,7549,55,162,2517,6360,2572,6522
250100,202101,3624,10905,3269,10260,159,561,2569,7926,2728,8487
250110,202101,4884,13624,4423,12970,243,887,3461,9960,3704,10847
250115,202101,700,1793,510,1504,10,43,368,1077,378,1120
250120,202101,1881,5389,1579,4899,27,128,1251,3849,1278,3977
250130,202101,5556,15087,4699,13874,72,385,3999,11647,4071,12032
250135,202101,1199,3282,1052,3029,21,80,917,2628,938,2708
250140,202101,2245,6511,2091,6324,105,420,1801,5413,1906,5833
250150,202101,4689,14466,4206,13649,148,627,3352,10710,3500,11337
250153,202101,1382,3638,1158,3304,28,77,924,2615,952,2692
250157,202101,1804,5176,1635,4863,58,228,1323,3869,1381,4097
250160,202101,3881,9601,3096,8551,39,140,2716,7513,2755,7653
250170,202101,1817,4665,1633,4406,23,88,1429,3811,1452,3899
250180,202101,20191,48027,17263,44342,728,2199,13610,34141,14338,36340
250190,202101,3965,10545,3324,9605,312,933,2307,6521,2619,7454
250200,202101,1929,5105,1674,4757,61,186,1410,4016,1471,4202
250205,202101,860,2620,744,2444,11,54,617,2004,628,2058
250210,202101,1539,4614,1390,4384,67,290,1100,3419,1167,3709
250215,202101,1569,4259,1315,3909,77,251,779,2332,856,2583
250220,202101,657,1807,525,1611,24,89,350,1060,374,1149
250230,202101,1674,3729,1175,2995,15,49,944,2340,959,2389
250240,202101,2254,6868,1981,6368,35,175,1672,5299,1707,5474
250250,202101,4529,12513,3967,11699,86,281,3382,10008,3468,10289
250260,202101,1673,4631,1416,4188,51,124,1119,3292,1170,3416
250270,202101,1186,3567,1077,3431,52,194,822,2693,874,2887
250280,202101,3368,9196,3028,8697,107,294,2421,6971,2528,7265
250290,202101,1535,4042,1327,3747,20,66,1062,2985,1082,3051
250300,202101,5440,14457,4894,13820,181,805,4106,11191,4287,11996
250310,202101,1161,3197,972,2884,38,128,736,2160,774,2288
250320,202101,12168,26923,10480,24997,244,668,9413,22183,9657,22851
250330,202101,2361,6460,1984,5943,108,318,1600,4801,1708,5119
250340,202101,1097,2778,984,2636,13,35,911,2437,924,2472
250350,202101,4135,11496,3667,10711,199,465,2867,8658,3066,9123
250355,202101,1955,5912,1758,5642,29,156,1570,5004,1599,5160
250360,202101,1735,4786,1564,4557,37,140,1318,3803,1355,3943
250370,202101,13550,34446,11251,30976,236,851,9506,25804,9742,26655
250375,202101,1175,3011,947,2736,4,16,899,2611,903,2627
250380,202101,1613,4106,1479,3939,30,112,1301,3373,1331,3485
250390,202101,1824,4623,1548,4186,80,212,1235,3318,1315,3530
250400,202101,68727,167499,50901,140236,14145,41979,13917,40857,28062,82836
250403,202101,1759,4832,1567,4608,73,364,1224,3423,1297,3787
250407,202101,1275,3097,1008,2705,79,165,682,1931,761,2096
250410,202101,644,1721,556,1572,4,9,463,1280,467,1289
250415,202101,1866,5169,1638,4808,29,136,1410,4115,1439,4251
250420,202101,1158,3244,1051,3092,29,101,933,2724,962,2825
250430,202101,6119,15045,5192,13834,142,419,4291,11221,4433,11640
250435,202101,1526,4247,1231,3744,14,73,942,2810,956,2883
250440,202101,4539,11956,3923,11182,70,191,3484,9937,3554,10128
250450,202101,1805,4734,1493,4307,28,97,1234,3577,1262,3674
250460,202101,7173,19387,6386,18241,338,1016,5107,14559,5445,15575
250470,202101,1532,3927,1272,3527,47,150,1015,2759,1062,2909
250480,202101,3932,10618,3345,9919,39,136,2950,8814,2989,8950
250485,202101,722,1615,544,1367,43,70,384,943,427,1013
250490,202101,5110,12086,4537,11435,163,477,4030,9982,4193,10459
250500,202101,1964,5386,1754,5019,72,225,1423,4076,1495,4301
250510,202101,5379,13486,4634,12500,76,197,4054,11023,4130,11220
250520,202101,1801,4829,1535,4447,125,391,1103,3182,1228,3573
250523,202101,2206,5431,1953,5109,72,284,1622,4086,1694,4370
250527,202101,1674,4259,1505,4070,24,66,1332,3629,1356,3695
250530,202101,624,1590,538,1467,5,11,477,1303,482,1314
250535,202101,1323,3900,1197,3664,25,107,970,2891,995,2998
250540,202101,3031,6822,2526,6261,79,141,2224,5617,2303,5758
250550,202101,767,2438,680,2268,17,71,509,1671,526,1742
250560,202101,1753,4776,1551,4493,37,137,1305,3701,1342,3838
250570,202101,2644,7845,2270,7170,80,294,1772,5528,1852,5822
250580,202101,1054,2744,927,2567,49,181,777,2108,826,2289
250590,202101,801,2244,718,2124,20,68,588,1750,608,1818
250600,202101,8123,20755,6771,19005,235,725,5532,15415,5767,16140
250610,202101,2942,8284,2640,7840,120,456,2187,6418,2307,6874
250620,202101,807,2074,699,1901,11,23,508,1361,519,1384
250625,202101,2457,7021,2195,6589,43,213,1872,5463,1915,5676
250630,202101,10183,27811,8305,24601,874,2603,5274,15344,6148,17947
250640,202101,3456,9398,3095,8921,103,389,2633,7487,2736,7876
250650,202101,951,2275,806,2077,13,36,705,1795,718,1831
250660,202101,1602,3972,1283,3538,39,108,1047,2823,1086,2931
250670,202101,2284,7126,2080,6771,43,190,1813,5801,1856,5991
250680,202101,5740,13304,5133,12622,55,205,4763,11563,4818,11768
250690,202101,6738,15095,5689,13796,105,241,5025,12120,5130,12361
250700,202101,4213,11802,3685,11009,471,1395,2495,7466,2966,8861
250710,202101,4295,12359,3767,11620,276,928,2752,8487,3028,9415
250720,202101,2711,7246,2431,6847,32,161,2142,5972,2174,6133
250730,202101,4072,10799,3568,10134,101,426,2987,8243,3088,8669
250740,202101,1904,4696,1600,4302,94,213,1256,3408,1350,3621
250750,202101,104475,253674,88833,232012,7036,19713,64948,166550,71984,186263
250760,202101,2337,6010,2045,5540,81,238,1629,4297,1710,4535
250770,202101,3961,11913,3552,11371,389,1198,2547,8282,2936,9480
250780,202101,1755,4679,1475,4174,53,185,1132,3119,1185,3304
250790,202101,2444,7151,2109,6654,130,511,1450,4463,1580,4974
250800,202101,2386,6307,2091,5830,87,178,1707,4806,1794,4984
250810,202101,1273,3315,1066,3023,32,63,896,2586,928,2649
250820,202101,1972,5400,1815,5230,28,126,1648,4719,1676,4845
250830,202101,5829,17298,4815,15265,279,1038,3280,10114,3559,11152
250840,202101,748,2361,644,2157,14,56,490,1651,504,1707
250850,202101,1784,5228,1604,4902,34,149,1331,3974,1365,4123
250855,202101,978,2839,836,2603,52,203,616,1892,668,2095
250860,202101,3119,9209,2615,8376,428,1460,1521,4890,1949,6350
250870,202101,1006,2767,868,2543,36,130,705,2041,741,2171
250880,202101,1595,4065,1323,3669,76,213,1025,2844,1101,3057
250890,202101,10215,26064,9030,24485,447,1638,7190,18680,7637,20318
250900,202101,2908,7841,2527,7180,98,258,2108,5929,2206,6187
250905,202101,2451,6801,2264,6544,42,160,2065,5967,2107,6127
250910,202101,5988,14574,4954,13403,80,276,4350,11800,4430,12076
250915,202101,2159,4954,1496,4242,26,56,1305,3788,1331,3844
250920,202101,3500,8806,3074,8168,330,754,2265,6070,2595,6824
250930,202101,2250,6007,2036,5729,52,216,1765,4860,1817,5076
250933,202101,1164,3427,1030,3184,17,84,806,2432,823,2516
250937,202101,680,1828,561,1635,21,70,431,1275,452,1345
250939,202101,1791,4718,1565,4431,61,195,1216,3425,1277,3620
250940,202101,4029,10588,3549,9958,15,61,3175,8913,3190,8974
250950,202101,1737,4390,1403,3967,25,95,1135,3145,1160,3240
250960,202101,1110,3255,977,3045,25,132,804,2423,829,2555
250970,202101,8247,21069,7289,19547,206,639,6076,15997,6282,16636
250980,202101,2366,6275,2140,5945,26,117,1870,5079,1896,5196
250990,202101,2039,6120,1713,5564,55,251,1270,4070,1325,4321
251000,202101,2012,5677,1635,5024,36,161,1341,4091,1377,4252
251010,202101,2661,7351,2418,6982,23,83,2181,6308,2204,6391
251020,202101,1613,4387,1446,4121,33,146,1248,3490,1281,3636
251030,202101,1003,2654,828,2347,35,96,574,1618,609,1714
251040,202101,1811,5066,1522,4577,33,162,1253,3745,1286,3907
251050,202101,1029,2810,867,2502,46,156,618,1708,664,1864
251060,202101,1068,2270,814,1959,8,26,624,1482,632,1508
251065,202101,475,1287,365,1082,11,32,252,733,263,765
251070,202101,724,1851,611,1686,9,34,525,1416,534,1450
251080,202101,18392,46670,14923,41466,2032,5794,9298,26044,11330,31838
251090,202101,2841,8094,2408,7341,56,193,1898,5761,1954,5954
251100,202101,793,2517,704,2343,22,84,549,1765,571,1849
251110,202101,1673,4437,1430,4021,54,132,1085,3060,1139,3192
251120,202101,7341,20246,6193,18867,264,944,4907,14987,5171,15931
251130,202101,3870,8553,3419,8046,56,157,3113,7286,3169,7443
251140,202101,4227,11727,3778,11108,69,283,3163,9197,3232,9480
251150,202101,2586,7534,2355,7153,91,388,1976,5869,2067,6257
251160,202101,2120,6191,1836,5782,37,180,1584,4898,1621,5078
251170,202101,1542,4170,1344,3917,30,105,1170,3388,1200,3493
251180,202101,2579,6861,2111,6205,156,465,1449,4244,1605,4709
251190,202101,4389,11379,3990,10929,43,241,3628,9731,3671,9972
251200,202101,4287,12535,3779,11895,70,308,3329,10495,3399,10803
251203,202101,923,3027,851,2866,21,111,639,2094,660,2205
251207,202101,1070,2924,842,2541,18,91,596,1756,614,1847
251210,202101,7575,18996,6225,17180,276,618,4773,13460,5049,14078
251220,202101,1166,2829,921,2503,55,120,701,1956,756,2076
251230,202101,4578,12649,3964,11591,107,389,3143,8959,3250,9348
251240,202101,3614,9826,3050,8891,163,431,2294,6615,2457,7046
251250,202101,10304,27486,9059,25403,743,2126,6669,18205,7412,20331
251260,202101,478,1343,434,1272,15,68,346,980,361,1048
251270,202101,4202,13053,3788,12501,108,440,3091,10417,3199,10857
251272,202101,1323,3587,1206,3431,47,176,1006,2797,1053,2973
251274,202101,883,2466,709,2149,56,194,469,1363,525,1557
251275,202101,1191,3360,1017,3074,26,121,809,2380,835,2501
251276,202101,1309,3555,1139,3331,28,146,925,2612,953,2758
251278,202101,578,1590,522,1511,46,112,385,1140,431,1252
251280,202101,2191,5936,1996,5659,48,143,1680,4719,1728,4862
251290,202101,5781,13579,5237,12924,142,459,4593,10990,4735,11449
251300,202101,860,2511,780,2390,7,38,664,2023,671,2061
251310,202101,2666,7633,2319,7103,44,251,1896,5663,1940,5914
251315,202101,1701,5269,1554,4990,91,270,1172,3743,1263,4013
251320,202101,1595,4236,1172,3504,32,112,873,2559,905,2671
251330,202101,2066,4797,1708,4378,23,80,1534,3969,1557,4049
251335,202101,1091,3098,977,2914,23,105,861,2513,884,2618
251340,202101,3682,8814,2958,7862,123,353,2284,6062,2407,6415
251350,202101,1018,2940,925,2788,27,102,759,2257,786,2359
251360,202101,1803,5047,1464,4561,18,104,1217,3785,1235,3889
251365,202101,711,1926,567,1646,5,20,446,1276,451,1296
251370,202101,24313,63405,20824,58449,2890,8116,12491,36028,15381,44144
251380,202101,1171,3304,1020,3045,17,99,852,2477,869,2576
251385,202101,736,1887,569,1584,23,67,412,1106,435,1173
251390,202101,6259,18040,5558,16977,470,1460,3746,11519,4216,12979
251392,202101,967,2604,823,2386,29,119,637,1807,666,1926
251394,202101,599,1719,490,1533,18,77,366,1131,384,1208
251396,202101,640,1730,555,1583,13,39,396,1106,409,1145
251398,202101,953,2389,659,1885,19,71,481,1344,500,1415
251400,202101,1242,2959,986,2620,22,88,790,2023,812,2111
251410,202101,1544,3595,1257,3192,20,79,1064,2594,1084,2673
251420,202101,1910,4997,1574,4606,41,146,1260,3645,1301,3791
251430,202101,1571,4706,1416,4434,32,153,1223,3812,1255,3965
251440,202101,1087,3006,881,2621,39,89,695,2103,734,2192
251445,202101,1538,4229,1421,4067,35,120,1212,3418,1247,3538
251450,202101,4372,12808,3913,12104,80,309,3266,10013,3346,10322
251455,202101,853,2568,780,2437,20,86,621,1891,641,1977
251460,202101,900,2595,783,2417,14,52,644,1995,658,2047
251465,202101,445,1300,383,1187,6,26,288,870,294,896
251470,202101,1172,3209,887,2624,72,234,514,1452,586,1686
251480,202101,990,2592,811,2275,17,69,627,1689,644,1758
251490,202101,1869,4883,1485,4340,63,191,1106,3262,1169,3453
251500,202101,1925,5398,1768,5201,32,121,1600,4708,1632,4829
251510,202101,2593,7749,2165,6904,106,385,1485,4644,1591,5029
251520,202101,988,2566,762,2150,71,190,477,1325,548,1515
251530,202101,14640,34919,11770,31359,102,560,10417,27270,10519,27830
251540,202101,2953,8370,2690,7882,66,226,2245,6500,2311,6726
251550,202101,3778,8849,3060,7978,114,209,2539,6694,2653,6903
251560,202101,527,1609,468,1517,56,195,324,1016,380,1211
251570,202101,941,2642,771,2308,18,81,612,1782,630,1863
251580,202101,1873,4466,1683,4198,34,149,1465,3510,1499,3659
251590,202101,1536,3831,1296,3554,48,134,1087,2926,1135,3060
251593,202101,901,2643,808,2490,86,268,519,1589,605,1857
251597,202101,2089,5866,1880,5590,19,100,1678,4916,1697,5016
251600,202101,6317,16975,5525,15778,176,526,4553,12850,4729,13376
251610,202101,3128,8931,2719,8177,240,654,1845,5680,2085,6334
251615,202101,1269,3122,1026,2761,24,66,825,2160,849,2226
251620,202101,19127,43421,14736,38052,94,327,12747,33230,12841,33557
251630,202101,4682,10936,3801,9720,203,508,2853,7261,3056,7769
251640,202101,2119,5763,1886,5401,28,132,1659,4651,1687,4783
251650,202101,3952,10549,3462,9905,136,410,2914,8363,3050,8773
251660,202101,3432,10264,3035,9570,71,323,2524,7833,2595,8156
251670,202101,3958,11162,3531,10545,47,240,3142,9310,3189,9550
251675,202101,620,1776,558,1700,75,219,373,1165,448,1384
251680,202101,2479,6513,2078,5993,40,126,1687,4924,1727,5050
251690,202101,3001,8427,2551,7658,86,272,1926,5735,2012,6007
251700,202101,2110,5912,1766,5481,42,188,1496,4557,1538,4745
251710,202101,771,1995,540,1525,38,126,314,837,352,963
251720,202101,1305,3674,1056,3247,21,94,819,2445,840,2539
251740,202101,603,1672,487,1456,41,151,327,934,368,1085
260005,202101,29725,62689,24522,56030,1717,3818,18730,42001,20447,45819
260010,202101,10120,26347,8391,23602,463,1353,4972,14102,5435,15455
260020,202101,6797,15804,5787,14362,86,390,4931,12016,5017,12406
260030,202101,6827,17277,5773,15753,135,403,4702,12778,4837,13181
260040,202101,7505,19091,6303,17363,409,1119,4513,12614,4922,13733
260050,202101,13899,35812,11591,33271,172,681,10685,30706,10857,31387
260060,202101,4069,9990,3515,9113,227,503,2726,7145,2953,7648
260070,202101,10622,26394,9102,24220,312,1094,7419,19202,7731,20296
260080,202101,6450,14681,5634,13605,107,358,4742,11256,4849,11614
260090,202101,4532,11726,4058,11084,437,1226,2961,8085,3398,9311
260100,202101,2889,7852,2439,7181,49,250,2021,5848,2070,6098
260105,202101,4945,13518,4429,12820,127,447,3722,10632,3849,11079
260110,202101,22044,60706,19671,57265,909,3081,16299,46814,17208,49895
260120,202101,14409,38032,12211,34791,1421,3939,7838,22719,9259,26658
260130,202101,3169,8018,2814,7502,277,703,2024,5358,2301,6061
260140,202101,12806,28671,11075,26652,525,1409,9348,22168,9873,23577
260150,202101,3537,8188,3058,7603,88,252,2692,6631,2780,6883
260160,202101,6439,16670,5481,15521,89,307,4956,14163,5045,14470
260170,202101,20327,47482,17282,43403,911,2308,13765,34187,14676,36495
260180,202101,3486,9190,3024,8562,66,246,2618,7302,2684,7548
260190,202101,17885,35932,15100,32659,163,436,13454,28563,13617,28999
260200,202101,10914,26256,9411,24344,434,986,7866,20673,8300,21659
260210,202101,11652,32678,9923,29842,304,1118,7924,23682,8228,24800
260220,202101,10229,24437,9472,23481,160,513,8370,20439,8530,20952
260230,202101,10646,25943,9287,24143,183,619,7879,20140,8062,20759
260240,202101,2705,8027,2386,7419,98,320,1843,5700,1941,6020
260250,202101,2190,5702,1916,5268,123,272,1455,4020,1578,4292
260260,202101,12816,32932,11427,30833,348,1150,9144,24192,9492,25342
260270,202101,4283,10246,3788,9660,107,394,3209,8039,3316,8433
260280,202101,12769,37976,11529,36223,429,1788,9856,30519,10285,32307
260290,202101,40585,101489,34936,93459,3728,10159,23777,63416,27505,73575
260300,202101,9468,25398,8291,23813,179,790,7067,20197,7246,20987
260310,202101,5266,13224,4661,12475,339,817,3605,9791,3944,10608
260320,202101,7620,21910,6470,19974,253,816,5259,16241,5512,17057
260330,202101,2559,7824,2244,7183,73,264,1770,5539,1843,5803
260340,202101,2023,5398,1757,5007,24,110,1522,4240,1546,4350
260345,202101,25217,64414,21045,58442,3172,9346,11075,30265,14247,39611
260350,202101,5630,12985,4876,12132,60,176,4361,10789,4421,10965
260360,202101,2473,6461,2242,6036,47,204,1582,4149,1629,4353
260370,202101,5502,15654,4756,14428,224,738,3680,11121,3904,11859
260380,202101,5015,14536,4305,13379,169,525,3272,10074,3441,10599
260390,202101,4506,13373,3758,11868,236,703,2490,7749,2726,8452
260392,202101,3327,10624,3013,10229,110,658,2452,8308,2562,8966
260400,202101,18357,41955,15838,38702,462,1281,12546,29523,13008,30804
260410,202101,72076,173782,56037,151725,9853,27916,25048,70303,34901,98219
260415,202101,4356,11507,3773,10561,56,235,3111,8538,3167,8773
260420,202101,12463,25898,10601,23828,95,272,9843,21926,9938,22198
260430,202101,2678,8302,2323,7598,102,414,1660,5351,1762,5765
260440,202101,3641,9365,3236,8772,68,239,2736,7284,2804,7523
260450,202101,5726,14288,5127,13524,279,559,4259,11440,4538,11999
260460,202101,5149,15202,4392,13887,464,1623,2627,8186,3091,9809
260470,202101,4857,12776,4119,11925,81,198,3790,11105,3871,11303
260480,202101,3924,10411,3304,9535,217,756,2299,6642,2516,7398
260490,202101,5326,12181,4738,11331,33,143,4325,10170,4358,10313
260500,202101,5946,14878,5074,13671,438,1107,3577,9791,4015,10898
260510,202101,9805,24005,8244,21832,110,426,7285,19131,7395,19557
260515,202101,4346,11538,3406,9814,158,426,2292,6449,2450,6875
260520,202101,16800,38686,14637,35951,695,1662,11999,29097,12694,30759
260530,202101,9727,27658,8320,25502,138,649,7176,21703,7314,22352
260540,202101,7165,15536,6344,14502,141,340,5710,12960,5851,13300
260545,202101,69,211,44,150,3,12,19,62,22,74
260550,202101,3028,8228,2498,7386,108,405,1731,5005,1839,5410
260560,202101,5912,15026,4976,13676,125,464,4183,11271,4308,11735
260570,202101,7645,20690,6751,19494,356,1125,5342,15493,5698,16618
260580,202101,4458,10491,4012,9899,26,91,3670,8998,3696,9089
260590,202101,6633,15366,5556,14170,231,555,4599,11907,4830,12462
260600,202101,30479,78170,24901,69781,1063,3271,18931,52132,19994,55403
260610,202101,7301,18715,6526,17719,393,1122,4902,13263,5295,14385
260620,202101,16589,42209,14519,39287,1250,3788,10605,28126,11855,31914
260630,202101,2360,6338,1938,5682,37,152,1574,4512,1611,4664
260640,202101,22097,49124,18461,44960,825,1990,14994,36325,15819,38315
260650,202101,6216,15910,4992,14423,439,880,4017,12016,4456,12896
260660,202101,6935,18096,6003,16875,164,646,5157,14195,5321,14841
260670,202101,2220,5772,1870,5238,76,191,1361,3749,1437,3940
260680,202101,28784,67902,24308,61644,1669,4487,17237,42893,18906,47380
260690,202101,3476,8959,2931,8120,76,298,2314,6344,2390,6642
260700,202101,6148,17054,5746,16602,20,76,5565,16168,5585,16244
260710,202101,1342,3484,1158,3226,31,116,916,2549,947,2665
260720,202101,23641,57786,20351,53532,1908,5065,14938,39214,16846,44279
260730,202101,7837,22032,6881,20722,247,850,5780,17193,6027,18043
260740,202101,1311,3704,1114,3385,14,73,870,2703,884,2776
260750,202101,7117,19375,5979,17958,258,518,5207,16164,5465,16682
260760,202101,5664,13258,4872,12338,196,519,4009,10204,4205,10723
260765,202101,8068,22950,7010,21507,406,1623,4968,14964,5374,16587
260770,202101,3856,9738,3215,8687,127,392,2506,6676,2633,7068
260775,202101,5199,13721,4577,12801,184,676,3584,9680,3768,10356
260780,202101,3638,10742,3258,10145,295,1064,2058,6196,2353,7260
260790,202101,119731,264891,99107,238510,14944,34685,61200,148039,76144,182724
260795,202101,2943,7477,2530,6953,78,269,1990,5507,2068,5776
260800,202101,5340,12326,4827,11649,128,401,4213,9852,4341,10253
260805,202101,3625,10123,3075,9176,158,552,2311,6761,2469,7313
260810,202101,6417,17371,5635,15873,471,1233,4035,11192,4506,12425
260820,202101,4519,10343,3993,9720,94,338,3354,7981,3448,8319
260825,202101,2930,8596,2573,7973,111,380,1932,5918,2043,6298
260830,202101,4165,12060,3480,10845,457,1238,2202,7123,2659,8361
260840,202101,4169,10769,3739,10181,208,530,3115,8510,3323,9040
260845,202101,4423,11523,3924,10681,223,632,2947,7900,3170,8532
260850,202101,5131,13900,4303,12365,345,1056,2742,7625,3087,8681
260860,202101,3332,9457,2879,8693,94,333,2314,6829,2408,7162
260870,202101,4511,10788,3865,10010,68,255,3460,8841,3528,9096
260875,202101,7162,17245,5879,15396,547,1411,4043,10668,4590,12079
260880,202101,9582,26741,8350,24635,490,1461,6524,19253,7014,20714
260890,202101,12912,32727,11205,30163,572,1624,8195,21555,8767,23179
260900,202101,5346,14684,4406,13383,322,1008,2932,8920,3254,9928
260910,202101,3231,8627,2808,7998,105,318,2214,6272,2319,6590
260915,202101,5104,14920,4487,14212,55,252,4097,13001,4152,13253
260920,202101,3275,7996,2764,7449,86,198,2395,6532,2481,6730
260930,202101,3719,11630,3217,10750,191,751,2384,7811,2575,8562
260940,202101,14796,34798,12925,32249,1042,2525,9671,23844,10713,26369
260950,202101,7131,18727,5779,16424,369,1223,3767,10207,4136,11430
260960,202101,70566,155271,56806,137911,6099,15100,36381,87288,42480,102388
260970,202101,5760,14797,5143,13976,271,592,3816,10653,4087,11245
260980,202101,4572,13097,4028,12419,53,181,3686,11456,3739,11637
260990,202101,18210,48955,15463,45236,848,2638,12135,35094,12983,37732
261000,202101,16235,37855,13667,34642,361,1237,11053,27348,11414,28585
261010,202101,2349,6121,2062,5743,73,188,1798,5026,1871,5214
261020,202101,6005,16171,5231,14899,176,657,4324,11866,4500,12523
261030,202101,3969,11500,3499,10681,124,493,2777,8272,2901,8765
261040,202101,5323,15219,4344,13372,156,598,3283,9823,3439,10421
261050,202101,7779,19998,7091,18942,433,827,5487,14798,5920,15625
261060,202101,14230,35094,12410,32933,260,824,10437,27413,10697,28237
261070,202101,65387,140563,54461,126357,2930,6503,41692,94712,44622,101215
261080,202101,6742,15929,6164,15223,131,315,5718,14096,5849,14411
261090,202101,19548,45333,17404,42569,276,934,15338,36825,15614,37759
261100,202101,8288,22662,7234,21117,504,1548,5296,15506,5800,17054
261110,202101,67366,184901,56773,165983,7785,23952,33497,96678,41282,120630
261120,202101,3572,8991,3134,8393,86,219,2695,7232,2781,7451
261130,202101,7293,17623,6454,16518,120,355,5704,14473,5824,14828
261140,202101,3707,8425,3300,7889,181,448,2626,6195,2807,6643
261150,202101,5185,13505,4616,12654,68,261,4016,10891,4084,11152
261153,202101,1906,5701,1611,5126,61,196,1075,3460,1136,3656
261160,202101,212736,486140,172595,431720,41838,107836,71371,181919,113209,289755
261170,202101,5995,14867,5360,13940,311,720,4272,11067,4583,11787
261180,202101,9492,23433,8303,21886,475,1176,6024,16028,6499,17204
261190,202101,4593,13215,4110,12429,164,711,3268,9570,3432,10281
261200,202101,3362,7701,2990,7204,114,306,2536,6007,2650,6313
261210,202101,1905,4584,1634,4201,65,182,1367,3454,1432,3636
261220,202101,13628,38167,11419,34168,1441,4640,6491,19169,7932,23809
261230,202101,3982,11318,3332,10429,45,182,2786,8810,2831,8992
261240,202101,5366,13289,4745,12310,282,705,3866,9946,4148,10651
261245,202101,3742,10315,3134,9249,80,371,2509,7128,2589,7499
261247,202101,2942,8720,2455,7856,161,545,1661,5287,1822,5832
261250,202101,22060,49979,19188,46681,1671,3609,14646,36601,16317,40210
261255,202101,4080,11845,3328,10394,137,583,2452,7431,2589,8014
261260,202101,12608,33942,10981,31832,339,1378,9450,27038,9789,28416
261270,202101,4473,10824,3917,10131,193,524,3232,8273,3425,8797
261280,202101,2536,7012,2240,6508,63,223,1795,5079,1858,5302
261290,202101,2942,7540,2463,7002,68,260,1997,5720,2065,5980
261300,202101,12495,34350,10665,31290,575,2023,7823,22418,8398,24441
261310,202101,8859,22179,7586,20468,607,1794,5607,14805,6214,16599
261320,202101,5919,16549,5190,15371,77,323,4410,12876,4487,13199
261330,202101,5743,14056,5190,13347,123,436,4512,11403,4635,11839
261340,202101,4237,11687,3679,10979,140,507,3065,9055,3205,9562
261350,202101,8766,25495,7757,23791,123,536,6297,19079,6420,19615
261360,202101,8013,19174,6803,17476,233,651,5454,13668,5687,14319
261370,202101,24093,59181,20210,53902,2091,5398,13106,35295,15197,40693
261380,202101,4083,12164,3620,11367,446,1469,2376,7364,2822,8833
261390,202101,16841,47165,14277,43069,1201,3947,9539,28483,10740,32430
261400,202101,4601,14441,4037,13203,165,718,3039,9668,3204,10386
261410,202101,9635,23704,7951,21148,433,1266,6326,16413,6759,17679
261420,202101,7256,21351,6533,20473,746,2637,4615,14423,5361,17060
261430,202101,3436,9646,2924,8839,61,273,2449,7294,2510,7567
261440,202101,1490,4370,1249,3917,41,190,898,2694,939,2884
261450,202101,14818,39668,13111,37054,173,625,10849,30742,11022,31367
261460,202101,7553,20529,6677,19164,300,917,5334,15262,5634,16179
261470,202101,4144,10214,3630,9529,24,121,3167,8290,3191,8411
261480,202101,5079,15386,4394,14246,199,793,3408,10830,3607,11623
261485,202101,4865,13713,4223,12739,322,1059,3070,9135,3392,10194
261500,202101,5936,14986,5189,13972,374,889,3651,10214,4025,11103
261510,202101,1875,5497,1636,5109,58,214,1246,3920,1304,4134
261520,202101,2343,7122,2113,6655,66,237,1554,4852,1620,5089
261530,202101,12054,34846,9761,30737,890,3348,4979,15059,5869,18407
261540,202101,8065,22933,7259,21781,1080,3179,4094,13008,5174,16187
261550,202101,3677,9672,3175,8897,232,696,2277,6248,2509,6944
261560,202101,7662,22700,6649,21184,272,1044,5148,16397,5420,17441
261570,202101,3499,9346,2802,8233,185,628,1938,5604,2123,6232
261580,202101,6846,17704,5915,16447,104,468,5317,14577,5421,15045
261590,202101,2692,6901,2186,6180,74,251,1653,4652,1727,4903
261600,202101,5216,12880,4443,11764,298,658,3142,8544,3440,9202
261610,202101,2146,6085,1725,5317,97,358,1159,3532,1256,3890
261618,202101,2549,6261,2229,5787,97,225,1773,4597,1870,4822
261620,202101,4187,11642,3815,11096,733,1867,2517,7665,3250,9532
261630,202101,6151,17190,5263,15553,356,1245,3556,10115,3912,11360
261640,202101,37301,82879,31739,76063,1891,3559,23875,59095,25766,62654
261650,202101,4105,10141,3499,9348,156,482,2617,6932,2773,7414
270010,202101,4320,14273,3753,13308,158,903,3004,10315,3162,11218
270020,202101,3816,9485,3341,8882,129,429,2862,7437,2991,7866
270030,202101,33928,90868,28274,81825,3378,9626,19111,55220,22489,64846
270040,202101,10670,28378,9161,26602,365,1302,7607,21955,7972,23257
270050,202101,5436,12596,4641,11696,234,537,4037,10249,4271,10786
270060,202101,2181,5442,1828,5044,147,348,1454,4077,1601,4425
270070,202101,4667,12976,4062,12143,137,504,3374,9918,3511,10422
270080,202101,1445,3883,1222,3500,48,145,935,2574,983,2719
270090,202101,1738,5293,1569,4963,62,252,1293,3992,1355,4244
270100,202101,5435,14132,4693,13055,166,587,3910,10685,4076,11272
270110,202101,3209,7445,2592,6739,139,298,2057,5623,2196,5921
270120,202101,2673,7319,2330,6865,71,304,1968,5696,2039,6000
270130,202101,5046,12782,4398,12012,119,371,3818,10439,3937,10810
270135,202101,1999,4791,1697,4455,35,122,1556,4045,1591,4167
270140,202101,9484,22029,7618,19462,322,1042,5967,14543,6289,15585
270150,202101,2695,8021,2465,7683,4,21,2326,7236,2330,7257
270160,202101,6208,16562,5273,15511,95,341,4876,14377,4971,14718
270170,202101,3328,9683,2805,8960,173,812,2138,6547,2311,7359
270180,202101,2203,6792,2024,6565,33,165,1840,5910,1873,6075
270190,202101,1603,4791,1424,4569,34,177,1255,3997,1289,4174
270200,202101,2354,7132,2055,6720,106,395,1513,4962,1619,5357
270210,202101,5687,13305,4843,12358,70,280,4464,11220,4534,11500
270220,202101,1537,3963,1230,3525,209,626,697,1983,906,2609
270230,202101,9162,25100,7612,22740,635,2041,5447,16195,6082,18236
270235,202101,5607,17223,4829,15989,113,518,4010,13136,4123,13654
270240,202101,10489,28792,8531,26062,973,3155,5839,17996,6812,21151
270250,202101,2763,6902,2426,6420,183,471,1923,5087,2106,5558
270255,202101,4310,12358,3385,10682,104,432,2606,8089,2710,8521
270260,202101,5517,16215,5001,15362,99,500,4387,13184,4486,13684
270270,202101,1030,2678,855,2465,95,281,633,1811,728,2092
270280,202101,3768,9043,3021,8111,470,748,2139,6202,2609,6950
270290,202101,7352,23255,6620,22048,159,763,5816,19142,5975,19905
270300,202101,4233,10864,3298,9852,168,437,2570,7876,2738,8313
270310,202101,6956,19263,5983,17742,84,457,5145,14884,5229,15341
270320,202101,5451,15944,4728,14557,391,1257,3381,10141,3772,11398
270330,202101,3879,12540,3461,11898,250,990,2686,9176,2936,10166
270340,202101,1552,4191,1342,3921,43,143,1147,3304,1190,3447
270350,202101,1859,4333,1534,3957,143,404,1095,2844,1238,3248
270360,202101,2593,6439,2311,6126,80,161,2126,5691,2206,5852
270370,202101,1395,4247,1279,4038,33,155,1091,3388,1124,3543
270375,202101,3091,7156,2558,6570,17,56,2399,6179,2416,6235
270380,202101,5411,15077,4549,13963,592,1727,3026,9675,3618,11402
270390,202101,1185,2967,961,2713,24,96,795,2243,819,2339
270400,202101,6229,16242,5228,14737,292,757,4050,11420,4342,12177
270410,202101,4549,12962,3948,12062,144,513,3298,10032,3442,10545
270420,202101,5448,16004,4892,15190,121,566,4253,12960,4374,13526
270430,202101,132280,311270,104217,275632,20249,55587,49862,134062,70111,189649
270440,202101,4618,12455,3989,11690,78,346,3502,10141,3580,10487
270450,202101,6981,18572,6116,17532,262,846,5116,14862,5378,15708
270460,202101,3711,8221,3185,7596,159,315,2858,6852,3017,7167
270470,202101,10824,30003,9413,28026,613,2035,7332,21812,7945,23847
270480,202101,2921,7657,2461,7000,90,353,2022,5614,2112,5967
270490,202101,938,2566,821,2425,50,149,661,1951,711,2100
270500,202101,4875,14766,4331,13862,290,1046,3385,10708,3675,11754
270510,202101,5437,14359,4577,13284,320,1260,3421,9474,3741,10734
270520,202101,3962,11154,3145,9781,651,2096,1289,4188,1940,6284
270530,202101,1285,3612,1087,3309,59,164,772,2388,831,2552
270540,202101,2241,6269,1935,5872,59,255,1692,5056,1751,5311
270550,202101,6689,17134,5316,15624,593,1405,3948,12105,4541,13510
270560,202101,2946,7563,2543,7029,119,381,2096,5738,2215,6119
270570,202101,4068,11340,3453,10430,119,375,2821,8477,2940,8852
270580,202101,2246,6290,2035,5990,102,310,1747,5100,1849,5410
270590,202101,1567,4717,1444,4552,16,82,1360,4262,1376,4344
270600,202101,2700,8304,2444,7920,45,234,2182,6996,2227,7230
270610,202101,3689,9448,3202,8813,99,266,2855,7838,2954,8104
270620,202101,1220,3656,1122,3473,32,139,974,2932,1006,3071
270630,202101,17372,42170,14929,38816,609,1865,12464,31745,13073,33610
270640,202101,5264,15109,4585,14016,168,676,3768,11304,3936,11980
270642,202101,2484,7939,2205,7496,143,621,1695,5637,1838,6258
270644,202101,3566,8829,2940,8027,304,725,2176,6139,2480,6864
270650,202101,3042,8912,2670,8395,350,1164,1916,6011,2266,7175
270660,202101,1986,5024,1702,4615,77,267,1297,3461,1374,3728
270670,202101,16068,36590,13355,33274,355,1057,11458,27884,11813,28941
270680,202101,5562,13064,4973,12426,121,177,4645,11760,4766,11937
270690,202101,9108,22179,7636,20330,415,1123,6079,16070,6494,17193
270700,202101,518,1545,456,1442,34,124,337,1045,371,1169
270710,202101,5330,16057,4742,15153,217,903,3818,12002,4035,12905
270720,202101,3611,10384,3217,9728,57,320,2865,8477,2922,8797
270730,202101,8035,17777,7058,16741,236,450,5541,14619,5777,15069
270740,202101,2362,6145,2083,5824,86,292,1743,4802,1829,5094
270750,202101,5677,14794,4969,13897,78,373,4458,12367,4536,12740
270760,202101,3216,9005,2784,8434,42,222,2376,7111,2418,7333
270770,202101,20680,50127,16574,45119,2595,6311,10250,29514,12845,35825
270780,202101,1786,4871,1645,4675,76,265,1423,3983,1499,4248
270790,202101,1631,4384,1364,4022,112,344,1011,2958,1123,3302
270800,202101,10924,29318,9863,27818,330,1146,8511,23691,8841,24837
270810,202101,3302,9356,2606,8203,169,641,1828,5638,1997,6279
270820,202101,1570,4712,1337,4342,50,249,1055,3345,1105,3594
270830,202101,5028,12022,4069,10843,153,525,3321,8693,3474,9218
270840,202101,8219,24335,7343,23088,160,864,6435,19735,6595,20599
270850,202101,8922,20974,7871,19735,657,1847,6515,16082,7172,17929
270860,202101,14232,31295,11269,27971,589,1329,9104,22616,9693,23945
270870,202101,2155,6022,1779,5436,234,674,1158,3661,1392,4335
270880,202101,8012,23816,7161,22540,208,886,5992,18533,6200,19419
270890,202101,2829,7575,2364,6918,174,526,1641,4805,1815,5331
270895,202101,3105,9354,2822,8988,71,384,2505,7822,2576,8206
270900,202101,1780,4597,1349,3903,36,107,1054,3014,1090,3121
270910,202101,3842,11003,3311,10176,86,287,2732,8289,2818,8576
270915,202101,9396,26550,7594,23634,640,2288,5161,15730,5801,18018
270920,202101,5038,15541,4583,14774,141,693,3812,11894,3953,12587
270930,202101,17062,39218,13173,34714,1780,4242,8851,24585,10631,28827
270940,202101,6650,17027,5635,15820,207,822,4625,12646,4832,13468
280010,202101,690,1869,552,1584,14,58,388,1011,402,1069
280020,202101,4843,12152,4116,11013,451,1141,2795,7544,3246,8685
280030,202101,75177,175154,59734,153592,12279,31780,27075,72420,39354,104200
280040,202101,2868,7988,2508,7446,250,761,1701,5034,1951,5795
280050,202101,3844,10882,3314,10080,575,1787,1928,5872,2503,7659
280060,202101,5728,14894,4589,13150,881,2678,2131,6372,3012,9050
280067,202101,6895,16838,5878,15301,304,804,4325,11115,4629,11919
280070,202101,1892,5568,1761,5365,120,375,1458,4413,1578,4788
280100,202101,3944,10376,3328,9410,324,940,2283,6453,2607,7393
280110,202101,1376,3707,1210,3460,17,85,1072,2986,1089,3071
280120,202101,7570,21605,6753,20302,778,2133,4882,15126,5660,17259
280130,202101,8971,20933,7889,19424,396,1064,6405,15602,6801,16666
280140,202101,5379,12771,4764,11967,187,559,4084,10118,4271,10677
280150,202101,4149,10380,3603,9646,363,884,2737,7393,3100,8277
280160,202101,1200,3392,1015,3090,95,315,692,2064,787,2379
280170,202101,5070,13370,4552,12718,233,626,3677,10311,3910,10937
280190,202101,1273,2783,1139,2606,54,125,941,2106,995,2231
280200,202101,1219,3181,1011,2895,69,248,754,2123,823,2371
280210,202101,16652,41114,14489,38049,1553,4191,9275,24408,10828,28599
280220,202101,1740,4601,1489,4274,47,210,1229,3492,1276,3702
280230,202101,4411,10913,3707,9887,326,707,2579,7027,2905,7734
280240,202101,3295,8749,2949,8228,44,231,2560,6960,2604,7191
280250,202101,895,2139,739,1906,83,216,493,1246,576,1462
280260,202101,2235,5295,1972,4968,40,95,1783,4533,1823,4628
280270,202101,2432,6461,2165,6058,146,395,1754,4897,1900,5292
280280,202101,4185,12241,3727,11560,505,1333,2589,8421,3094,9754
280290,202101,17928,46733,15398,43235,1292,3825,10399,29455,11691,33280
280300,202101,12151,28672,10635,27041,296,792,7912,22066,8208,22858
280310,202101,1384,3526,1149,3134,41,132,864,2289,905,2421
280320,202101,8528,22873,7416,21230,893,2514,4944,14097,5837,16611
280330,202101,4664,11455,3980,10523,250,703,2916,7703,3166,8406
280340,202101,5397,11353,4490,10375,230,405,3873,9122,4103,9527
280350,202101,25997,60403,22910,56364,1081,2802,18199,43969,19280,46771
280360,202101,5596,15357,4918,14238,725,2117,2893,8535,3618,10652
280370,202101,2105,5192,1780,4667,54,150,1424,3670,1478,3820
280380,202101,1008,2629,860,2430,77,206,589,1687,666,1893
280390,202101,3633,8842,3084,8000,169,379,2430,6332,2599,6711
280400,202101,3831,9633,3332,8957,524,1220,2040,5791,2564,7011
280410,202101,2240,6154,1811,5480,192,601,1029,3067,1221,3668
280420,202101,4289,11296,3962,10888,70,261,3647,9955,3717,10216
280430,202101,2046,4904,1803,4590,65,232,1474,3626,1539,3858
280440,202101,4237,11181,3744,10458,150,496,3157,8599,3307,9095
280445,202101,2340,5928,2095,5507,49,153,1565,3940,1614,4093
280450,202101,10163,23471,8835,21706,1017,2136,5812,14931,6829,17067
280460,202101,6867,16102,6217,15217,346,796,5318,12878,5664,13674
280470,202101,1677,4681,1438,4251,66,228,1074,3094,1140,3322
280480,202101,43259,103653,37398,95500,3050,8260,26582,66487,29632,74747
280490,202101,3774,10663,3248,9769,93,389,2505,7292,2598,7681
280500,202101,1014,2379,875,2195,27,87,744,1830,771,1917
280510,202101,2534,6307,2200,5847,76,269,1709,4451,1785,4720
280520,202101,1568,4019,1378,3757,52,149,1106,2971,1158,3120
280530,202101,2410,5984,2089,5539,287,638,1444,3977,1731,4615
280540,202101,8811,23463,8049,22378,247,836,7051,19359,7298,20195
280550,202101,6557,15116,5455,13584,159,579,4546,10904,4705,11483
280560,202101,7233,19735,6808,19100,132,483,6036,16714,6168,17197
280570,202101,6409,15450,5228,13958,229,697,3904,10417,4133,11114
280580,202101,5684,14805,4974,13780,578,1408,3526,9947,4104,11355
280590,202101,2846,6428,2438,5956,103,394,1937,4538,2040,4932
280600,202101,3512,9263,3108,8699,166,513,2233,6262,2399,6775
280610,202101,2452,6006,2210,5641,142,353,1805,4580,1947,4933
280620,202101,5507,13232,4750,12252,416,904,3336,9008,3752,9912
280630,202101,3817,10558,3513,10139,158,582,2900,8258,3058,8840
280640,202101,2323,6239,2051,5932,50,159,1826,5292,1876,5451
280650,202101,1179,3073,961,2759,85,285,705,1933,790,2218
280660,202101,3673,8003,3158,7402,220,402,2618,6260,2838,6662
280670,202101,19630,44133,16935,40689,1243,2927,13067,31422,14310,34349
280680,202101,2713,6470,2338,5941,221,418,1699,4398,1920,4816
280690,202101,961,2314,814,2123,52,119,642,1654,694,1773
280700,202101,1165,2900,1011,2671,23,86,807,2098,830,2184
280710,202101,15257,34017,12946,31388,538,1014,10888,27155,11426,28169
280720,202101,2654,6033,2207,5506,56,179,1630,4180,1686,4359
280730,202101,1075,2730,960,2550,51,154,727,1863,778,2017
280740,202101,13897,33778,11923,30807,705,1975,8657,21766,9362,23741
280750,202101,3631,10035,3166,9253,186,588,2287,6583,2473,7171
280760,202101,6435,16840,5612,15587,598,1528,3688,10582,4286,12110
290010,202101,3191,6654,2091,4953,5,16,1722,3906,1727,3922
290020,202101,5361,14068,4894,13482,342,622,4109,11742,4451,12364
290030,202101,4673,10495,3765,9505,179,396,3184,8164,3363,8560
290035,202101,5147,11065,4281,9958,353,533,3398,8233,3751,8766
290040,202101,4151,10100,3550,9382,106,283,2807,7831,2913,8114
290050,202101,2002,6437,1679,5738,114,476,1116,3712,1230,4188
290060,202101,1334,3117,997,2611,105,282,639,1676,744,1958
290070,202101,36828,79983,31713,73713,1734,4227,24846,57066,26580,61293
290080,202101,5208,15182,4512,14135,469,1552,3123,9908,3592,11460
290090,202101,2163,4131,1521,3449,17,53,1386,3122,1403,3175
290100,202101,9710,25105,7889,22434,1301,3468,4255,12740,5556,16208
290110,202101,5120,13445,4559,12594,316,888,3299,9018,3615,9906
290115,202101,3902,11196,3286,10106,222,741,2421,7396,2643,8137
290120,202101,6489,15832,5497,14466,131,419,4733,12268,4864,12687
290130,202101,4673,11315,3643,9977,155,436,2831,7763,2986,8199
290135,202101,4245,9870,3516,8710,163,432,2785,6672,2948,7104
290140,202101,4434,11489,3424,10159,93,335,2886,8537,2979,8872
290150,202101,2474,6311,2127,5883,136,369,1646,4594,1782,4963
290160,202101,3396,7641,3012,7118,257,536,2410,5704,2667,6240
290170,202101,3354,8432,2968,8014,111,288,2649,7237,2760,7525
290180,202101,2963,8033,2449,7194,77,284,2012,5852,2089,6136
290190,202101,4221,11675,3714,10984,137,521,3062,8934,3199,9455
290195,202101,2273,5654,1822,5064,26,135,1551,4271,1577,4406
290200,202101,4029,11219,3284,9974,167,567,2503,7528,2670,8095
290205,202101,3419,8750,3025,8179,132,463,2360,6174,2492,6637
290210,202101,12591,35340,11188,33220,814,2269,8695,26235,9509,28504
290220,202101,2880,7010,2528,6568,117,304,2078,5386,2195,5690
290225,202101,3119,6696,2404,5942,147,264,2010,5075,2157,5339
290230,202101,2444,6440,2230,6185,31,91,2010,5570,2041,5661
290240,202101,3711,9260,2956,8322,71,244,2491,7014,2562,7258
290250,202101,3920,11364,3281,10405,97,329,2703,8710,2800,9039
290260,202101,5466,13155,4615,11942,159,516,3889,9822,4048,10338
290265,202101,3527,10139,2877,8912,229,665,1999,6234,2228,6899
290270,202101,10712,36408,10033,35262,520,2275,8135,28324,8655,30599
290280,202101,6047,17913,5238,16322,290,1018,3794,11696,4084,12714
290290,202101,9819,28292,8011,25031,782,2642,5254,16195,6036,18837
290300,202101,4130,11187,3062,9176,145,478,2204,6572,2349,7050
290310,202101,1557,3812,1232,3421,46,211,966,2586,1012,2797
290320,202101,23943,61855,19037,54482,4189,11726,9049,27429,13238,39155
290323,202101,3709,10042,3241,9327,104,321,2566,7384,2670,7705
290327,202101,4049,11649,3484,10581,256,718,2518,7611,2774,8329
290330,202101,2188,4547,1700,4024,40,63,1511,3642,1551,3705
290340,202101,5644,13898,4302,12260,405,1170,3122,9037,3527,10207
290350,202101,4718,13008,3945,11703,282,837,2797,8348,3079,9185
290360,202101,5034,13087,4425,12303,132,331,3794,10653,3926,10984
290370,202101,5226,12663,3831,10835,171,434,2733,7907,2904,8341
290380,202101,5588,14735,4668,13480,118,284,3994,11750,4112,12034
290390,202101,14400,40865,12004,37085,1307,3956,7772,24450,9079,28406
290395,202101,2860,8176,2309,7248,60,282,1767,5469,1827,5751
290400,202101,3735,10001,3040,8850,83,342,2343,6680,2426,7022
290405,202101,4648,13386,4004,12292,299,941,2756,8654,3055,9595
290410,202101,5704,15294,4389,13201,120,528,3313,9701,3433,10229
290420,202101,2979,8143,2473,7368,67,226,1932,5718,1999,5944
290430,202101,3186,8591,2623,7721,236,714,1781,5161,2017,5875
290440,202101,2865,6976,2056,5715,51,123,1445,4102,1496,4225
290450,202101,3498,8785,2751,7654,151,378,1995,5637,2146,6015
290460,202101,11683,32735,9856,29304,1984,6000,4310,12839,6294,18839
290470,202101,4500,10970,3316,9342,389,1210,1899,5437,2288,6647
290475,202101,6458,18596,5488,16901,83,462,4529,13661,4612,14123
290480,202101,1756,4411,1437,3963,75,261,1017,2668,1092,2929
290485,202101,4445,12885,3933,12169,97,497,3378,10271,3475,10768
290490,202101,9010,21134,8096,19889,488,1088,6350,15871,6838,16959
290500,202101,4010,11912,3134,10065,536,1804,1360,4269,1896,6073
290510,202101,3426,8503,2860,7772,70,218,2477,6700,2547,6918
290515,202101,3633,10023,3169,9388,38,124,2864,8621,2902,8745
290520,202101,11500,32440,8951,27568,612,2002,5411,16487,6023,18489
290530,202101,4964,14094,4195,12845,124,503,3557,10816,3681,11319
290540,202101,3353,8731,3006,8351,46,145,2787,7732,2833,7877
290550,202101,4235,11058,3718,10447,11,64,3426,9726,3437,9790
290560,202101,6235,16086,4748,13925,388,1430,3124,8853,3512,10283
290570,202101,44237,108014,39274,101774,2457,6483,31584,81415,34041,87898
290580,202101,7813,22578,6744,21041,611,1834,4944,15845,5555,17679
290590,202101,7037,21446,5947,19506,151,585,4785,15779,4936,16364
290600,202101,19064,52002,16831,48401,676,2069,13638,39058,14314,41127
290610,202101,2570,7862,2028,6758,93,362,1426,4707,1519,5069
290620,202101,6192,17388,5377,16056,190,545,4537,13543,4727,14088
290630,202101,9219,22034,7371,19678,606,1558,5622,15198,6228,16756
290640,202101,2775,7090,2160,6211,89,258,1548,4576,1637,4834
290650,202101,12882,31637,11372,29952,2469,6199,7143,19696,9612,25895
290660,202101,3583,9193,3014,8375,54,156,2268,6490,2322,6646
290670,202101,6600,18108,5613,16500,363,1018,4274,12774,4637,13792
290680,202101,10810,29724,9052,27130,198,1026,7498,22024,7696,23050
290682,202101,4735,12103,4115,11279,124,280,3476,9619,3600,9899
290685,202101,3456,7751,2494,6386,201,462,1524,4199,1725,4661
290687,202101,6404,17302,5243,15423,674,1890,3394,10255,4068,12145
290689,202101,2854,7811,2177,6573,194,631,1464,4423,1658,5054
290690,202101,5304,13760,4317,12389,285,891,3154,8910,3439,9801
290700,202101,2601,7074,2286,6673,58,210,1943,5687,2001,5897
290710,202101,8114,22878,6972,21298,158,637,5885,18001,6043,18638
290720,202101,18291,49800,16670,47335,901,2829,13441,37712,14342,40541
290730,202101,7045,16627,6012,15435,292,576,4715,12355,5007,12931
290740,202101,1007,2721,792,2373,38,119,649,1953,687,2072
290750,202101,10777,26685,9362,24484,604,1689,6993,17803,7597,19492
290755,202101,1997,5635,1624,4962,89,279,1144,3533,1233,3812
290760,202101,3656,10643,2986,9384,172,503,2038,6609,2210,7112
290770,202101,2654,8294,2440,8025,46,225,2069,6870,2115,7095
290780,202101,8152,20142,7075,18737,262,585,5528,14997,5790,15582
290790,202101,4632,12768,4036,11908,167,470,3303,9896,3470,10366
290800,202101,7000,14458,4961,12074,287,644,3705,9112,3992,9756
290810,202101,5220,13664,4230,12235,109,344,3230,9546,3339,9890
290820,202101,4753,12854,4296,12223,172,502,3269,9423,3441,9925
290830,202101,4471,10125,3956,9476,26,73,3470,8201,3496,8274
290840,202101,17226,44870,14740,41041,1983,4549,9342,27808,11325,32357
290850,202101,6634,15816,5929,15066,201,502,5100,13082,5301,13584
290860,202101,6162,17383,5371,16482,216,682,4539,14214,4755,14896
290870,202101,4714,12912,3596,10788,153,472,2513,7497,2666,7969
290880,202101,1377,3404,1107,3052,70,179,754,2175,824,2354
290890,202101,9212,18536,8313,17542,150,319,7803,16407,7953,16726
290900,202101,2394,6176,1853,5231,103,235,1158,3271,1261,3506
290910,202101,5112,12144,3931,10358,47,144,3357,8762,3404,8906
290920,202101,5111,12744,4647,12213,83,128,4350,11614,4433,11742
290930,202101,7479,20805,6071,18354,218,895,4715,13883,4933,14778
290940,202101,3552,10018,2987,9206,162,565,2425,7445,2587,8010
290950,202101,1450,3626,1183,3225,70,190,825,2261,895,2451
290960,202101,5479,14083,4923,13400,173,434,4185,11448,4358,11882
290970,202101,3239,9526,2666,8486,102,378,2062,6566,2164,6944
290980,202101,12120,28680,10199,25814,783,2150,6418,15786,7201,17936
290990,202101,9576,25213,8526,23533,258,1014,7184,19194,7442,20208
291000,202101,3354,8585,2602,7634,111,337,2136,6329,2247,6666
291005,202101,15217,37313,13445,35041,1299,3039,10351,27283,11650,30322
291010,202101,3043,9129,2492,7957,115,408,1647,5123,1762,5531
291020,202101,1237,3018,999,2606,23,80,731,1798,754,1878
291030,202101,2506,6053,1765,4787,111,271,1085,2880,1196,3151
291040,202101,5360,14534,4488,13318,150,565,3559,10524,3709,11089
291050,202101,7492,19355,6385,17861,586,1836,4684,12898,5270,14734
291060,202101,5987,18054,5070,16834,313,1336,3837,12678,4150,14014
291070,202101,15955,42486,13383,38404,421,1414,10931,31197,11352,32611
291072,202101,24170,60977,17550,49995,3171,9354,7599,21843,10770,31197
291075,202101,5350,13093,4829,12310,102,270,4057,10176,4159,10446
291077,202101,1621,4182,1268,3575,58,121,890,2519,948,2640
291080,202101,109906,266661,86476,234385,25208,70112,23907,70475,49115,140587
291085,202101,5565,13982,4695,12642,169,508,3928,10558,4097,11066
291090,202101,1980,3751,1423,3126,47,100,1146,2471,1193,2571
291100,202101,3199,6912,2214,5745,98,254,1696,4364,1794,4618
291110,202101,5934,17488,5062,16031,308,1223,3878,11867,4186,13090
291120,202101,7445,18133,6270,16657,286,811,4852,12873,5138,13684
291125,202101,2175,3801,1652,3228,89,132,1334,2646,1423,2778
291130,202101,3284,9223,2428,7562,64,288,1804,5441,1868,5729
291140,202101,4883,13010,3569,10657,450,1216,2177,6533,2627,7749
291150,202101,2464,5319,1892,4675,4,12,1786,4408,1790,4420
291160,202101,4988,13564,4147,12362,361,1145,2794,8284,3155,9429
291165,202101,2132,5774,1614,4756,27,119,1198,3431,1225,3550
291170,202101,20803,52209,17412,46583,909,2684,11596,30429,12505,33113
291180,202101,6337,14408,4644,12196,239,611,3634,9547,3873,10158
291185,202101,3028,8082,2667,7516,95,279,2063,5843,2158,6122
291190,202101,7653,18560,6316,16855,277,845,5011,13343,5288,14188
291200,202101,2801,7576,2076,6214,84,264,1301,3742,1385,4006
291210,202101,7047,14971,5264,12932,133,435,3884,9605,4017,10040
291220,202101,4003,11316,3607,10733,166,607,2901,8518,3067,9125
291230,202101,4407,9418,3315,8228,33,85,2996,7508,3029,7593
291240,202101,4135,10561,3543,9570,59,207,3047,8125,3106,8332
291250,202101,3328,9729,2610,8418,146,445,1693,5503,1839,5948
291260,202101,1442,3362,1184,3027,28,84,971,2501,999,2585
291270,202101,5362,13763,4167,12052,634,1838,2591,7689,3225,9527
291280,202101,2634,6270,1942,5273,152,421,1253,3370,1405,3791
291290,202101,5744,14988,4440,12983,327,1029,3053,8873,3380,9902
291300,202101,3759,10178,2971,8880,114,414,2283,6722,2397,7136
291310,202101,5017,13279,4314,12016,118,368,3652,10058,3770,10426
291320,202101,5950,16408,4640,14012,1020,2877,2312,7418,3332,10295
291330,202101,1767,4486,1472,4008,80,206,1101,2966,1181,3172
291340,202101,4256,10891,3439,9485,80,269,2622,7114,2702,7383
291345,202101,2883,8602,2619,8192,97,339,2216,6937,2313,7276
291350,202101,6804,16694,5294,14894,46,149,4613,13214,4659,13363
291360,202101,36559,83090,28793,73826,2701,6856,19048,50053,21749,56909
291370,202101,8066,21721,7127,20289,535,1604,5290,14799,5825,16403
291380,202101,3383,9171,2979,8626,100,406,2494,7160,2594,7566
291390,202101,13145,27969,10132,24642,434,1011,8384,20425,8818,21436
291400,202101,13629,34745,11252,31214,1514,3695,6666,19978,8180,23673
291410,202101,2956,7682,2318,6596,36,146,1708,4770,1744,4916
291420,202101,1964,4714,1540,4195,23,96,1359,3678,1382,3774
291430,202101,2711,7627,2351,7038,63,280,1899,5509,1962,5789
291440,202101,6386,18072,5553,16708,342,1055,4298,12990,4640,14045
291450,202101,9764,22746,8064,20806,75,127,7124,18870,7199,18997
291460,202101,15670,41064,13754,38234,677,2067,10411,28733,11088,30800
291465,202101,9271,22490,7295,20238,126,565,6345,17476,6471,18041
291470,202101,17100,37645,14256,34442,812,1727,10554,26306,11366,28033
291480,202101,41738,91668,31007,77278,3637,9303,16482,41119,20119,50422
291490,202101,5511,13627,4744,12763,132,426,4288,11477,4420,11903
291500,202101,4965,12072,4168,11009,63,273,3812,10011,3875,10284
291510,202101,4321,10558,3212,9171,46,266,2696,7621,2742,7887
291520,202101,4507,10138,3395,8683,185,500,2629,6674,2814,7174
291530,202101,2317,5219,1642,4350,325,790,900,2641,1225,3431
291535,202101,3363,9784,2971,9101,161,450,2301,7258,2462,7708
291540,202101,2241,4947,1544,4133,68,220,1271,3370,1339,3590
291550,202101,5611,12770,4371,11217,399,838,2977,7856,3376,8694
291560,202101,18226,42888,13258,36371,1394,3639,7831,22448,9225,26087
291570,202101,2392,5655,1886,5036,53,153,1564,4319,1617,4472
291580,202101,6273,16010,4943,14253,241,748,3650,10457,3891,11205
291590,202101,2194,5253,1908,4927,69,241,1699,4289,1768,4530
291600,202101,5418,12436,4181,10567,361,967,2884,7063,3245,8030
291610,202101,5599,14462,5019,13827,68,259,4622,12700,4690,12959
291620,202101,3104,6927,2335,6094,109,266,1813,4842,1922,5108
291630,202101,3357,7392,2518,6305,300,810,1804,4444,2104,5254
291640,202101,16091,38813,12159,33196,1706,4379,5644,15949,7350,20328
291650,202101,9421,23270,8368,22035,566,1038,7026,19043,7592,20081
291660,202101,2038,4948,1503,4139,135,415,975,2548,1110,2963
291670,202101,2035,5347,1720,4899,96,242,1308,3783,1404,4025
291680,202101,4042,9813,3286,8745,297,807,2347,6234,2644,7041
291685,202101,4726,11174,3790,9987,221,467,2871,7825,3092,8292
291690,202101,4124,9015,2879,7232,269,535,2149,5489,2418,6024
291700,202101,8623,24680,7600,22905,325,1158,6200,18357,6525,19515
291710,202101,5198,12242,3876,10418,213,656,2821,7465,3034,8121
291720,202101,4450,13310,3741,11899,554,1818,2274,7125,2828,8943
291730,202101,6282,15836,5422,14722,253,757,4520,12200,4773,12957
291733,202101,2782,7107,2384,6590,56,160,1749,5081,1805,5241
291735,202101,2931,7673,2351,6650,72,165,1779,5008,1851,5173
291740,202101,3950,10116,2939,8234,94,224,2042,5684,2136,5908
291750,202101,19415,45939,15893,40846,1560,3895,10682,27896,12242,31791
291760,202101,10150,28980,7954,25518,2403,8703,2211,7079,4614,15782
291770,202101,7064,18707,5941,16809,326,1009,4528,12492,4854,13501
291780,202101,5155,13518,4647,12817,88,311,4083,11152,4171,11463
291790,202101,2758,7473,2505,7152,233,549,1890,5586,2123,6135
291800,202101,29032,72186,21709,61446,3545,9688,10415,30842,13960,40530
291810,202101,10517,24723,8852,22714,307,738,7443,19332,7750,20070
291820,202101,3833,9935,3345,9312,85,274,2717,7568,2802,7842
291830,202101,4481,10416,3667,9333,194,391,2895,7406,3089,7797
291835,202101,6520,19352,5155,16766,506,1747,3314,10927,3820,12674
291840,202101,47087,128283,41058,119044,4208,13038,28982,83452,33190,96490
291845,202101,2528,6485,1989,5825,120,358,1599,4748,1719,5106
291850,202101,3787,10839,3126,9750,239,726,2254,7208,2493,7934
291855,202101,2222,4278,1720,3723,40,95,1549,3360,1589,3455
291860,202101,2259,5845,1579,4540,50,138,1063,2946,1113,3084
291870,202101,1269,3180,855,2460,41,118,582,1650,623,1768
291875,202101,2929,8702,2529,7873,62,250,1871,5660,1933,5910
291880,202101,5669,15912,4815,14485,223,644,3564,10817,3787,11461
291890,202101,1618,3275,1051,2622,131,290,700,1768,831,2058
291900,202101,1288,2999,997,2557,19,67,785,1959,804,2026
291905,202101,2403,6118,1985,5465,77,276,1525,4048,1602,4324
291910,202101,3001,7371,2544,6816,56,193,2179,5988,2235,6181
291915,202101,7279,20507,5943,18273,214,754,4494,13981,4708,14735
291920,202101,26185,67174,22190,61734,2019,6139,15603,42580,17622,48719
291930,202101,2483,6614,2135,6147,224,652,1459,4244,1683,4896
291940,202101,3898,9846,2616,7683,199,581,1535,4483,1734,5064
291950,202101,9026,27122,7676,24526,268,997,5380,17005,5648,18002
291955,202101,15186,38166,13494,35995,1093,3072,10625,28397,11718,31469
291960,202101,3002,7912,2525,7275,124,362,1971,5822,2095,6184
291970,202101,4493,11193,3760,10303,123,408,2877,7911,3000,8319
291980,202101,9445,26907,7536,23586,1053,3041,4489,14488,5542,17529
291990,202101,2327,5946,1910,5447,30,124,1767,5045,1797,5169
291992,202101,3845,9254,3105,8307,236,526,2462,6741,2698,7267
291995,202101,2092,5731,1728,5138,51,214,1320,3844,1371,4058
292000,202101,2608,6026,2133,5469,89,328,1688,4276,1777,4604
292010,202101,5625,13080,4610,11665,158,474,3853,9542,4011,10016
292020,202101,4564,13057,3785,11684,202,730,2740,8185,2942,8915
292030,202101,1787,5446,1627,5150,74,264,1052,3267,1126,3531
292040,202101,4433,11193,3468,9755,228,584,2640,7576,2868,8160
292045,202101,4044,10425,2998,8890,32,90,2642,7987,2674,8077
292050,202101,6443,17855,5247,15798,240,829,3389,10067,3629,10896
292060,202101,11109,25620,10264,24574,454,1024,9009,21385,9463,22409
292070,202101,5670,14745,4950,13892,284,818,4258,11867,4542,12685
292080,202101,3044,7699,2545,7055,76,265,2261,6206,2337,6471
292090,202101,4534,9789,3199,8185,237,650,2399,6164,2636,6814
292100,202101,10972,26414,9436,24523,943,2512,6549,17090,7492,19602
292105,202101,3614,8713,3159,8103,91,209,2644,6791,2735,7000
292110,202101,5980,14318,4235,11600,910,2544,2034,5567,2944,8111
292120,202101,6878,17457,5716,15561,339,956,4346,11649,4685,12605
292130,202101,3419,8109,2829,7385,106,321,2212,5696,2318,6017
292140,202101,4978,11704,4224,10588,315,787,3363,8403,3678,9190
292145,202101,2321,6706,1973,6114,69,184,1511,4746,1580,4930
292150,202101,14531,38678,12635,35622,294,1117,10343,28645,10637,29762
292160,202101,2956,7138,2229,6206,36,98,1814,5306,1850,5404
292170,202101,8340,22082,6979,19896,323,1094,5296,14780,5619,15874
292180,202101,2837,7719,2102,6357,156,469,1305,3891,1461,4360
292190,202101,2906,7612,2485,6975,87,301,1964,5461,2051,5762
292200,202101,8631,20986,6440,17945,1076,3131,3225,9314,4301,12445
292205,202101,3817,10485,3320,9756,57,255,2896,8480,2953,8735
292210,202101,6532,15029,5286,13468,83,348,4764,12013,4847,12361
292220,202101,2205,5100,1938,4701,51,127,1543,3620,1594,3747
292225,202101,3152,9139,2784,8581,67,312,2391,7228,2458,7540
292230,202101,8538,20308,7662,19206,155,509,6618,16312,6773,16821
292240,202101,4644,13393,4100,12432,306,899,2889,8790,3195,9689
292250,202101,5863,14874,5291,14046,398,1035,4014,10603,4412,11638
292260,202101,3393,8755,3025,8278,92,249,2638,7229,2730,7478
292265,202101,3343,9025,2806,8219,67,278,2238,6443,2305,6721
292270,202101,4328,9877,3447,8831,111,277,2875,7384,2986,7661
292273,202101,2781,5856,2228,5190,51,87,1630,4078,1681,4165
292275,202101,1587,4123,1248,3674,54,157,945,2835,999,2992
292280,202101,2634,6149,2122,5564,81,159,1795,4845,1876,5004
292285,202101,2530,6077,2035,5414,73,154,1666,4474,1739,4628
292290,202101,7498,19433,5927,17260,166,604,4868,14124,5034,14728
292300,202101,10550,25853,8333,22917,810,2333,5743,15863,6553,18196
292303,202101,2914,8272,2542,7674,81,193,2127,6483,2208,6676
292305,202101,2255,6025,2086,5798,43,189,1893,5175,1936,5364
292310,202101,6695,16645,5795,15563,135,441,5090,13538,5225,13979
292320,202101,6091,16503,4854,14225,271,877,3522,10052,3793,10929
292330,202101,2718,5941,2207,5366,102,194,1715,4360,1817,4554
292335,202101,4646,12046,4148,11332,207,499,3511,9674,3718,10173
292340,202101,5455,15222,4541,13491,211,604,3373,9964,3584,10568
292350,202101,2468,6670,2065,6119,74,271,1683,5003,1757,5274
292360,202101,4898,12946,4092,11592,234,727,2879,8056,3113,8783
292370,202101,10235,23850,8855,22072,115,393,8242,20299,8357,20692
292380,202101,6616,18481,5944,17288,378,1120,4564,13156,4942,14276
292390,202101,4556,8602,3361,7213,122,228,2946,6329,3068,6557
292400,202101,22134,62207,19164,57542,1857,5633,13196,39909,15053,45542
292405,202101,4507,10794,3805,9699,85,216,3177,7983,3262,8199
292410,202101,2226,5255,1847,4777,67,147,1624,4231,1691,4378
292420,202101,3337,10125,3067,9727,97,504,2673,8249,2770,8753
292430,202101,4782,14167,3633,12074,269,910,2367,7912,2636,8822
292440,202101,8499,26623,7892,25706,128,630,7095,22976,7223,23606
292450,202101,4010,11360,3146,9699,85,315,2471,7572,2556,7887
292460,202101,4873,13197,3998,11751,325,896,2903,8562,3228,9458
292465,202101,2678,6777,2298,6297,95,200,1542,4658,1637,4858
292467,202101,1880,5263,1652,4955,241,644,1149,3588,1390,4232
292470,202101,2900,7329,2265,6364,54,112,1782,5019,1836,5131
292480,202101,6256,14632,5102,13233,73,275,4641,11931,4714,12206
292490,202101,2068,5279,1756,4823,122,272,1329,3745,1451,4017
292500,202101,6533,17700,5230,15430,492,1523,3386,9880,3878,11403
292510,202101,13188,35108,10314,30603,522,1765,7217,21362,7739,23127
292520,202101,7013,17261,6215,16138,436,1163,4879,12553,5315,13716
292525,202101,5881,13852,4815,12664,118,265,4189,11198,4307,11463
292530,202101,28177,73507,21845,63065,5032,14693,8844,26120,13876,40813
292540,202101,4363,7962,3420,6958,120,205,3089,6308,3209,6513
292550,202101,8366,21425,6447,19143,504,1412,4500,14374,5004,15786
292560,202101,4381,10815,3818,10080,88,237,3177,8467,3265,8704
292570,202101,3570,9377,3006,8322,76,277,2534,6848,2610,7125
292575,202101,6827,19402,6282,18693,385,1101,5051,15211,5436,16312
292580,202101,7601,18910,6299,17002,131,426,5332,14247,5463,14673
292590,202101,7322,19390,6232,17505,282,875,5096,14104,5378,14979
292593,202101,2794,6937,2331,6178,65,169,1971,5170,2036,5339
292595,202101,5368,14148,4582,13188,143,491,3875,11085,4018,11576
292600,202101,10726,29062,9302,26900,322,919,7436,21567,7758,22486
292610,202101,4131,10677,3530,9626,191,434,2657,7349,2848,7783
292620,202101,6331,17208,5288,15951,124,273,4810,14815,4934,15088
292630,202101,8463,20441,6824,17871,724,1873,4362,11541,5086,13414
292640,202101,8251,23853,7177,22067,196,734,5139,15957,5335,16691
292650,202101,4415,10850,3981,10290,104,287,3625,9275,3729,9562
292660,202101,11315,30110,9624,27672,447,1394,7359,21231,7806,22625
292665,202101,2179,6363,1886,5975,66,196,1587,5100,1653,5296
292670,202101,3519,9435,2728,7973,115,358,1852,5306,1967,5664
292680,202101,3920,10249,3112,8847,178,466,2295,6409,2473,6875
292690,202101,2597,6621,1801,5330,195,533,1076,3332,1271,3865
292700,202101,9907,26608,8672,24720,758,1880,5969,17644,6727,19524
292710,202101,2537,7628,2363,7393,38,124,2161,6790,2199,6914
292720,202101,8991,21184,7593,19576,211,551,6068,15937,6279,16488
292730,202101,4685,10530,4363,10111,310,507,3677,8744,3987,9251
292740,202101,314211,749931,270696,688927,36736,93207,170139,431810,206875,525017
292750,202101,6073,16156,5355,15135,220,633,4177,12008,4397,12641
292760,202101,3872,11035,3383,10179,208,682,2498,7454,2706,8136
292770,202101,6267,16040,5069,14395,739,2156,3295,9606,4034,11762
292780,202101,2073,4066,1541,3431,68,163,1236,2635,1304,2798
292790,202101,4076,8518,3107,7472,172,385,2556,6210,2728,6595
292800,202101,11185,27856,9572,25430,290,823,8027,21056,8317,21879
292805,202101,3649,8576,2868,7574,113,336,2277,5957,2390,6293
292810,202101,10606,27455,8469,24111,207,831,6430,17734,6637,18565
292820,202101,7261,19998,5355,16799,415,1376,3733,11540,4148,12916
292830,202101,2873,6727,2463,6223,87,237,2094,5332,2181,5569
292840,202101,8586,22435,7285,20689,143,531,6376,17852,6519,18383
292850,202101,2468,6507,2076,5942,148,441,1453,4141,1601,4582
292860,202101,16930,37041,15228,35059,384,971,13254,30135,13638,31106
292870,202101,17907,43918,15443,40542,995,2589,10569,27524,11564,30113
292880,202101,10841,29392,9254,27017,246,1008,7331,20714,7577,21722
292890,202101,7107,19316,6294,18163,170,683,5541,15869,5711,16552
292895,202101,3067,6432,2270,5263,105,230,1833,4215,1938,4445
292900,202101,2588,6890,2349,6525,56,220,1948,5261,2004,5481
292905,202101,4222,10798,3366,9546,113,373,2531,7109,2644,7482
292910,202101,4755,12886,4349,12320,205,571,3376,9505,3581,10076
292920,202101,9636,26320,8940,25360,265,979,7672,21413,7937,22392
292925,202101,5372,15050,4519,13540,220,637,3254,9713,3474,10350
292930,202101,6329,18386,5494,16895,462,1575,3545,10671,4007,12246
292935,202101,2476,6067,1926,5460,20,110,1735,4932,1755,5042
292937,202101,2761,6890,2385,6400,66,176,1985,5357,2051,5533
292940,202101,2812,7085,2245,6256,172,390,1636,4753,1808,5143
292950,202101,9292,23371,8134,21717,505,1155,6156,16425,6661,17580
292960,202101,5153,12405,4322,11243,123,315,3464,8937,3587,9252
292970,202101,3767,10676,3346,10047,79,358,2811,8454,2890,8812
292975,202101,4432,9375,3945,8839,114,187,3606,8172,3720,8359
292980,202101,3201,7683,2591,6789,74,238,2150,5552,2224,5790
292990,202101,11167,30679,9402,27563,629,1925,6878,19879,7507,21804
293000,202101,2669,6194,2295,5635,41,139,1846,4538,1887,4677
293010,202101,17976,45565,14586,40370,1916,5495,8894,24641,10810,30136
293015,202101,8242,25018,6546,21773,434,1548,4340,14757,4774,16305
293020,202101,9706,27961,8764,26626,134,560,7921,24103,8055,24663
293030,202101,5158,13494,3960,11637,105,334,2740,8268,2845,8602
293040,202101,4401,11375,3707,10394,69,256,3248,9075,3317,9331
293050,202101,22506,54163,19917,50360,1135,2830,15092,37681,16227,40511
293060,202101,3462,9149,2810,7947,229,671,1951,5443,2180,6114
293070,202101,24385,58619,21387,54861,1884,5055,15916,40700,17800,45755
293075,202101,3572,11074,3110,10286,141,618,2505,8257,2646,8875
293076,202101,3461,8463,3166,8120,49,138,2847,7358,2896,7496
293077,202101,6304,17172,5095,15267,456,1465,3179,9920,3635,11385
293080,202101,4759,13805,4102,12682,86,386,3346,10146,3432,10532
293090,202101,3227,9278,2496,8076,211,670,1611,5302,1822,5972
293100,202101,5801,15199,4811,13445,203,565,3806,10544,4009,11109
293105,202101,3745,11840,3289,10904,237,805,2305,7601,2542,8406
293110,202101,2384,5892,1985,5314,67,230,1620,4245,1687,4475
293120,202101,4379,11787,3911,11067,113,280,3255,9245,3368,9525
293130,202101,3655,10026,3193,9426,73,277,2765,8087,2838,8364
293135,202101,29902,69237,22292,59377,3320,9648,10761,28967,14081,38615
293140,202101,2396,5226,2086,4856,57,119,1766,4111,1823,4230
293150,202101,5468,16104,4503,14300,324,1039,3087,9872,3411,10911
293160,202101,3755,9158,3203,8559,236,379,2701,7579,2937,7958
293170,202101,4902,10185,4287,9430,115,246,3756,8229,3871,8475
293180,202101,4310,12072,3600,10780,80,322,2865,8372,2945,8694
293190,202101,13980,37609,12397,35366,133,598,11066,31329,11199,31927
293200,202101,8389,20639,6779,18087,187,654,5506,14380,5693,15034
293210,202101,5113,13472,4409,12391,273,774,3410,9562,3683,10336
293220,202101,4783,12191,3522,10128,813,2355,1442,4250,2255,6605
293230,202101,3771,9611,2779,8215,205,657,1906,5701,2111,6358
293240,202101,4496,11797,3622,10381,67,157,2744,8214,2811,8371
293245,202101,3730,10098,3400,9617,142,464,2901,8098,3043,8562
293250,202101,5887,13546,4802,12167,155,382,4016,10187,4171,10569
293260,202101,4628,12135,3836,10901,157,452,2653,7605,2810,8057
293270,202101,7130,15634,5627,14027,402,585,4395,11836,4797,12421
293280,202101,4350,11458,3828,10732,234,582,2994,8523,3228,9105
293290,202101,14618,41545,12937,38957,1588,4868,8711,26442,10299,31310
293300,202101,5660,13664,4882,12536,274,690,3585,9283,3859,9973
293305,202101,4071,9522,3579,8930,54,118,3242,8100,3296,8218
293310,202101,2054,5255,1740,4775,47,143,1391,3776,1438,3919
293315,202101,4091,9549,3403,8520,202,446,2793,7006,2995,7452
293317,202101,2639,6150,2357,5768,145,270,1868,4589,2013,4859
293320,202101,12192,28828,10801,27291,227,641,9735,24438,9962,25079
293325,202101,1742,4251,1352,3742,208,563,818,2313,1026,2876
293330,202101,59492,164972,48544,146015,8593,26863,22892,68627,31485,95490
293340,202101,2161,6057,1801,5431,76,249,1285,3837,1361,4086
293345,202101,3520,9424,2834,8415,373,863,1813,5938,2186,6801
293350,202101,6479,18608,5601,17566,60,308,5120,16256,5180,16564
293360,202101,15121,37763,12896,34793,284,1182,11396,30203,11680,31385
310010,202101,947,2103,608,1638,45,164,229,574,274,738
310020,202101,2715,7206,2031,6011,434,1392,464,1309,898,2701
310030,202101,1864,5185,1434,4444,206,701,928,2778,1134,3479
310040,202101,870,2260,695,1965,32,133,469,1225,501,1358
310050,202101,1473,4357,1232,3977,116,480,822,2554,938,3034
310060,202101,3096,8716,2697,8180,74,300,2257,6776,2331,7076
310070,202101,337,756,238,616,10,21,177,455,187,476
310080,202101,670,1763,480,1421,73,237,225,629,298,866
310090,202101,4699,12235,3881,10918,274,816,2869,7956,3143,8772
310100,202101,3493,9491,2947,8591,73,329,2418,6852,2491,7181
310110,202101,4576,11886,3557,10147,730,2268,1604,4410,2334,6678
310120,202101,623,1506,394,1145,40,140,235,638,275,778
310130,202101,355,914,301,838,26,101,225,597,251,698
310140,202101,261,751,186,629,40,157,69,202,109,359
310150,202101,5516,14257,4122,11749,521,1693,2001,5358,2522,7051
310160,202101,7871,19333,5668,15754,1034,3160,2064,5748,3098,8908
310163,202101,1002,2973,819,2639,181,666,270,799,451,1465
310170,202101,9281,23288,7439,20447,632,1784,5257,14438,5889,16222
310180,202101,1748,4289,1280,3530,154,459,748,2015,902,2474
310190,202101,2645,7586,2153,6705,475,1654,354,1033,829,2687
310200,202101,1858,5431,1362,4479,163,615,664,2149,827,2764
310205,202101,1104,3018,881,2674,137,470,479,1431,616,1901
310210,202101,2554,6785,2118,6024,112,321,1526,4256,1638,4577
310220,202101,1268,3410,981,2854,81,254,652,1820,733,2074
310230,202101,2208,6022,1783,5242,219,703,1130,3103,1349,3806
310240,202101,985,2955,838,2698,50,186,593,1854,643,2040
310250,202101,1050,2767,845,2431,18,75,588,1678,606,1753
310260,202101,3124,7953,2080,6142,598,2050,629,1491,1227,3541
310270,202101,2713,6563,2174,5836,91,282,1798,4815,1889,5097
310280,202101,2452,5626,1917,4859,251,668,1148,2804,1399,3472
310285,202101,1843,5795,1533,5245,166,623,941,3202,1107,3825
310290,202101,1106,2877,901,2523,192,615,473,1194,665,1809
310300,202101,1518,4344,1292,3959,137,514,756,2154,893,2668
310310,202101,307,733,199,545,35,99,96,255,131,354
310320,202101,528,1321,365,1071,23,83,203,564,226,647
310330,202101,474,1109,288,787,45,141,114,279,159,420
310340,202101,7954,20804,6464,18333,830,2329,3378,9706,4208,12035
310350,202101,12655,30119,8765,23964,1429,4197,4159,10934,5588,15131
310360,202101,500,1124,380,970,10,31,262,671,272,702
310370,202101,1275,3880,1088,3536,202,716,354,1215,556,1931
310375,202101,854,2105,598,1725,92,269,324,939,416,1208
310380,202101,396,892,216,608,33,98,98,262,131,360
310390,202101,444,1303,353,1127,76,257,98,274,174,531
310400,202101,10205,24697,7444,20574,663,2134,4617,12453,5280,14587
310410,202101,856,2457,566,1927,83,310,223,708,306,1018
310420,202101,4383,11287,3053,8807,391,1264,1289,3447,1680,4711
310430,202101,1459,3911,975,3024,202,686,356,984,558,1670
310440,202101,652,1691,454,1333,42,150,239,659,281,809
310445,202101,1374,3860,1010,3138,53,159,729,2223,782,2382
310450,202101,4550,11347,3455,9635,136,505,2654,7191,2790,7696
310460,202101,1723,4531,1299,3755,215,669,476,1270,691,1939
310470,202101,3649,8019,2859,6988,295,694,1980,4983,2275,5677
310480,202101,977,2480,764,2139,85,247,481,1305,566,1552
310490,202101,2748,7427,2175,6503,217,799,1249,3511,1466,4310
310500,202101,1328,3701,1009,3171,174,626,540,1629,714,2255
310510,202101,2055,5276,1369,4036,242,790,516,1518,758,2308
310520,202101,1158,3003,848,2449,135,373,451,1314,586,1687
310530,202101,728,1819,485,1399,67,233,167,394,234,627
310540,202101,2920,8180,2424,7320,510,1623,1109,3219,1619,4842
310550,202101,1254,3160,894,2564,78,287,507,1346,585,1633
310560,202101,14726,37940,10561,30716,1412,4679,4658,12241,6070,16920
310570,202101,1021,2667,809,2372,56,200,599,1727,655,1927
310590,202101,4059,10696,3246,9166,192,609,1887,5016,2079,5625
310600,202101,1307,3804,1079,3343,137,482,560,1646,697,2128
310610,202101,467,1247,298,973,107,360,40,114,147,474
310620,202101,171942,430699,125925,349281,16730,53913,63239,159692,79969,213605
310630,202101,4478,12117,3526,10267,344,1064,2170,6104,2514,7168
310640,202101,1094,3211,900,2838,181,613,368,1114,549,1727
310650,202101,2399,6703,1755,5467,170,560,1032,3110,1202,3670
310660,202101,1306,3466,1068,3145,29,98,906,2652,935,2750
310665,202101,1414,3563,1146,3186,26,101,936,2629,962,2730
310670,202101,58446,148081,49518,133128,4389,13393,34290,87842,38679,101235
310680,202101,767,1784,638,1607,18,64,547,1327,565,1391
310690,202101,1979,5071,1424,4135,110,372,819,2258,929,2630
310700,202101,478,1051,382,935,21,68,307,726,328,794
310710,202101,5597,15691,4129,13525,833,3231,793,2314,1626,5545
310720,202101,1038,2364,809,2077,29,91,619,1534,648,1625
310730,202101,10173,26564,8707,24254,377,1295,6518,17751,6895,19046
310740,202101,6332,17063,4561,13487,646,2135,1775,4739,2421,6874
310750,202101,1221,2923,926,2498,102,309,507,1274,609,1583
310760,202101,648,1630,457,1338,36,113,245,724,281,837
310770,202101,1081,2857,746,2354,78,304,387,1117,465,1421
310780,202101,4262,10076,3557,9158,68,182,2922,7530,2990,7712
310790,202101,1783,5579,1529,5042,345,1207,250,727,595,1934
310800,202101,2349,6857,1741,5640,345,1361,105,270,450,1631
310810,202101,1283,3123,1054,2749,45,126,759,1906,804,2032
310820,202101,1232,3069,747,2252,159,496,164,513,323,1009
310825,202101,2588,7684,2079,6845,67,381,1686,5361,1753,5742
310830,202101,1882,5218,1345,4173,236,855,573,1676,809,2531
310840,202101,2062,5530,1527,4627,335,1172,398,1043,733,2215
310850,202101,1440,3949,1209,3622,40,201,946,2706,986,2907
310855,202101,3050,8004,2366,6899,159,556,1696,4811,1855,5367
310860,202101,6812,19618,5502,17102,550,1790,3367,10580,3917,12370
310870,202101,948,2270,754,1991,56,135,556,1482,612,1617
310880,202101,982,2913,783,2514,111,377,433,1350,544,1727
310890,202101,2158,6132,1405,4637,258,918,213,608,471,1526
310900,202101,3783,10387,2588,7785,376,1162,1109,3132,1485,4294
310910,202101,2181,5239,1538,4235,140,446,332,843,472,1289
310920,202101,1895,4874,1452,4212,197,618,836,2378,1033,2996
310925,202101,912,2472,742,2193,65,227,506,1417,571,1644
310930,202101,5743,14796,4026,12031,780,2377,1810,5644,2590,8021
310940,202101,6626,15525,5348,13690,186,572,4123,10272,4309,10844
310945,202101,1258,3274,983,2835,173,524,475,1332,648,1856
310950,202101,1873,5506,1265,4161,227,831,374,1029,601,1860
310960,202101,726,1937,407,1265,66,242,77,218,143,460
310970,202101,1125,3277,790,2582,200,724,135,407,335,1131
310980,202101,254,604,167,474,19,64,106,291,125,355
310990,202101,1284,3487,1010,3026,153,499,540,1589,693,2088
311000,202101,3876,10648,2843,8962,688,2316,1160,3575,1848,5891
311010,202101,895,2533,720,2191,211,709,303,899,514,1608
311020,202101,1114,2807,706,2066,38,117,381,1098,419,1215
311030,202101,1646,4020,1167,3249,220,696,533,1417,753,2113
311040,202101,266,822,221,725,66,228,76,233,142,461
311050,202101,2934,7085,2199,6031,351,1098,1118,2904,1469,4002
311060,202101,3152,7972,2367,6549,317,1001,971,2449,1288,3450
311070,202101,2255,5579,1640,4633,162,594,921,2414,1083,3008
311080,202101,1144,2566,927,2230,59,158,721,1661,780,1819
311090,202101,2023,6388,1599,5598,362,1392,499,1708,861,3100
311100,202101,2380,6701,1410,4714,258,981,251,737,509,1718
311110,202101,3591,7326,2015,5126,357,963,720,1887,1077,2850
311115,202101,1384,3023,1170,2746,61,154,951,2189,1012,2343
311120,202101,6661,17316,5135,14608,717,2266,1937,4893,2654,7159
311130,202101,1817,4718,1391,4143,94,358,832,2398,926,2756
311140,202101,1412,3445,1125,3057,68,219,802,2136,870,2355
311150,202101,1438,4559,1122,3940,175,687,605,2074,780,2761
311160,202101,3768,10740,2667,8686,657,2353,789,2449,1446,4802
311170,202101,879,2206,697,1968,39,113,440,1312,479,1425
311180,202101,1342,3000,840,2264,156,460,373,996,529,1456
311190,202101,847,2314,644,1932,113,394,265,694,378,1088
311200,202101,1999,5335,1456,4316,265,861,541,1469,806,2330
311205,202101,850,2519,695,2219,48,211,437,1317,485,1528
311210,202101,977,2831,847,2652,107,298,610,1967,717,2265
311220,202101,743,2025,623,1810,43,150,413,1131,456,1281
311230,202101,7889,23314,6007,19522,1147,3878,2189,7240,3336,11118
311240,202101,1045,2685,809,2353,173,521,341,992,514,1513
311250,202101,1117,3212,867,2734,181,544,335,1022,516,1566
311260,202101,2685,6519,1733,4883,246,779,756,1915,1002,2694
311265,202101,1288,3321,951,2758,39,151,650,1844,689,1995
311270,202101,2924,8673,2552,8068,132,585,1884,5713,2016,6298
311280,202101,1025,2625,476,1511,73,265,34,80,107,345
311290,202101,1849,5521,1690,5199,127,390,1158,3566,1285,3956
311300,202101,4666,12803,3834,11431,190,745,3056,8911,3246,9656
311310,202101,554,1527,471,1382,41,127,299,843,340,970
311320,202101,3212,9652,2769,8716,359,1345,1362,3880,1721,5225
311330,202101,5189,13390,4120,11670,428,1310,2333,6739,2761,8049
311340,202101,10275,28329,8186,24685,2018,6612,2394,6814,4412,13426
311350,202101,2433,5901,1750,4678,166,455,934,2278,1100,2733
311360,202101,1102,2670,722,2111,196,637,250,707,446,1344
311370,202101,4632,11068,3405,9161,141,546,2304,5817,2445,6363
311380,202101,351,1047,253,848,62,206,110,394,172,600
311390,202101,1730,5183,1376,4691,586,2223,357,1120,943,3343
311400,202101,1507,4097,1111,3341,180,579,382,1011,562,1590
311410,202101,1711,4948,1372,4443,213,777,776,2432,989,3209
311420,202101,1499,4338,1061,3444,186,690,286,776,472,1466
311430,202101,4113,10690,2767,8077,477,1440,926,2638,1403,4078
311440,202101,2874,7946,2179,6779,557,2041,471,1354,1028,3395
311450,202101,1667,4917,1207,4078,318,1227,326,947,644,2174
311455,202101,1002,2198,675,1724,174,456,254,694,428,1150
311460,202101,476,1448,319,1113,63,286,81,227,144,513
311470,202101,507,1537,338,1156,82,324,49,156,131,480
311480,202101,1014,2590,829,2307,44,127,633,1752,677,1879
311490,202101,247,719,186,604,33,131,85,245,118,376
311500,202101,444,1070,349,938,16,51,236,618,252,669
311510,202101,3211,8247,2231,6586,288,951,968,2682,1256,3633
311520,202101,641,1758,562,1612,70,252,317,890,387,1142
311530,202101,8436,19532,5375,14667,1289,3889,1414,3667,2703,7556
311535,202101,786,2149,531,1616,86,266,186,523,272,789
311540,202101,486,1515,434,1415,70,266,295,917,365,1183
311545,202101,1982,5615,1696,5170,91,313,1317,3972,1408,4285
311547,202101,1438,3656,1258,3390,64,165,845,2312,909,2477
311550,202101,2716,7482,2170,6505,296,1008,952,2697,1248,3705
311560,202101,303,651,194,487,75,181,45,105,120,286
311570,202101,1601,3672,1139,3034,34,97,903,2436,937,2533
311580,202101,2062,3839,1374,3028,145,285,922,2045,1067,2330
311590,202101,478,1255,382,1107,64,213,217,616,281,829
311600,202101,1714,3855,1437,3492,68,160,1219,2927,1287,3087
311610,202101,2234,7086,1870,6345,180,701,1097,3631,1277,4332
311615,202101,3212,8910,2623,7934,111,405,2072,6150,2183,6555
311620,202101,431,1093,375,1031,9,34,328,890,337,924
311630,202101,1337,3626,1100,3144,89,292,736,2024,825,2316
311640,202101,664,1763,538,1568,63,212,263,697,326,909
311650,202101,1925,4885,1589,4370,177,520,987,2634,1164,3154
311660,202101,2828,8016,2116,6637,373,1293,585,1564,958,2857
311670,202101,1526,3957,1119,3233,165,528,438,1268,603,1796
311680,202101,2112,5952,1607,5036,152,454,1096,3448,1248,3902
311690,202101,596,1287,472,1135,33,63,351,899,384,962
311700,202101,2157,5148,1721,4549,23,116,1467,3757,1490,3873
311710,202101,1485,4245,1083,3537,268,944,381,1241,649,2185
311720,202101,420,1228,335,1076,39,138,165,536,204,674
311730,202101,3436,8878,2267,6586,645,2020,458,1368,1103,3388
311740,202101,885,2282,740,2110,69,190,601,1766,670,1956
311750,202101,3825,11290,3092,9990,402,1404,1790,5576,2192,6980
311760,202101,628,1738,516,1541,68,246,263,681,331,927
311770,202101,2094,5927,1637,5125,257,831,742,2250,999,3081
311780,202101,1331,3760,956,3033,145,530,328,894,473,1424
311783,202101,2261,6029,1845,5328,35,164,1492,4134,1527,4298
311787,202101,796,2252,613,1829,87,294,267,679,354,973
311790,202101,1466,3938,961,3024,234,820,254,735,488,1555
311800,202101,4780,14236,3887,12363,792,2654,539,1491,1331,4145
311810,202101,937,2798,750,2473,45,161,508,1649,553,1810
311820,202101,771,1843,566,1529,61,197,360,911,421,1108
311830,202101,8071,22807,5613,17609,1558,5281,695,2135,2253,7416
311840,202101,3599,8952,2897,7958,219,646,2160,5891,2379,6537
311850,202101,361,947,293,820,13,41,196,526,209,567
311860,202101,59368,147898,45774,124997,6247,18512,25976,67588,32223,86100
311870,202101,1854,4875,1290,3878,218,767,501,1335,719,2102
311880,202101,6269,16089,5262,14713,288,704,3952,11285,4240,11989
311890,202101,1701,4037,1315,3507,86,264,921,2328,1007,2592
311900,202101,735,1858,553,1615,53,181,356,1010,409,1191
311910,202101,4018,10301,3036,9030,517,1512,1561,4807,2078,6319
311920,202101,2106,5493,1700,4910,118,310,1065,3184,1183,3494
311930,202101,3798,8772,2742,7314,813,2361,828,2031,1641,4392
311940,202101,15435,39968,11497,32585,1559,4859,5278,13958,6837,18817
311950,202101,2316,6121,1773,5222,125,410,1058,3183,1183,3593
311960,202101,481,1165,381,1016,24,90,248,600,272,690
311970,202101,410,1305,304,1034,56,228,73,207,129,435
311980,202101,447,1199,237,786,24,77,83,272,107,349
311990,202101,519,1205,327,918,61,213,141,354,202,567
311995,202101,951,2608,493,1571,21,70,69,142,90,212
312000,202101,764,1887,567,1594,53,139,346,1006,399,1145
312010,202101,959,2575,742,2229,44,146,486,1395,530,1541
312015,202101,1351,3902,1198,3656,45,196,978,2920,1023,3116
312020,202101,1590,4851,1211,4035,228,812,295,907,523,1719
312030,202101,2007,4872,1749,4587,15,54,1648,4314,1663,4368
312040,202101,837,2412,594,1948,65,216,266,844,331,1060
312050,202101,1180,3600,954,3172,214,858,313,908,527,1766
312060,202101,852,2047,553,1676,135,411,263,811,398,1222
312070,202101,913,2571,649,2038,39,140,367,1089,406,1229
312080,202101,2608,6358,1962,5407,106,328,1303,3444,1409,3772
312083,202101,849,2195,638,1869,48,177,435,1232,483,1409
312087,202101,2475,6392,2004,5668,42,133,1573,4487,1615,4620
312090,202101,10127,26094,7945,22700,1097,3436,4170,11558,5267,14994
312100,202101,1545,4391,1236,3819,94,355,765,2267,859,2622
312110,202101,1040,3169,865,2822,177,677,326,962,503,1639
312120,202101,1000,2660,680,2103,174,624,196,495,370,1119
312125,202101,1670,4257,1397,3878,101,327,1049,2801,1150,3128
312130,202101,1024,2493,774,2074,64,190,356,873,420,1063
312140,202101,697,1989,569,1732,111,379,254,706,365,1085
312150,202101,449,1234,384,1105,16,62,276,742,292,804
312160,202101,8810,23714,6758,20137,808,2737,3337,9506,4145,12243
312170,202101,883,2387,687,2008,38,136,449,1280,487,1416
312180,202101,1379,3657,1099,3135,156,458,566,1563,722,2021
312190,202101,653,1781,485,1473,75,257,175,488,250,745
312200,202101,4372,11980,3460,10508,1059,3197,1177,3723,2236,6920
312210,202101,1367,3013,997,2492,33,101,756,1851,789,1952
312220,202101,1566,4841,1360,4453,105,377,855,2801,960,3178
312230,202101,13203,33719,8914,26067,2039,6792,1820,4508,3859,11300
312235,202101,1928,4830,1529,4268,85,278,1102,2997,1187,3275
312240,202101,671,2167,513,1836,110,429,149,515,259,944
312245,202101,2624,6745,2154,6023,61,167,1776,4946,1837,5113
312247,202101,942,2271,686,1902,118,341,368,1027,486,1368
312250,202101,955,2514,620,1857,78,244,231,675,309,919
312260,202101,936,2486,745,2202,39,154,576,1633,615,1787
312270,202101,720,1974,547,1631,30,118,308,839,338,957
312280,202101,416,1213,322,1042,89,299,47,140,136,439
312290,202101,772,2239,626,1984,117,407,203,619,320,1026
312300,202101,966,2897,654,2135,157,557,122,329,279,886
312310,202101,949,2808,768,2447,119,409,354,1077,473,1486
312320,202101,1953,4980,1435,4090,327,986,325,888,652,1874
312330,202101,820,2415,666,2081,61,221,414,1259,475,1480
312340,202101,243,629,172,510,43,155,75,196,118,351
312350,202101,243,481,173,408,17,45,119,270,136,315
312352,202101,1542,4614,1370,4305,85,270,844,2832,929,3102
312360,202101,2757,7841,2047,6524,388,1374,700,2080,1088,3454
312370,202101,1851,4707,1514,4142,168,516,927,2419,1095,2935
312380,202101,2117,4755,1750,4288,4,12,1573,3810,1577,3822
312385,202101,1218,3298,960,2842,150,468,430,1281,580,1749
312390,202101,1870,5329,1414,4496,193,709,529,1535,722,2244
312400,202101,2731,7762,2274,6998,674,2244,730,2224,1404,4468
312410,202101,11572,31541,9396,27933,1614,4951,5203,15307,6817,20258
312420,202101,3754,9952,3124,8934,576,1795,1672,4652,2248,6447
312430,202101,7796,20562,6435,18138,368,1216,4631,12739,4999,13955
312440,202101,914,2927,749,2560,358,1305,112,341,470,1646
312450,202101,1165,3397,890,2918,243,837,289,995,532,1832
312460,202101,436,1131,303,928,50,148,150,484,200,632
312470,202101,473,1134,300,830,29,84,109,270,138,354
312480,202101,1023,2513,717,2062,95,307,360,981,455,1288
312490,202101,2063,5018,1617,4374,202,581,880,2318,1082,2899
312500,202101,1021,2487,840,2236,44,155,608,1591,652,1746
312510,202101,3681,9679,2630,7720,628,1789,648,1945,1276,3734
312520,202101,160,426,124,374,33,111,54,161,87,272
312530,202101,566,1387,487,1292,15,52,429,1142,444,1194
312540,202101,1579,4329,1081,3349,138,453,611,1831,749,2284
312550,202101,770,2006,598,1680,44,141,387,1000,431,1141
312560,202101,1919,4973,1540,4381,72,216,1159,3297,1231,3513
312570,202101,2226,5330,1672,4634,462,1314,643,1876,1105,3190
312580,202101,595,1611,419,1247,54,188,190,530,244,718
312590,202101,1585,4554,1256,3890,81,358,800,2282,881,2640
312595,202101,1976,5698,1659,5178,250,724,998,3286,1248,4010
312600,202101,1163,2753,688,1855,107,363,127,394,234,757
312610,202101,6722,16873,4460,12724,657,2057,1537,3972,2194,6029
312620,202101,2500,6427,1862,5530,56,233,1487,4508,1543,4741
312630,202101,280,801,199,649,35,132,76,247,111,379
312640,202101,511,1387,360,1128,37,125,151,481,188,606
312650,202101,1999,5094,1395,3974,61,199,987,2690,1048,2889
312660,202101,1308,3153,1003,2646,93,252,673,1726,766,1978
312670,202101,4821,12713,4029,11456,175,706,2957,8050,3132,8756
312675,202101,1280,3289,1050,2956,56,173,860,2394,916,2567
312680,202101,1369,3832,1189,3558,48,202,980,2851,1028,3053
312690,202101,2910,6102,2277,5350,45,122,1909,4492,1954,4614
312695,202101,950,2550,810,2328,40,92,631,1821,671,1913
312700,202101,2025,5299,1468,4286,143,491,821,2261,964,2752
312705,202101,1392,3267,1200,2988,14,50,1101,2718,1115,2768
312707,202101,1313,3804,1018,3285,66,307,667,2036,733,2343
312710,202101,6380,14531,3820,10586,911,2707,1084,3142,1995,5849
312720,202101,1052,2772,792,2358,96,300,482,1401,578,1701
312730,202101,1613,3770,1135,3111,94,291,659,1740,753,2031
312733,202101,1345,3532,1020,2918,34,134,712,1931,746,2065
312735,202101,705,1885,595,1672,75,224,339,867,414,1091
312737,202101,784,1734,564,1424,65,180,379,933,444,1113
312738,202101,695,1751,500,1428,42,137,289,783,331,920
312740,202101,413,1033,246,751,44,149,59,135,103,284
312750,202101,1565,4488,1166,3733,198,660,507,1555,705,2215
312760,202101,1728,5034,1242,4044,223,772,452,1427,675,2199
312770,202101,43889,104428,27882,77244,5454,16277,9470,25478,14924,41755
312780,202101,2395,7068,2024,6469,234,779,1306,4189,1540,4968
312790,202101,236,557,126,389,5,21,37,98,42,119
312800,202101,4860,13518,3707,11335,866,2789,1350,4004,2216,6793
312810,202101,1513,4025,1019,3212,254,884,372,1076,626,1960
312820,202101,1714,4519,1392,3966,58,207,1043,2892,1101,3099
312825,202101,1338,3104,1170,2890,19,64,1013,2452,1032,2516
312830,202101,2737,7644,1703,5523,330,1216,445,1355,775,2571
312840,202101,1329,3538,1066,3098,83,319,614,1656,697,1975
312850,202101,933,2237,659,1834,21,88,409,1042,430,1130
312860,202101,1070,2757,732,2243,181,586,174,486,355,1072
312870,202101,5976,15911,3722,11654,574,1934,880,2555,1454,4489
312880,202101,1427,3519,1103,2973,37,123,656,1769,693,1892
312890,202101,2209,5443,1631,4508,115,300,827,2334,942,2634
312900,202101,1219,3084,998,2803,146,459,468,1428,614,1887
312910,202101,1548,2832,833,1900,176,338,310,742,486,1080
312920,202101,984,2577,682,2091,111,389,284,806,395,1195
312930,202101,2352,5730,1817,4939,404,1117,797,2213,1201,3330
312940,202101,961,2608,756,2313,67,260,403,1175,470,1435
312950,202101,2987,7320,1987,5730,498,1579,627,1748,1125,3327
312960,202101,1799,4716,1523,4304,79,201,1172,3404,1251,3605
312965,202101,1603,4395,1335,3987,112,334,930,2744,1042,3078
312970,202101,1365,3796,1086,3344,144,533,644,1859,788,2392
312980,202101,23574,63831,19086,55960,3666,11657,8954,24668,12620,36325
312990,202101,483,1194,316,910,51,167,157,413,208,580
313000,202101,476,1359,361,1149,29,123,212,634,241,757
313005,202101,2486,7120,2110,6483,162,473,1491,4563,1653,5036
313010,202101,5001,13502,4018,11953,696,2241,2383,6989,3079,9230
313020,202101,1057,3138,762,2486,130,453,150,425,280,878
313030,202101,1097,2502,746,1992,87,283,477,1198,564,1481
313040,202101,793,2413,655,2144,42,178,393,1217,435,1395
313050,202101,1738,4739,1218,3973,198,777,397,1154,595,1931
313055,202101,1879,5016,1671,4721,53,175,1451,4068,1504,4243
313060,202101,960,2294,700,1856,173,556,133,311,306,867
313065,202101,1625,4784,1433,4472,47,167,1117,3412,1164,3579
313070,202101,940,2441,718,2069,66,207,424,1194,490,1401
313080,202101,380,1052,282,864,53,182,107,278,160,460
313090,202101,5038,13243,4282,12033,338,1075,2879,7996,3217,9071
313100,202101,1329,3410,1030,2980,25,102,786,2216,811,2318
313110,202101,1436,3795,1067,3160,101,367,588,1629,689,1996
313115,202101,2595,7391,2095,6441,271,946,1094,3138,1365,4084
313120,202101,3703,8747,2707,7446,213,664,1767,4845,1980,5509
313130,202101,31267,79289,23964,66118,2446,7659,13668,35615,16114,43274
313140,202101,621,1312,365,953,30,74,241,635,271,709
313150,202101,1330,3684,994,3086,302,1018,170,461,472,1479
313160,202101,1187,2923,925,2528,21,75,715,1898,736,1973
313170,202101,10994,30890,8107,25607,1335,4623,3293,9767,4628,14390
313180,202101,2020,5313,1438,4141,192,573,826,2336,1018,2909
313190,202101,4209,11991,3122,9820,559,1901,1076,3160,1635,5061
313200,202101,1098,3002,960,2762,14,48,811,2262,825,2310
313210,202101,3771,10807,3094,9583,368,1249,1870,5627,2238,6876
313220,202101,1700,4435,1136,3329,163,531,460,1195,623,1726
313230,202101,2971,8202,2454,7568,44,155,2049,6460,2093,6615
313240,202101,9680,23465,6190,17958,978,3249,2693,7312,3671,10561
313250,202101,5951,17452,4581,14497,799,2547,2067,6361,2866,8908
313260,202101,654,1685,479,1384,59,220,237,623,296,843
313270,202101,5757,14100,4632,12554,551,1408,3180,8830,3731,10238
313280,202101,463,1293,304,969,38,137,131,394,169,531
313290,202101,948,2901,701,2459,204,784,228,789,432,1573
313300,202101,1579,4165,1151,3423,279,910,297,759,576,1669
313310,202101,1175,3441,914,2906,145,553,271,742,416,1295
313320,202101,2072,5492,1517,4599,258,910,602,1838,860,2748
313330,202101,4121,10658,3112,9140,176,616,2003,5866,2179,6482
313340,202101,1383,3073,985,2525,81,220,694,1763,775,1983
313350,202101,2904,8025,1884,5724,229,777,675,1789,904,2566
313360,202101,1495,3595,1037,2871,152,515,544,1370,696,1885
313370,202101,1443,3998,1189,3493,140,488,653,1760,793,2248
313375,202101,1757,4577,1129,3391,205,658,234,650,439,1308
313380,202101,6199,15339,4449,12180,740,2290,2129,5201,2869,7491
313390,202101,801,2547,698,2377,51,236,467,1520,518,1756
313400,202101,3594,8864,2786,7769,139,435,2140,5872,2279,6307
313410,202101,1316,3350,1025,2854,48,164,765,2071,813,2235
313420,202101,15531,34205,8108,21894,1811,5461,1099,2944,2910,8405
313430,202101,962,2797,745,2352,124,480,319,873,443,1353
313440,202101,5954,12976,3957,10360,387,1047,2421,6369,2808,7416
313450,202101,743,1949,526,1536,87,278,184,462,271,740
313460,202101,2073,5817,1637,5133,326,1161,772,2294,1098,3455
313470,202101,2821,7166,2233,6311,234,671,1475,4210,1709,4881
313480,202101,996,2822,572,1876,60,221,175,525,235,746
313490,202101,2726,6567,1392,4179,342,1123,283,827,625,1950
313500,202101,523,1456,385,1160,38,115,145,405,183,520
313505,202101,10181,26565,8675,24528,324,1114,6999,19776,7323,20890
313507,202101,1452,3737,1190,3334,32,131,956,2594,988,2725
313510,202101,13691,37466,10743,31747,1280,3874,5010,14536,6290,18410
313520,202101,14227,39583,11432,34833,566,2101,8629,25663,9195,27764
313530,202101,518,1528,389,1249,45,159,155,444,200,603
313535,202101,2292,6331,1895,5571,257,692,1156,3416,1413,4108
313540,202101,771,2261,626,1912,106,335,266,738,372,1073
313545,202101,1120,3670,949,3323,147,544,508,1730,655,2274
313550,202101,1749,5270,1446,4563,291,1016,739,2232,1030,3248
313560,202101,2695,5241,2027,4427,57,89,1714,3769,1771,3858
313570,202101,981,2812,801,2489,190,619,319,966,509,1585
313580,202101,5777,14686,4494,12556,493,1422,2659,7468,3152,8890
313590,202101,1043,2904,850,2627,197,646,405,1326,602,1972
313600,202101,4072,10651,3392,9604,87,348,2864,7954,2951,8302
313610,202101,1065,2644,862,2306,85,259,556,1403,641,1662
313620,202101,5396,14131,4234,12049,491,1588,2479,6794,2970,8382
313630,202101,8567,20422,6118,16782,578,1862,3774,10108,4352,11970
313640,202101,1184,2558,714,1961,135,409,346,944,481,1353
313650,202101,1699,5048,1347,4458,101,387,884,2963,985,3350
313652,202101,751,2329,673,2174,106,360,427,1348,533,1708
313655,202101,1128,2800,884,2496,46,130,680,1932,726,2062
313657,202101,1114,2982,893,2636,35,133,667,1871,702,2004
313660,202101,926,2589,753,2280,75,272,473,1365,548,1637
313665,202101,4887,12855,3868,11074,393,1263,2451,6688,2844,7951
313670,202101,48784,118107,31687,89551,4356,13542,14385,38447,18741,51989
313680,202101,1018,2695,844,2413,61,200,571,1589,632,1789
313690,202101,770,2356,596,2041,142,545,154,501,296,1046
313695,202101,1829,4853,1382,4114,93,280,915,2788,1008,3068
313700,202101,2835,9037,2460,8533,234,813,1858,6509,2092,7322
313710,202101,1471,3290,1046,2730,77,210,698,1844,775,2054
313720,202101,5529,15110,3925,11772,527,1666,1634,4528,2161,6194
313730,202101,1350,2988,1017,2546,85,180,669,1698,754,1878
313740,202101,1662,5848,1402,5181,310,1330,268,834,578,2164
313750,202101,2006,5261,1554,4478,274,887,752,2024,1026,2911
313753,202101,2185,5183,1470,4033,147,439,812,2154,959,2593
313760,202101,5347,14547,4081,12128,777,2584,1871,5167,2648,7751
313770,202101,3948,11013,3156,9744,191,609,2361,7398,2552,8007
313780,202101,3903,10278,2854,8547,218,772,871,2651,1089,3423
313790,202101,489,1479,436,1387,37,128,266,839,303,967
313800,202101,1370,3092,1002,2589,118,349,528,1288,646,1637
313810,202101,1595,4009,1279,3563,47,168,992,2686,1039,2854
313820,202101,17435,44188,11019,30669,1761,5110,2957,8015,4718,13125
313830,202101,383,1085,276,844,50,183,94,262,144,445
313835,202101,904,2631,753,2355,61,244,422,1234,483,1478
313840,202101,7181,18528,5514,15786,1278,3897,1186,3528,2464,7425
313850,202101,987,2385,779,2103,144,465,365,884,509,1349
313860,202101,2553,6745,1928,5580,288,950,834,2216,1122,3166
313862,202101,1306,2740,629,1752,38,111,296,817,334,928
313865,202101,2570,6741,2124,6013,78,219,1604,4480,1682,4699
313867,202101,1352,4035,1128,3627,180,560,649,2160,829,2720
313868,202101,1671,5109,1381,4543,44,213,1060,3368,1104,3581
313870,202101,779,2072,569,1700,89,277,223,607,312,884
313880,202101,1724,4426,1246,3606,157,519,604,1571,761,2090
313890,202101,1982,4298,1480,3646,44,149,1101,2633,1145,2782
313900,202101,4094,11683,2936,9343,733,2550,715,2085,1448,4635
313910,202101,655,1884,502,1604,104,354,107,335,211,689
313920,202101,2942,8929,2468,7950,514,1632,1218,3968,1732,5600
313925,202101,1567,3936,1278,3431,179,464,823,2210,1002,2674
313930,202101,4522,13600,3684,12070,266,1013,2402,7748,2668,8761
313940,202101,8749,25000,6504,21122,684,2769,1535,5659,2219,8428
313950,202101,5144,11267,3863,9713,372,1171,2371,5968,2743,7139
313960,202101,5659,13541,3800,10429,730,2268,1252,3138,1982,5406
313970,202101,1494,3976,1258,3588,19,61,808,2258,827,2319
313980,202101,1263,3256,824,2584,120,432,335,986,455,1418
313990,202101,1897,5931,1379,4779,334,1343,451,1370,785,2713
314000,202101,9510,24142,8016,21623,577,1997,5354,14235,5931,16232
314010,202101,1458,3477,1156,3074,41,134,891,2294,932,2428
314015,202101,1922,5267,1485,4523,185,653,821,2438,1006,3091
314020,202101,478,1301,331,1051,73,276,65,220,138,496
314030,202101,788,2229,626,1925,61,186,337,1015,398,1201
314040,202101,600,1617,493,1426,75,247,263,728,338,975
314050,202101,1851,4846,1368,3975,145,502,749,2013,894,2515
314053,202101,1773,5278,1461,4668,306,965,768,2544,1074,3509
314055,202101,2196,5864,1853,5326,44,164,1516,4351,1560,4515
314060,202101,1282,3343,965,2845,38,141,691,2013,729,2154
314070,202101,4717,12744,3708,10965,709,2086,1667,4894,2376,6980
314080,202101,2138,5464,1494,4385,183,605,636,1692,819,2297
314085,202101,2193,6006,1800,5405,208,646,1038,3173,1246,3819
314090,202101,4721,12500,4044,11511,226,748,2655,7825,2881,8573
314100,202101,3030,7244,2347,6294,37,113,1756,4742,1793,4855
314110,202101,4863,13434,3993,11809,432,1453,2233,6170,2665,7623
314120,202101,716,1674,309,926,58,208,73,205,131,413
314130,202101,624,1617,405,1228,27,108,243,716,270,824
314140,202101,4477,12532,3602,10935,471,1474,1834,5481,2305,6955
314150,202101,1510,3726,1111,3047,67,180,758,2041,825,2221
314160,202101,2181,5658,1609,4608,226,720,674,1920,900,2640
314170,202101,895,2487,728,2164,35,135,487,1345,522,1480
314180,202101,5378,14790,4340,13123,347,1131,2634,7966,2981,9097
314190,202101,590,1454,424,1217,77,260,205,528,282,788
314200,202101,2975,8230,2463,7360,158,529,1727,5037,1885,5566
314210,202101,2003,5173,1603,4468,198,554,781,2137,979,2691
314220,202101,1374,3715,1011,3087,220,753,359,1001,579,1754
314225,202101,1020,2883,856,2617,70,175,629,1980,699,2155
314230,202101,787,2035,643,1856,89,272,404,1205,493,1477
314240,202101,1042,2791,802,2417,187,598,305,924,492,1522
314250,202101,495,1380,311,991,48,142,107,314,155,456
314260,202101,956,2546,737,2248,165,542,395,1184,560,1726
314270,202101,3228,9089,2663,8221,74,313,1973,6041,2047,6354
314280,202101,3402,7815,2312,6165,239,716,1305,3292,1544,4008
314290,202101,4372,11271,3625,9954,302,842,2485,6689,2787,7531
314300,202101,2020,5645,1326,4186,219,746,473,1384,692,2130
314310,202101,3897,10084,2609,7889,795,2685,393,1024,1188,3709
314315,202101,935,3127,800,2841,52,228,559,1922,611,2150
314320,202101,3008,8089,1983,6172,339,1152,715,2137,1054,3289
314330,202101,48158,134282,36580,113921,9546,31099,7583,24924,17129,56023
314340,202101,2428,5979,1524,4375,269,899,392,968,661,1867
314345,202101,1459,4213,1173,3696,143,452,712,2231,855,2683
314350,202101,791,2128,514,1625,111,360,117,326,228,686
314360,202101,535,1555,340,1130,48,179,117,349,165,528
314370,202101,741,1950,598,1739,43,140,402,1127,445,1267
314380,202101,1105,2967,732,2316,165,591,153,460,318,1051
314390,202101,13812,34545,9177,26277,1503,4643,2941,7497,4444,12140
314400,202101,3815,11421,2912,9620,731,2504,1081,3707,1812,6211
314410,202101,2637,7381,1849,5911,243,896,609,2052,852,2948
314420,202101,838,2039,606,1661,36,138,407,1045,443,1183
314430,202101,7786,18815,5482,15011,773,2234,2616,6808,3389,9042
314435,202101,1876,4919,1472,4259,125,420,967,2706,1092,3126
314437,202101,899,2278,648,1869,71,217,324,935,395,1152
314440,202101,610,1735,438,1399,129,447,85,224,214,671
314450,202101,1364,3626,1150,3280,108,356,667,1835,775,2191
314460,202101,3135,9427,2302,7726,586,2098,554,1790,1140,3888
314465,202101,2192,6261,1868,5658,56,202,1440,4243,1496,4445
314467,202101,906,2365,765,2142,21,57,614,1681,635,1738
314470,202101,2318,6529,1922,5760,327,1059,902,2525,1229,3584
314480,202101,6492,18147,4792,14664,763,2643,1838,4985,2601,7628
314490,202101,1082,2825,796,2236,63,196,510,1384,573,1580
314500,202101,1666,3958,1201,3337,319,863,406,1183,725,2046
314505,202101,2006,4896,1639,4367,97,275,1206,3117,1303,3392
314510,202101,1918,4955,1353,4081,268,911,598,1774,866,2685
314520,202101,4779,14483,3603,12090,721,2667,455,1369,1176,4036
314530,202101,5279,16913,4765,15923,292,1197,3535,11551,3827,12748
314535,202101,2437,6351,1992,5714,72,283,1536,4367,1608,4650
314537,202101,1101,3083,846,2676,41,166,616,1898,657,2064
314540,202101,389,953,267,754,20,61,155,417,175,478
314545,202101,1945,4593,1740,4355,28,80,1531,3916,1559,3996
314550,202101,681,1631,504,1372,36,122,299,748,335,870
314560,202101,4464,13202,3309,10656,473,1705,1154,3309,1627,5014
314570,202101,298,825,217,673,27,92,93,292,120,384
314580,202101,445,1323,360,1159,97,312,113,358,210,670
314585,202101,651,2007,502,1682,57,228,215,702,272,930
314587,202101,2006,5421,1514,4637,200,584,868,2730,1068,3314
314590,202101,4053,10842,2989,8886,376,1252,1367,3737,1743,4989
314600,202101,1894,5114,1141,3693,232,789,133,417,365,1206
314610,202101,8801,21578,6298,17962,950,3261,2745,8008,3695,11269
314620,202101,2220,5196,1758,4613,41,132,1462,3819,1503,3951
314625,202101,1540,4168,1330,3874,29,171,1153,3284,1182,3455
314630,202101,5407,13442,4447,12154,105,422,3722,10082,3827,10504
314640,202101,683,1595,501,1316,72,219,281,681,353,900
314650,202101,810,1855,502,1374,50,162,285,703,335,865
314655,202101,1578,4306,1134,3519,165,500,562,1759,727,2259
314660,202101,322,723,212,535,11,23,140,341,151,364
314670,202101,1595,3598,1123,2938,20,62,750,1923,770,1985
314675,202101,1675,4389,1429,3983,66,206,1124,3056,1190,3262
314690,202101,2018,5511,1541,4819,390,1356,544,1664,934,3020
314700,202101,10211,28009,6777,21510,1264,4433,2235,6851,3499,11284
314710,202101,7784,21604,5731,17310,911,3052,2116,5599,3027,8651
314720,202101,2106,6187,1491,4944,286,1037,367,1143,653,2180
314730,202101,2279,5839,1659,4756,254,809,703,1846,957,2655
314740,202101,2913,8143,2260,6978,299,972,1150,3461,1449,4433
314750,202101,279,756,214,624,25,84,131,345,156,429
314760,202101,1964,5771,1292,4258,208,794,336,863,544,1657
314770,202101,1083,3111,603,1929,53,181,187,552,240,733
314780,202101,347,824,238,661,39,137,130,315,169,452
314790,202101,11302,29814,7935,23618,1525,5234,2887,7866,4412,13100
314795,202101,1504,3908,1278,3520,28,117,1033,2742,1061,2859
314800,202101,10516,26693,6627,19611,1140,3672,1802,4756,2942,8428
314810,202101,8634,22819,6307,18806,1598,5063,2029,5962,3627,11025
314820,202101,1249,2988,984,2583,68,226,612,1537,680,1763
314830,202101,1529,4591,1300,4172,207,763,647,1994,854,2757
314840,202101,842,2599,661,2279,49,214,453,1488,502,1702
314850,202101,2149,4853,1744,4348,40,117,1519,3794,1559,3911
314860,202101,3185,9238,2650,8279,168,678,1876,5691,2044,6369
314870,202101,6302,15699,4806,13740,276,853,3571,10331,3847,11184
314875,202101,1745,5177,1538,4913,126,308,1220,4012,1346,4320
314880,202101,793,1950,616,1683,27,80,371,1018,398,1098
314890,202101,410,1207,319,1025,49,176,135,405,184,581
314900,202101,721,1924,567,1653,72,245,264,726,336,971
314910,202101,1652,4614,1227,3925,189,704,626,1889,815,2593
314915,202101,2170,6402,1830,5802,120,392,1210,3766,1330,4158
314920,202101,462,1207,300,964,6,15,200,657,206,672
314930,202101,5478,15229,4159,12780,677,2317,1701,4842,2378,7159
314940,202101,393,979,320,855,38,101,205,524,243,625
314950,202101,532,1317,362,1042,26,91,191,494,217,585
314960,202101,834,1964,639,1643,30,98,463,1118,493,1216
314970,202101,945,2753,724,2299,134,457,319,925,453,1382
314980,202101,1497,3821,1120,3269,189,639,553,1570,742,2209
314990,202101,2375,6810,1716,5337,330,1089,368,1030,698,2119
314995,202101,1578,4325,1257,3758,35,147,857,2424,892,2571
315000,202101,1098,2760,788,2290,60,186,526,1509,586,1695
315010,202101,369,1003,280,851,45,159,136,396,181,555
315015,202101,2275,6314,1980,5820,182,607,1334,3850,1516,4457
315020,202101,789,2291,560,1785,67,264,243,712,310,976
315030,202101,585,1549,400,1208,85,263,82,214,167,477
315040,202101,833,2292,674,2004,85,280,414,1206,499,1486
315050,202101,1205,3099,891,2604,54,198,481,1351,535,1549
315053,202101,1059,2748,828,2360,49,153,489,1322,538,1475
315057,202101,1721,5113,1401,4577,137,437,940,3129,1077,3566
315060,202101,580,1722,423,1408,86,289,106,341,192,630
315070,202101,508,1329,350,1055,79,263,93,266,172,529
315080,202101,2937,8105,2286,6876,213,734,1485,4221,1698,4955
315090,202101,783,2327,584,1961,85,309,235,763,320,1072
315100,202101,1315,3813,877,2841,139,536,385,1090,524,1626
315110,202101,1933,4581,1411,3799,129,345,715,1979,844,2324
315120,202101,12378,28486,9229,23810,1147,2689,5109,13648,6256,16337
315130,202101,1628,4406,1358,3940,142,469,562,1535,704,2004
315140,202101,2865,7910,2250,6819,396,1312,1132,3244,1528,4556
315150,202101,4272,10221,3041,8268,437,1399,1458,3858,1895,5257
315160,202101,1755,4234,1158,3292,244,755,531,1470,775,2225
315170,202101,1308,4123,930,3214,211,800,241,784,452,1584
315180,202101,16935,40681,9499,27246,1203,3909,3153,7965,4356,11874
315190,202101,2179,4766,1696,4133,200,481,1229,3040,1429,3521
315200,202101,3890,10937,2844,9108,777,2711,779,2385,1556,5096
315210,202101,8547,21977,5920,16542,683,2067,2923,7385,3606,9452
315213,202101,1112,2907,967,2710,21,72,805,2207,826,2279
315217,202101,2830,8083,2169,6986,96,417,1492,4600,1588,5017
315220,202101,8478,22870,6679,19721,1060,3294,2943,8728,4003,12022
315230,202101,3011,7071,2550,6461,176,251,1963,5291,2139,5542
315240,202101,2352,6884,1975,6231,433,1409,950,3036,1383,4445
315250,202101,13068,34911,9544,28353,1436,4585,4062,11516,5498,16101
315260,202101,859,2346,465,1517,71,234,39,105,110,339
315270,202101,835,2379,605,1950,80,277,216,596,296,873
315280,202101,2750,6801,1692,4938,410,1299,271,772,681,2071
315290,202101,1137,2769,684,2048,183,621,199,573,382,1194
315300,202101,620,1512,436,1259,75,237,227,673,302,910
315310,202101,1220,3400,929,2851,74,249,530,1535,604,1784
315320,202101,648,1890,457,1507,66,236,185,565,251,801
315330,202101,744,2512,418,1635,65,304,128,443,193,747
315340,202101,2891,6949,2085,5793,288,827,1098,3026,1386,3853
315350,202101,1548,4221,1244,3743,176,628,701,2056,877,2684
315360,202101,1683,4949,1296,4163,186,632,538,1609,724,2241
315370,202101,474,1352,380,1165,74,221,147,445,221,666
315380,202101,201,583,148,469,40,141,33,76,73,217
315390,202101,1117,3120,896,2712,138,500,429,1182,567,1682
315400,202101,3951,10683,3125,9207,422,1326,1742,4900,2164,6226
315410,202101,2421,5511,1813,4619,459,1291,292,764,751,2055
315415,202101,1378,3721,1114,3312,242,847,411,1240,653,2087
315420,202101,1430,4003,993,3180,180,607,199,611,379,1218
315430,202101,3547,8601,2503,7020,434,1429,1103,2904,1537,4333
315440,202101,1035,2718,826,2374,61,207,496,1341,557,1548
315445,202101,1902,4581,1365,3813,85,286,995,2734,1080,3020
315450,202101,2225,6094,1838,5469,229,622,1132,3392,1361,4014
315460,202101,37457,102359,31061,91081,4269,14223,17539,48268,21808,62491
315470,202101,637,1765,454,1324,28,90,259,716,287,806
315480,202101,1081,3115,770,2443,136,464,254,774,390,1238
315490,202101,2870,7233,2034,5885,287,868,774,2133,1061,3001
315500,202101,515,1376,324,962,40,134,165,437,205,571
315510,202101,1214,3129,1039,2889,20,87,913,2499,933,2586
315520,202101,987,2682,813,2396,44,150,629,1807,673,1957
315530,202101,596,1662,475,1442,119,412,239,679,358,1091
315540,202101,1488,3945,1049,3150,96,354,490,1421,586,1775
315550,202101,1870,4887,1228,3715,249,867,304,914,553,1781
315560,202101,6177,18659,5220,16923,296,899,3440,11423,3736,12322
315570,202101,2060,5473,1645,4782,104,337,935,2677,1039,3014
315580,202101,2967,6909,2258,5801,337,981,859,2085,1196,3066
315590,202101,876,2195,671,1876,67,237,394,1016,461,1253
315600,202101,2491,7695,1797,6311,285,931,890,3327,1175,4258
315610,202101,963,2424,718,1989,103,359,325,777,428,1136
315620,202101,513,1346,392,1171,38,128,225,686,263,814
315630,202101,1014,2680,769,2227,122,376,366,969,488,1345
315640,202101,341,833,253,723,27,102,154,412,181,514
315645,202101,968,2473,667,1980,152,490,177,498,329,988
315650,202101,1666,4021,1346,3580,33,106,1095,2826,1128,2932
315660,202101,2448,6015,1837,4962,103,308,1321,3449,1424,3757
315670,202101,13490,36364,10338,30759,1953,6085,4706,13427,6659,19512
315680,202101,3163,8939,2336,7374,290,1058,1255,3736,1545,4794
315690,202101,3398,8139,2078,5910,456,1288,589,1830,1045,3118
315700,202101,7945,21671,6061,18027,966,3042,2684,7668,3650,10710
315710,202101,1807,4458,1282,3667,44,193,904,2469,948,2662
315720,202101,4414,12128,3678,10797,192,725,2578,7266,2770,7991
315725,202101,2184,5628,1684,4823,196,544,1027,3091,1223,3635
315727,202101,561,1441,430,1231,58,200,180,492,238,692
315730,202101,556,1727,493,1592,96,342,150,435,246,777
315733,202101,1110,2809,806,2305,117,396,312,856,429,1252
315737,202101,1148,3194,906,2727,25,102,661,1908,686,2010
315740,202101,776,2159,628,1866,64,222,416,1158,480,1380
315750,202101,1230,3233,982,2841,94,285,597,1754,691,2039
315760,202101,1108,2610,976,2436,43,131,817,1991,860,2122
315765,202101,1948,5062,1604,4610,27,105,1421,4066,1448,4171
315770,202101,975,2674,748,2356,296,1028,156,414,452,1442
315780,202101,29756,80052,24914,71591,1270,4569,17392,47657,18662,52226
315790,202101,3551,10904,3041,9936,334,1148,1864,6209,2198,7357
315800,202101,1296,4394,979,3601,130,548,346,1113,476,1661
315810,202101,1263,3142,1037,2754,55,191,803,2032,858,2223
315820,202101,2544,6790,2075,6134,191,616,1436,4257,1627,4873
315830,202101,1191,3519,822,2721,80,292,284,845,364,1137
315840,202101,845,2015,595,1588,41,133,300,723,341,856
315850,202101,1160,3373,917,2945,183,629,441,1326,624,1955
315860,202101,470,1344,340,1114,57,199,120,352,177,551
315870,202101,465,1221,375,1083,17,60,271,750,288,810
315880,202101,1089,2800,729,2152,91,300,150,417,241,717
315890,202101,1657,4699,1340,4255,331,1149,662,2092,993,3241
315895,202101,6221,16604,4692,13650,430,1407,2466,6682,2896,8089
315900,202101,802,2035,691,1879,61,163,524,1394,585,1557
315910,202101,487,1339,408,1215,58,176,284,842,342,1018
315920,202101,1421,3593,802,2430,123,456,262,715,385,1171
315930,202101,1056,2341,714,1861,136,326,310,842,446,1168
315935,202101,808,2423,638,2101,124,441,225,729,349,1170
315940,202101,593,1620,471,1432,55,178,253,742,308,920
315950,202101,1129,3122,936,2810,77,221,728,2180,805,2401
315960,202101,5303,14877,3592,11427,997,3576,348,720,1345,4296
315970,202101,583,1535,465,1379,57,179,310,933,367,1112
315980,202101,4143,8871,2280,5878,409,1122,853,2025,1262,3147
315990,202101,3548,9018,2787,7725,289,829,1567,4229,1856,5058
316000,202101,573,1448,438,1253,51,187,216,575,267,762
316010,202101,811,2172,610,1826,43,147,369,1027,412,1174
316020,202101,921,2787,734,2416,104,392,402,1241,506,1633
316030,202101,2678,7491,2074,6409,241,747,1310,4137,1551,4884
316040,202101,2335,6598,1768,5542,297,1061,479,1302,776,2363
316045,202101,2077,5334,1910,5135,77,149,1664,4592,1741,4741
316050,202101,380,1043,300,912,37,112,163,458,200,570
316060,202101,647,1624,480,1391,17,75,341,944,358,1019
316070,202101,5221,14366,4268,12603,743,2227,1974,5729,2717,7956
316080,202101,719,2245,559,1928,138,503,87,261,225,764
316090,202101,391,1130,298,939,43,143,143,427,186,570
316095,202101,1282,3948,1022,3298,284,967,334,1027,618,1994
316100,202101,2440,7053,1795,5723,315,1093,672,1949,987,3042
316105,202101,807,2109,666,1880,37,122,459,1331,496,1453
316110,202101,13740,39056,11545,35372,820,2863,7902,23877,8722,26740
316120,202101,1211,3416,793,2445,129,413,239,595,368,1008
316130,202101,1220,2767,803,2081,65,185,474,1203,539,1388
316140,202101,1206,3183,779,2388,101,339,367,1112,468,1451
316150,202101,1952,4262,1559,3729,194,597,660,1479,854,2076
316160,202101,989,2662,799,2315,36,124,558,1577,594,1701
316165,202101,819,2033,632,1741,90,288,339,874,429,1162
316170,202101,1175,2885,890,2460,43,148,627,1663,670,1811
316180,202101,1374,3868,949,3014,140,525,165,486,305,1011
316190,202101,2651,7453,1585,4931,233,757,601,1644,834,2401
316200,202101,3134,8979,2376,7671,566,1959,613,1890,1179,3849
316210,202101,4430,12967,3219,10200,1140,3951,180,474,1320,4425
316220,202101,603,1803,407,1368,88,336,47,182,135,518
316225,202101,1583,3557,1188,2939,51,186,900,2061,951,2247
316230,202101,407,1095,320,954,36,111,177,541,213,652
316240,202101,5484,15774,4812,14601,360,1184,3648,10916,4008,12100
316245,202101,3010,9623,2734,9150,111,631,2141,6829,2252,7460
316250,202101,10274,24369,7611,20220,1569,4553,2870,7565,4439,12118
316255,202101,2850,7875,2510,7339,112,338,1901,5632,2013,5970
316257,202101,1367,3289,1005,2651,110,286,609,1530,719,1816
316260,202101,2153,5351,1702,4621,222,582,882,2459,1104,3041
316265,202101,1110,2966,868,2557,18,68,654,1889,672,1957
316270,202101,3657,11113,3144,10007,466,1572,1582,4834,2048,6406
316280,202101,2842,7967,2434,7222,301,983,1393,4004,1694,4987
316290,202101,3298,9094,2658,7922,281,981,1162,3326,1443,4307
316292,202101,5004,13185,4042,11618,504,1545,2594,7176,3098,8721
316294,202101,806,2385,613,2051,112,429,165,513,277,942
316295,202101,3211,8907,2624,7897,140,510,1837,5272,1977,5782
316300,202101,1005,2841,811,2528,42,149,602,1847,644,1996
316310,202101,781,2068,514,1597,108,392,96,254,204,646
316320,202101,661,1833,523,1622,56,210,234,689,290,899
316330,202101,1084,2777,832,2352,57,196,630,1723,687,1919
316340,202101,991,2639,737,2186,69,261,427,1204,496,1465
316350,202101,1266,3547,1049,3197,94,306,732,2209,826,2515
316360,202101,617,1647,508,1467,51,158,373,1068,424,1226
316370,202101,4953,13029,3721,10855,609,2060,1540,4021,2149,6081
316380,202101,1705,4090,1357,3599,54,113,936,2509,990,2622
316390,202101,780,2102,556,1707,227,780,83,232,310,1012
316400,202101,1162,3257,772,2489,107,379,250,742,357,1121
316410,202101,1117,3077,938,2809,59,184,744,2184,803,2368
316420,202101,1963,5296,1706,4962,40,142,1421,4053,1461,4195
316430,202101,812,2115,521,1613,91,309,172,490,263,799
316440,202101,814,2459,648,2165,114,436,172,524,286,960
316443,202101,519,1439,386,1187,99,356,80,229,179,585
316447,202101,1949,5212,1717,4821,22,87,1502,4156,1524,4243
316450,202101,2120,6445,1632,5434,223,795,968,3148,1191,3943
316460,202101,1219,3059,992,2705,121,373,640,1658,761,2031
316470,202101,6707,19109,4867,15269,764,2706,1875,5380,2639,8086
316480,202101,186,509,157,469,47,141,71,206,118,347
316490,202101,319,850,223,675,37,116,78,202,115,318
316500,202101,1155,3553,775,2653,163,616,180,574,343,1190
316510,202101,756,2421,605,2123,108,396,301,1047,409,1443
316520,202101,1328,3171,1046,2720,120,393,553,1295,673,1688
316530,202101,1116,2898,812,2350,79,304,429,1106,508,1410
316540,202101,876,2239,691,1959,107,344,347,891,454,1235
316550,202101,1329,3853,1146,3515,47,166,890,2710,937,2876
316553,202101,4338,12631,3129,9767,443,1540,1227,3386,1670,4926
316555,202101,2508,7865,2274,7540,102,369,1909,6354,2011,6723
316556,202101,505,1256,391,1052,30,81,223,548,253,629
316557,202101,1042,3179,908,2958,278,991,336,1049,614,2040
316560,202101,318,883,218,732,45,182,70,209,115,391
316570,202101,1262,3624,1047,3231,263,821,355,1151,618,1972
316580,202101,376,792,222,546,34,98,105,238,139,336
316590,202101,1340,3418,941,2646,199,492,449,1241,648,1733
316600,202101,935,2840,802,2574,120,401,417,1332,537,1733
316610,202101,602,1870,492,1692,60,265,290,961,350,1226
316620,202101,2091,5425,1837,5074,83,246,1471,4044,1554,4290
316630,202101,1518,4525,1251,4024,317,1042,493,1731,810,2773
316640,202101,137,362,111,327,16,57,51,124,67,181
316650,202101,1047,3246,843,2930,83,312,523,1836,606,2148
316660,202101,181,448,78,238,7,26,15,39,22,65
316670,202101,1748,4401,1318,3723,324,973,456,1268,780,2241
316680,202101,2265,5742,1687,4648,103,303,1255,3366,1358,3669
316690,202101,1388,3889,1060,3299,175,585,488,1478,663,2063
316695,202101,1012,2926,829,2600,25,99,585,1822,610,1921
316700,202101,396,923,323,832,16,48,250,619,266,667
316710,202101,3070,9959,2380,8531,436,1666,1008,3579,1444,5245
316720,202101,20235,54740,15012,44885,2506,8042,6494,18403,9000,26445
316730,202101,446,1182,359,1020,44,152,177,469,221,621
316740,202101,746,2147,644,1984,71,254,401,1244,472,1498
316750,202101,388,1152,299,987,68,247,128,393,196,640
316760,202101,3313,10636,2748,9494,1087,4067,592,1925,1679,5992
316770,202101,1591,3580,1227,3087,27,77,1000,2578,1027,2655
316780,202101,544,1603,426,1372,163,577,73,207,236,784
316790,202101,716,1937,516,1536,98,320,148,406,246,726
316800,202101,6247,17389,5026,15184,586,1964,2500,7332,3086,9296
316805,202101,987,2185,795,1977,59,162,609,1529,668,1691
316810,202101,591,1641,417,1299,77,278,218,636,295,914
316820,202101,296,726,164,479,19,70,63,165,82,235
316830,202101,783,2035,627,1791,79,242,378,1060,457,1302
316840,202101,2753,7017,2184,6066,187,643,1520,4016,1707,4659
316850,202101,1857,4892,1349,3966,226,715,579,1634,805,2349
316860,202101,18717,47657,13718,40291,2164,7388,6257,17932,8421,25320
316870,202101,7716,20840,5755,17104,836,2712,2597,7257,3433,9969
316880,202101,895,2377,733,2152,137,440,359,1011,496,1451
316890,202101,1128,2482,676,1887,87,313,422,1087,509,1400
316900,202101,2255,6029,1754,5041,337,1067,540,1450,877,2517
316905,202101,515,1533,418,1345,106,372,164,535,270,907
316910,202101,851,2211,515,1616,133,454,42,122,175,576
316920,202101,1750,4281,1243,3533,217,660,591,1637,808,2297
316930,202101,7572,21593,5668,18200,1281,4446,1531,4640,2812,9086
316935,202101,3963,10705,2896,8730,510,1664,1156,3325,1666,4989
316940,202101,6354,18505,4914,15583,718,2500,2005,5894,2723,8394
316950,202101,1864,4341,1462,3792,40,133,1224,3121,1264,3254
316960,202101,5003,11210,3614,9339,315,910,2502,6305,2817,7215
316970,202101,3745,10526,3244,9607,503,1552,1361,3850,1864,5402
316980,202101,634,1902,485,1608,165,619,52,185,217,804
316990,202101,11875,31486,8789,25337,2139,6740,1386,3596,3525,10336
317000,202101,2479,7270,2184,6838,166,462,1621,5137,1787,5599
317005,202101,2511,7022,2020,6040,317,1003,1084,3168,1401,4171
317010,202101,23504,54750,14764,41484,2815,8801,5700,16396,8515,25197
317020,202101,60290,142764,35859,100918,6406,19779,11517,30016,17923,49795
317030,202101,689,1800,538,1593,13,54,417,1220,430,1274
317040,202101,10766,26976,7600,21609,1651,5082,2687,7852,4338,12934
317043,202101,846,1894,604,1554,46,120,442,1125,488,1245
317047,202101,1174,2808,816,2237,73,219,521,1366,594,1585
317050,202101,1133,3484,823,2764,107,386,343,1000,450,1386
317052,202101,2331,6452,1875,5721,265,793,1151,3550,1416,4343
317057,202101,1788,4248,1323,3502,33,119,865,2274,898,2393
317060,202101,513,1325,331,970,39,122,140,357,179,479
317065,202101,1138,3338,935,2941,57,177,587,1757,644,1934
317070,202101,7210,19900,5193,16038,910,3152,1586,4632,2496,7784
317075,202101,902,2327,659,1923,101,327,311,823,412,1150
317080,202101,5945,13797,4416,11403,1164,3268,1495,3692,2659,6960
317090,202101,4683,13512,4174,12691,291,837,3120,9560,3411,10397
317100,202101,2598,6159,1678,4658,379,1079,597,1638,976,2717
317103,202101,2222,5795,1911,5344,78,351,1504,4028,1582,4379
317107,202101,1449,3795,1112,3171,78,265,668,1701,746,1966
317110,202101,664,1566,347,1064,54,193,117,373,171,566
317115,202101,1049,3012,913,2768,56,149,618,1887,674,2036
317120,202101,14736,39231,11947,34816,1069,3732,7408,20576,8477,24308
317130,202101,11228,25861,7296,19494,1127,3341,2461,6550,3588,9891
317140,202101,857,2037,670,1758,39,105,452,1223,491,1328
317150,202101,990,2352,745,2047,31,98,589,1588,620,1686
317160,202101,3487,8361,2322,6513,162,475,1288,3717,1450,4192
317170,202101,1761,4378,1294,3587,180,591,584,1427,764,2018
317180,202101,1963,6063,1454,4845,274,979,388,1197,662,2176
317190,202101,1178,3173,877,2686,229,672,353,1099,582,1771
317200,202101,5634,14882,4282,12338,1028,3189,927,2461,1955,5650
317210,202101,1178,2844,917,2487,26,101,683,1875,709,1976
317220,202101,233,728,201,667,47,160,76,266,123,426
320010,202101,4508,12988,3644,11279,376,1288,2306,6940,2682,8228
320013,202101,2038,5459,1411,4229,231,710,619,1945,850,2655
320016,202101,2971,7594,2373,6703,166,446,1756,4980,1922,5426
320020,202101,3832,9819,2828,8101,593,1894,1018,3021,1611,4915
320030,202101,1704,4734,1134,3577,211,715,393,1193,604,1908
320035,202101,1906,5194,1562,4611,383,1247,682,1944,1065,3191
320040,202101,4077,11438,3389,10215,458,1456,1909,5520,2367,6976
320050,202101,1749,3967,1506,3621,185,529,892,2071,1077,2600
320060,202101,12851,34776,9612,28436,1456,4627,4477,12417,5933,17044
320070,202101,1532,4259,1099,3395,186,645,404,1172,590,1817
320080,202101,5729,14606,4024,11248,796,2371,1438,3788,2234,6159
320090,202101,8538,22528,5678,16685,1249,3895,2002,5470,3251,9365
320100,202101,3063,8257,2508,7305,432,1378,1270,3700,1702,5078
320110,202101,2062,4753,1395,3685,202,561,685,1738,887,2299
320115,202101,1807,5769,1535,5313,651,2410,395,1409,1046,3819
320120,202101,23892,60574,16786,47875,2339,7174,7770,20948,10109,28122
320130,202101,46767,128434,38651,113974,4817,15621,22762,65081,27579,80702
320140,202101,3496,9469,2331,7194,336,1209,941,2861,1277,4070
320150,202101,13582,34969,9858,27916,2421,7574,1568,3922,3989,11496
320160,202101,6023,16685,4465,13709,710,2407,2003,6055,2713,8462
320170,202101,1698,4843,1235,3914,336,1044,445,1495,781,2539
320180,202101,683,2146,548,1887,202,737,144,448,346,1185
320190,202101,2802,8855,2159,7447,517,1910,549,1775,1066,3685
320200,202101,1322,3509,895,2745,193,650,337,1028,530,1678
320210,202101,4267,10828,3311,9200,532,1583,1734,4606,2266,6189
320220,202101,2929,7563,2247,6463,342,1069,1196,3261,1538,4330
320225,202101,1330,4130,948,3237,326,1219,192,648,518,1867
320230,202101,4989,13672,3843,11781,816,2758,1529,4510,2345,7268
320240,202101,16064,40356,11975,33855,2855,8825,3822,10620,6677,19445
320245,202101,3067,8969,2418,7689,846,2849,427,1325,1273,4174
320250,202101,2374,6603,1631,4863,367,1204,463,1198,830,2402
320255,202101,1899,5853,1622,5340,417,1419,736,2491,1153,3910
320260,202101,1425,3988,862,2736,175,606,207,552,382,1158
320265,202101,2456,7497,1991,6565,869,3086,319,1046,1188,4132
320270,202101,2174,6239,1675,5261,435,1471,586,1851,1021,3322
320280,202101,7157,18936,5851,16732,1105,3451,2938,8079,4043,11530
320290,202101,1343,3963,877,2848,237,838,224,682,461,1520
320300,202101,3644,10889,2904,9388,814,2861,728,2196,1542,5057
320305,202101,5078,14268,3961,12088,731,2446,1924,5677,2655,8123
320310,202101,2224,6070,1557,4684,265,845,699,1968,964,2813
320313,202101,2415,5997,1602,4514,314,996,422,1079,736,2075
320316,202101,1469,4114,1198,3662,187,585,700,2141,887,2726
320320,202101,22045,57290,15830,46596,3584,11033,5703,16826,9287,27859
320330,202101,2905,7860,2271,6721,407,1214,1187,3582,1594,4796
320332,202101,7508,20005,5998,17309,1330,4140,2683,7648,4013,11788
320334,202101,1733,4844,1217,3789,257,983,312,722,569,1705
320335,202101,1417,4204,1016,3276,227,814,258,764,485,1578
320340,202101,4769,11853,3956,10675,490,1454,2313,6286,2803,7740
320350,202101,5395,13221,3836,10451,447,1362,2053,5232,2500,6594
320360,202101,1414,3596,1056,2924,131,363,514,1364,645,1727
320370,202101,2533,7736,1868,6312,560,2002,577,1934,1137,3936
320380,202101,2599,6903,2159,6194,245,749,1363,3809,1608,4558
320390,202101,7179,19169,5320,15515,1086,3384,2111,5769,3197,9153
320400,202101,3285,9206,2488,7521,693,2233,779,2232,1472,4465
320405,202101,4912,12768,3751,10789,555,1742,1856,5183,2411,6925
320410,202101,4738,12200,3588,10357,648,1821,1784,5393,2432,7214
320420,202101,2739,7150,2072,5973,515,1660,321,921,836,2581
320425,202101,2110,5085,1618,4257,115,327,1033,2634,1148,2961
320430,202101,3140,7832,2473,6647,335,973,1520,3921,1855,4894
320435,202101,2091,6506,1656,5654,588,2135,521,1792,1109,3927
320440,202101,1505,4131,1112,3381,175,585,492,1408,667,1993
320450,202101,1726,4887,1350,4181,258,910,608,1749,866,2659
320455,202101,4361,13072,2976,9796,716,2547,725,2165,1441,4712
320460,202101,2052,6015,1472,4813,349,1224,400,1195,749,2419
320465,202101,1280,3574,966,2977,135,417,509,1583,644,2000
320470,202101,3626,9911,2625,7843,572,1822,651,1743,1223,3565
320480,202101,1662,4533,1359,4027,185,615,805,2328,990,2943
320490,202101,21224,55430,15886,46185,2619,8310,6628,19102,9247,27412
320495,202101,1225,3367,880,2694,191,668,314,916,505,1584
320500,202101,51802,136838,41540,119465,5570,17404,24129,66486,29699,83890
320501,202101,4328,12541,3228,10532,876,3211,1049,3366,1925,6577
320503,202101,2295,6594,1511,4968,401,1435,417,1321,818,2756
320506,202101,2618,7788,1930,6270,570,2004,170,557,740,2561
320510,202101,10188,27307,8303,24126,847,2847,5151,14468,5998,17315
320515,202101,1779,4872,1377,4046,364,1178,459,1279,823,2457
320517,202101,2163,6443,1735,5530,535,1863,529,1660,1064,3523
320520,202101,36842,94197,27750,79070,4538,14262,11905,32640,16443,46902
320530,202101,32669,85583,25965,73859,2319,7797,16423,44100,18742,51897
330010,202101,23007,60035,19063,53622,2313,7136,12623,34428,14936,41564
330015,202101,1381,3368,1078,2919,182,554,605,1566,787,2120
330020,202101,19638,48761,16519,44324,2310,6912,11402,29928,13712,36840
330022,202101,1847,4918,1438,4237,241,718,834,2443,1075,3161
330023,202101,5028,11805,3650,9898,573,1746,2069,5494,2642,7240
330025,202101,6841,15777,4013,11105,877,2701,790,2086,1667,4787
330030,202101,10313,27227,7844,23260,799,2753,4817,13637,5616,16390
330040,202101,14479,37248,11552,32424,997,3146,7827,21141,8824,24287
330045,202101,84241,197307,69389,178642,5231,13212,54903,141056,60134,154268
330050,202101,2473,6504,1832,5428,342,1082,914,2586,1256,3668
330060,202101,5130,13300,4005,11309,762,2427,1703,4432,2465,6859
330070,202101,22109,55325,17796,49205,2714,8021,10593,29083,13307,37104
330080,202101,8703,21790,7415,20007,895,2582,5166,13768,6061,16350
330090,202101,3321,6969,2311,5581,155,403,1603,3871,1758,4274
330093,202101,2677,6351,2016,5450,110,325,1533,4128,1643,4453
330095,202101,1261,3519,994,3043,77,282,608,1721,685,2003
330100,202101,70804,185250,60476,170237,3467,11576,46511,129026,49978,140602
330110,202101,2064,5703,1656,5035,258,862,945,2771,1203,3633
330115,202101,2535,6051,1790,4907,243,766,1011,2662,1254,3428
330120,202101,3485,7754,2608,6641,208,593,1842,4529,2050,5122
330130,202101,4388,11740,3583,10543,479,1471,2229,6535,2708,8006
330140,202101,3798,9766,3017,8661,416,1324,1940,5437,2356,6761
330150,202101,2101,5537,1595,4747,278,873,800,2322,1078,3195
330160,202101,1335,3592,986,2975,181,589,524,1508,705,2097
330170,202101,110021,268333,88231,239199,11672,31159,59489,163472,71161,194631
330180,202101,1931,4608,1480,3983,92,282,1021,2680,1113,2962
330185,202101,9727,24188,8098,21955,468,1547,6506,17202,6974,18749
330187,202101,4360,10907,3421,9394,462,1368,2039,5548,2501,6916
330190,202101,34021,80941,28619,73614,1872,5228,22698,57645,24570,62873
330200,202101,15873,39677,12822,35964,2476,6532,7971,23198,10447,29730
330205,202101,2123,5214,1606,4396,97,318,1114,2917,1211,3235
330210,202101,3500,8615,2545,6978,357,1055,1270,3248,1627,4303
330220,202101,11937,29146,8429,23387,1657,5182,3110,7957,4767,13139
330225,202101,3904,9692,2987,8319,188,641,2164,5869,2352,6510
330227,202101,16890,40370,14055,36967,517,1486,12048,31370,12565,32856
330230,202101,2113,4550,1375,3632,117,334,808,2156,925,2490
330240,202101,23144,59690,19098,53530,2209,6840,12855,35185,15064,42025
330245,202101,1748,4258,1057,3065,200,582,402,1164,602,1746
330250,202101,38201,96362,31428,86496,5170,14659,19415,53197,24585,67856
330260,202101,4833,11535,3658,9956,316,1004,2640,6947,2956,7951
330270,202101,31141,69281,19263,50121,2946,8192,7895,19634,10841,27826
330280,202101,2326,6026,1747,5057,186,577,1023,2870,1209,3447
330285,202101,24701,58125,19443,50664,1359,4198,14504,36520,15863,40718
330290,202101,3905,9333,3141,8342,342,1007,2242,5760,2584,6767
330300,202101,5782,13456,4216,11245,322,978,2950,7703,3272,8681
330310,202101,2695,6518,1913,5231,134,314,1276,3499,1410,3813
330320,202101,16823,38908,12858,34033,1489,3722,9148,24611,10637,28333
330330,202101,41385,88849,32047,76358,2728,7206,22951,53384,25679,60590
330340,202101,17716,40963,12655,33310,1759,5357,6766,16535,8525,21892
330350,202101,144359,328392,119000,297750,7347,19061,98016,243634,105363,262695
330360,202101,7369,17784,6310,16513,195,505,5357,13967,5552,14472
330370,202101,4886,13839,3781,11988,897,2913,1549,5134,2446,8047
330380,202101,5365,14053,4072,11806,637,2168,2125,5854,2762,8022
330385,202101,4014,11335,3268,10255,742,2569,1569,4841,2311,7410
330390,202101,26453,70076,20215,59626,2620,8966,11923,33132,14543,42098
330395,202101,3178,7775,2620,7076,152,478,1907,5025,2059,5503
330400,202101,3353,8711,2842,7919,148,529,2137,5615,2285,6144
330410,202101,3319,8728,2365,7086,474,1552,1008,2851,1482,4403
330411,202101,2733,7324,2114,6203,136,479,1476,4168,1612,4647
330412,202101,1520,4265,1235,3797,129,463,768,2227,897,2690
330414,202101,23864,59414,19376,53340,1433,4225,14540,39484,15973,43709
330415,202101,4296,11615,3340,9977,339,1070,1972,5837,2311,6907
330420,202101,11776,28795,8370,23334,949,3045,4430,11477,5379,14522
330430,202101,9548,22727,7987,20617,305,1009,6314,15796,6619,16805
330440,202101,2553,6721,1939,5700,287,988,1135,3189,1422,4177
330450,202101,1401,3911,1104,3414,146,491,602,1824,748,2315
330452,202101,17443,43616,14011,38434,1618,5092,9152,24146,10770,29238
330455,202101,547105,1282880,423765,1108574,56899,159152,273640,702838,330539,861990
330460,202101,1156,3111,865,2695,140,480,476,1437,616,1917
330470,202101,4744,11715,3411,9704,1121,3315,892,2646,2013,5961
330475,202101,9715,24729,7836,22321,1177,3846,5073,14106,6250,17952
330480,202101,5941,15200,4998,13838,403,1250,3489,9344,3892,10594
330490,202101,111644,253846,90486,225663,9859,25508,64661,159834,74520,185342
330500,202101,7491,18212,6192,16451,601,1793,4470,11673,5071,13466
330510,202101,40317,97814,29760,83105,4537,13649,18484,50767,23021,64416
330513,202101,1215,3105,957,2753,206,636,457,1324,663,1960
330515,202101,2487,6520,1990,5840,365,1176,1116,3173,1481,4349
330520,202101,11210,29127,9145,25980,1119,3555,5729,15828,6848,19383
330530,202101,1708,4079,1251,3407,250,742,569,1527,819,2269
330540,202101,2786,7328,2175,6291,524,1564,923,2599,1447,4163
330550,202101,9008,22691,6854,19897,1820,5822,2950,8427,4770,14249
330555,202101,18291,37986,15148,34319,770,1945,12417,28379,13187,30324
330560,202101,4075,10774,3302,9520,504,1484,1941,5470,2445,6954
330570,202101,2659,7246,2267,6673,340,1088,1497,4367,1837,5455
330575,202101,5336,13697,4574,12426,269,844,3676,9681,3945,10525
330580,202101,17392,45777,13575,39052,2328,7227,6722,18551,9050,25778
330590,202101,1424,3817,1167,3486,216,638,724,2199,940,2837
330600,202101,12030,31158,9825,27696,868,2862,6336,17318,7204,20180
330610,202101,9038,24003,7255,21229,532,1830,5056,14458,5588,16288
330615,202101,2073,5646,1646,5077,308,970,1019,3218,1327,4188
330620,202101,4006,11313,3142,9848,671,2267,1361,4016,2032,6283
330630,202101,24063,59687,18957,51880,1246,4065,13601,36002,14847,40067
350010,202101,2003,5133,1089,3237,218,692,208,464,426,1156
350020,202101,700,1767,409,1214,51,166,154,426,205,592
350030,202101,3452,9580,2596,8109,634,2184,1116,3274,1750,5458
350040,202101,722,2039,418,1394,49,189,144,362,193,551
350050,202101,1329,3229,863,2429,177,573,308,714,485,1287
350055,202101,891,2318,709,2043,78,242,408,1123,486,1365
350060,202101,201,512,120,356,15,51,51,148,66,199
350070,202101,3179,8340,2064,6351,399,1374,681,1865,1080,3239
350075,202101,591,1702,439,1411,170,576,50,172,220,748
350080,202101,646,1668,426,1283,57,196,168,454,225,650
350090,202101,589,1373,355,979,66,194,152,389,218,583
350100,202101,2298,6043,1614,4859,123,459,1001,2815,1124,3274
350110,202101,474,1182,327,928,16,52,187,523,203,575
350115,202101,1216,3490,1003,3064,175,593,515,1422,690,2015
350120,202101,666,1535,372,1003,33,116,204,480,237,596
350130,202101,3089,8118,2423,6906,429,1229,1174,3192,1603,4421
350140,202101,773,2163,536,1716,46,198,279,836,325,1034
350150,202101,538,1633,433,1432,98,324,125,383,223,707
350160,202101,10830,27106,7290,20643,895,2851,4362,11731,5257,14582
350170,202101,2285,6445,1862,5544,308,998,859,2330,1167,3328
350180,202101,1002,2450,543,1604,100,308,132,354,232,662
350190,202101,2797,7884,1914,6018,334,1189,787,2117,1121,3306
350200,202101,442,1240,343,1056,16,54,221,639,237,693
350210,202101,5797,13293,3961,10457,478,1388,2444,6192,2922,7580
350220,202101,2847,7755,1928,5950,411,1345,608,1693,1019,3038
350230,202101,956,2439,783,2200,142,427,440,1206,582,1633
350240,202101,628,1802,400,1272,91,285,95,280,186,565
350250,202101,2546,7077,1916,6054,592,2066,471,1453,1063,3519
350260,202101,815,1918,531,1438,52,162,327,845,379,1007
350270,202101,4499,11956,3597,10265,520,1637,1930,5110,2450,6747
350275,202101,2319,6188,1818,5429,295,967,1055,3014,1350,3981
350280,202101,18281,41330,11079,29726,1762,4969,4425,11340,6187,16309
350290,202101,3149,8662,2158,6631,380,1285,847,2435,1227,3720
350300,202101,619,1656,463,1373,58,175,251,695,309,870
350310,202101,889,2546,660,2101,112,408,257,726,369,1134
350315,202101,582,1444,388,1123,23,83,202,537,225,620
350320,202101,15063,38175,10986,31057,2208,6906,4279,11187,6487,18093
350330,202101,13647,33250,9766,25965,1016,2989,6123,15300,7139,18289
350335,202101,365,1032,281,871,37,130,126,365,163,495
350340,202101,1151,2902,713,2121,116,401,295,771,411,1172
350350,202101,753,1860,581,1672,64,212,358,1018,422,1230
350360,202101,1052,3082,801,2570,208,680,244,800,452,1480
350370,202101,610,1514,426,1182,146,381,132,375,278,756
350380,202101,4328,11759,3109,9309,878,2576,805,2482,1683,5058
350390,202101,10643,27669,8383,23903,1591,4761,4077,11154,5668,15915
350395,202101,419,1074,218,687,24,71,80,235,104,306
350400,202101,7863,19102,5456,15214,1321,3998,1505,4150,2826,8148
350410,202101,9870,27180,7228,22134,1417,4841,2844,8049,4261,12890
350420,202101,757,2023,525,1524,79,258,126,310,205,568
350430,202101,653,1733,531,1550,71,242,327,873,398,1115
350440,202101,2063,5124,1669,4537,128,374,1091,2901,1219,3275
350450,202101,6383,17453,4952,14999,1067,3549,2057,5861,3124,9410
350460,202101,1704,4359,921,2786,143,473,268,715,411,1188
350470,202101,250,631,193,534,12,38,136,362,148,400
350480,202101,977,2390,637,1819,129,452,162,352,291,804
350490,202101,1942,5020,1388,4142,317,974,432,1186,749,2160
350500,202101,671,1768,509,1483,65,209,243,661,308,870
350510,202101,1159,2990,866,2458,94,302,520,1404,614,1706
350520,202101,2115,6396,1637,5468,253,946,719,2172,972,3118
350530,202101,2787,6966,2087,5658,220,670,1248,3148,1468,3818
350535,202101,1431,3890,1240,3626,180,575,766,2173,946,2748
350540,202101,1980,4617,1478,3886,171,463,941,2372,1112,2835
350550,202101,8188,20028,5668,15898,589,1980,3288,8542,3877,10522
350560,202101,3865,10786,3090,9454,295,954,1953,5782,2248,6736
350570,202101,24218,66630,19642,57992,3463,11295,10152,28668,13615,39963
350580,202101,2036,5407,1234,3778,337,1120,220,548,557,1668
350590,202101,5007,13414,3701,10545,475,1547,2175,5705,2650,7252
350600,202101,34593,79266,21581,57011,3093,9288,10102,24472,13195,33760
350610,202101,6756,18324,4840,14542,817,2713,2251,6339,3068,9052
350620,202101,413,1047,256,804,24,77,148,445,172,522
350630,202101,1417,3643,1042,2981,65,235,681,1816,746,2051
350635,202101,9273,22594,6945,18980,912,2741,4246,11125,5158,13866
350640,202101,891,2371,483,1492,71,220,136,365,207,585
350650,202101,8406,22244,5797,17156,1086,3489,2196,6032,3282,9521
350660,202101,4458,11586,3436,9909,561,1630,1810,5251,2371,6881
350670,202101,1773,4683,1446,4211,141,420,983,2875,1124,3295
350680,202101,1081,2886,735,2257,131,423,300,873,431,1296
350690,202101,1267,3249,899,2649,153,480,476,1371,629,1851
350700,202101,4780,12007,3448,9967,690,2282,1475,4077,2165,6359
350710,202101,2759,7522,2342,6799,400,1364,1274,3393,1674,4757
350715,202101,781,2218,651,1998,69,269,359,1025,428,1294
350720,202101,152,408,110,335,18,58,31,77,49,135
350730,202101,627,1671,529,1510,27,101,399,1074,426,1175
350740,202101,1673,4425,1161,3394,201,636,391,1054,592,1690
350745,202101,561,1409,322,979,36,135,132,367,168,502
350750,202101,9629,24787,7311,20866,1218,4075,3367,8603,4585,12678
350760,202101,14607,36003,10558,29107,2136,6508,4490,11162,6626,17670
350770,202101,990,2459,629,1828,35,112,404,1142,439,1254
350775,202101,670,1540,463,1236,57,150,220,593,277,743
350780,202101,2273,5452,1607,4510,264,877,565,1816,829,2693
350790,202101,1951,5113,1248,3813,251,838,343,843,594,1681
350800,202101,3470,9892,2979,9044,241,830,2059,6060,2300,6890
350810,202101,2784,6748,2152,5820,328,833,1150,3193,1478,4026
350820,202101,934,2158,540,1468,52,174,267,655,319,829
350830,202101,861,2372,499,1579,72,241,157,414,229,655
350840,202101,3230,9312,2419,7811,538,1929,1082,3220,1620,5149
350850,202101,7426,20364,5809,17483,1081,3533,2820,8037,3901,11570
350860,202101,3568,9495,3068,8829,108,397,2356,6732,2464,7129
350870,202101,2545,7129,1899,6104,259,936,1064,3330,1323,4266
350880,202101,1282,3631,1009,3089,266,848,267,786,533,1634
350890,202101,531,1360,337,959,51,149,129,336,180,485
350900,202101,7079,18947,4557,13749,923,3049,1616,4509,2539,7558
350910,202101,897,2168,769,1973,91,237,554,1404,645,1641
350920,202101,12047,29383,10221,26472,399,1267,8396,20966,8795,22233
350925,202101,4104,11094,2936,9012,550,1817,1393,3970,1943,5787
350930,202101,1472,3810,1028,2954,76,228,644,1809,720,2037
350940,202101,2228,5792,1708,4964,168,554,1083,3016,1251,3570
350945,202101,812,2278,614,1892,98,334,310,887,408,1221
350950,202101,88298,224359,68372,187818,8521,25651,42335,111017,50856,136668
350960,202101,6372,17130,4944,14472,579,1941,2951,8190,3530,10131
350970,202101,3481,9614,2485,7783,709,2488,527,1410,1236,3898
350980,202101,643,1753,518,1517,133,409,237,689,370,1098
350990,202101,1724,4777,1278,4059,306,1086,447,1343,753,2429
350995,202101,776,2397,696,2239,53,209,482,1492,535,1701
351000,202101,2830,7323,1975,5834,357,1102,717,2065,1074,3167
351010,202101,334,820,225,636,29,94,114,307,143,401
351015,202101,813,2434,658,2104,106,372,291,830,397,1202
351020,202101,8614,23242,6580,19804,1433,4357,3009,8882,4442,13239
351030,202101,2782,8214,2234,7150,326,1165,1190,3694,1516,4859
351040,202101,4932,12192,4133,11006,201,641,3382,8771,3583,9412
351050,202101,16553,40159,12018,33216,2321,6794,5384,14737,7705,21531
351060,202101,47270,118285,36204,99608,3582,10931,24359,64852,27941,75783
351070,202101,1365,3344,745,2299,175,594,125,373,300,967
351080,202101,2730,6520,1948,5602,205,708,1306,3571,1511,4279
351090,202101,322,922,235,763,46,157,66,212,112,369
351100,202101,2538,6850,1653,5091,365,1193,476,1521,841,2714
351110,202101,6011,15178,3897,11329,637,2053,1701,4638,2338,6691
351120,202101,762,1914,511,1507,64,194,194,562,258,756
351130,202101,1182,3027,549,1713,100,321,148,423,248,744
351140,202101,2137,5967,1582,4928,292,1014,685,1927,977,2941
351150,202101,2629,7470,1774,5600,281,984,697,1970,978,2954
351160,202101,1066,3291,780,2626,160,585,202,568,362,1153
351170,202101,1337,3643,1147,3315,86,271,822,2292,908,2563
351190,202101,997,2741,666,2071,124,393,238,682,362,1075
351200,202101,1571,3712,1165,3120,86,268,822,2055,908,2323
351210,202101,1532,3751,960,2674,79,257,553,1428,632,1685
351220,202101,3264,9088,2786,8309,297,916,1852,5468,2149,6384
351230,202101,1710,4591,1272,3828,215,771,588,1596,803,2367
351240,202101,2359,5940,1459,4088,317,965,522,1314,839,2279
351250,202101,1045,2774,635,1961,84,282,228,684,312,966
351260,202101,903,2267,653,1814,129,365,251,660,380,1025
351270,202101,441,1176,355,1027,38,141,207,521,245,662
351280,202101,3705,9661,2855,8089,569,1626,1296,3547,1865,5173
351290,202101,1200,2949,843,2341,113,344,503,1339,616,1683
351300,202101,18122,48645,12509,37995,2156,7112,5416,15695,7572,22807
351310,202101,3403,8228,2592,7002,171,587,1912,4904,2083,5491
351320,202101,936,2682,699,2190,126,416,249,709,375,1125
351330,202101,494,1180,406,1017,23,67,286,646,309,713
351340,202101,6102,17259,4926,15189,1195,3845,2156,6624,3351,10469
351350,202101,11263,27916,9284,24848,928,2638,6785,17670,7713,20308
351360,202101,3685,9792,3019,8808,719,2244,1201,3239,1920,5483
351370,202101,2018,5547,1360,4196,314,1038,424,1185,738,2223
351380,202101,47925,114533,33982,90604,4120,11851,19656,50002,23776,61853
351385,202101,325,863,148,467,27,81,40,118,67,199
351390,202101,1343,3238,830,2493,112,398,479,1348,591,1746
351400,202101,895,2477,741,2171,111,324,463,1330,574,1654
351410,202101,2559,7049,1841,5644,308,986,743,2206,1051,3192
351420,202101,425,1002,239,679,28,73,139,366,167,439
351430,202101,926,2475,738,2173,60,177,501,1432,561,1609
351440,202101,3354,8671,2223,6435,409,1246,622,1538,1031,2784
351450,202101,1685,4445,1115,3395,214,706,187,442,401,1148
351460,202101,844,2178,663,1898,150,413,361,1037,511,1450
351470,202101,1183,2980,928,2560,85,296,604,1558,689,1854
351480,202101,2463,7193,1958,6331,366,1318,848,2558,1214,3876
351490,202101,1995,5556,1702,5035,68,276,1386,3966,1454,4242
351492,202101,342,925,280,795,7,21,214,596,221,617
351495,202101,170,437,131,364,17,42,70,194,87,236
351500,202101,37677,91546,28730,76860,4050,11588,17488,44728,21538,56316
351510,202101,12662,31210,9202,25361,1083,3424,5751,15131,6834,18555
351512,202101,472,1271,343,991,59,176,119,315,178,491
351515,202101,3173,7049,1999,5257,353,1042,589,1652,942,2694
351518,202101,2258,5663,1454,4248,188,617,803,2135,991,2752
351519,202101,695,1906,441,1410,84,270,70,204,154,474
351520,202101,1289,3169,555,1666,53,180,235,627,288,807
351530,202101,345,902,205,611,32,100,84,202,116,302
351535,202101,1841,4508,1346,3665,207,615,690,1752,897,2367
351540,202101,2546,6273,1691,4769,270,876,656,1629,926,2505
351550,202101,7090,17411,4772,13260,469,1482,2711,6974,3180,8456
351560,202101,433,1231,337,1045,80,271,103,294,183,565
351565,202101,234,650,186,563,41,141,51,132,92,273
351570,202101,21086,55725,16127,45969,1610,4965,10099,27568,11709,32533
351580,202101,235,603,135,416,11,36,60,195,71,231
351590,202101,513,1172,273,749,21,83,159,387,180,470
351600,202101,1338,3516,1028,2941,103,326,604,1618,707,1944
351610,202101,781,1842,492,1331,25,71,284,722,309,793
351620,202101,22409,58284,16230,47890,2566,8629,7440,19882,10006,28511
351630,202101,28203,73221,22694,63922,3064,9216,14234,38701,17298,47917
351640,202101,17571,45658,13819,38990,1305,4235,9331,25180,10636,29415
351650,202101,363,953,180,572,25,81,51,142,76,223
351660,202101,736,2035,473,1463,74,243,81,203,155,446
351670,202101,5810,15493,3794,11197,809,2376,1577,4360,2386,6736
351680,202101,415,1163,266,842,42,135,72,184,114,319
351685,202101,396,1124,317,996,85,273,101,296,186,569
351690,202101,1091,2712,608,1766,85,277,265,693,350,970
351700,202101,1284,3173,936,2589,156,438,514,1338,670,1776
351710,202101,747,1999,541,1617,50,176,295,795,345,971
351720,202101,1353,3475,892,2685,140,448,365,1035,505,1483
351730,202101,924,2422,768,2183,58,206,490,1312,548,1518
351740,202101,3428,8578,2720,7244,471,1358,1369,3345,1840,4703
351750,202101,1283,3298,796,2454,143,466,311,929,454,1395
351760,202101,3229,9039,2377,7357,488,1708,880,2456,1368,4164
351770,202101,1729,5020,1408,4412,248,821,758,2311,1006,3132
351780,202101,1171,2952,714,2113,94,320,262,727,356,1047
351790,202101,1324,3143,1046,2775,160,436,625,1674,785,2110
351800,202101,525,1197,263,708,28,79,101,224,129,303
351810,202101,1036,2703,861,2444,54,148,601,1628,655,1776
351820,202101,2566,7186,1790,5688,462,1584,416,1230,878,2814
351830,202101,4456,11853,3442,10114,312,1104,2188,6102,2500,7206
351840,202101,8464,23001,6329,19124,875,2997,3350,9416,4225,12413
351850,202101,1505,4097,1001,3119,167,595,346,924,513,1519
351860,202101,2639,7549,2023,6408,339,1190,1072,3413,1411,4603
351870,202101,23249,58659,17239,48893,4131,12161,7178,20617,11309,32778
351880,202101,131654,334804,98838,279347,21118,66143,47411,126999,68529,193142
351885,202101,918,2411,723,2092,57,201,480,1328,537,1529
351890,202101,835,2137,527,1622,111,362,94,244,205,606
351900,202101,1109,2918,854,2544,115,347,499,1464,614,1811
351905,202101,415,1113,292,881,25,83,144,380,169,463
351907,202101,20788,53887,16195,45844,1804,5691,10455,28419,12259,34110
351910,202101,1623,4188,1135,3146,77,235,661,1660,738,1895
351920,202101,852,2238,643,1841,98,323,282,729,380,1052
351925,202101,915,2382,707,2009,87,293,368,963,455,1256
351930,202101,3206,8883,2875,8294,590,1696,1885,5365,2475,7061
351940,202101,1071,2734,770,2209,123,375,376,1067,499,1442
351950,202101,1676,3769,1250,3140,55,165,893,2152,948,2317
351960,202101,4988,12486,3631,10094,790,2365,1630,4205,2420,6570
351970,202101,7006,20495,5508,17903,849,3109,3031,9548,3880,12657
351980,202101,964,2227,617,1680,84,265,354,886,438,1151
351990,202101,1458,3437,1056,2845,52,193,517,1255,569,1448
352000,202101,2606,7363,2246,6621,246,833,1486,4119,1732,4952
352010,202101,2245,5941,1806,5227,477,1513,391,1157,868,2670
352020,202101,1334,3643,1025,3139,146,496,509,1482,655,1978
352030,202101,5693,14881,4427,12820,817,2582,2163,6074,2980,8656
352040,202101,2872,7526,1977,5762,268,885,747,1852,1015,2737
352042,202101,2912,7003,1937,5481,355,1151,865,2330,1220,3481
352044,202101,2067,5370,1208,3762,197,691,233,687,430,1378
352050,202101,12375,32547,8152,24360,1974,6749,1595,3998,3569,10747
352060,202101,674,1823,501,1509,73,243,218,600,291,843
352070,202101,927,1854,597,1419,60,154,297,632,357,786
352080,202101,482,1199,274,786,30,104,96,240,126,344
352090,202101,1465,4281,1210,3781,134,485,601,1708,735,2193
352100,202101,3343,9360,2706,8174,574,1909,1181,3432,1755,5341
352110,202101,586,1672,443,1398,97,312,178,522,275,834
352115,202101,502,1333,410,1189,57,196,241,680,298,876
352120,202101,880,2590,729,2288,78,234,430,1268,508,1502
352130,202101,2025,5610,1363,4024,203,646,559,1520,762,2166
352140,202101,1129,3078,810,2462,139,452,372,1097,511,1549
352150,202101,875,2297,686,1988,73,224,487,1380,560,1604
352160,202101,992,2429,721,2004,76,267,408,1076,484,1343
352170,202101,2974,7875,2358,6688,312,993,1451,3846,1763,4839
352180,202101,2366,6334,1818,5359,401,1343,562,1473,963,2816
352190,202101,1250,3352,992,2957,187,514,493,1543,680,2057
352200,202101,324,970,227,772,35,139,81,268,116,407
352210,202101,19628,45808,15451,40338,925,2729,12083,30905,13008,33634
352215,202101,660,1695,563,1552,74,229,349,924,423,1153
352220,202101,20903,51230,14505,40049,2624,7937,6570,16750,9194,24687
352230,202101,14263,40601,11063,34664,2618,9156,3970,11429,6588,20585
352240,202101,10101,25822,7738,21965,1652,5272,3400,8959,5052,14231
352250,202101,22147,61445,17721,53966,2795,9102,10613,31810,13408,40912
352260,202101,4687,11663,3128,8692,428,1373,1766,4400,2194,5773
352265,202101,909,2519,802,2373,50,173,605,1743,655,1916
352270,202101,1420,4183,1059,3426,219,764,374,1135,593,1899
352280,202101,2437,6078,1843,5226,190,648,1116,2945,1306,3593
352290,202101,1103,3154,899,2778,117,401,485,1356,602,1757
352300,202101,850,2290,578,1720,76,263,304,839,380,1102
352310,202101,43056,113866,32231,95176,7693,23348,13990,41559,21683,64907
352320,202101,6501,16929,5050,14216,750,2399,2711,6877,3461,9276
352330,202101,2162,5723,1646,5006,281,1008,896,2544,1177,3552
352340,202101,5931,15550,4390,12751,653,2177,2246,6002,2899,8179
352350,202101,2117,5975,1651,4970,165,609,948,2596,1113,3205
352360,202101,1212,3207,997,2839,79,275,750,2056,829,2331
352370,202101,1065,2983,924,2753,18,72,759,2227,777,2299
352380,202101,826,2225,621,1862,128,382,218,636,346,1018
352390,202101,14202,34805,9712,26994,1545,4688,5333,14017,6878,18705
352400,202101,3417,9349,2795,8207,591,2030,1402,3823,1993,5853
352410,202101,3247,8235,2471,6970,206,696,1540,4166,1746,4862
352420,202101,805,1927,571,1595,111,323,214,557,325,880
352430,202101,8003,19752,5745,15834,1134,3554,2727,7046,3861,10600
352440,202101,17695,47459,13297,39172,3177,9656,4889,14035,8066,23691
352450,202101,738,1758,367,1136,51,176,127,374,178,550
352460,202101,2931,8034,2062,6478,395,1366,845,2498,1240,3864
352470,202101,3288,8275,2487,6995,279,891,1543,4126,1822,5017
352480,202101,3953,9322,2660,7026,400,1208,1284,3015,1684,4223
352490,202101,738,2096,590,1838,95,330,291,857,386,1187
352500,202101,9975,25548,6713,19491,2674,8542,673,1101,3347,9643
352510,202101,3758,10111,2792,8431,557,1826,1314,3777,1871,5603
352520,202101,2871,7357,2226,6290,377,1230,1288,3289,1665,4519
352530,202101,10472,26699,7072,20330,1171,3887,2568,6326,3739,10213
352540,202101,580,1694,423,1339,60,204,148,420,208,624
352550,202101,989,2737,692,2178,124,442,238,667,362,1109
352560,202101,557,1533,423,1275,80,257,198,549,278,806
352570,202101,2316,6594,1478,4758,341,1194,144,363,485,1557
352580,202101,655,1688,549,1496,43,135,381,987,424,1122
352585,202101,318,837,232,694,21,79,139,375,160,454
352590,202101,12828,33445,8987,26207,2170,6912,4008,10825,6178,17737
352600,202101,1887,5061,1487,4345,151,481,940,2600,1091,3081
352610,202101,2755,7690,2069,6493,399,1418,867,2566,1266,3984
352620,202101,5517,13970,4209,12124,1170,3435,1663,4844,2833,8279
352630,202101,823,2029,611,1729,109,352,280,724,389,1076
352640,202101,2912,7437,2106,6012,202,606,1206,3306,1408,3912
352650,202101,579,1642,401,1258,55,190,145,435,200,625
352660,202101,1054,3080,878,2729,98,323,523,1584,621,1907
352670,202101,9438,25232,6297,19049,1561,5106,1728,4815,3289,9921
352680,202101,3325,9738,2328,7479,351,1341,1107,3176,1458,4517
352690,202101,27030,67210,21172,57410,1307,4251,15126,39292,16433,43543
352700,202101,569,1418,429,1240,149,494,104,296,253,790
352710,202101,5131,13125,3660,10482,848,2691,1537,4038,2385,6729
352720,202101,7701,20670,6026,17634,2332,7034,1510,4090,3842,11124
352725,202101,577,1372,331,934,22,56,168,455,190,511
352730,202101,5077,14641,4583,13532,529,1709,2111,5462,2640,7171
352740,202101,2252,5340,1700,4527,171,542,1038,2606,1209,3148
352750,202101,422,1047,261,756,41,137,113,287,154,424
352760,202101,1598,4402,1256,3749,95,269,748,2248,843,2517
352770,202101,860,2320,597,1820,123,383,229,671,352,1054
352780,202101,610,1697,441,1370,99,288,114,366,213,654
352790,202101,454,1204,324,956,36,122,126,323,162,445
352800,202101,1255,3781,885,2914,243,820,112,320,355,1140
352810,202101,1152,2692,736,1966,122,350,435,1087,557,1437
352820,202101,464,1302,339,1080,69,211,69,229,138,440
352830,202101,573,1442,269,819,25,81,61,154,86,235
352840,202101,3929,11162,3218,9894,1040,3429,1069,3165,2109,6594
352850,202101,10562,25650,7307,20427,1910,5803,2365,5981,4275,11784
352860,202101,1011,2781,770,2357,141,474,284,828,425,1302
352870,202101,854,2105,594,1594,52,165,366,929,418,1094
352880,202101,1695,3990,1198,3144,197,545,639,1607,836,2152
352885,202101,303,827,229,702,20,72,138,400,158,472
352890,202101,686,1650,448,1155,38,111,270,620,308,731
352900,202101,17710,45875,11837,34391,1916,5971,5183,14143,7099,20114
352910,202101,414,1092,237,722,29,93,69,181,98,274
352920,202101,2621,6623,1914,5437,120,372,1332,3677,1452,4049
352930,202101,5624,15052,4193,12291,724,2360,1996,5451,2720,7811
352940,202101,21497,57462,15688,45582,3028,9623,7057,19241,10085,28864
352950,202101,535,1407,331,1037,86,269,68,196,154,465
352960,202101,716,1895,410,1258,71,237,113,289,184,526
352965,202101,220,618,141,463,41,132,34,102,75,234
352970,202101,2899,6896,2228,5800,234,665,1453,3705,1687,4370
352980,202101,1341,3550,1077,3162,252,816,555,1583,807,2399
352990,202101,4020,11205,3144,9771,617,2106,1570,4674,2187,6780
353000,202101,471,1286,270,820,38,123,63,159,101,282
353010,202101,2559,6316,1689,4746,331,1066,710,1800,1041,2866
353020,202101,3502,8995,2119,6173,286,927,729,1981,1015,2908
353030,202101,4372,10895,3016,8574,665,2088,895,2399,1560,4487
353040,202101,637,1437,440,1154,82,207,225,580,307,787
353050,202101,5128,14562,3640,11552,666,2280,1643,4990,2309,7270
353060,202101,47331,120233,39180,107354,2649,8701,29432,77856,32081,86557
353070,202101,9293,26317,6803,21036,1248,4239,2904,8288,4152,12527
353080,202101,4030,10939,2650,8292,472,1682,1048,2877,1520,4559
353090,202101,581,1734,463,1490,34,115,290,908,324,1023
353100,202101,289,769,138,434,25,83,38,95,63,178
353110,202101,7398,19447,5956,17419,1259,3794,3020,9161,4279,12955
353120,202101,384,947,289,794,39,130,139,335,178,465
353130,202101,2446,5683,1534,4143,374,1134,510,1227,884,2361
353140,202101,2704,6656,1960,5415,103,342,1393,3697,1496,4039
353150,202101,1586,3867,1130,3132,226,646,479,1255,705,1901
353160,202101,609,1565,446,1300,73,219,183,484,256,703
353170,202101,517,1375,386,1196,77,266,170,522,247,788
353180,202101,9719,23465,7710,20366,668,1963,5763,14794,6431,16757
353190,202101,3319,8863,2664,7580,341,1041,1555,4151,1896,5192
353200,202101,1782,4704,980,3084,158,546,251,724,409,1270
353205,202101,371,1108,319,998,51,170,155,471,206,641
353210,202101,885,2044,574,1541,29,84,389,1026,418,1110
353215,202101,376,1031,295,888,43,143,143,397,186,540
353220,202101,717,1893,470,1400,95,266,76,214,171,480
353230,202101,836,2290,658,2014,183,617,255,716,438,1333
353240,202101,2285,6170,1888,5532,268,907,1136,3204,1404,4111
353250,202101,1294,2902,812,2118,101,301,460,1131,561,1432
353260,202101,1169,2668,644,1825,87,273,308,834,395,1107
353270,202101,666,1730,567,1556,48,148,390,1004,438,1152
353280,202101,657,1747,463,1404,128,398,117,349,245,747
353282,202101,1781,4973,1502,4470,176,571,918,2590,1094,3161
353284,202101,351,795,190,500,19,71,87,195,106,266
353286,202101,174,427,105,316,15,48,37,102,52,150
353290,202101,1475,3890,928,2798,155,475,290,802,445,1277
353300,202101,1997,5273,1465,4245,233,769,660,1704,893,2473
353310,202101,390,950,285,766,23,80,188,477,211,557
353320,202101,634,1550,537,1420,7,31,469,1226,476,1257
353325,202101,662,1901,462,1471,96,294,159,500,255,794
353330,202101,522,1332,362,1042,43,128,200,533,243,661
353340,202101,2741,7440,1974,5925,383,1283,924,2577,1307,3860
353350,202101,3500,8860,2436,6809,542,1592,709,1770,1251,3362
353360,202101,640,1780,496,1505,50,158,290,863,340,1021
353370,202101,550,1581,457,1436,36,114,328,999,364,1113
353380,202101,277,827,233,738,21,68,127,375,148,443
353390,202101,6234,15299,4704,12759,449,1394,2853,7296,3302,8690
353400,202101,450,1187,339,980,60,205,133,319,193,524
353410,202101,518,1397,389,1169,69,205,219,671,288,876
353420,202101,409,1060,256,742,58,159,19,42,77,201
353430,202101,2179,5974,1687,5070,331,1074,784,2252,1115,3326
353440,202101,63990,170772,46883,138427,7241,23412,25511,71080,32752,94492
353450,202101,361,894,241,691,35,116,116,299,151,415
353460,202101,3147,8512,2281,6888,169,583,1026,2995,1195,3578
353470,202101,7661,19921,5532,16039,872,2925,2478,6576,3350,9501
353475,202101,1489,3841,1047,2957,156,474,526,1380,682,1854
353480,202101,1594,4230,1277,3695,53,195,911,2550,964,2745
353490,202101,1073,2830,730,2189,99,331,331,924,430,1255
353500,202101,1054,2471,785,2075,164,449,435,1128,599,1577
353510,202101,738,2209,539,1730,131,463,138,373,269,836
353520,202101,1024,2662,654,1998,76,259,305,867,381,1126
353530,202101,2364,6208,1854,5298,255,827,984,2592,1239,3419
353540,202101,2052,5463,1686,4888,271,829,993,2802,1264,3631
353550,202101,5707,14605,4648,12923,733,2145,2659,7096,3392,9241
353560,202101,2266,6067,1709,5210,453,1508,498,1361,951,2869
353570,202101,581,1492,432,1257,46,142,254,702,300,844
353580,202101,2011,5295,1523,4353,342,989,698,1954,1040,2943
353590,202101,675,1759,453,1349,87,275,194,573,281,848
353600,202101,1689,4161,1278,3453,153,413,697,1839,850,2252
353610,202101,566,1685,410,1373,84,345,121,367,205,712
353620,202101,2605,6878,1834,5559,359,1218,598,1666,957,2884
353625,202101,494,1206,335,932,23,75,210,568,233,643
353630,202101,1294,3947,1086,3505,231,829,409,1208,640,2037
353640,202101,1368,3528,1100,3120,156,437,598,1691,754,2128
353650,202101,7378,19466,5583,16151,577,1879,3392,9286,3969,11165
353657,202101,384,994,286,831,25,81,139,376,164,457
353660,202101,1275,2678,864,2135,397,982,197,476,594,1458
353670,202101,3993,10993,3095,9260,579,1951,1507,4170,2086,6121
353680,202101,672,1744,496,1494,71,243,286,803,357,1046
353690,202101,398,1041,193,595,24,79,38,105,62,184
353700,202101,2026,5248,1679,4678,115,371,1246,3332,1361,3703
353710,202101,5262,11696,3177,8073,331,873,1761,3989,2092,4862
353715,202101,409,1083,249,783,11,45,86,256,97,301
353720,202101,1962,5126,1514,4463,227,707,843,2447,1070,3154
353730,202101,4357,11262,3313,9465,464,1560,1769,4615,2233,6175
353740,202101,1961,5148,1375,4129,327,1076,458,1226,785,2302
353750,202101,833,2491,598,2033,136,522,113,365,249,887
353760,202101,12419,28591,9465,24665,1860,4949,5105,13098,6965,18047
353770,202101,732,2185,428,1434,74,271,56,163,130,434
353780,202101,5119,14071,4097,12168,843,2808,2053,5636,2896,8444
353790,202101,2625,7837,1913,6345,506,1874,401,1151,907,3025
353800,202101,17959,46488,14070,40299,1987,6013,7885,22509,9872,28522
353810,202101,1131,3005,732,2192,103,348,318,905,421,1253
353820,202101,1709,4554,1199,3550,248,797,401,1119,649,1916
353830,202101,617,1555,458,1286,80,238,202,545,282,783
353850,202101,1594,4385,1227,3702,248,738,456,1337,704,2075
353860,202101,2590,7066,1983,6040,469,1638,882,2419,1351,4057
353870,202101,29055,75405,20782,59614,2619,8459,10917,28589,13536,37048
353880,202101,3108,8501,2468,7315,206,706,1524,4348,1730,5054
353890,202101,2659,5684,1842,4551,130,361,1326,3079,1456,3440
353900,202101,725,2021,528,1630,80,276,213,606,293,882
353910,202101,2368,6508,1974,5903,197,693,1355,3972,1552,4665
353920,202101,1835,5037,1303,3995,299,1041,322,816,621,1857
353930,202101,4282,11282,2907,8715,482,1673,1215,3210,1697,4883
353940,202101,1035,2923,722,2318,120,407,262,774,382,1181
353950,202101,3179,8528,2446,7206,470,1498,1298,3579,1768,5077
353960,202101,694,1796,479,1388,88,265,209,578,297,843
353970,202101,637,1514,479,1278,42,125,327,849,369,974
353980,202101,16273,40638,12744,34590,792,2530,9258,24024,10050,26554
353990,202101,931,2252,569,1600,98,296,252,673,350,969
354000,202101,2396,5736,1374,3855,300,891,238,637,538,1528
354010,202101,341,890,239,723,48,157,126,364,174,521
354020,202101,3452,9348,2716,7858,593,1854,1126,2966,1719,4820
354025,202101,708,1969,477,1517,71,255,130,388,201,643
354030,202101,509,1113,280,736,65,182,132,324,197,506
354040,202101,785,1823,506,1369,23,76,374,977,397,1053
354050,202101,914,2570,639,2079,142,496,207,653,349,1149
354060,202101,3233,9122,2261,7080,474,1617,858,2470,1332,4087
354070,202101,3568,9267,2395,6998,406,1388,1062,2667,1468,4055
354075,202101,2612,7446,2054,6446,270,964,1175,3594,1445,4558
354080,202101,1345,3651,886,2768,181,585,238,683,419,1268
354085,202101,433,897,340,775,0,0,262,555,262,555
354090,202101,1648,4555,1420,4090,77,232,1104,3115,1181,3347
354100,202101,19020,50953,13073,40755,2816,9555,4938,15250,7754,24805
354105,202101,1410,3551,983,2783,125,357,451,1205,576,1562
354110,202101,441,1238,313,990,53,172,106,326,159,498
354120,202101,1325,3559,891,2636,177,577,308,802,485,1379
354130,202101,5280,13849,3509,10497,833,2613,198,403,1031,3016
354140,202101,18885,46171,12844,35189,2107,6432,5548,13929,7655,20361
354150,202101,2878,6797,2198,5734,477,1285,864,2232,1341,3517
354160,202101,2748,7944,2050,6570,574,2003,558,1613,1132,3616
354165,202101,662,1966,508,1663,79,299,259,789,338,1088
354170,202101,1813,4999,1522,4460,98,333,954,2677,1052,3010
354180,202101,370,1024,271,815,47,149,110,295,157,444
354190,202101,1457,4052,1031,3186,72,249,501,1471,573,1720
354200,202101,856,2060,660,1767,64,191,437,1103,501,1294
354210,202101,805,2088,647,1826,36,124,480,1286,516,1410
354220,202101,3075,8204,2340,6770,351,1094,1242,3397,1593,4491
354230,202101,742,1811,591,1635,42,143,435,1162,477,1305
354240,202101,1668,4599,1130,3534,191,654,344,942,535,1596
354250,202101,520,1243,323,940,88,261,77,239,165,500
354260,202101,7982,21045,6085,17762,1210,3806,2610,7300,3820,11106
354270,202101,993,2971,811,2619,175,560,320,1013,495,1573
354280,202101,786,1954,664,1784,61,195,426,1057,487,1252
354290,202101,910,2868,771,2586,126,422,387,1334,513,1756
354300,202101,3495,10196,2963,9221,777,2406,1207,3735,1984,6141
354310,202101,717,2093,589,1840,131,438,227,661,358,1099
354320,202101,983,2378,651,1829,103,322,241,597,344,919
354323,202101,451,1076,300,803,41,96,131,340,172,436
354325,202101,1467,4368,1027,3358,167,539,339,1060,506,1599
354330,202101,9311,23410,6309,17384,745,2345,3711,9498,4456,11843
354340,202101,32359,80621,21887,62452,3247,10472,11606,31536,14853,42008
354350,202101,1158,2971,920,2582,98,290,605,1634,703,1924
354360,202101,591,1507,351,1118,66,212,78,247,144,459
354370,202101,995,2810,799,2502,125,418,478,1458,603,1876
354380,202101,685,1795,493,1487,89,359,123,279,212,638
354390,202101,13400,32147,8833,24245,1559,4581,3922,10171,5481,14752
354400,202101,1510,4810,1155,3981,195,740,433,1466,628,2206
354410,202101,5851,15612,4457,12881,902,2813,2042,5574,2944,8387
354420,202101,1454,3755,1073,3084,147,460,644,1762,791,2222
354425,202101,2645,6361,1870,5043,432,1156,805,2181,1237,3337
354430,202101,1481,3938,1150,3420,109,370,699,1971,808,2341
354440,202101,543,1446,365,1088,57,192,159,437,216,629
354450,202101,414,1073,231,723,35,107,76,212,111,319
354460,202101,837,2097,552,1597,72,224,301,850,373,1074
354470,202101,465,1164,320,891,23,73,158,385,181,458
354480,202101,1191,2693,782,2057,67,172,519,1314,586,1486
354490,202101,809,2381,590,1895,96,322,273,814,369,1136
354500,202101,2079,5763,1686,5165,521,1670,381,1195,902,2865
354510,202101,706,1959,569,1697,52,167,308,833,360,1000
354515,202101,339,969,248,787,39,144,106,321,145,465
354520,202101,6880,18644,4869,14395,654,2241,2697,7388,3351,9629
354530,202101,4227,11973,3272,10119,789,2456,1203,3792,1992,6248
354540,202101,1305,3425,949,2803,214,673,348,1013,562,1686
354550,202101,540,1388,427,1182,64,202,243,638,307,840
354560,202101,2281,5472,1226,3456,147,428,610,1603,757,2031
354570,202101,1213,3020,495,1400,82,242,58,151,140,393
354580,202101,8257,21493,5379,16067,800,2596,2699,7739,3499,10335
354600,202101,1864,4886,1449,4134,147,500,950,2551,1097,3051
354610,202101,434,1108,250,739,24,70,118,331,142,401
354620,202101,445,1236,281,921,52,200,105,306,157,506
354625,202101,289,762,166,526,30,99,25,49,55,148
354630,202101,2021,5984,1621,5172,559,1895,292,854,851,2749
354640,202101,3193,9078,2371,7435,390,1343,905,2651,1295,3994
354650,202101,874,2260,703,1983,56,160,443,1228,499,1388
354660,202101,3558,8305,1864,5484,158,568,873,2354,1031,2922
354670,202101,1042,2877,714,2220,150,501,256,727,406,1228
354680,202101,5246,13543,3930,11422,892,2728,1920,5693,2812,8421
354690,202101,478,1508,345,1207,73,267,94,322,167,589
354700,202101,877,2354,633,1883,76,243,323,902,399,1145
354710,202101,470,1248,336,987,43,134,134,334,177,468
354720,202101,268,643,117,350,43,139,25,76,68,215
354730,202101,9448,26513,7187,22168,976,3316,4089,12131,5065,15447
354740,202101,308,824,134,438,17,67,27,77,44,144
354750,202101,2565,6520,1688,4925,260,828,751,1961,1011,2789
354760,202101,2096,5537,1474,4381,335,1097,481,1251,816,2348
354765,202101,340,893,142,448,19,65,35,93,54,158
354770,202101,2362,5825,1756,4777,318,934,811,2063,1129,2997
354780,202101,53198,134139,40472,109492,4056,12402,25753,65379,29809,77781
354790,202101,966,2649,751,2296,72,250,458,1337,530,1587
354800,202101,2523,6424,1982,5601,476,1358,893,2392,1369,3750
354805,202101,1315,3004,911,2422,98,268,544,1356,642,1624
354810,202101,629,1854,369,1302,47,189,91,305,138,494
354820,202101,930,2627,665,2133,118,427,190,482,308,909
354830,202101,456,1106,294,818,51,154,95,245,146,399
354840,202101,919,2265,562,1555,54,159,311,801,365,960
354850,202101,20681,53251,14390,42141,1589,5363,8578,23814,10167,29177
354860,202101,1716,4767,1048,3364,167,604,310,896,477,1500
354870,202101,57081,143706,44153,120064,4539,13566,27832,71593,32371,85159
354880,202101,5715,13926,2854,7964,323,1033,1140,2591,1463,3624
354890,202101,15631,38929,12103,33048,1591,4932,7155,18916,8746,23848
354900,202101,385,966,242,717,45,144,63,162,108,306
354910,202101,5514,14356,3344,10437,778,2567,571,1716,1349,4283
354920,202101,508,1382,260,870,30,106,58,174,88,280
354925,202101,298,842,185,585,22,76,48,131,70,207
354930,202101,361,863,236,652,20,62,115,288,135,350
354940,202101,2308,6817,1632,5328,555,1923,320,966,875,2889
354950,202101,1485,3812,1185,3400,55,224,887,2406,942,2630
354960,202101,906,2429,687,2101,52,183,397,1148,449,1331
354970,202101,4121,11314,3217,9804,341,1191,2099,6177,2440,7368
354980,202101,32560,76651,22039,58664,2272,7243,13576,33670,15848,40913
354990,202101,65932,165515,49753,136071,3894,12443,32807,84427,36701,96870
354995,202101,2825,6293,2130,5391,135,402,1591,3875,1726,4277
355000,202101,1548,3812,1160,3250,188,613,571,1475,759,2088
355010,202101,3731,10058,2260,6976,741,2342,267,860,1008,3202
355020,202101,3607,10026,2666,8386,533,1853,1048,3120,1581,4973
355030,202101,1345230,3283514,978511,2585708,143894,417974,496803,1209134,640697,1627108
355040,202101,2917,7140,2256,6280,282,789,1607,4484,1889,5273
355050,202101,981,2266,716,1891,170,515,281,668,451,1183
355060,202101,5985,16058,4348,13051,712,2473,2111,5778,2823,8251
355070,202101,8727,22309,7073,19711,822,2624,4522,11874,5344,14498
355080,202101,903,2569,567,1938,110,411,81,228,191,639
355090,202101,1145,3244,880,2796,212,681,299,944,511,1625
355100,202101,21310,55388,16453,48262,2595,8027,9811,28603,12406,36630
355110,202101,788,2155,560,1799,166,616,96,274,262,890
355120,202101,696,1798,501,1521,42,142,226,643,268,785
355130,202101,826,1840,423,1115,26,87,262,643,288,730
355140,202101,1922,4336,1615,3916,94,258,1322,3111,1416,3369
355150,202101,4115,10805,3280,9342,360,1147,2124,5803,2484,6950
355160,202101,1984,5367,1431,4397,361,1217,349,998,710,2215
355170,202101,10404,26043,8080,22153,1428,4253,4356,11549,5784,15802
355180,202101,2840,7549,2009,6161,403,1357,744,2096,1147,3453
355190,202101,1814,4781,1419,4154,347,999,734,2264,1081,3263
355200,202101,784,2426,660,2223,179,667,273,881,452,1548
355210,202101,2905,7895,2261,6581,414,1360,1134,3081,1548,4441
355220,202101,43621,115161,34523,97834,7663,23095,14623,38463,22286,61558
355230,202101,1116,2801,615,1820,104,294,218,603,322,897
355240,202101,24370,64021,17069,49480,2153,6807,9369,25521,11522,32328
355250,202101,36531,97068,27175,79064,6689,20545,10349,28817,17038,49362
355255,202101,654,1633,357,1096,56,194,132,391,188,585
355260,202101,1462,3548,1060,2886,131,442,605,1509,736,1951
355270,202101,1121,3312,857,2779,197,656,297,893,494,1549
355280,202101,30749,77824,21950,61460,2872,8740,11099,29135,13971,37875
355290,202101,859,2322,658,1971,130,380,283,821,413,1201
355300,202101,1257,3684,990,3160,167,591,340,1016,507,1607
355310,202101,946,2602,706,2203,94,285,392,1245,486,1530
355320,202101,519,1359,392,1132,76,250,155,366,231,616
355330,202101,2900,7260,2220,6115,127,456,1685,4407,1812,4863
355340,202101,4098,9028,3146,7763,387,870,1945,4894,2332,5764
355350,202101,1279,3644,955,3035,197,653,362,1123,559,1776
355360,202101,1184,3010,910,2602,117,369,539,1504,656,1873
355365,202101,341,909,187,637,38,121,27,97,65,218
355370,202101,5262,13464,4057,11556,977,2585,1745,5484,2722,8069
355380,202101,2852,7585,2161,6329,370,1189,795,2015,1165,3204
355385,202101,1427,3737,1177,3370,106,370,750,1960,856,2330
355390,202101,820,2214,597,1739,136,426,232,612,368,1038
355395,202101,1952,5329,1365,4160,226,735,480,1296,706,2031
355400,202101,8848,25069,7024,21533,1663,5811,2548,6980,4211,12791
355410,202101,22037,60113,13690,43002,2713,9351,3702,11341,6415,20692
355420,202101,606,1925,501,1729,138,516,123,412,261,928
355430,202101,3679,9274,2768,7632,605,1676,1317,3574,1922,5250
355440,202101,762,2062,465,1445,75,241,136,402,211,643
355450,202101,2937,7495,1914,5518,328,1025,805,2107,1133,3132
355460,202101,492,1190,305,883,42,150,140,365,182,515
355465,202101,410,1069,319,922,45,144,171,478,216,622
355470,202101,1045,2689,604,1811,159,544,184,483,343,1027
355475,202101,340,808,273,715,16,35,202,521,218,556
355480,202101,3836,10515,3106,9435,415,1452,2061,6116,2476,7568
355490,202101,924,2462,518,1613,38,130,274,790,312,920
355495,202101,800,2227,580,1849,69,262,209,584,278,846
355500,202101,6495,16656,3901,11674,590,1950,1342,3721,1932,5671
355510,202101,1314,3197,837,2380,115,383,353,893,468,1276
355520,202101,354,783,165,479,28,77,50,145,78,222
355530,202101,391,902,140,406,19,64,48,124,67,188
355535,202101,494,1338,371,1139,73,277,169,469,242,746
355540,202101,10702,26521,8762,23805,1234,3673,5812,15274,7046,18947
355550,202101,598,1748,494,1555,59,209,274,799,333,1008
355560,202101,1106,2805,615,1899,129,471,32,97,161,568
355570,202101,242,679,129,422,23,77,33,99,56,176
355580,202101,1177,2859,756,2155,135,433,293,771,428,1204
355590,202101,170,426,133,369,21,63,78,205,99,268
355600,202101,1477,3575,979,2757,157,471,377,1051,534,1522
355610,202101,1740,4258,1151,3249,124,382,614,1642,738,2024
355620,202101,4682,12363,3500,10082,376,1311,1979,5249,2355,6560
355630,202101,2272,6217,1614,4994,253,822,791,2409,1044,3231
355635,202101,853,2482,627,2040,108,380,181,528,289,908
355640,202101,2938,8140,1953,6170,366,1259,584,1793,950,3052
355645,202101,4132,11526,3012,9569,437,1542,1614,4968,2051,6510
355650,202101,6136,16562,4734,13989,1277,3893,1429,3820,2706,7713
355660,202101,1297,3337,905,2631,134,419,305,878,439,1297
355670,202101,3592,9574,2394,6896,293,993,1181,2975,1474,3968
355680,202101,2664,7267,1190,3837,302,1025,117,409,419,1434
355690,202101,780,2294,504,1744,123,462,16,35,139,497
355695,202101,242,682,150,481,13,64,28,63,41,127
355700,202101,7243,20541,5891,17567,956,3071,3213,8993,4169,12064
355710,202101,8769,20589,5762,15188,828,2444,2727,6395,3555,8839
355715,202101,456,1214,251,769,49,163,49,131,98,294
355720,202101,1450,4030,1139,3484,186,616,616,1764,802,2380
355730,202101,885,2439,723,2136,118,384,354,965,472,1349
410010,202101,1257,3476,961,2863,192,618,216,608,408,1226
410020,202101,1016,3062,783,2530,277,846,165,559,442,1405
410030,202101,1519,4146,1302,3813,174,550,725,2144,899,2694
410040,202101,12188,33524,8946,27488,1937,6365,2808,8018,4745,14383
410045,202101,848,2245,593,1755,86,284,219,595,305,879
410050,202101,2248,5603,1560,4415,285,884,534,1411,819,2295
410060,202101,2056,5780,1602,4897,363,1183,495,1446,858,2629
410070,202101,1938,4895,1450,4019,234,712,565,1422,799,2134
410080,202101,1322,3524,953,2844,248,765,240,729,488,1494
410090,202101,1094,2800,929,2537,92,244,545,1558,637,1802
410100,202101,1753,5044,1161,3633,171,602,145,437,316,1039
410105,202101,481,1207,276,810,31,93,103,284,134,377
410110,202101,3252,8113,2287,6295,267,812,1080,2765,1347,3577
410115,202101,564,1455,415,1197,56,174,161,440,217,614
410120,202101,2552,7117,2203,6595,469,1553,1149,3319,1618,4872
410130,202101,1223,3273,1066,2981,192,624,562,1450,754,2074
410140,202101,15724,37965,10370,28493,1870,5663,2712,6796,4582,12459
410150,202101,16302,38084,8342,22705,1396,4209,2004,4919,3400,9128
410160,202101,2790,7692,2233,6727,512,1661,740,2262,1252,3923
410165,202101,735,1963,605,1700,56,190,360,944,416,1134
410170,202101,2774,7180,1876,5265,414,1286,119,352,533,1638
410180,202101,13776,38008,10590,31630,1424,4677,5548,15494,6972,20171
410185,202101,409,1195,296,907,56,180,88,248,144,428
410190,202101,2140,5304,1556,4292,308,880,415,1091,723,1971
410200,202101,5348,12222,2986,8206,463,1445,420,1116,883,2561
410210,202101,3065,7638,1931,5642,296,975,663,1667,959,2642
410220,202101,514,1329,336,998,60,188,81,236,141,424
410230,202101,1691,4470,1309,3721,188,581,624,1658,812,2239
410240,202101,5043,13198,3497,10259,790,2573,371,978,1161,3551
410250,202101,2646,6262,1961,5176,151,507,940,2399,1091,2906
410260,202101,1734,4347,1080,3110,172,512,479,1365,651,1877
410270,202101,455,1214,327,989,47,164,119,342,166,506
410275,202101,606,1727,446,1411,68,237,189,556,257,793
410280,202101,2255,5989,1495,4490,213,711,594,1636,807,2347
410290,202101,3307,9234,2278,7073,620,1882,572,1797,1192,3679
410300,202101,626,1600,505,1414,44,141,258,679,302,820
410302,202101,353,892,205,616,26,88,99,287,125,375
410304,202101,1242,3213,1030,2817,118,334,620,1642,738,1976
410305,202101,1720,4096,1203,3359,122,390,765,2051,887,2441
410310,202101,2480,6961,1987,6032,304,1015,984,2940,1288,3955
410315,202101,608,1459,367,1071,127,373,89,275,216,648
410320,202101,1067,2954,734,2290,114,395,125,367,239,762
410322,202101,552,1434,321,929,32,110,163,431,195,541
410330,202101,1511,3654,1053,2816,166,478,300,792,466,1270
410335,202101,856,2272,656,1902,95,293,285,774,380,1067
410337,202101,841,2038,597,1575,61,165,249,628,310,793
410340,202101,507,1441,344,1038,21,71,170,436,191,507
410345,202101,2414,6239,1274,3756,252,778,332,847,584,1625
410347,202101,736,1859,550,1522,54,172,176,492,230,664
410350,202101,1504,3724,1076,3010,149,440,461,1217,610,1657
410360,202101,4302,10518,3321,8810,441,1261,1651,4224,2092,5485
410370,202101,13375,35599,8774,24903,1010,3125,3710,9304,4720,12429
410380,202101,1584,3971,1170,3234,163,453,385,986,548,1439
410390,202101,2609,6575,1740,5046,382,1237,538,1405,920,2642
410395,202101,912,2598,747,2254,159,495,283,863,442,1358
410400,202101,6459,16772,4866,13731,681,2061,2491,6611,3172,8672
410405,202101,871,2045,620,1674,105,325,278,704,383,1029
410410,202101,1259,3345,1179,3220,161,518,735,2078,896,2596
410420,202101,10506,28528,8056,23741,1213,4028,3342,8870,4555,12898
410425,202101,3177,8815,2176,6770,352,1193,777,2176,1129,3369
410430,202101,12911,32214,9118,25389,1382,4214,3290,8537,4672,12751
410440,202101,2233,6662,1918,6090,273,977,1018,3181,1291,4158
410442,202101,2162,6556,1781,5740,440,1450,472,1425,912,2875
410445,202101,2213,6375,1621,5226,318,1186,305,1031,623,2217
410450,202101,1414,3489,1047,2915,200,619,383,1001,583,1620
410460,202101,2081,5134,1596,4364,159,454,801,2100,960,2554
410465,202101,2676,7698,2124,6669,376,1251,748,2197,1124,3448
410470,202101,1938,5349,1368,4324,348,1255,212,725,560,1980
410480,202101,35997,85529,19580,56647,3019,9773,4297,10727,7316,20500
410490,202101,10827,29971,7911,24029,1420,4660,3188,9071,4608,13731
410500,202101,1861,4794,1310,3766,270,885,387,977,657,1862
410510,202101,1778,4441,1192,3354,228,620,341,957,569,1577
410520,202101,3002,9426,2669,8759,925,3107,892,3031,1817,6138
410530,202101,1598,3872,770,2166,97,278,202,465,299,743
410540,202101,2748,7333,1919,5684,298,979,855,2419,1153,3398
410550,202101,7274,19308,4861,14093,778,2464,1343,3335,2121,5799
410560,202101,1445,3783,1087,3068,227,710,372,922,599,1632
410570,202101,2434,6618,1776,5460,479,1758,200,631,679,2389
410580,202101,24858,64155,18010,51782,3313,10252,7719,20771,11032,31023
410590,202101,1547,4372,1054,3228,147,474,293,758,440,1232
410600,202101,1754,4647,1362,3893,304,837,432,1299,736,2136
410610,202101,698,1806,532,1506,55,186,237,621,292,807
410620,202101,2451,7008,1658,5146,352,1215,246,704,598,1919
410630,202101,2407,6293,1583,4651,293,994,319,790,612,1784
410640,202101,4685,10867,3187,8298,685,2071,390,1021,1075,3092
410645,202101,1051,2971,856,2723,274,905,360,1163,634,2068
410650,202101,2273,6128,1584,4767,313,1004,537,1485,850,2489
410655,202101,908,2159,639,1685,26,76,328,819,354,895
410657,202101,611,1649,382,1160,50,172,127,327,177,499
410660,202101,3295,8409,1934,5464,349,1020,537,1397,886,2417
410670,202101,1020,2532,633,1807,119,340,226,588,345,928
410680,202101,2577,7707,1807,5781,421,1381,296,977,717,2358
410685,202101,507,1304,383,1098,89,296,148,379,237,675
410690,202101,128853,311569,86333,234209,13033,40478,33830,81008,46863,121486
410700,202101,2453,6166,2032,5519,319,888,1008,2670,1327,3558
410710,202101,875,2195,573,1635,107,314,219,574,326,888
410712,202101,629,1776,518,1569,127,430,202,574,329,1004
410715,202101,771,2220,491,1613,65,236,176,548,241,784
410720,202101,3071,7780,2452,6624,342,1091,547,1448,889,2539
410725,202101,1092,2708,635,1854,116,372,87,216,203,588
410730,202101,679,1795,530,1522,120,398,103,300,223,698
410740,202101,915,2559,672,2086,84,291,266,810,350,1101
410750,202101,1718,4324,1373,3693,189,576,639,1641,828,2217
410752,202101,353,876,186,553,26,77,84,239,110,316
410753,202101,299,907,207,699,36,141,41,119,77,260
410754,202101,1056,2721,878,2458,58,127,606,1794,664,1921
410755,202101,538,1397,381,1089,54,168,168,430,222,598
410760,202101,3606,9226,2609,7461,659,2163,566,1487,1225,3650
410765,202101,13401,37117,10489,31462,1745,5690,2375,6348,4120,12038
410770,202101,1055,2488,748,1980,68,189,383,1028,451,1217
410773,202101,1254,3332,1103,3108,105,337,706,1925,811,2262
410775,202101,1477,3649,1291,3377,60,186,872,2223,932,2409
410780,202101,629,1545,423,1156,63,182,113,283,176,465
410785,202101,686,1807,528,1544,89,287,189,571,278,858
410790,202101,785,2204,647,1946,156,515,61,131,217,646
410800,202101,3381,7484,2750,6589,51,157,1793,4168,1844,4325
410810,202101,418,1113,329,942,21,67,174,447,195,514
410820,202101,889,2497,470,1433,94,300,80,202,174,502
410830,202101,37723,90873,26238,71952,4864,15381,10057,25708,14921,41089
410832,202101,1019,2648,822,2313,92,288,484,1276,576,1564
410840,202101,8406,21166,5051,14860,949,3025,1284,3539,2233,6564
410845,202101,1135,2823,891,2464,179,521,362,990,541,1511
410850,202101,2196,6307,1930,5822,307,1002,951,2786,1258,3788
410855,202101,768,1914,505,1409,49,131,239,617,288,748
410860,202101,4197,10228,3300,8810,316,999,1901,4774,2217,5773
410865,202101,1400,4062,1212,3698,136,457,709,2197,845,2654
410870,202101,1216,3292,1004,2937,84,266,669,1943,753,2209
410880,202101,4540,12050,3233,9705,530,1652,486,1559,1016,3211
410890,202101,947,2681,709,2212,152,529,178,541,330,1070
410895,202101,972,3075,828,2763,245,908,186,584,431,1492
410900,202101,835,2221,592,1749,97,304,127,314,224,618
410910,202101,395,938,242,648,12,40,136,331,148,371
410920,202101,841,2011,604,1627,77,227,305,801,382,1028
410930,202101,1641,4183,1132,3305,263,903,218,613,481,1516
410940,202101,22073,59734,16058,49131,3244,10957,4984,14925,8228,25882
410950,202101,1885,5504,1689,5211,49,186,1396,4257,1445,4443
410960,202101,7408,18309,5125,14501,1149,3614,1999,5593,3148,9207
410965,202101,1113,2831,778,2202,82,255,440,1230,522,1485
410970,202101,3941,10495,2798,8331,624,2216,375,922,999,3138
410975,202101,1311,3238,1003,2756,112,337,486,1312,598,1649
410980,202101,7503,18590,4854,13857,556,1740,2081,5391,2637,7131
410990,202101,1350,3293,924,2623,213,715,315,863,528,1578
411000,202101,632,1643,428,1270,62,211,116,282,178,493
411005,202101,452,1155,275,780,48,156,85,207,133,363
411007,202101,2208,6160,1799,5468,422,1364,631,1900,1053,3264
411010,202101,4102,12265,3242,10536,810,2886,345,1011,1155,3897
411020,202101,2296,6451,1859,5667,511,1623,503,1495,1014,3118
411030,202101,769,1882,550,1442,36,128,313,714,349,842
411040,202101,972,2425,533,1479,69,221,165,380,234,601
411050,202101,1918,5958,1566,5183,398,1434,222,639,620,2073
411060,202101,1905,5030,1217,3608,261,902,201,533,462,1435
411065,202101,386,988,263,751,34,99,118,319,152,418
411070,202101,7205,18241,5703,15775,746,2303,2825,7545,3571,9848
411080,202101,2065,5405,1638,4689,416,1372,321,898,737,2270
411090,202101,814,2142,542,1614,44,151,159,449,203,600
411095,202101,2760,6374,1493,4043,170,486,373,917,543,1403
411100,202101,1201,3072,843,2448,85,280,280,831,365,1111
411110,202101,614,1600,296,927,38,117,19,43,57,160
411120,202101,1273,3493,1062,3102,312,1055,229,608,541,1663
411125,202101,5081,14773,4554,13839,1015,3030,2192,7016,3207,10046
411130,202101,717,1905,513,1527,109,293,175,569,284,862
411140,202101,2221,6849,1904,6184,557,1948,495,1584,1052,3532
411150,202101,3742,9446,2564,7130,504,1643,245,496,749,2139
411155,202101,946,2413,565,1700,81,225,228,649,309,874
411160,202101,351,810,243,654,29,85,57,160,86,245
411170,202101,711,2099,561,1759,134,419,188,583,322,1002
411180,202101,5391,14229,4227,12207,620,1989,2027,5469,2647,7458
411190,202101,1693,4319,1260,3549,204,609,493,1263,697,1872
411200,202101,4729,12810,3389,10319,827,2811,674,1770,1501,4581
411210,202101,3177,7039,2115,5326,353,994,723,1708,1076,2702
411220,202101,853,2182,602,1699,144,455,159,417,303,872
411230,202101,829,2200,600,1765,119,379,221,628,340,1007
411240,202101,1565,3732,1061,2838,108,333,521,1279,629,1612
411250,202101,2198,5812,1606,4746,305,1054,498,1411,803,2465
411260,202101,322,841,222,641,24,71,89,225,113,296
411270,202101,2021,5352,1509,4332,208,634,749,1966,957,2600
411275,202101,1418,3244,991,2548,137,425,462,1101,599,1526
411280,202101,1282,3461,868,2675,236,750,121,353,357,1103
411290,202101,820,2149,527,1584,54,148,277,852,331,1000
411295,202101,1241,3115,881,2412,105,308,387,994,492,1302
411300,202101,1007,2503,653,1819,60,177,306,739,366,916
411310,202101,863,1973,659,1693,55,142,283,722,338,864
411320,202101,5397,13802,3945,11245,605,1847,1725,4438,2330,6285
411325,202101,1326,3822,1130,3489,181,536,644,2068,825,2604
411330,202101,3274,8825,2388,7228,519,1696,736,2267,1255,3963
411340,202101,826,2248,499,1534,73,237,154,447,227,684
411342,202101,1035,2484,609,1657,103,304,225,571,328,875
411345,202101,1049,2692,789,2265,53,165,571,1647,624,1812
411350,202101,2683,7200,1732,5275,433,1423,275,779,708,2202
411360,202101,698,1668,491,1342,72,204,159,413,231,617
411370,202101,57339,139801,41771,113722,2919,9524,24933,63213,27852,72737
411373,202101,1366,3448,1107,3062,103,338,595,1652,698,1990
411375,202101,1091,2739,796,2190,130,361,311,837,441,1198
411380,202101,1133,2590,772,1935,40,112,477,1108,517,1220
411390,202101,1466,4045,1161,3377,182,583,487,1249,669,1832
411400,202101,2268,5561,1693,4485,161,507,887,2214,1048,2721
411410,202101,2569,7025,1904,5630,405,1318,436,1209,841,2527
411420,202101,4276,10339,2301,6583,290,932,437,954,727,1886
411430,202101,3382,9131,2591,7661,526,1685,912,2489,1438,4174
411435,202101,399,1108,251,798,50,160,75,198,125,358
411440,202101,2432,6772,1981,5934,402,1298,704,2048,1106,3346
411450,202101,2407,6510,1820,5524,238,722,968,2996,1206,3718
411460,202101,4119,10533,2639,7756,410,1427,487,1281,897,2708
411470,202101,759,1931,570,1571,105,316,215,534,320,850
411480,202101,4855,12769,3583,10437,681,2386,1330,3437,2011,5823
411490,202101,1608,4150,1230,3525,161,539,510,1308,671,1847
411500,202101,1271,3400,861,2535,153,483,160,382,313,865
411510,202101,2287,5810,1840,5051,387,1239,459,1265,846,2504
411520,202101,30069,72740,17504,48688,2001,6481,6766,16913,8767,23394
411530,202101,927,2421,556,1709,83,272,94,262,177,534
411535,202101,489,1399,302,957,33,120,87,227,120,347
411540,202101,2600,6333,1781,4858,154,491,908,2399,1062,2890
411545,202101,893,2569,757,2339,73,230,485,1498,558,1728
411550,202101,709,1782,521,1450,75,223,86,259,161,482
411560,202101,1920,5169,1110,3460,159,568,64,168,223,736
411570,202101,7181,16551,4855,13074,1074,3171,859,2338,1933,5509
411573,202101,737,2001,627,1824,99,293,313,899,412,1192
411575,202101,2001,5428,1499,4411,279,901,355,1013,634,1914
411580,202101,4761,10869,2883,8020,421,1424,515,1297,936,2721
411585,202101,595,1796,280,932,64,231,49,144,113,375
411590,202101,385,1054,276,832,42,126,135,382,177,508
411600,202101,300,759,194,595,39,122,58,166,97,288
411605,202101,1535,3535,994,2695,138,472,507,1338,645,1810
411610,202101,2510,5893,1782,4646,68,230,1209,2934,1277,3164
411620,202101,2695,7204,2305,6594,388,1173,1243,3555,1631,4728
411630,202101,744,1943,502,1485,75,274,184,487,259,761
411640,202101,460,1184,327,910,40,123,110,272,150,395
411650,202101,202,583,131,433,26,94,29,72,55,166
411660,202101,915,2335,668,1878,53,155,276,731,329,886
411670,202101,1336,3221,915,2432,98,276,445,1098,543,1374
411680,202101,1383,3714,1036,3027,136,458,456,1281,592,1739
411690,202101,3830,9669,2904,8106,629,1777,813,2429,1442,4206
411695,202101,622,1874,421,1355,47,169,174,516,221,685
411700,202101,1672,4287,1124,3247,233,714,186,513,419,1227
411705,202101,1883,5775,1598,5297,284,906,956,3358,1240,4264
411710,202101,1926,4853,1331,3766,298,858,268,748,566,1606
411720,202101,1009,2303,726,1833,144,369,268,649,412,1018
411721,202101,971,2416,732,1981,142,369,210,559,352,928
411722,202101,839,2180,493,1429,85,278,180,428,265,706
411725,202101,1153,3217,795,2534,190,653,174,547,364,1200
411727,202101,1479,4063,958,2949,216,685,149,418,365,1103
411729,202101,676,1640,426,1172,55,202,159,382,214,584
411730,202101,5173,13712,4060,11561,801,2450,1772,4941,2573,7391
411740,202101,522,1349,270,803,55,149,62,165,117,314
411745,202101,766,2194,528,1657,69,229,109,273,178,502
411750,202101,5397,14125,3965,11352,538,1666,1920,5180,2458,6846
411760,202101,6462,17208,5002,14724,1589,4882,960,3172,2549,8054
411770,202101,2992,8633,2201,6920,492,1654,350,1005,842,2659
411780,202101,2633,7396,2284,6753,635,1960,778,2331,1413,4291
411790,202101,2721,6548,1533,4434,298,1010,299,745,597,1755
411800,202101,980,2760,749,2252,128,407,150,418,278,825
411810,202101,1570,4039,1170,3241,189,527,533,1389,722,1916
411820,202101,10791,30791,8770,27321,2084,7034,3800,11524,5884,18558
411830,202101,559,1400,436,1207,79,239,99,288,178,527
411840,202101,11909,31600,8161,23931,1355,4281,2187,5823,3542,10104
411845,202101,559,1582,328,1042,42,153,74,201,116,354
411850,202101,7085,18044,4856,14199,1180,3902,771,2071,1951,5973
411860,202101,667,1856,482,1468,76,238,120,330,196,568
411870,202101,571,1668,401,1289,92,333,95,272,187,605
411880,202101,2257,5572,1655,4625,223,704,598,1572,821,2276
411885,202101,1073,2782,770,2244,112,386,239,630,351,1016
411890,202101,1346,3556,958,2846,153,521,100,288,253,809
411900,202101,746,2050,477,1487,110,370,72,203,182,573
411910,202101,939,2761,696,2248,154,583,269,797,423,1380
411915,202101,14621,35904,10044,27652,1418,4385,4125,10166,5543,14551
411920,202101,1093,3185,917,2805,195,695,334,939,529,1634
411925,202101,456,1201,323,961,69,229,127,359,196,588
411930,202101,4828,14662,4078,13284,1776,6287,272,1078,2048,7365
411940,202101,3227,9460,2522,7975,617,2012,796,2269,1413,4281
411950,202101,13997,37558,11573,33593,1504,4968,6885,19156,8389,24124
411960,202101,5849,15600,4629,13138,844,2616,1805,4871,2649,7487
411965,202101,464,1275,339,1022,49,161,145,414,194,575
411970,202101,1091,2509,846,2184,166,409,367,1077,533,1486
411980,202101,1448,3566,1049,2916,260,722,384,1057,644,1779
411990,202101,37094,96505,23840,72478,4295,14418,8188,23695,12483,38113
411995,202101,3402,8262,2576,7008,747,2271,693,1822,1440,4093
412000,202101,1833,4258,1296,3355,31,101,907,2194,938,2295
412010,202101,585,1816,438,1495,75,267,122,366,197,633
412015,202101,529,1485,435,1321,60,196,261,783,321,979
412020,202101,435,1201,274,856,44,159,108,299,152,458
412030,202101,592,1661,435,1370,71,227,131,404,202,631
412033,202101,941,2485,681,1959,88,265,261,653,349,918
412035,202101,743,2021,475,1525,46,179,263,809,309,988
412040,202101,586,1566,368,1124,57,168,55,165,112,333
412050,202101,1596,3977,1091,3046,227,712,261,727,488,1439
412060,202101,7176,20799,6015,18514,1559,5417,1697,5021,3256,10438
412065,202101,600,1651,453,1365,102,328,104,309,206,637
412070,202101,1168,3010,928,2554,114,345,381,964,495,1309
412080,202101,2141,5962,1465,4609,221,741,365,1042,586,1783
412085,202101,295,705,104,318,10,31,21,56,31,87
412090,202101,5670,14750,4212,12040,1042,3146,1553,4457,2595,7603
412100,202101,1590,4330,1209,3614,370,1210,253,839,623,2049
412110,202101,808,2125,564,1633,79,239,180,485,259,724
412120,202101,1946,5579,1493,4699,296,1015,394,1068,690,2083
412125,202101,612,1740,432,1370,83,273,116,354,199,627
412130,202101,816,2042,565,1578,93,273,141,405,234,678
412135,202101,627,1669,297,898,50,163,87,224,137,387
412140,202101,1635,3930,1101,3019,178,613,228,592,406,1205
412150,202101,2740,7126,2336,6428,342,1077,1421,3699,1763,4776
412160,202101,884,2726,507,1710,77,287,75,211,152,498
412170,202101,4241,11566,3574,10520,718,2338,1458,3932,2176,6270
412175,202101,1284,3631,1078,3280,219,687,479,1453,698,2140
412180,202101,1604,4409,1177,3615,144,508,535,1527,679,2035
412190,202101,3301,8263,2451,6796,324,984,1059,2901,1383,3885
412200,202101,1648,4863,1193,3844,316,1123,182,545,498,1668
412210,202101,620,1471,383,1061,50,152,148,373,198,525
412215,202101,3261,8847,2570,7490,617,1754,1097,3520,1714,5274
412217,202101,974,2518,826,2257,54,161,571,1508,625,1669
412220,202101,5479,15285,4483,13485,1288,3758,1399,4559,2687,8317
412230,202101,2624,7664,2089,6643,334,1211,535,1460,869,2671
412240,202101,7193,18427,4577,13261,775,2421,1348,3517,2123,5938
412250,202101,1984,5093,1476,4125,346,1025,317,809,663,1834
412260,202101,1198,3213,886,2560,136,412,266,727,402,1139
412265,202101,883,2406,700,2095,153,477,276,790,429,1267
412270,202101,977,2664,622,1916,83,285,239,663,322,948
412280,202101,381,1061,301,930,68,212,86,253,154,465
412290,202101,1011,2562,700,1998,110,339,228,599,338,938
412300,202101,1642,4231,1138,3352,246,767,249,766,495,1533
412310,202101,741,2072,591,1768,99,349,209,584,308,933
412320,202101,812,2079,524,1490,52,174,161,463,213,637
412330,202101,1580,4205,1086,3269,212,702,359,1105,571,1807
412340,202101,1117,3051,716,2184,102,379,127,341,229,720
412350,202101,2837,7356,1837,5417,355,1117,304,823,659,1940
412360,202101,255,697,183,547,6,31,112,307,118,338
412370,202101,840,2407,576,1848,115,411,57,192,172,603
412380,202101,1469,3980,1046,3150,275,852,119,415,394,1267
412382,202101,476,1172,315,915,39,146,140,338,179,484
412385,202101,2169,5911,1779,5163,559,1528,552,1799,1111,3327
412390,202101,2436,5826,1960,5099,324,846,709,1850,1033,2696
412395,202101,639,1832,456,1422,54,146,198,634,252,780
412400,202101,906,2390,647,1903,123,402,174,496,297,898
412402,202101,2075,5079,1445,4059,353,1022,178,515,531,1537
412405,202101,2959,7786,1953,5920,495,1754,94,256,589,2010
412410,202101,6004,15465,4470,12988,757,2569,1523,4170,2280,6739
412420,202101,524,1323,348,974,30,101,163,396,193,497
412430,202101,589,1480,309,899,36,115,122,330,158,445
412440,202101,2653,7189,1753,5446,414,1421,257,849,671,2270
412450,202101,453,1302,319,974,48,141,28,67,76,208
412460,202101,1035,2673,807,2299,147,456,362,1010,509,1466
412470,202101,1480,4709,1229,4157,307,1092,258,870,565,1962
412480,202101,1013,2667,690,1975,116,358,221,554,337,912
412490,202101,1292,3178,1045,2731,131,336,516,1274,647,1610
412500,202101,1903,4797,1444,3949,317,889,379,954,696,1843
412510,202101,1845,5603,1283,4208,292,1021,134,364,426,1385
412520,202101,1150,3015,654,1947,155,437,57,187,212,624
412530,202101,693,1824,506,1443,75,238,103,290,178,528
412535,202101,780,2010,523,1521,87,276,115,280,202,556
412540,202101,1173,2975,849,2390,96,335,277,821,373,1156
412545,202101,664,1707,470,1321,69,193,171,476,240,669
412550,202101,32151,85383,23008,67214,3626,11568,9312,24755,12938,36323
412555,202101,284,736,195,549,21,62,57,127,78,189
412560,202101,4466,12889,3377,10407,608,2043,942,2920,1550,4963
412570,202101,4403,11052,2560,7517,510,1686,320,1019,830,2705
412575,202101,1029,2582,827,2237,108,322,442,1118,550,1440
412580,202101,1397,3628,1000,2877,79,274,535,1473,614,1747
412590,202101,401,1049,226,696,35,113,23,62,58,175
412600,202101,1607,4305,1222,3534,179,578,562,1511,741,2089
412610,202101,801,2098,570,1604,62,187,276,683,338,870
412620,202101,1260,3294,962,2839,193,649,283,778,476,1427
412625,202101,8462,22161,5193,15717,705,2420,332,909,1037,3329
412627,202101,1145,3207,752,2394,137,479,198,628,335,1107
412630,202101,2803,8164,2045,6567,379,1252,592,1735,971,2987
412635,202101,386,1054,269,804,35,126,94,232,129,358
412640,202101,1037,2715,589,1784,65,203,183,499,248,702
412650,202101,1663,4503,1336,3856,214,684,527,1328,741,2012
412660,202101,2374,6082,1693,4797,272,815,509,1304,781,2119
412665,202101,381,973,307,845,49,143,154,409,203,552
412667,202101,1757,4606,1315,3756,181,561,551,1495,732,2056
412670,202101,856,2000,556,1511,108,334,154,382,262,716
412680,202101,1985,5235,1387,4093,179,617,509,1323,688,1940
412690,202101,1119,2940,813,2353,132,415,305,831,437,1246
412700,202101,1923,5079,1601,4580,192,635,872,2437,1064,3072
412710,202101,5778,16715,4367,13721,830,2973,1230,3392,2060,6365
412720,202101,1115,3288,858,2733,136,458,175,479,311,937
412730,202101,2413,6380,1697,4942,317,1035,596,1620,913,2655
412740,202101,1852,5110,1276,3952,219,792,182,542,401,1334
412750,202101,3808,9995,3120,9025,292,1009,2063,5647,2355,6656
412760,202101,2857,7711,2380,6912,442,1444,1245,3380,1687,4824
412770,202101,9958,25164,5458,16370,721,2327,1272,3260,1993,5587
412780,202101,1144,3057,864,2542,189,602,328,934,517,1536
412785,202101,2016,4831,1428,3848,127,353,966,2539,1093,2892
412788,202101,1323,3693,1087,3288,294,898,450,1335,744,2233
412790,202101,1326,3494,763,2354,112,401,232,619,344,1020
412795,202101,1232,3148,666,2013,94,310,132,356,226,666
412796,202101,2120,6064,1752,5385,355,1156,591,1676,946,2832
412800,202101,3626,8779,2516,6742,284,887,1160,2754,1444,3641
412810,202101,11570,29288,7524,21214,877,2895,2942,7361,3819,10256
412820,202101,6067,16613,4313,13110,1032,3329,1232,3755,2264,7084
412830,202101,333,939,237,730,34,100,62,183,96,283
412840,202101,1837,4535,1315,3526,148,452,589,1429,737,1881
412850,202101,2722,7127,1974,5831,316,997,826,2410,1142,3407
412853,202101,1436,3631,1204,3230,182,535,606,1447,788,1982
412855,202101,1186,3087,786,2295,121,416,220,597,341,1013
412860,202101,732,1803,499,1441,69,220,272,743,341,963
412862,202101,676,1651,466,1303,83,236,193,508,276,744
412863,202101,1244,3736,1110,3497,241,788,570,1780,811,2568
412865,202101,693,1883,509,1508,139,409,129,418,268,827
412870,202101,821,2121,591,1730,170,552,125,407,295,959
412880,202101,834,2229,551,1650,90,306,96,254,186,560
420005,202101,385,1125,237,800,32,107,111,380,143,487
420010,202101,3189,7801,2133,6030,130,408,1560,4436,1690,4844
420020,202101,393,1231,262,896,39,159,60,165,99,324
420030,202101,64,209,44,168,12,53,18,60,30,113
420040,202101,487,1467,298,1046,60,233,19,49,79,282
420050,202101,705,1597,474,1195,67,199,298,674,365,873
420055,202101,153,461,82,290,15,70,23,68,38,138
420060,202101,92,245,52,152,8,25,13,29,21,54
420070,202101,649,1957,491,1639,102,357,198,636,300,993
420075,202101,76,191,42,121,6,22,15,25,21,47
420080,202101,344,982,272,821,72,243,108,322,180,565
420090,202101,398,1232,255,890,52,197,43,121,95,318
420100,202101,1214,3168,1014,2863,47,162,826,2296,873,2458
420110,202101,232,737,211,693,43,166,104,320,147,486
420120,202101,549,1475,369,1079,64,214,173,432,237,646
420125,202101,331,1011,230,782,58,206,90,296,148,502
420127,202101,272,716,99,311,13,49,28,79,41,128
420130,202101,3190,8751,2426,7468,342,1257,1183,3328,1525,4585
420140,202101,3366,9064,2398,7379,680,2354,329,1060,1009,3414
420150,202101,658,1644,453,1294,39,128,279,770,318,898
420160,202101,188,457,68,223,8,28,20,65,28,93
420165,202101,147,415,86,283,20,68,26,75,46,143
420170,202101,260,837,180,626,25,87,55,158,80,245
420180,202101,162,520,99,354,15,54,31,97,46,151
420190,202101,195,602,118,408,33,127,33,103,66,230
420195,202101,1294,3291,945,2742,285,992,96,189,381,1181
420200,202101,4376,10455,2649,7294,335,1141,1096,2590,1431,3731
420205,202101,1704,4585,1129,3413,162,519,616,1851,778,2370
420207,202101,1645,4295,1029,3126,193,676,417,1191,610,1867
420208,202101,307,873,179,631,54,202,42,133,96,335
420209,202101,148,482,94,310,16,55,36,102,52,157
420210,202101,2940,7505,1987,5967,321,1098,995,2891,1316,3989
420213,202101,745,2274,633,2060,142,500,322,1030,464,1530
420215,202101,182,542,128,421,31,114,30,91,61,205
420220,202101,245,708,148,499,25,102,71,216,96,318
420230,202101,4927,13254,3764,11103,555,1780,2009,5685,2564,7465
420240,202101,13071,35912,8380,25254,1031,3531,4075,10765,5106,14296
420243,202101,349,995,277,855,43,155,167,492,210,647
420245,202101,1182,3084,854,2533,59,210,543,1551,602,1761
420250,202101,417,1160,348,1046,54,185,199,559,253,744
420253,202101,461,1135,327,942,31,102,188,537,219,639
420257,202101,150,395,93,293,17,66,47,146,64,212
420260,202101,1045,2722,759,2329,120,431,491,1468,611,1899
420270,202101,502,1311,256,755,34,113,115,328,149,441
420280,202101,1092,3276,851,2772,146,530,310,989,456,1519
420285,202101,120,248,51,147,11,45,11,23,22,68
420287,202101,427,979,309,821,90,244,108,291,198,535
420290,202101,4470,12646,3441,10339,469,1619,2010,5587,2479,7206
420300,202101,6978,19663,4103,12867,726,2535,1286,3509,2012,6044
420310,202101,754,1726,381,1054,33,102,214,551,247,653
420315,202101,734,2040,504,1643,101,351,201,653,302,1004
420320,202101,4896,13166,3501,10854,955,3286,901,2588,1856,5874
420325,202101,297,821,210,648,28,89,100,285,128,374
420330,202101,951,2751,604,2029,100,395,182,552,282,947
420340,202101,890,2474,674,2093,157,511,110,301,267,812
420350,202101,1116,2923,822,2408,69,232,582,1672,651,1904
420360,202101,2733,7441,1493,4777,279,978,121,390,400,1368
420370,202101,1064,2860,876,2558,77,262,600,1696,677,1958
420380,202101,4106,10776,2774,8387,577,1874,1044,3019,1621,4893
420390,202101,1038,2518,720,1885,123,384,297,535,420,919
420395,202101,1052,2966,720,2312,105,397,109,249,214,646
420400,202101,935,2622,646,2019,106,386,257,746,363,1132
420410,202101,530,1432,411,1187,42,125,277,786,319,911
420415,202101,267,792,202,651,52,187,77,248,129,435
420417,202101,567,1679,461,1460,126,412,167,545,293,957
420419,202101,132,467,106,409,38,155,8,32,46,187
420420,202101,10624,27328,7089,20952,1929,6527,1976,5301,3905,11828
420425,202101,593,1584,397,1185,35,121,200,586,235,707
420430,202101,3000,8022,1794,5406,409,1267,578,1639,987,2906
420435,202101,238,611,117,380,13,42,58,182,71,224
420440,202101,693,1870,429,1308,116,391,151,431,267,822
420445,202101,246,596,161,445,31,86,74,192,105,278
420450,202101,673,1973,497,1590,91,344,175,499,266,843
420455,202101,1935,4723,1395,3905,190,616,673,1768,863,2384
420460,202101,8703,23125,6537,19182,903,2998,3369,9470,4272,12468
420470,202101,564,1465,308,965,52,192,61,162,113,354
420475,202101,64,166,24,79,6,21,2,7,8,28
420480,202101,5029,12407,3086,9210,620,2051,1052,3134,1672,5185
420490,202101,336,937,244,752,53,186,94,281,147,467
420500,202101,1319,3644,843,2745,146,522,367,1193,513,1715
420510,202101,148,417,85,274,9,36,22,61,31,97
420515,202101,59,155,36,103,3,18,15,36,18,54
420517,202101,734,2021,630,1826,50,150,447,1299,497,1449
420519,202101,274,673,200,566,22,70,120,352,142,422
420520,202101,268,726,142,478,27,92,9,32,36,124
420530,202101,766,2253,532,1743,83,328,208,588,291,916
420535,202101,235,687,101,343,14,58,45,145,59,203
420540,202101,35071,83146,22959,63220,3249,10177,8175,19472,11424,29649
420543,202101,192,568,151,480,18,59,81,239,99,298
420545,202101,1111,3292,837,2691,149,539,321,904,470,1443
420550,202101,3263,8657,2086,6669,322,1216,861,2812,1183,4028
420555,202101,269,771,185,593,22,86,111,330,133,416
420560,202101,376,937,253,754,49,160,147,432,196,592
420570,202101,2163,5858,1711,5012,285,973,786,2194,1071,3167
420580,202101,1741,4438,1253,3701,290,919,420,1285,710,2204
420590,202101,2579,6845,1514,4550,270,969,430,992,700,1961
420600,202101,953,2755,728,2340,92,348,420,1285,512,1633
420610,202101,306,887,178,596,40,143,62,218,102,361
420620,202101,730,1771,488,1381,101,301,200,564,301,865
420630,202101,877,2628,639,2046,75,266,382,1163,457,1429
420640,202101,465,1264,230,785,69,226,23,82,92,308
420650,202101,3408,8925,2103,6235,288,934,821,2109,1109,3043
420660,202101,408,1056,268,761,52,158,72,183,124,341
420665,202101,588,1510,377,1152,70,243,158,422,228,665
420670,202101,1189,3298,764,2424,128,502,287,786,415,1288
420675,202101,170,475,100,334,19,87,47,135,66,222
420680,202101,305,709,157,502,29,101,76,236,105,337
420690,202101,809,2379,502,1661,68,279,135,375,203,654
420700,202101,2356,6150,1754,5147,213,681,1014,2878,1227,3559
420710,202101,915,2579,704,2128,68,284,445,1213,513,1497
420720,202101,1109,3104,802,2568,139,479,418,1273,557,1752
420730,202101,2896,7500,2149,6273,340,1105,1162,3269,1502,4374
420740,202101,472,1388,265,932,68,266,21,91,89,357
420750,202101,1826,5279,1185,3802,200,749,492,1440,692,2189
420757,202101,78,192,38,124,3,5,18,58,21,63
420760,202101,297,870,158,495,31,109,46,129,77,238
420765,202101,419,1224,192,664,27,109,81,267,108,376
420768,202101,1297,3641,1124,3357,144,434,824,2439,968,2873
420770,202101,441,1185,220,742,39,152,87,270,126,422
420775,202101,253,758,172,573,35,131,58,161,93,292
420780,202101,881,2450,543,1701,108,368,98,270,206,638
420785,202101,190,494,133,372,12,40,68,158,80,198
420790,202101,970,2928,716,2417,119,475,391,1239,510,1714
420800,202101,608,1534,299,916,79,271,78,226,157,497
420810,202101,1346,4159,1092,3662,308,1184,391,1134,699,2318
420820,202101,11690,28987,8426,23745,1539,4884,3929,10210,5468,15094
420830,202101,3880,10158,2907,8426,516,1609,1262,3550,1778,5159
420840,202101,451,1320,220,794,61,236,24,75,85,311
420845,202101,2300,5851,1416,4267,257,944,572,1640,829,2584
420850,202101,1005,3232,628,2238,120,474,123,379,243,853
420860,202101,297,747,167,521,30,105,49,130,79,235
420870,202101,726,2030,541,1685,149,533,218,622,367,1155
420880,202101,976,2969,760,2525,154,607,297,889,451,1496
420890,202101,7772,20999,4863,15029,678,2334,1707,4658,2385,6992
420895,202101,165,479,107,331,30,88,30,98,60,186
420900,202101,1459,3598,881,2590,117,419,412,1051,529,1470
420910,202101,28540,74927,17971,54658,2630,9112,7152,19308,9782,28420
420915,202101,483,1746,356,1382,52,196,196,778,248,974
420917,202101,330,786,184,498,30,87,90,241,120,328
420920,202101,70,195,30,108,1,2,5,20,6,22
420930,202101,15299,39919,10875,32208,1953,6435,4772,13448,6725,19883
420940,202101,2846,6913,1666,4893,383,1284,335,816,718,2100
420945,202101,127,363,100,305,24,83,39,110,63,193
420950,202101,327,948,185,607,28,112,47,143,75,255
420960,202101,968,2366,704,1928,118,381,311,759,429,1140
420970,202101,2235,6111,1581,4919,445,1446,456,1397,901,2843
420980,202101,260,857,226,787,107,383,61,225,168,608
420985,202101,279,807,141,507,36,146,43,133,79,279
420990,202101,274,861,159,567,26,97,36,122,62,219
421000,202101,512,1534,374,1237,79,285,96,285,175,570
421003,202101,457,1079,161,464,7,19,20,47,27,66
421005,202101,52,138,37,116,8,24,18,61,26,85
421010,202101,3099,8513,2219,6881,440,1546,614,1666,1054,3212
421020,202101,350,1083,275,948,42,175,139,453,181,628
421030,202101,700,2088,542,1774,168,620,178,525,346,1145
421040,202101,606,1439,379,1091,24,84,239,675,263,759
421050,202101,968,2592,641,1880,129,415,246,625,375,1040
421055,202101,167,456,94,287,15,50,58,158,73,208
421060,202101,603,1732,429,1356,77,286,212,599,289,885
421070,202101,623,1865,386,1263,69,259,128,385,197,644
421080,202101,482,1381,402,1232,39,142,246,749,285,891
421085,202101,345,988,127,452,17,52,15,46,32,98
421090,202101,257,663,142,405,11,43,42,105,53,148
421100,202101,739,1645,320,956,89,306,90,223,179,529
421105,202101,1464,3990,1012,3091,170,543,462,1342,632,1885
421110,202101,1042,2695,856,2459,18,53,632,1925,650,1978
421120,202101,959,2879,714,2334,110,390,218,632,328,1022
421125,202101,287,747,205,598,74,240,73,180,147,420
421130,202101,4571,13299,3779,11772,849,3045,1937,5628,2786,8673
421140,202101,328,880,195,591,30,91,68,193,98,284
421145,202101,425,1174,274,843,71,234,95,269,166,503
421150,202101,570,1541,371,1151,61,222,195,565,256,787
421160,202101,489,1333,360,1084,51,172,229,657,280,829
421165,202101,209,605,128,421,26,86,55,172,81,258
421170,202101,944,2583,806,2360,133,376,489,1475,622,1851
421175,202101,950,2374,582,1806,114,398,254,761,368,1159
421180,202101,363,938,201,613,33,127,89,234,122,361
421185,202101,308,822,210,620,22,71,125,366,147,437
421187,202101,263,803,167,556,27,90,59,188,86,278
421189,202101,316,926,249,793,43,155,99,294,142,449
421190,202101,10647,28692,7345,22472,1329,4364,2730,7738,4059,12102
421200,202101,615,1769,506,1574,61,223,321,965,382,1188
421205,202101,178,467,130,391,23,87,60,157,83,244
421210,202101,1009,2549,586,1844,120,389,224,708,344,1097
421220,202101,1294,3849,1004,3247,220,796,317,928,537,1724
421223,202101,298,821,185,614,46,147,86,288,132,435
421225,202101,778,2288,653,2078,111,410,396,1227,507,1637
421227,202101,594,1692,373,1224,73,265,157,524,230,789
421230,202101,541,1397,344,1031,56,204,138,407,194,611
421240,202101,267,787,132,461,10,41,22,67,32,108
421250,202101,1897,4813,1357,3938,131,450,836,2326,967,2776
421260,202101,182,550,49,180,13,58,9,28,22,86
421265,202101,615,1643,547,1545,10,32,483,1344,493,1376
421270,202101,328,860,138,479,20,66,48,162,68,228
421280,202101,1763,4706,1334,3994,177,666,771,2185,948,2851
421290,202101,921,2459,481,1450,88,281,113,314,201,595
421300,202101,262,680,134,431,12,52,21,60,33,112
421310,202101,170,477,114,368,23,78,61,197,84,275
421315,202101,205,546,131,388,42,114,26,88,68,202
421320,202101,601,1897,327,1102,34,97,39,95,73,192
421330,202101,560,1664,406,1344,82,312,114,352,196,664
421335,202101,326,990,269,894,68,255,107,344,175,599
421340,202101,1310,3593,941,2914,169,610,416,1166,585,1776
421350,202101,1397,3606,939,2803,174,585,383,1074,557,1659
421360,202101,2173,5830,1278,3980,224,822,485,1323,709,2145
421370,202101,656,2137,407,1467,72,263,119,380,191,643
421380,202101,779,2065,672,1901,86,276,397,1079,483,1355
421390,202101,157,428,57,208,14,42,19,67,33,109
421400,202101,298,936,215,748,35,138,109,361,144,499
421410,202101,177,499,84,303,21,83,24,74,45,157
421415,202101,164,486,102,324,21,70,20,54,41,124
421420,202101,541,1468,444,1287,50,167,278,780,328,947
421430,202101,91,278,68,218,7,27,17,49,24,76
421440,202101,561,1510,342,1116,67,216,146,461,213,677
421450,202101,436,1287,253,874,32,126,42,149,74,275
421460,202101,354,1052,197,712,22,88,33,102,55,190
421470,202101,246,690,147,480,31,103,52,182,83,285
421480,202101,2585,6893,1710,5141,350,1246,669,1804,1019,3050
421490,202101,112,389,70,263,10,36,16,48,26,84
421500,202101,1970,5766,1375,4547,351,1375,336,968,687,2343
421505,202101,268,752,224,692,32,120,146,431,178,551
421507,202101,400,1119,214,719,45,167,80,245,125,412
421510,202101,309,874,199,605,29,94,102,288,131,382
421520,202101,469,1230,315,893,26,80,185,477,211,557
421530,202101,265,772,162,540,27,121,48,130,75,251
421535,202101,357,943,225,713,35,132,120,369,155,501
421540,202101,279,657,148,441,20,63,51,134,71,197
421545,202101,610,1794,460,1532,100,403,225,693,325,1096
421550,202101,1922,5105,1553,4562,290,882,895,2613,1185,3495
421555,202101,162,491,73,258,8,34,10,23,18,57
421560,202101,83,276,54,203,10,38,17,59,27,97
421565,202101,850,2203,559,1750,142,496,143,442,285,938
421567,202101,401,1264,261,886,84,304,72,219,156,523
421568,202101,315,940,237,763,33,118,107,339,140,457
421569,202101,148,418,73,233,12,42,37,116,49,158
421570,202101,1088,2908,781,2344,167,574,224,616,391,1190
421575,202101,266,763,199,588,27,89,90,238,117,327
421580,202101,3921,10622,2555,7809,374,1355,983,2561,1357,3916
421590,202101,131,411,108,358,30,108,35,107,65,215
421600,202101,545,1476,377,1123,75,255,118,298,193,553
421605,202101,697,1805,499,1484,86,226,269,853,355,1079
421610,202101,983,2687,673,2090,115,387,221,662,336,1049
421620,202101,3581,9442,2151,6846,428,1582,627,1888,1055,3470
421625,202101,120,336,57,180,13,44,12,38,25,82
421630,202101,2334,6044,1498,4440,254,921,545,1333,799,2254
421635,202101,249,665,181,523,17,55,117,315,134,370
421640,202101,648,1732,468,1464,93,335,210,641,303,976
421650,202101,2271,6197,1533,4842,347,1276,494,1343,841,2619
421660,202101,9553,26402,6703,20964,997,3469,2986,8557,3983,12026
421670,202101,712,2035,506,1546,92,318,235,686,327,1004
421680,202101,977,2646,730,2209,191,629,365,1009,556,1638
421690,202101,1232,3478,826,2627,149,531,296,928,445,1459
421700,202101,478,1401,324,1060,64,233,108,336,172,569
421710,202101,189,605,95,327,20,72,22,72,42,144
421715,202101,104,280,83,234,19,52,44,124,63,176
421720,202101,1816,4906,1080,3345,287,932,264,712,551,1644
421725,202101,239,568,121,360,20,66,53,128,73,194
421730,202101,362,1023,198,590,27,87,100,279,127,366
421740,202101,696,1964,473,1482,106,350,142,407,248,757
421750,202101,823,1928,386,1124,92,288,136,358,228,646
421755,202101,146,408,90,275,15,59,46,123,61,182
421760,202101,904,2347,616,1827,96,327,234,578,330,905
421770,202101,2220,5881,1612,4838,421,1250,564,1813,985,3063
421775,202101,204,522,120,357,14,43,49,137,63,180
421780,202101,753,2193,482,1630,99,385,209,651,308,1036
421790,202101,825,2248,493,1631,109,375,225,724,334,1099
421795,202101,167,457,122,351,24,83,44,114,68,197
421800,202101,2373,6391,1720,5178,205,718,1005,2878,1210,3596
421810,202101,577,1578,401,1255,44,167,235,720,279,887
421820,202101,858,2484,508,1625,99,369,164,422,263,791
421825,202101,1264,3560,1124,3348,120,380,791,2309,911,2689
421830,202101,1892,5574,1540,4931,308,1064,651,2023,959,3087
421835,202101,195,481,123,364,29,96,34,94,63,190
421840,202101,194,624,137,495,29,113,34,115,63,228
421850,202101,343,964,197,666,41,161,55,142,96,303
421860,202101,284,785,159,533,25,98,55,160,80,258
421870,202101,4030,10073,2977,8170,459,1498,1547,3785,2006,5283
421875,202101,272,798,117,359,17,57,36,91,53,148
421880,202101,580,1635,385,1201,88,324,96,287,184,611
421885,202101,191,547,120,387,28,90,28,79,56,169
421890,202101,792,2389,594,1996,106,430,323,1008,429,1438
421895,202101,386,984,330,913,40,116,222,643,262,759
421900,202101,990,2602,748,2109,94,309,359,911,453,1220
421910,202101,299,858,187,592,30,127,53,133,83,260
421915,202101,356,997,205,645,44,138,38,112,82,250
421917,202101,547,1283,313,984,108,359,77,257,185,616
421920,202101,340,1038,243,850,93,340,65,224,158,564
421930,202101,2409,6048,1271,3908,276,971,433,1159,709,2130
421935,202101,372,1166,294,997,59,210,166,547,225,757
421940,202101,349,1011,172,552,22,76,44,126,66,202
421950,202101,2778,6960,1613,4787,322,1044,415,1099,737,2143
421960,202101,170,431,87,273,14,61,21,54,35,115
421970,202101,1766,4532,1097,3170,213,736,425,1039,638,1775
421985,202101,274,739,166,519,14,46,67,200,81,246
422000,202101,1865,4789,1520,4257,146,495,1042,2870,1188,3365
430003,202101,559,1507,368,1161,65,219,159,502,224,721
430005,202101,250,656,157,489,32,106,73,213,105,319
430010,202101,1619,3919,1282,3402,138,401,911,2351,1049,2752
430020,202101,573,1303,434,1122,44,135,284,709,328,844
430030,202101,933,2208,512,1453,119,386,166,436,285,822
430040,202101,10066,23799,6041,16834,1577,4713,750,2216,2327,6929
430045,202101,466,1175,332,928,26,84,224,614,250,698
430047,202101,233,508,96,265,25,73,28,77,53,150
430050,202101,842,2141,497,1450,107,329,123,339,230,668
430055,202101,252,631,131,379,17,62,72,184,89,246
430057,202101,79,166,31,81,6,21,11,23,17,44
430060,202101,16466,43437,12724,37652,2565,8076,5954,17439,8519,25515
430063,202101,796,2226,645,1916,127,376,351,1048,478,1424
430064,202101,1003,2727,747,2208,224,685,281,823,505,1508
430066,202101,93,198,66,157,6,13,50,113,56,126
430070,202101,718,1820,105,344,9,34,15,34,24,68
430080,202101,828,2033,512,1427,77,251,276,660,353,911
430085,202101,848,1891,514,1360,100,279,220,568,320,847
430087,202101,765,1846,639,1681,66,179,439,1144,505,1323
430090,202101,492,1291,194,618,9,35,63,199,72,234
430100,202101,768,1810,477,1276,92,287,174,397,266,684
430105,202101,1127,2972,746,2323,119,427,354,1059,473,1486
430107,202101,166,484,103,325,22,76,28,75,50,151
430110,202101,2189,5419,1640,4623,292,887,837,2321,1129,3208
430120,202101,1132,3323,762,2400,138,457,332,1043,470,1500
430130,202101,3325,7581,2417,6309,833,2217,417,1334,1250,3551
430140,202101,935,2403,671,1919,170,446,341,963,511,1409
430150,202101,530,1363,287,873,61,205,95,276,156,481
430155,202101,237,600,112,337,19,53,22,61,41,114
430160,202101,19322,44621,15090,38780,1768,4926,8937,22684,10705,27610
430163,202101,3022,7100,2132,5698,84,299,1563,4071,1647,4370
430165,202101,280,687,86,272,12,26,14,39,26,65
430170,202101,943,2475,326,1106,47,166,42,127,89,293
430175,202101,639,1876,538,1657,140,432,246,763,386,1195
430180,202101,607,1449,479,1243,55,132,330,869,385,1001
430185,202101,626,1550,326,937,85,221,58,159,143,380
430187,202101,680,1488,481,1244,75,203,256,697,331,900
430190,202101,1365,3535,1085,3102,233,712,492,1345,725,2057
430192,202101,122,326,40,120,5,15,9,22,14,37
430195,202101,400,1181,60,217,5,19,9,26,14,45
430200,202101,1015,3015,813,2653,281,942,219,735,500,1677
430205,202101,442,1162,396,1078,13,48,349,921,362,969
430210,202101,5481,13996,3727,10309,594,1758,1217,2724,1811,4482
430215,202101,298,766,193,560,39,117,70,208,109,325
430220,202101,628,1564,199,663,25,91,39,104,64,195
430222,202101,177,490,130,394,13,46,44,125,57,171
430223,202101,238,609,191,530,14,35,121,329,135,364
430225,202101,16,32,10,23,0,0,7,16,7,16
430230,202101,1911,5147,1586,4650,133,439,1170,3368,1303,3807
430235,202101,341,951,225,702,49,172,69,181,118,353
430237,202101,505,1177,377,972,17,47,287,725,304,772
430240,202101,1270,2943,727,1985,80,263,382,947,462,1210
430245,202101,697,1946,546,1665,150,475,254,798,404,1273
430250,202101,913,2216,659,1822,229,680,38,95,267,775
430258,202101,137,365,99,289,7,15,52,153,59,168
430260,202101,639,1674,445,1306,57,188,249,734,306,922
430265,202101,208,597,138,453,30,92,43,149,73,241
430270,202101,2856,7014,2252,6074,384,1136,1347,3518,1731,4654
430280,202101,4984,11593,3487,9073,658,1718,1514,3896,2172,5614
430290,202101,2198,4997,1795,4533,46,146,1554,3831,1600,3977
430300,202101,9876,24622,7417,20409,1127,3407,3958,10558,5085,13965
430310,202101,11497,28211,7812,21521,992,3024,3803,9765,4795,12789
430320,202101,994,2513,558,1665,59,186,311,921,370,1107
430330,202101,680,1637,403,1084,70,192,162,389,232,581
430340,202101,577,1347,382,1031,65,174,226,597,291,771
430350,202101,7627,19007,5768,15779,729,2176,3463,8997,4192,11173
430355,202101,300,793,110,353,18,61,14,35,32,96
430360,202101,805,1914,536,1445,102,310,223,563,325,873
430367,202101,297,675,172,461,30,95,98,247,128,342
430370,202101,422,1154,212,642,30,98,61,153,91,251
430380,202101,693,1702,339,1052,79,278,100,294,179,572
430390,202101,3079,7323,1837,5075,352,1121,288,575,640,1696
430400,202101,1001,2134,771,1823,64,164,469,1074,533,1238
430410,202101,518,1234,360,980,63,179,215,572,278,751
430420,202101,2509,6758,1930,5536,460,1388,892,2434,1352,3822
430430,202101,562,1419,264,811,63,186,60,198,123,384
430435,202101,1445,3633,1124,3131,194,591,590,1633,784,2224
430440,202101,3659,9913,2873,8586,286,963,1785,5295,2071,6258
430450,202101,6536,16219,5210,13902,885,2617,2667,6776,3552,9393
430460,202101,31811,79729,23748,66680,3960,12272,12295,32962,16255,45234
430461,202101,232,612,77,240,13,43,31,84,44,127
430462,202101,242,665,151,480,25,89,54,166,79,255
430463,202101,5825,15063,4292,12357,844,2724,1964,5371,2808,8095
430465,202101,428,1079,347,934,56,172,217,561,273,733
430466,202101,4021,10058,3136,8646,733,2102,1448,3808,2181,5910
430467,202101,495,1165,350,944,46,150,194,477,240,627
430468,202101,1230,2998,968,2613,80,246,655,1717,735,1963
430469,202101,520,1372,73,234,8,25,15,30,23,55
430470,202101,5326,13612,3542,10431,1048,3358,893,2445,1941,5803
430471,202101,526,1468,426,1287,61,199,256,738,317,937
430480,202101,676,1884,436,1355,50,174,98,265,148,439
430485,202101,171,444,66,201,19,50,6,24,25,74
430490,202101,339,880,195,581,25,91,99,266,124,357
430495,202101,386,1019,256,775,33,106,122,345,155,451
430500,202101,964,2469,666,1972,224,727,173,461,397,1188
430510,202101,25347,65190,18487,52042,2949,9404,8736,22601,11685,32005
430511,202101,319,912,137,445,19,64,19,58,38,122
430512,202101,948,2109,738,1797,167,413,272,687,439,1100
430513,202101,762,1888,362,1037,51,154,180,487,231,641
430515,202101,356,1009,262,815,30,88,141,439,171,527
430517,202101,1157,3434,861,2761,165,522,403,1338,568,1860
430520,202101,1243,3127,666,1901,120,364,153,395,273,759
430530,202101,950,2352,386,1155,67,193,105,305,172,498
430535,202101,3391,8654,2472,6990,344,1012,1250,3387,1594,4399
430537,202101,331,1115,304,1045,18,54,248,850,266,904
430540,202101,602,1423,337,964,58,166,159,454,217,620
430543,202101,818,1407,462,1011,57,119,190,485,247,604
430544,202101,739,2062,511,1552,123,390,167,486,290,876
430545,202101,2257,5727,1671,4839,314,924,867,2562,1181,3486
430550,202101,335,913,247,731,44,141,97,264,141,405
430558,202101,112,261,53,145,8,15,19,54,27,69
430560,202101,271,631,134,400,20,70,50,132,70,202
430570,202101,834,2019,590,1577,103,310,301,740,404,1050
430580,202101,819,2030,583,1669,149,459,245,702,394,1161
430583,202101,199,493,37,113,4,12,11,28,15,40
430585,202101,224,549,119,330,19,59,50,118,69,177
430587,202101,190,520,142,431,21,68,56,164,77,232
430590,202101,1362,3253,1127,2908,58,173,932,2355,990,2528
430593,202101,16,48,12,37,1,3,5,15,6,18
430595,202101,427,1062,123,395,12,49,21,45,33,94
430597,202101,454,1141,240,709,23,69,79,182,102,251
430600,202101,1961,5005,895,2543,154,453,240,625,394,1078
430605,202101,1260,3280,905,2624,110,367,428,1178,538,1545
430607,202101,515,1207,433,1082,26,67,318,783,344,850
430610,202101,5745,13250,3860,10446,1062,3307,843,2204,1905,5511
430613,202101,266,617,75,215,13,35,18,35,31,70
430620,202101,607,1455,449,1165,62,187,271,631,333,818
430630,202101,388,1054,114,368,20,62,22,62,42,124
430632,202101,450,1173,201,609,27,83,85,244,112,327
430635,202101,526,1227,395,1012,45,118,289,743,334,861
430637,202101,451,1094,352,946,39,120,232,595,271,715
430640,202101,1030,2709,678,1998,102,315,263,711,365,1026
430642,202101,346,951,258,753,42,121,137,382,179,503
430645,202101,152,358,58,158,8,23,21,52,29,75
430650,202101,1594,4510,1271,3962,380,1179,541,1828,921,3007
430655,202101,280,694,170,479,29,95,82,197,111,292
430660,202101,5111,12949,3927,11021,846,2492,1707,4737,2553,7229
430670,202101,643,1563,489,1296,33,93,286,773,319,866
430673,202101,521,1186,221,621,38,105,87,225,125,330
430675,202101,238,685,53,189,6,22,20,70,26,92
430676,202101,4992,12234,3961,10650,472,1397,2524,6635,2996,8032
430680,202101,1025,2720,600,1846,154,486,138,410,292,896
430690,202101,2703,7318,2133,6298,732,2266,586,1657,1318,3923
430692,202101,215,662,166,577,13,44,123,439,136,483
430693,202101,912,2370,557,1686,107,384,143,399,250,783
430695,202101,404,1019,250,713,29,76,135,365,164,441
430697,202101,389,971,301,835,76,197,145,434,221,631
430700,202101,7059,17229,4301,12140,828,2558,1002,2531,1830,5089
430705,202101,391,928,193,558,16,43,82,217,98,260
430710,202101,1626,3472,1138,2821,149,413,683,1665,832,2078
430720,202101,656,1581,344,1041,43,127,176,536,219,663
430730,202101,968,2631,675,2079,95,285,356,1087,451,1372
430740,202101,615,1643,319,1029,54,174,79,266,133,440
430745,202101,335,905,221,668,45,155,69,179,114,334
430750,202101,1335,3351,930,2674,205,616,436,1231,641,1847
430755,202101,437,1072,279,749,22,63,156,392,178,455
430760,202101,1958,4776,1495,4073,321,957,693,1787,1014,2744
430770,202101,6086,15117,4715,13064,582,1857,3009,8050,3591,9907
430780,202101,1792,4366,1063,3120,195,645,408,1145,603,1790
430781,202101,455,1263,262,820,35,105,80,214,115,319
430783,202101,342,780,206,568,20,61,130,336,150,397
430786,202101,31,110,21,78,3,13,2,9,5,22
430790,202101,4265,10258,3000,8121,324,1036,1848,4662,2172,5698
430800,202101,740,1694,556,1429,40,101,370,951,410,1052
430805,202101,329,860,221,634,14,50,142,388,156,438
430807,202101,481,1190,256,759,36,115,96,255,132,370
430810,202101,661,1564,287,847,33,121,132,361,165,482
430820,202101,1116,2991,684,2164,123,414,219,660,342,1074
430825,202101,239,592,86,232,11,28,27,66,38,94
430830,202101,1653,4660,1336,4059,76,234,955,2872,1031,3106
430840,202101,1047,2520,718,1979,100,273,466,1296,566,1569
430843,202101,162,381,75,203,4,13,34,86,38,99
430845,202101,459,1075,307,833,52,152,140,360,192,512
430850,202101,2197,5623,1487,4283,239,744,556,1633,795,2377
430860,202101,826,1906,375,1051,50,172,175,405,225,577
430865,202101,496,1235,370,1025,75,217,155,423,230,640
430870,202101,581,1534,264,831,40,143,79,215,119,358
430880,202101,1482,3334,1012,2621,170,445,539,1359,709,1804
430885,202101,170,448,90,293,5,16,57,180,62,196
430890,202101,958,2347,646,1830,59,246,142,377,201,623
430900,202101,3036,6581,2110,5279,175,531,1408,3305,1583,3836
430905,202101,791,1976,512,1449,91,295,205,534,296,829
430910,202101,1759,4680,1299,3759,200,660,622,1590,822,2250
430912,202101,493,1376,339,1063,24,73,226,716,250,789
430915,202101,475,1416,363,1208,135,431,89,316,224,747
430920,202101,21930,55272,16702,46714,2164,6664,10045,27451,12209,34115
430925,202101,88,203,36,114,4,12,18,55,22,67
430930,202101,9932,23372,6341,17885,1206,3461,2575,7629,3781,11090
430940,202101,896,2296,541,1559,119,358,170,434,289,792
430950,202101,761,1747,491,1284,36,125,316,754,352,879
430955,202101,368,956,87,255,21,64,24,59,45,123
430957,202101,162,550,148,522,21,79,99,341,120,420
430960,202101,1254,2973,708,1983,147,432,303,815,450,1247
430965,202101,1582,3749,1224,3189,69,179,927,2475,996,2654
430970,202101,331,789,169,477,23,74,83,205,106,279
430975,202101,480,1419,367,1159,78,265,201,599,279,864
430980,202101,381,862,226,601,26,84,107,255,133,339
430990,202101,501,1443,330,1041,44,138,151,471,195,609
430995,202101,534,1348,406,1142,43,132,239,651,282,783
431000,202101,1313,3091,561,1630,98,305,45,117,143,422
431010,202101,2089,5503,1363,4238,264,908,337,918,601,1826
431020,202101,7508,16241,4442,11680,987,2944,1519,3474,2506,6418
431030,202101,356,952,169,557,31,109,24,77,55,186
431033,202101,3672,8444,2384,6458,491,1360,869,2357,1360,3717
431036,202101,332,726,66,196,7,24,21,49,28,73
431040,202101,852,2160,553,1653,79,265,253,699,332,964
431041,202101,433,1003,319,831,25,56,193,503,218,559
431043,202101,305,786,177,554,42,144,85,264,127,408
431046,202101,99,263,41,128,4,9,7,21,11,30
431050,202101,1325,3210,948,2599,178,540,435,1236,613,1776
431053,202101,629,1668,367,1109,77,276,120,308,197,584
431055,202101,569,1380,480,1242,52,123,346,889,398,1012
431057,202101,213,608,120,388,26,85,32,95,58,180
431060,202101,5356,13423,3598,10464,819,2612,1031,2893,1850,5505
431065,202101,391,965,281,782,43,130,139,380,182,510
431070,202101,403,1101,240,739,55,184,64,187,119,371
431075,202101,211,612,133,433,31,109,35,112,66,221
431080,202101,551,1483,383,1129,57,201,148,406,205,607
431085,202101,769,1981,492,1356,57,157,256,688,313,845
431087,202101,384,1088,312,943,20,58,220,685,240,743
431090,202101,395,931,157,487,28,96,44,142,72,238
431100,202101,3253,7066,2230,5743,315,836,1148,3008,1463,3844
431110,202101,1374,3142,937,2399,246,656,381,882,627,1538
431112,202101,586,1597,496,1430,61,200,319,884,380,1084
431113,202101,365,989,313,888,48,156,197,540,245,696
431115,202101,932,2613,729,2242,89,344,440,1251,529,1595
431120,202101,2527,6657,1744,5165,497,1635,376,1024,873,2659
431123,202101,392,1056,256,768,46,121,138,434,184,555
431125,202101,944,2681,763,2331,279,827,257,853,536,1680
431127,202101,198,524,62,205,7,24,12,35,19,59
431130,202101,2840,7161,2106,5967,300,974,1196,3289,1496,4263
431140,202101,5474,12746,3377,8870,402,1173,1539,3492,1941,4665
431142,202101,485,1269,365,1061,45,139,224,656,269,795
431150,202101,1025,2704,742,2189,132,432,335,948,467,1380
431160,202101,624,1798,413,1322,73,244,118,374,191,618
431162,202101,480,1144,282,795,29,88,159,420,188,508
431164,202101,165,373,40,124,8,27,4,10,12,37
431170,202101,432,1184,304,922,90,281,84,242,174,523
431171,202101,652,1522,532,1362,118,265,305,812,423,1077
431173,202101,359,954,273,832,76,256,115,334,191,590
431175,202101,1261,2905,798,2126,135,365,298,749,433,1114
431177,202101,763,2058,602,1803,124,435,372,1064,496,1499
431179,202101,330,723,98,290,18,52,25,73,43,125
431180,202101,2073,5229,1292,3696,305,905,392,1071,697,1976
431190,202101,519,1332,258,753,27,85,94,228,121,313
431198,202101,361,1034,285,893,91,299,88,301,179,600
431200,202101,357,885,85,233,18,56,11,29,29,85
431205,202101,190,527,97,318,28,92,33,112,61,204
431210,202101,601,1458,486,1301,124,335,217,615,341,950
431213,202101,263,684,198,569,13,46,104,297,117,343
431215,202101,582,1383,263,767,20,58,137,377,157,435
431217,202101,149,389,102,303,14,47,54,147,68,194
431220,202101,515,1329,319,951,28,100,184,510,212,610
431225,202101,1457,3408,1122,2860,114,304,762,1938,876,2242
431230,202101,661,1879,534,1612,77,244,329,954,406,1198
431235,202101,149,380,23,82,3,8,4,20,7,28
431237,202101,294,924,239,794,48,172,127,403,175,575
431238,202101,29,77,24,67,5,16,11,23,16,39
431240,202101,4331,10605,3434,9206,434,1342,2115,5349,2549,6691
431242,202101,237,622,207,572,39,113,115,305,154,418
431244,202101,306,737,163,457,22,79,61,141,83,220
431245,202101,1216,2827,777,2073,73,211,414,1052,487,1263
431247,202101,268,674,162,458,29,90,71,176,100,266
431250,202101,1646,4057,1216,3484,265,771,632,1930,897,2701
431260,202101,249,687,165,522,23,86,54,164,77,250
431261,202101,232,691,188,620,13,45,106,339,119,384
431262,202101,334,935,169,552,11,30,113,376,124,406
431265,202101,1553,3637,624,1819,81,273,205,518,286,791
431267,202101,258,642,171,462,8,33,126,312,134,345
431270,202101,2767,6148,1487,4029,326,892,494,1362,820,2254
431275,202101,115,330,65,214,23,70,13,46,36,116
431280,202101,237,637,76,241,4,13,9,21,13,34
431290,202101,313,911,197,620,33,108,39,89,72,197
431295,202101,68,167,20,61,3,8,6,18,9,26
431300,202101,278,714,56,171,7,20,17,38,24,58
431301,202101,306,854,70,222,8,21,6,20,14,41
431303,202101,541,1420,333,988,24,90,150,409,174,499
431306,202101,2254,5283,1379,3837,179,562,600,1472,779,2034
431308,202101,25,76,23,72,10,34,10,31,20,65
431310,202101,527,1456,372,1116,53,161,162,452,215,613
431320,202101,598,1634,323,1042,48,148,66,176,114,324
431330,202101,1660,3902,836,2392,142,460,331,853,473,1313
431333,202101,209,542,119,346,23,64,39,101,62,165
431335,202101,36,101,21,68,4,8,2,6,6,14
431337,202101,2443,6401,1803,5358,313,1056,986,2821,1299,3877
431339,202101,408,1053,304,866,84,246,116,327,200,573
431340,202101,17748,42813,12423,33986,1973,5985,5679,14578,7652,20563
431342,202101,416,909,308,743,27,50,253,611,280,661
431344,202101,385,972,231,682,9,30,123,352,132,382
431346,202101,230,565,91,288,16,54,25,76,41,130
431349,202101,602,1588,342,1011,82,228,118,351,200,579
431350,202101,3943,10042,2930,8328,387,1261,1595,4348,1982,5609
431360,202101,545,1304,268,762,83,239,69,198,152,437
431365,202101,2012,4678,1597,4121,122,351,1209,3092,1331,3443
431370,202101,4306,10344,3102,8399,622,1768,1546,4268,2168,6036
431380,202101,787,2081,632,1832,46,143,444,1288,490,1431
431390,202101,2593,6295,1602,4559,153,517,792,1972,945,2489
431395,202101,1273,3115,900,2549,188,561,408,1195,596,1756
431400,202101,305,856,169,538,35,105,36,113,71,218
431402,202101,858,1903,628,1555,73,192,426,1029,499,1221
431403,202101,201,553,159,469,23,70,70,194,93,264
431405,202101,4430,11578,3414,9888,585,1883,1657,4547,2242,6430
431406,202101,514,1457,376,1167,73,221,201,638,274,859
431407,202101,445,1227,314,953,70,235,158,458,228,693
431410,202101,16241,40281,10974,31158,1536,5051,5712,15012,7248,20063
431413,202101,199,522,55,179,6,20,10,35,16,55
431415,202101,629,1535,394,1140,69,241,198,513,267,754
431417,202101,543,1200,373,947,61,176,202,504,263,680
431420,202101,1591,3529,1193,2981,165,427,679,1661,844,2088
431430,202101,554,1413,271,832,44,146,85,239,129,385
431440,202101,28846,66840,19981,53127,3288,9529,7994,19905,11282,29434
431442,202101,119,335,54,188,10,39,8,25,18,64
431445,202101,388,1079,119,378,16,42,9,23,25,65
431446,202101,244,719,187,604,34,125,93,290,127,415
431447,202101,716,1878,417,1235,83,268,146,431,229,699
431449,202101,769,1984,470,1370,92,247,177,533,269,780
431450,202101,2252,4610,1761,3923,81,195,1376,2988,1457,3183
431454,202101,33,105,28,91,8,23,8,24,16,47
431455,202101,585,1374,290,774,37,109,146,350,183,459
431460,202101,2823,6778,1975,5290,514,1439,498,1353,1012,2792
431470,202101,1362,3815,1001,3045,181,558,434,1341,615,1899
431475,202101,236,634,57,195,5,18,7,14,12,32
431477,202101,371,973,231,686,36,103,96,259,132,362
431478,202101,217,575,51,160,11,30,7,17,18,47
431480,202101,3170,7765,2534,6792,598,1600,1282,3488,1880,5088
431490,202101,103334,241652,78147,203718,5474,16897,56682,142136,62156,159033
431500,202101,468,1185,350,960,57,159,185,489,242,648
431505,202101,243,584,165,467,10,33,119,336,129,369
431507,202101,331,775,136,396,44,139,35,91,79,230
431510,202101,1533,3916,1036,2954,242,753,332,947,574,1700
431513,202101,203,452,116,309,9,19,76,203,85,222
431514,202101,109,277,77,219,4,12,52,139,56,151
431515,202101,452,1135,331,915,80,219,173,459,253,678
431517,202101,53,163,44,139,6,17,22,65,28,82
431520,202101,386,966,159,494,20,71,68,182,88,253
431530,202101,4159,8708,2371,6060,551,1422,602,1557,1153,2979
431531,202101,202,494,125,347,14,38,53,134,67,172
431532,202101,534,1229,330,866,68,203,138,352,206,555
431535,202101,233,605,104,319,18,56,24,63,42,119
431540,202101,1736,5574,1612,5403,57,226,1310,4418,1367,4644
431545,202101,340,882,62,206,5,17,13,40,18,57
431550,202101,2059,5170,1496,4132,238,709,750,1991,988,2700
431555,202101,651,1454,385,1008,27,74,228,594,255,668
431560,202101,21975,52873,15060,42151,3127,9053,5054,14978,8181,24031
431570,202101,4215,10280,3534,9280,441,1266,2492,6291,2933,7557
431575,202101,235,579,184,491,68,160,45,132,113,292
431580,202101,555,1431,354,1034,37,125,199,553,236,678
431590,202101,566,1572,427,1284,92,289,171,531,263,820
431595,202101,350,947,236,709,48,141,90,242,138,383
431600,202101,1337,3099,934,2515,213,622,376,1003,589,1625
431610,202101,1355,3440,927,2656,132,362,475,1394,607,1756
431620,202101,476,1219,221,642,36,107,84,227,120,334
431630,202101,1285,3148,617,1802,99,308,220,592,319,900
431640,202101,6119,14399,5161,13202,493,1304,3898,10002,4391,11306
431642,202101,545,1324,347,928,31,82,159,393,190,475
431643,202101,381,920,181,510,17,44,54,156,71,200
431645,202101,1792,3972,1406,3463,60,190,1141,2759,1201,2949
431647,202101,289,705,97,281,10,25,25,61,35,86
431650,202101,115,319,78,261,6,23,43,127,49,150
431660,202101,822,2161,410,1305,65,246,114,306,179,552
431670,202101,1133,2683,702,1899,109,309,348,891,457,1200
431673,202101,231,580,89,297,10,35,21,64,31,99
431675,202101,407,1059,108,364,9,34,23,65,32,99
431680,202101,7443,18844,5442,15185,1257,3635,2267,6172,3524,9807
431690,202101,23321,56586,15641,42930,3031,8877,6423,17456,9454,26333
431695,202101,170,409,106,308,22,77,53,130,75,207
431697,202101,452,1053,350,894,50,121,207,535,257,656
431700,202101,1277,3280,1062,2892,158,396,644,1764,802,2160
431710,202101,12855,30337,8982,24822,1460,4359,4634,12874,6094,17233
431720,202101,6261,15304,3772,10604,911,2686,778,1964,1689,4650
431725,202101,28,81,22,71,3,10,10,30,13,40
431730,202101,3869,9090,2420,6850,544,1631,760,2306,1304,3937
431740,202101,5020,11735,3323,8924,869,2702,857,1964,1726,4666
431750,202101,7195,18407,5449,15632,1187,3659,2244,6332,3431,9991
431755,202101,311,842,73,252,10,36,9,32,19,68
431760,202101,5256,11722,3576,9075,401,1150,2168,5223,2569,6373
431770,202101,1888,4384,1461,3817,117,332,1084,2766,1201,3098
431775,202101,196,497,99,306,20,60,12,31,32,91
431780,202101,2053,5015,1336,3716,209,649,562,1497,771,2146
431790,202101,751,2005,532,1584,94,270,244,727,338,997
431795,202101,226,573,116,346,28,75,28,75,56,150
431800,202101,8027,18890,4972,14111,1227,4130,479,1444,1706,5574
431805,202101,291,673,88,279,12,40,20,61,32,101
431810,202101,3232,7568,2031,5396,383,1048,862,2189,1245,3237
431820,202101,2059,5471,1618,4771,471,1449,542,1705,1013,3154
431830,202101,8779,18842,6432,15743,1627,4733,1757,4275,3384,9008
431840,202101,2526,6495,2018,5687,298,843,1278,3617,1576,4460
431842,202101,525,1313,179,550,24,82,69,179,93,261
431843,202101,330,865,245,699,32,95,120,325,152,420
431844,202101,200,524,70,223,14,50,25,79,39,129
431845,202101,498,1312,354,1027,36,104,207,598,243,702
431846,202101,260,680,223,624,10,30,199,560,209,590
431848,202101,91,235,59,174,10,32,12,28,22,60
431849,202101,404,972,71,209,9,26,8,16,17,42
431850,202101,4048,10847,3120,9031,719,2243,1040,2955,1759,5198
431860,202101,631,1492,343,944,58,166,194,515,252,681
431861,202101,87,238,51,157,10,34,16,45,26,79
431862,202101,438,1373,363,1245,70,261,180,592,250,853
431870,202101,19843,49766,16035,43874,1782,5577,10078,26460,11860,32037
431880,202101,3837,9738,2720,7785,419,1383,1285,3469,1704,4852
431890,202101,4321,10758,2708,7750,753,2366,470,1496,1223,3862
431900,202101,925,2300,600,1723,90,286,306,835,396,1121
431910,202101,735,1757,276,771,38,109,88,201,126,310
431912,202101,468,1250,368,1075,74,220,203,601,277,821
431915,202101,1010,2484,805,2151,24,82,624,1626,648,1708
431920,202101,1224,2796,1011,2522,30,69,862,2145,892,2214
431930,202101,648,1716,441,1325,160,450,162,517,322,967
431935,202101,84,222,61,176,15,46,13,37,28,83
431936,202101,300,851,164,515,39,123,65,192,104,315
431937,202101,141,347,92,248,12,33,43,98,55,131
431940,202101,2990,7006,1726,4729,193,578,859,2260,1052,2838
431950,202101,1773,4656,1410,4063,417,1247,524,1475,941,2722
431960,202101,2862,6919,2132,5620,570,1603,577,1511,1147,3114
431970,202101,393,989,167,490,36,104,48,126,84,230
431971,202101,77,189,29,92,2,8,4,8,6,16
431973,202101,464,1487,386,1334,38,136,278,963,316,1099
431975,202101,107,216,21,64,2,7,2,6,4,13
431980,202101,943,2440,728,2091,144,435,349,968,493,1403
431990,202101,5327,12692,3658,10302,413,1424,1888,5116,2301,6540
432000,202101,10930,25802,7981,21317,1954,5218,3312,9037,5266,14255
432010,202101,2132,5166,1569,4207,237,693,915,2323,1152,3016
432020,202101,1722,4465,1069,3068,218,646,402,1111,620,1757
432023,202101,483,1144,257,717,32,101,128,322,160,423
432026,202101,927,2570,686,2109,177,542,222,686,399,1228
432030,202101,352,864,201,557,16,46,115,311,131,357
432032,202101,322,831,223,634,23,76,126,332,149,408
432035,202101,628,1785,542,1639,174,520,231,721,405,1241
432040,202101,1024,2381,382,1170,53,170,131,358,184,528
432045,202101,153,439,100,328,25,72,37,130,62,202
432050,202101,503,1245,373,1023,79,213,152,441,231,654
432055,202101,554,1479,363,1124,128,403,70,204,198,607
432057,202101,197,535,152,416,15,39,67,166,82,205
432060,202101,422,1003,128,395,33,107,38,109,71,216
432065,202101,197,542,141,424,29,92,57,169,86,261
432067,202101,710,2041,602,1800,54,180,452,1304,506,1484
432070,202101,1604,4164,1064,3129,224,730,351,925,575,1655
432080,202101,4637,10812,3530,9098,593,1790,1659,4018,2252,5808
432085,202101,346,899,244,742,58,180,104,331,162,511
432090,202101,1705,4184,1052,2960,183,556,511,1320,694,1876
432100,202101,955,2375,476,1439,103,336,81,204,184,540
432110,202101,1937,5096,1327,4025,311,1071,134,364,445,1435
432120,202101,2594,6989,2017,6027,372,1238,820,2312,1192,3550
432130,202101,2488,6280,2061,5653,612,1704,886,2481,1498,4185
432132,202101,176,503,108,354,20,66,53,150,73,216
432135,202101,975,2278,652,1735,40,124,476,1251,516,1375
432140,202101,1567,4652,1188,3889,181,615,713,2324,894,2939
432143,202101,1336,3463,1021,2989,60,188,677,1966,737,2154
432145,202101,1659,4327,1063,3103,156,483,357,900,513,1383
432146,202101,101,282,70,231,24,87,23,67,47,154
432147,202101,442,1234,266,869,87,306,68,190,155,496
432149,202101,431,1041,227,634,20,56,107,266,127,322
432150,202101,3007,7502,2213,6122,440,1305,911,2464,1351,3769
432160,202101,4865,12602,3548,10536,822,2743,1291,3666,2113,6409
432162,202101,225,483,30,82,6,20,6,11,12,31
432163,202101,99,246,20,52,0,0,3,4,3,4
432166,202101,602,1669,473,1407,94,313,164,435,258,748
432170,202101,1412,3765,941,2890,164,560,377,1086,541,1646
432180,202101,3009,7066,1638,4528,302,879,606,1467,908,2346
432183,202101,345,1007,241,772,54,194,72,210,126,404
432185,202101,801,2050,462,1386,36,121,227,638,263,759
432190,202101,1868,4450,1260,3504,180,568,701,1812,881,2380
432195,202101,796,2046,540,1580,157,423,183,573,340,996
432200,202101,3207,8024,2324,6648,363,1063,1324,3811,1687,4874
432210,202101,367,958,231,691,45,167,106,269,151,436
432215,202101,597,1763,545,1684,51,133,411,1295,462,1428
432218,202101,244,605,114,330,12,42,56,144,68,186
432220,202101,3433,7994,2549,6607,473,1267,1323,3385,1796,4652
432225,202101,82,234,63,196,10,26,35,115,45,141
432230,202101,711,1641,384,1032,42,116,177,420,219,536
432232,202101,468,1148,292,848,59,180,104,274,163,454
432234,202101,253,637,119,356,18,51,16,43,34,94
432235,202101,44,125,18,57,5,17,4,13,9,30
432237,202101,303,781,271,730,10,19,228,605,238,624
432240,202101,15415,37729,11169,32073,850,2483,7112,21426,7962,23909
432250,202101,5211,14707,3903,12122,990,3225,1628,4997,2618,8222
432252,202101,406,972,259,709,31,90,135,349,166,439
432253,202101,839,2546,557,1824,128,448,56,172,184,620
432254,202101,686,1599,197,578,33,91,40,108,73,199
432255,202101,98,251,57,172,3,9,28,78,31,87
432260,202101,4716,11975,3522,9723,991,2815,1169,3082,2160,5897
432270,202101,1766,4859,1420,4201,410,1320,337,922,747,2242
432280,202101,1376,3398,739,2169,101,307,273,680,374,987
432285,202101,142,427,22,67,2,6,3,7,5,13
432290,202101,325,887,182,559,60,192,33,71,93,263
432300,202101,24734,61800,18422,51745,2561,8125,10733,29065,13294,37190
432310,202101,824,2187,595,1772,65,199,407,1211,472,1410
432320,202101,196,453,77,233,7,24,29,80,36,104
432330,202101,249,558,78,255,10,23,13,42,23,65
432335,202101,159,455,59,210,5,21,17,58,22,79
432340,202101,302,725,134,418,8,26,48,138,56,164
432345,202101,700,1562,608,1452,16,42,508,1193,524,1235
432350,202101,338,859,182,563,27,89,70,220,97,309
432360,202101,231,676,44,146,4,7,15,50,19,57
432370,202101,287,699,194,545,15,50,132,362,147,412
432375,202101,450,1128,338,910,61,164,177,473,238,637
432377,202101,164,524,31,112,6,27,4,9,10,36
432380,202101,1585,4170,1038,3171,173,610,528,1564,701,2174
500020,202101,2432,6300,1795,5249,148,521,1131,3201,1279,3722
500025,202101,1167,2841,744,2060,72,208,395,1049,467,1257
500060,202101,7788,21839,5337,16768,665,2166,3093,9983,3758,12149
500070,202101,4099,10571,2887,8509,533,1611,1239,3728,1772,5339
500080,202101,1602,3906,986,2783,172,533,387,961,559,1494
500085,202101,1940,4830,1352,3831,315,936,624,1704,939,2640
500090,202101,2128,5601,1443,4412,237,776,488,1605,725,2381
500100,202101,3461,8799,2630,7450,420,1358,1316,3521,1736,4879
500110,202101,7675,19467,4958,15250,1042,3563,1441,5252,2483,8815
500124,202101,1978,5773,1574,5102,257,771,831,2851,1088,3622
500150,202101,1312,2935,828,2242,136,392,334,886,470,1278
500190,202101,4743,12275,3035,8972,630,1899,697,1963,1327,3862
500200,202101,2264,5332,1657,4338,174,471,997,2518,1171,2989
500210,202101,4516,10726,3199,9011,865,2368,1398,4092,2263,6460
500215,202101,1377,3773,998,3089,100,341,558,1713,658,2054
500220,202101,2687,7496,1762,5723,278,964,475,1468,753,2432
500230,202101,1948,4526,1485,3885,172,416,1004,2618,1176,3034
500240,202101,3875,11337,2743,8985,403,1450,1139,3799,1542,5249
500260,202101,3227,6821,2080,5285,274,710,1110,2699,1384,3409
500270,202101,133067,310950,81300,224865,12781,39034,30849,79668,43630,118702
500280,202101,1305,3267,894,2634,139,423,455,1338,594,1761
500290,202101,3507,8368,2094,5934,302,996,689,1716,991,2712
500295,202101,3469,8316,2201,6089,341,1050,873,2091,1214,3141
500310,202101,954,1982,653,1609,94,205,336,856,430,1061
500315,202101,3719,10151,2969,9041,241,755,2151,6670,2392,7425
500320,202101,18857,50364,13147,41016,3323,10874,4464,14881,7787,25755
500325,202101,4223,9413,2925,7722,216,598,1977,5270,2193,5868
500330,202101,6448,14602,4284,11521,355,1047,2281,6346,2636,7393
500345,202101,2028,4954,1365,3936,308,931,459,1313,767,2244
500348,202101,2323,6023,1755,5042,241,728,998,2902,1239,3630
500350,202101,1297,3527,728,2291,85,267,297,892,382,1159
500370,202101,26097,66253,18702,54382,2348,7872,10004,28615,12352,36487
500375,202101,2360,6220,1578,4642,273,865,530,1455,803,2320
500380,202101,3232,8078,2241,6393,618,1918,469,1361,1087,3279
500390,202101,607,1254,364,954,50,162,224,553,274,715
500400,202101,1503,3787,998,2820,172,538,345,878,517,1416
500410,202101,2344,5744,1652,4717,174,486,938,2805,1112,3291
500430,202101,2506,6144,1727,4988,223,769,747,2257,970,3026
500440,202101,1181,2864,745,2198,115,374,270,854,385,1228
500450,202101,1460,3541,842,2447,138,437,230,610,368,1047
500460,202101,3428,9233,2107,6627,342,1228,660,2018,1002,3246
500470,202101,2331,6250,1433,4413,393,1353,308,823,701,2176
500480,202101,2044,6250,1737,5777,168,574,1291,4357,1459,4931
500490,202101,1028,2355,615,1747,120,411,166,483,286,894
500500,202101,4087,10851,2625,8478,848,3171,358,1199,1206,4370
500510,202101,664,1671,441,1257,27,83,276,773,303,856
500515,202101,1647,4238,1273,3641,136,430,796,2176,932,2606
500520,202101,3170,9538,2482,8318,639,2124,1015,3721,1654,5845
500525,202101,909,2623,720,2352,58,205,470,1526,528,1731
500540,202101,4244,11017,2615,8208,675,2680,236,660,911,3340
500560,202101,5303,14419,4251,13108,287,880,3393,10698,3680,11578
500568,202101,4172,9153,2584,6819,649,1756,891,2403,1540,4159
500570,202101,7503,17324,4730,12720,806,2366,1857,4649,2663,7015
500580,202101,2951,7831,2160,6451,494,1519,966,2924,1460,4443
500600,202101,3313,8223,2376,6740,534,1563,970,2824,1504,4387
500620,202101,7772,20214,5293,15567,1036,3222,2030,5729,3066,8951
500625,202101,532,1453,347,1070,64,203,90,260,154,463
500627,202101,730,1904,462,1432,81,276,145,424,226,700
500630,202101,6582,14991,3839,10552,739,2230,1117,3059,1856,5289
500635,202101,2898,9011,2239,8168,168,643,1543,6192,1711,6835
500640,202101,1661,3621,1097,2876,36,109,747,1936,783,2045
500660,202101,17307,43965,11984,36397,3707,12836,3003,9358,6710,22194
500690,202101,2271,6244,1476,4901,495,1918,82,217,577,2135
500710,202101,2702,7206,2097,6204,574,1814,683,1892,1257,3706
500720,202101,4687,11736,3075,9074,690,2169,930,2845,1620,5014
500730,202101,1070,2641,580,1738,118,338,138,454,256,792
500740,202101,4443,10567,3053,8414,400,1163,1561,4231,1961,5394
500750,202101,951,2408,653,1899,82,217,242,656,324,873
500755,202101,887,2279,497,1546,90,301,105,292,195,593
500769,202101,4958,12081,2785,8044,514,1676,344,841,858,2517
500770,202101,1385,3740,924,2942,158,578,310,977,468,1555
500780,202101,1158,2805,756,2150,147,480,200,521,347,1001
500790,202101,6601,17711,5149,15290,1047,3345,2488,7439,3535,10784
500793,202101,2017,5146,1458,4190,351,1075,487,1290,838,2365
500795,202101,2695,6617,2162,5952,114,286,1713,4974,1827,5260
500797,202101,708,1783,452,1330,131,391,131,391,262,782
500800,202101,3208,7137,1963,5317,612,1962,200,594,812,2556
500830,202101,17480,43379,12139,33741,2498,7441,4384,11517,6882,18958
500840,202101,1337,3254,844,2334,107,301,330,857,437,1158
510010,202101,1762,3965,1188,3241,117,279,843,2339,960,2618
510020,202101,3610,8998,1881,5626,360,1180,437,1141,797,2321
510025,202101,6314,15203,3847,11298,552,1798,1634,4675,2186,6473
510030,202101,2544,5683,1700,4436,333,869,697,1777,1030,2646
510035,202101,1212,3143,770,2452,91,308,456,1547,547,1855
510040,202101,2301,5106,1703,4334,181,446,1058,2819,1239,3265
510050,202101,2087,4333,1399,3472,175,456,962,2356,1137,2812
510060,202101,1369,3416,872,2532,177,568,212,573,389,1141
510080,202101,1203,3141,770,2433,235,785,230,644,465,1429
510100,202101,635,1474,451,1185,57,151,248,625,305,776
510120,202101,270,488,147,342,11,24,107,252,118,276
510125,202101,1883,4666,1480,4103,146,533,806,2098,952,2631
510130,202101,1411,3513,986,2841,206,655,299,894,505,1549
510140,202101,2962,7518,2001,6320,693,2565,740,2234,1433,4799
510160,202101,1678,4300,1239,3737,161,469,887,2748,1048,3217
510170,202101,4248,11221,3147,9460,765,2416,1225,3793,1990,6209
510180,202101,14371,31992,9309,24752,1979,5781,2828,8478,4807,14259
510185,202101,1705,4382,1090,3505,422,1381,254,1083,676,2464
510190,202101,1968,5593,1263,4435,350,1358,216,855,566,2213
510250,202101,16818,42141,12453,35617,2422,7272,6002,17842,8424,25114
510260,202101,1804,7683,1504,7162,244,1273,932,4801,1176,6074
510263,202101,3045,8485,1887,6126,296,1076,337,961,633,2037
510267,202101,4801,13533,2778,9093,480,1699,395,1154,875,2853
510268,202101,1186,2905,921,2510,99,251,622,1703,721,1954
510269,202101,979,2641,600,1925,138,489,195,596,333,1085
510270,202101,2955,8332,2025,6669,341,1278,832,2700,1173,3978
510279,202101,1690,4335,1027,3195,176,615,426,1261,602,1876
510285,202101,1099,2874,741,2267,235,801,160,442,395,1243
510300,202101,3512,8893,2591,7658,371,1129,1510,4691,1881,5820
510305,202101,1383,3805,859,2789,177,613,196,723,373,1336
510310,202101,847,2070,579,1632,158,459,170,507,328,966
510320,202101,3476,8560,2403,6763,521,1627,592,1652,1113,3279
510325,202101,4126,12090,3031,10078,855,3009,844,2902,1699,5911
510330,202101,2535,7666,1704,6200,311,1140,628,2701,939,3841
510335,202101,4803,13713,3633,11855,546,1915,2027,6780,2573,8695
510336,202101,428,1194,311,1016,51,164,160,584,211,748
510337,202101,1432,4106,912,3173,351,1349,186,654,537,2003
510340,202101,89326,197842,57803,153117,13896,43211,17109,42969,31005,86180
510343,202101,941,2589,653,2058,113,405,285,855,398,1260
510345,202101,1221,3471,935,2928,148,464,424,1296,572,1760
510350,202101,2755,7028,1831,5481,370,1205,758,2188,1128,3393
510360,202101,1901,3893,1217,3096,72,135,840,2325,912,2460
510370,202101,1683,4730,1257,4047,176,627,742,2500,918,3127
510380,202101,529,1308,310,940,48,169,125,380,173,549
510385,202101,1183,3960,887,3409,91,404,576,2292,667,2696
510390,202101,1237,3214,835,2714,250,832,270,1033,520,1865
510395,202101,712,1603,485,1272,27,74,303,846,330,920
510410,202101,4594,12628,3360,10505,635,2077,1730,5652,2365,7729
510420,202101,2461,5077,1653,4011,115,283,1084,2640,1199,2923
510450,202101,392,993,234,689,55,162,34,120,89,282
510452,202101,790,2194,577,1808,82,271,330,1004,412,1275
510454,202101,898,2456,705,2135,72,214,437,1388,509,1602
510455,202101,931,2524,675,2023,113,365,284,789,397,1154
510460,202101,1676,4162,1211,3488,91,314,784,2179,875,2493
510480,202101,4500,10730,2996,8051,548,1626,1175,3107,1723,4733
510490,202101,1650,4220,1236,3712,169,503,818,2484,987,2987
510500,202101,1473,3652,913,2761,180,576,307,940,487,1516
510510,202101,3389,9738,2469,8132,585,2194,789,2757,1374,4951
510515,202101,5073,12831,3366,9841,754,2498,942,2408,1696,4906
510517,202101,1010,2897,760,2469,232,840,142,411,374,1251
510520,202101,2108,4245,1185,3095,101,260,590,1655,691,1915
510523,202101,1112,2671,826,2241,174,454,476,1333,650,1787
510525,202101,7158,19439,5359,15983,795,2602,2545,7177,3340,9779
510530,202101,536,1371,392,1160,28,89,254,745,282,834
510550,202101,2186,6487,1594,5473,355,1278,730,2540,1085,3818
510558,202101,2283,6070,1667,5132,222,631,761,2580,983,3211
510560,202101,1459,4165,895,3063,180,698,217,813,397,1511
510562,202101,5441,13958,4025,11494,964,2985,1327,4000,2291,6985
510590,202101,2972,7401,2191,6383,167,500,1573,4696,1740,5196
510600,202101,1283,2927,855,2310,151,413,397,1075,548,1488
510610,202101,2501,6018,1712,5012,166,545,1089,3206,1255,3751
510615,202101,2520,6242,1777,5065,287,867,966,2812,1253,3679
510617,202101,956,2890,742,2547,91,364,485,1706,576,2070
510618,202101,1167,3076,831,2524,184,610,379,1105,563,1715
510619,202101,745,1845,478,1403,60,179,143,397,203,576
510620,202101,1416,3176,665,1965,167,594,38,80,205,674
510621,202101,1513,4058,918,2905,193,696,289,835,482,1531
510622,202101,4516,12509,3100,9587,996,3336,418,1195,1414,4531
510623,202101,2586,6423,1878,5323,473,1529,593,1644,1066,3173
510624,202101,1568,3987,771,2521,92,334,185,549,277,883
510625,202101,2823,6811,1501,4482,246,883,328,986,574,1869
510626,202101,1403,3416,889,2608,227,769,201,609,428,1378
510627,202101,605,1546,334,1029,79,270,79,257,158,527
510628,202101,1385,3195,920,2582,175,524,349,965,524,1489
510629,202101,1516,4271,1110,3542,214,731,399,1277,613,2008
510630,202101,3316,9087,1956,6545,440,1559,355,1303,795,2862
510631,202101,568,1352,417,1124,12,28,317,881,329,909
510637,202101,3565,8411,2517,6892,637,1964,688,1909,1325,3873
510642,202101,5240,14822,3977,12937,921,3301,1781,5864,2702,9165
510645,202101,964,1836,578,1356,180,387,219,540,399,927
510650,202101,6929,17627,5477,16029,633,1673,3729,12142,4362,13815
510665,202101,1804,3890,1150,2861,248,583,414,1127,662,1710
510670,202101,430,918,250,661,26,68,137,369,163,437
510675,202101,6105,16673,4233,13242,1156,3979,834,2499,1990,6478
510677,202101,2079,5272,1435,4329,192,677,777,2281,969,2958
510680,202101,674,1712,383,1174,74,248,88,237,162,485
510682,202101,1410,4137,1040,3540,352,1340,249,820,601,2160
510685,202101,464,1357,340,1112,53,187,178,583,231,770
510700,202101,3932,9353,2751,7740,245,754,2055,5781,2300,6535
510704,202101,10307,24146,6895,18418,1577,4478,1720,4517,3297,8995
510706,202101,2013,5932,1407,4931,265,948,735,2801,1000,3749
510710,202101,2550,6346,1689,4727,367,1087,550,1478,917,2565
510715,202101,565,1217,411,1010,30,95,211,507,241,602
510718,202101,2290,5151,1352,3894,357,1031,504,1753,861,2784
510719,202101,450,948,265,706,25,69,153,389,178,458
510720,202101,810,1899,548,1503,90,281,265,688,355,969
510724,202101,786,2116,544,1658,75,241,299,888,374,1129
510726,202101,1020,1845,542,1277,65,171,254,605,319,776
510729,202101,581,1351,267,768,30,103,66,209,96,312
510730,202101,2842,6804,1923,5416,244,793,987,2697,1231,3490
510735,202101,1016,2862,771,2524,73,291,571,1854,644,2145
510740,202101,910,2238,587,1647,102,290,271,745,373,1035
510757,202101,469,1491,368,1337,113,461,144,496,257,957
510760,202101,42274,92169,25590,67148,5132,15548,8094,19618,13226,35166
510770,202101,4121,9320,2809,7668,210,552,1939,5520,2149,6072
510774,202101,339,843,238,688,32,93,129,382,161,475
510775,202101,603,1589,382,1228,77,276,84,251,161,527
510776,202101,417,1036,292,814,66,181,108,313,174,494
510777,202101,1450,3873,1033,3338,148,548,659,2110,807,2658
510779,202101,681,1823,529,1584,58,166,299,981,357,1147
510780,202101,3594,9166,2662,7850,641,1858,1149,3834,1790,5692
510785,202101,1879,4909,1108,3548,303,1050,182,668,485,1718
510787,202101,2587,7284,1747,5572,508,1726,203,670,711,2396
510788,202101,574,1363,404,1101,61,173,192,601,253,774
510790,202101,17275,43915,10990,32744,2379,7904,1897,5105,4276,13009
510792,202101,8722,23918,5525,17746,1159,4206,881,2552,2040,6758
510794,202101,1122,3009,777,2427,254,869,147,412,401,1281
510795,202101,7926,20563,5243,15817,1153,3853,1431,4220,2584,8073
510800,202101,1600,4068,1051,3187,317,991,131,388,448,1379
510805,202101,1392,3886,995,3159,233,798,339,984,572,1782
510810,202101,588,1195,365,900,99,244,142,378,241,622
510820,202101,739,1392,407,982,32,95,207,508,239,603
510830,202101,794,1902,571,1624,38,108,422,1276,460,1384
510835,202101,527,1262,350,1011,41,136,216,606,257,742
510840,202101,55429,116044,37623,94490,7418,17519,18055,50308,25473,67827
510850,202101,1681,4021,978,2925,315,1079,118,321,433,1400
510860,202101,2151,5664,1332,4292,404,1541,106,344,510,1885
510880,202101,715,1996,539,1667,128,421,192,596,320,1017
510885,202101,633,1492,413,1180,76,230,136,396,212,626
510890,202101,633,1826,471,1548,111,383,202,677,313,1060
510895,202101,1251,3155,820,2448,152,544,363,1015,515,1559
520005,202101,2602,6571,1999,5839,580,1693,817,2791,1397,4484
520010,202101,2258,6374,1633,5181,394,1384,520,1474,914,2858
520013,202101,2722,6905,1790,5217,392,1182,505,1618,897,2800
520015,202101,488,1219,351,1020,82,240,140,427,222,667
520017,202101,1170,2926,874,2479,190,565,433,1218,623,1783
520020,202101,392,862,304,757,24,74,236,570,260,644
520025,202101,32476,90201,27856,83823,2742,8933,20041,60064,22783,68997
520030,202101,5562,13955,4469,12450,299,906,3201,8882,3500,9788
520050,202101,386,912,239,658,14,39,153,435,167,474
520055,202101,1778,4244,1159,3069,137,327,633,1657,770,1984
520060,202101,1411,3763,1048,3123,243,837,298,859,541,1696
520080,202101,1734,4534,1321,3966,241,729,647,2128,888,2857
520082,202101,922,2311,716,1973,74,199,385,1105,459,1304
520085,202101,803,2105,624,1828,111,342,311,900,422,1242
520090,202101,817,1597,562,1321,67,110,422,1053,489,1163
520110,202101,36213,96676,25168,78564,7448,26665,2259,6433,9707,33098
520120,202101,192,457,108,319,11,41,45,131,56,172
520130,202101,3644,8818,2858,7618,579,1549,1236,3390,1815,4939
520140,202101,38787,102390,26872,82384,9390,31401,3439,11052,12829,42453
520145,202101,600,1343,415,1097,61,180,247,601,308,781
520150,202101,614,1390,452,1199,71,192,250,675,321,867
520160,202101,701,1622,509,1330,106,263,217,620,323,883
520170,202101,4670,9409,3100,7631,166,474,2401,5871,2567,6345
520180,202101,2205,5924,1804,5363,321,1033,995,2937,1316,3970
520215,202101,1683,4042,1202,3313,283,821,394,1059,677,1880
520235,202101,576,1314,330,941,33,114,126,348,159,462
520250,202101,1463,3691,1035,2988,324,1007,244,788,568,1795
520260,202101,782,1805,512,1389,97,271,204,564,301,835
520280,202101,710,1711,560,1489,114,312,263,750,377,1062
520310,202101,997,2153,659,1658,139,395,256,680,395,1075
520320,202101,1560,4179,1169,3533,151,498,644,1891,795,2389
520330,202101,3973,10476,2905,8762,405,1470,1575,4618,1980,6088
520340,202101,2453,5369,1536,4110,183,463,885,2486,1068,2949
520350,202101,2663,6335,1915,5239,558,1603,757,2103,1315,3706
520355,202101,1831,4985,1314,3983,448,1453,242,628,690,2081
520357,202101,714,1694,513,1405,30,73,378,1078,408,1151
520360,202101,678,1763,523,1511,136,411,159,486,295,897
520380,202101,1372,3386,817,2374,84,258,406,1103,490,1361
520390,202101,993,2160,582,1653,160,494,201,620,361,1114
520393,202101,479,1144,324,905,40,127,144,379,184,506
520396,202101,838,2132,700,1925,40,133,521,1397,561,1530
520400,202101,1582,3850,1225,3368,149,458,844,2300,993,2758
520410,202101,1842,4198,1136,3110,195,572,435,1141,630,1713
520420,202101,361,828,283,711,20,54,222,534,242,588
520425,202101,1385,3353,761,2194,197,600,141,390,338,990
520430,202101,2241,5077,1280,3604,224,743,41,108,265,851
520440,202101,2799,6744,1701,4826,404,1256,442,1189,846,2445
520450,202101,11448,26806,7702,21312,2326,7112,1605,4638,3931,11750
520455,202101,679,1863,493,1578,138,466,135,458,273,924
520460,202101,1002,2314,780,2034,65,148,631,1676,696,1824
520465,202101,714,1819,577,1636,71,240,418,1141,489,1381
520470,202101,1973,5083,1501,4453,470,1462,551,1755,1021,3217
520480,202101,883,2405,618,1969,192,638,149,487,341,1125
520485,202101,1520,4327,1269,3990,150,480,908,2854,1058,3334
520490,202101,3875,10619,2925,9105,996,3210,1038,3382,2034,6592
520495,202101,1555,3407,1192,2920,51,130,969,2369,1020,2499
520500,202101,1146,3093,782,2389,182,597,325,993,507,1590
520505,202101,766,1674,529,1380,59,165,345,888,404,1053
520510,202101,7180,17714,4842,14190,1051,3451,1451,4530,2502,7981
520520,202101,1143,2841,850,2388,203,611,306,864,509,1475
520530,202101,2012,5602,1545,4845,391,1303,685,2204,1076,3507
520540,202101,2804,7265,1809,5366,325,1052,483,1335,808,2387
520545,202101,910,2353,687,1990,138,399,289,845,427,1244
520547,202101,776,2117,632,1883,150,458,314,930,464,1388
520549,202101,13479,35484,11260,32372,1434,4393,7733,22043,9167,26436
520551,202101,4451,11878,3703,10788,372,1252,2645,7557,3017,8809
520552,202101,796,2040,656,1861,137,378,376,1141,513,1519
520570,202101,492,1095,335,875,86,197,128,387,214,584
520580,202101,2139,4855,1625,4261,112,355,1205,3103,1317,3458
520590,202101,1234,3023,856,2418,279,792,224,657,503,1449
520620,202101,7585,20546,6006,18219,1470,4646,2671,8428,4141,13074
520630,202101,685,1772,495,1432,88,271,157,419,245,690
520640,202101,2272,5565,1726,4630,399,1044,743,2075,1142,3119
520650,202101,853,1951,638,1658,93,244,356,985,449,1229
520660,202101,514,1239,282,838,49,163,76,233,125,396
520670,202101,924,2479,779,2272,59,181,530,1522,589,1703
520680,202101,650,1657,500,1425,72,201,267,775,339,976
520690,202101,296,693,203,556,62,160,58,179,120,339
520710,202101,392,958,286,786,13,32,201,543,214,575
520725,202101,1417,3338,977,2635,109,340,614,1596,723,1936
520735,202101,724,1795,479,1382,101,275,183,570,284,845
520740,202101,2055,4586,1562,4021,271,641,886,2485,1157,3126
520750,202101,645,1542,445,1225,79,212,208,583,287,795
520753,202101,1192,3226,913,2711,171,541,367,1011,538,1552
520760,202101,1196,2679,1053,2506,30,55,965,2332,995,2387
520780,202101,1401,3297,1028,2783,118,316,525,1416,643,1732
520790,202101,3335,7880,2376,6336,344,935,1255,3514,1599,4449
520800,202101,15717,40602,12346,35657,1789,5373,7362,21809,9151,27182
520810,202101,1270,2672,959,2319,158,389,616,1580,774,1969
520815,202101,524,1616,403,1362,75,275,118,407,193,682
520830,202101,1854,3864,1314,3254,55,106,1080,2681,1135,2787
520840,202101,2526,6728,2055,6120,849,2753,557,1773,1406,4526
520850,202101,625,1565,465,1335,147,491,134,387,281,878
520860,202101,6293,16767,4618,14088,1243,4116,1664,4958,2907,9074
520870,202101,104167,239794,70576,190258,14853,43405,25580,67833,40433,111238
520880,202101,6578,18803,5108,16192,1118,3717,1927,6151,3045,9868
520890,202101,3849,9150,2638,7272,498,1517,1178,3203,1676,4720
520910,202101,4543,11319,2922,8559,685,2183,699,1983,1384,4166
520915,202101,693,1942,405,1290,72,247,135,411,207,658
520920,202101,4358,9710,3079,8124,402,1095,1644,4553,2046,5648
520929,202101,664,1555,501,1320,52,112,283,797,335,909
520940,202101,901,2402,709,2133,39,112,526,1564,565,1676
520945,202101,484,1051,380,912,16,38,271,640,287,678
520960,202101,1049,2475,826,2145,203,465,417,1151,620,1616
520970,202101,2420,6579,1894,5743,454,1555,487,1610,941,3165
520980,202101,742,1806,544,1542,90,269,225,620,315,889
520990,202101,2940,7741,2350,6995,339,969,1554,4717,1893,5686
520993,202101,1124,2634,776,2097,115,349,434,1116,549,1465
520995,202101,2237,5626,1679,4854,249,733,657,1985,906,2718
521000,202101,8434,21890,5565,16720,1067,3312,1670,4979,2737,8291
521010,202101,3465,8962,2614,7501,240,680,1536,4386,1776,5066
521015,202101,774,1906,539,1489,39,125,339,893,378,1018
521020,202101,3167,7996,1869,5519,540,1807,128,398,668,2205
521030,202101,501,1091,338,843,73,160,137,372,210,532
521040,202101,7394,18009,5480,15029,1166,3340,2262,6388,3428,9728
521056,202101,898,2347,704,2064,220,636,199,657,419,1293
521060,202101,937,2499,694,2048,109,336,286,846,395,1182
521080,202101,1095,2347,569,1536,80,235,239,563,319,798
521090,202101,3091,8254,2088,6271,542,1750,260,825,802,2575
521100,202101,1641,3835,1209,3221,192,495,733,1994,925,2489
521120,202101,4430,10538,3276,9111,178,457,1630,5274,1808,5731
521130,202101,961,2131,547,1437,18,51,281,785,299,836
521140,202101,1245,3181,926,2641,97,296,482,1384,579,1680
521150,202101,11967,26005,7475,19666,1244,3779,3511,9485,4755,13264
521160,202101,602,1254,432,1011,55,116,283,650,338,766
521170,202101,987,2301,723,1916,52,147,473,1217,525,1364
521180,202101,7093,19374,5836,17248,928,2996,3065,8805,3993,11801
521190,202101,10512,25817,6189,18712,1524,4968,1269,4074,2793,9042
521200,202101,679,1631,482,1323,44,125,283,787,327,912
521205,202101,612,1492,459,1247,16,49,352,918,368,967
521210,202101,632,1605,373,1098,70,223,73,164,143,387
521220,202101,3428,8289,2241,6474,362,1158,883,2569,1245,3727
521225,202101,379,796,277,685,50,117,156,400,206,517
521230,202101,1295,3264,1142,3078,355,954,568,1659,923,2613
521250,202101,29628,78185,23097,68703,8397,26022,6769,21676,15166,47698
521260,202101,517,1205,383,992,57,146,221,562,278,708
521270,202101,1783,4440,1556,4176,76,177,1214,3282,1290,3459
521280,202101,1732,4607,1295,3881,310,1025,554,1668,864,2693
521290,202101,470,1088,327,910,40,131,210,568,250,699
521295,202101,1081,2359,840,2099,64,110,701,1808,765,1918
521300,202101,1846,4502,1456,3953,272,683,897,2538,1169,3221
521305,202101,706,1652,505,1363,76,187,285,787,361,974
521308,202101,4670,12378,3243,9719,299,885,1906,5619,2205,6504
521310,202101,7868,20032,5569,16243,1166,3736,2408,6723,3574,10459
521340,202101,389,900,282,747,21,58,185,485,206,543
521350,202101,1978,5008,1501,4303,127,458,1063,2899,1190,3357
521370,202101,1196,3018,718,2208,203,716,89,305,292,1021
521375,202101,1192,2883,813,2344,186,536,245,795,431,1331
521377,202101,1479,3116,1094,2650,101,170,871,2225,972,2395
521380,202101,6049,15878,3922,12020,426,1426,1017,3361,1443,4787
521385,202101,634,1506,493,1329,52,134,286,828,338,962
521390,202101,685,1664,477,1363,142,446,175,528,317,974
521400,202101,2567,5927,2004,5253,217,542,1382,3737,1599,4279
521405,202101,1282,3271,928,2652,160,475,467,1315,627,1790
521410,202101,778,2081,579,1736,95,277,288,916,383,1193
521440,202101,1108,2739,799,2285,269,854,216,633,485,1487
521450,202101,3843,11264,2817,9308,742,2459,691,2496,1433,4955
521460,202101,5387,14038,3783,11221,1231,3822,893,2731,2124,6553
521470,202101,562,1485,340,1043,45,125,109,333,154,458
521480,202101,350,878,214,624,46,133,68,194,114,327
521483,202101,2301,5433,1599,4382,335,979,652,1764,987,2743
521486,202101,1735,4104,1308,3510,86,216,927,2492,1013,2708
521487,202101,392,941,272,778,42,118,142,424,184,542
521490,202101,882,2319,661,1961,37,131,448,1285,485,1416
521500,202101,2186,5239,1636,4424,95,311,1201,3168,1296,3479
521520,202101,704,1632,502,1343,73,200,204,558,277,758
521523,202101,11528,34714,9452,31455,2636,9598,2438,8453,5074,18051
521525,202101,1035,2342,791,2012,84,213,560,1429,644,1642
521530,202101,2184,5569,1338,3896,273,821,368,1079,641,1900
521540,202101,818,2038,565,1642,73,239,280,842,353,1081
521550,202101,1580,3986,873,2565,153,517,214,640,367,1157
521560,202101,4375,11344,2990,9487,444,1624,1513,5148,1957,6772
521565,202101,630,1497,482,1295,72,178,295,785,367,963
521570,202101,3167,8700,2183,6804,424,1564,177,590,601,2154
521580,202101,471,1125,272,793,36,111,87,234,123,345
521590,202101,615,1438,454,1218,78,229,267,699,345,928
521600,202101,365,973,237,722,28,69,111,336,139,405
521630,202101,1648,3567,1022,2679,204,582,346,883,550,1465
521640,202101,1801,4129,1188,3255,252,728,422,1140,674,1868
521645,202101,542,1392,349,1045,83,238,105,313,188,551
521680,202101,1060,3196,814,2724,233,848,134,497,367,1345
521690,202101,535,1278,447,1169,59,167,284,725,343,892
521710,202101,3117,7643,2017,5890,362,1203,535,1432,897,2635
521720,202101,2116,4860,1368,3747,133,412,770,2123,903,2535
521730,202101,3423,9391,2633,8064,698,2548,783,2000,1481,4548
521740,202101,3708,9576,2802,8279,643,2067,1056,3280,1699,5347
521760,202101,14220,38530,10967,33631,2708,9166,4095,13284,6803,22450
521770,202101,3011,7071,1961,5424,564,1676,500,1414,1064,3090
521800,202101,6334,16741,4605,13900,994,3061,1900,6236,2894,9297
521805,202101,443,1086,341,942,100,248,149,425,249,673
521810,202101,597,1402,425,1173,56,159,258,717,314,876
521830,202101,5407,14845,4291,13136,279,1037,3103,9313,3382,10350
521839,202101,721,1696,514,1367,80,248,287,681,367,929
521850,202101,5192,11985,3285,9208,559,1771,663,1791,1222,3562
521860,202101,1445,3852,1010,3086,183,610,314,937,497,1547
521870,202101,670,1863,485,1507,94,326,127,347,221,673
521878,202101,640,1649,443,1267,58,197,239,615,297,812
521880,202101,17875,43361,12220,34674,3065,9133,4338,12516,7403,21649
521890,202101,2962,7659,1979,5946,549,1797,387,1059,936,2856
521900,202101,1449,3353,812,2387,230,645,79,238,309,883
521910,202101,1217,2572,802,2089,68,181,446,1274,514,1455
521920,202101,482,1304,353,1087,59,207,158,465,217,672
521925,202101,735,1883,532,1581,75,239,301,890,376,1129
521930,202101,5273,12520,3489,9855,887,2363,1294,4127,2181,6490
521935,202101,1048,2472,707,1886,66,190,407,1032,473,1222
521940,202101,1284,2781,817,2160,190,562,334,867,524,1429
521945,202101,630,1645,507,1444,108,315,268,784,376,1099
521950,202101,733,1758,513,1418,125,350,206,556,331,906
521960,202101,707,1817,468,1371,52,166,243,662,295,828
521970,202101,2475,6061,1976,5469,161,435,1496,4198,1657,4633
521971,202101,723,1696,512,1379,151,406,147,403,298,809
521973,202101,1381,3538,1124,3187,43,115,900,2539,943,2654
521975,202101,11606,30462,9528,27591,1608,4768,5859,17125,7467,21893
521980,202101,2495,5821,1926,5074,150,396,1453,3914,1603,4310
521990,202101,1010,2870,807,2506,181,594,288,895,469,1489
522000,202101,2570,6698,2068,6091,314,926,1265,3915,1579,4841
522005,202101,320,773,238,649,48,136,114,313,162,449
522010,202101,3920,9457,2795,7673,566,1726,1084,2878,1650,4604
522015,202101,1004,2587,737,2178,236,675,272,841,508,1516
522020,202101,5444,12777,3537,9783,722,2113,1385,3994,2107,6107
522026,202101,752,1979,506,1552,87,295,182,517,269,812
522028,202101,406,985,302,821,70,194,128,355,198,549
522040,202101,3015,6743,2151,5605,264,743,1461,3754,1725,4497
522045,202101,16887,46416,12545,38850,2930,9772,3455,10468,6385,20240
522050,202101,1069,2790,739,2231,199,665,261,691,460,1356
522060,202101,2901,7526,2033,6093,181,553,1165,3600,1346,4153
522068,202101,1731,4429,1378,4012,113,306,1087,3209,1200,3515
522070,202101,642,1527,523,1357,19,53,437,1119,456,1172
522100,202101,714,1804,487,1460,64,218,256,734,320,952
522108,202101,1025,2537,803,2224,57,189,644,1735,701,1924
522119,202101,1588,3804,1218,3327,201,558,605,1789,806,2347
522130,202101,391,999,276,839,23,69,196,612,219,681
522140,202101,18582,48096,12956,38207,3192,10059,3469,9871,6661,19930
522145,202101,763,1883,520,1518,142,408,184,542,326,950
522150,202101,1027,2519,746,2064,197,551,224,650,421,1201
522155,202101,1074,2677,833,2304,159,387,468,1352,627,1739
522157,202101,593,1383,487,1249,25,78,390,1004,415,1082
522160,202101,5649,14467,3679,10890,994,3178,297,970,1291,4148
522170,202101,2527,6433,1907,5529,279,818,1089,3223,1368,4041
522180,202101,543,1261,345,898,57,157,84,233,141,390
522185,202101,19346,47239,13701,39539,5269,16664,2774,8719,8043,25383
522190,202101,744,1765,501,1352,90,252,204,534,294,786
522200,202101,1554,4379,1051,3453,212,762,196,587,408,1349
522205,202101,1681,3901,1281,3371,147,412,849,2245,996,2657
522220,202101,1252,3070,929,2588,111,323,550,1553,661,1876
522230,202101,1107,2767,879,2445,195,663,432,1116,627,1779
530010,202101,162687,433167,131163,387864,19343,62842,78464,228473,97807,291315